囗	uv
艹	cc
燊	ha
孃	nw
豸	pd
頫	vy
滉	do
苾	cx
妺	nh
岞	uv
翚	xg
夐	dm
丌	hp
厶	vd
匚	hv
嫋	ng
唻	kl
谞	yp
	dd
	jy
彐	vh
巛	vv
勹	pv
乇	pq
鼟	ud
鼕	uw
鬠	ir
饹	uw
饤	ud
鞥	gr
阨	ei
鈤	jo
酖	yg
這	yz
辸	nz
踰	zr
跩	zo
谉	yg
诪	yf
觝	du
觍	dj
蜰	oi
蜅	if
薢	cd
蒐	cg
萬	co
菎	co
莻	cn
苢	cu
芣	cb
臢	on
脣	io
脌	or
肐	or
聓	ge
耲	lw
羺	yy
羶	yw
籧	vh
簑	vw
筽	vk
稖	hl
硸	eu
硃	ep
砆	ee
眛	mh
盻	mb
盉	hm
皰	pb
瘧	bh
痳	ba
痀	bb
疪	bb
瓰	wf
瑩	hw
玙	wh
焾	hr
災	vh
瀽	dg
滪	dy
涢	dk
洈	dd
沴	dr
沘	db
汙	de
歞	od
欬	wd
檛	ak
梽	au
柮	ai
枂	ao
曵	ov
旡	hv
旕	fk
斠	gd
敠	yb
敁	bb
攃	fc
扥	fp
慓	xx
愒	xo
彣	wp
彔	vu
彑	vv
彊	gh
庼	gb
嶅	fu
屰	bc
尫	hw
尛	xx
孶	wz
嫳	bn
奼	np
奻	nn
奭	de
夬	vd
垇	tu
囸	wh
囜	ws
喨	kw
啂	ka
唜	hk
唈	kk
吅	kk
吂	wk
厖	iy
僜	rd
偟	rb
倆	rh
仒	rd
乻	fv
丟	ws
褔	yh
嗐	kg
伈	rx
伣	rk
伭	rw
佖	rx
佸	rq
佺	rr
佽	rd
侁	rn
侂	rg
侘	rg
侴	ri
鸼	vn
𠝹	td
鳣	yw
鲿	yx
鲝	yy
㑩	rs
嬤	ng
弨	gd
嫚	no
鞬	gy
琭	wx
珋	wp
弇	rc
赟	wb
彟	xc
潾	dm
眬	my
珪	wt
傕	rg
锜	jd
訚	my
翃	ux
瓘	wc
炘	hj
槚	mx
矞	sk
愔	xl
鞳	gc
纮	su
磻	ep
倕	rp
崟	uj
泚	dv
绹	sb
