双双	aaaa
双轨	aacx
双方	aadh
双赢	aadl
双击	aafu
双眼	aage
双语	aaiw
双手	aajf
双唇	aajf
双向	aajn
双面	aajq
双重	aajt
双边	aajz
欢欢喜喜	aall
双层	aapf
备忘录	ades
冬眠	adgp
冬季	adhz
冬瓜	adjj
冬天	adty
艰难	aeat
艰辛	aedx
艰巨	aegi
艰苦	aehx
处理器	aeoo
艰险	aepv
鸡蛋	agjl
又是	aibt
又要	aicr
又名	aido
又能	aigd
圣诞节	aihp
又说	aiiv
又不	aijy
又将	aikd
对话框	aimc
又一	aiti
又会	aivf
又有	aixd
又在	aixi
劝导	ajex
劝说	ajiv
劝告	ajjl
对不起	ajll
务实	ajnd
劝阻	ajpq
对症下药	ajth
务必	ajuj
对答如流	akrs
对簿公堂	akvw
对牛弹琴	akze
圣诞	alij
圣贤	alna
圣旨	altb
圣人	alvi
圣经	alwz
条文	amdx
条理	ameb
条规	amfv
条目	amgi
条款	amlf
条件	amtk
条例	amtt
邓小平	amtv
条约	amws
条子	amzi
观音	andb
观望	andl
观看	anjf
观摩	anjm
观察	annx
观测	ansb
观念	anvj
观众	anvv
观赏	anwn
观光	anww
观点	anyo
难兄难弟	aoav
各处	aoay
各方	aodh
各异	aoeh
各种	aoho
各项	aoij
各自	aojg
欢蹦乱跳	aojo
各地	aolc
各省	aomj
欢呼雀跃	aomo
各样	aomv
各国	aoqe
各界	aoqv
各位	aotd
各式	aoti
各个	aovi
各人	aovi
各单位	aovt
各级	aowj
各有	aoxd
鸡鸣狗盗	aoxv
各类	aoxy
各尽所能	apjg
邓小平	apmt
备忘	aqdl
备课	aqib
备受	aqjn
备用	aqnf
备案	aqnr
备注	aqsd
备份	aqtv
备有	aqxd
备战	aqyo
欢乐	arcm
欢迎	arcp
欢腾	ardv
欢欣	arjk
欢笑	arkj
欢喜	arlo
欢呼	aroj
欢送	arvy
欢快	aryz
难题	atbt
难忘	atdl
难于	atfi
难说	ativ
难看	atjf
难度	atjh
难受	atjn
难办	atjv
欢歌笑语	atki
难以	atld
难堪	atlq
难听	atoj
难民	atpt
难免	atro
难得	atsb
又一个	atvi
难道	atvj
又一次	atvr
难关	atvy
难过	atxd
难怪	atya
难点	atyo
处心积虑	auhy
对照	axbd
对头	axdd
对方	axdh
对立	axdi
对外	axdy
对峙	axel
对抗	axfd
对接	axfd
对于	axfi
对换	axfr
对白	axgi
对称	axhr
对话	axij
戏谑	axiy
对手	axjf
对了	axji
各有所爱	axjj
对不起	axjl
对面	axjq
对应	axjw
对等	axkl
对策	axkt
对此	axlt
对本	axmt
对内	axnv
对家	axnx
对口	axoi
对路	axol
对阵	axpc
对联	axpv
戏剧	axpx
对虾	axqt
对象	axro
对流	axsd
对待	axsl
对开	axth
对付	axtx
对仗	axtx
对比	axui
戏曲	axui
对着	axvf
对准	axvt
对决	axvz
对数	axxr
处处	ayay
处方	aydh
处理	ayeb
处于	ayfi
处所	ayjj
鸡犬不宁	ayjn
处长	ayki
处境	ayld
处以	ayld
处罚	ayqi
处置	ayqx
处女	ayri
处分	ayvd
处在	ayxi
败诉	baij
败坏	balj
败类	baxy
日日夜夜	bbdd
鹦鹉	bbfl
旷日持久	bbfr
明日黄花	bbhh
晶莹	bbhn
昌盛	bbjj
电影院	bbpn
晶体	bbtm
昌平	bbtv
日晒雨淋	bbus
婴儿	bbwi
曝光	bbww
影影绰绰	bbww
婴孩	bbzd
昂贵	bcqb
景观	bdan
照明	bdbd
明明	bdbd
明暗	bdbd
暗暗	bdbd
明辨是非	bdbe
明日	bdbi
明星	bdbj
影星	bdbj
明晰	bdbm
明辨是非	bdbn
明晚	bdbr
明显	bdbw
影碟	bdch
明确	bdcr
景区	bdcx
影音	bddb
明朗	bdde
明月	bddi
暗恋	bddm
明亮	bddo
暗夜	bddt
明珠	bdek
暗示	bdfm
昭示	bdfm
照抄	bdfm
照搬	bdfn
畅通无阻	bdfp
明白	bdgi
昭然若揭	bdhf
暗访	bdid
明证	bdit
影评	bdit
照顾	bdjc
景物	bdjf
照看	bdjf
明了	bdji
照应	bdjw
影视	bdjy
暗算	bdkg
影片	bdki
照片	bdki
景气	bdkz
明年	bdlc
明智	bdly
明知	bdly
照相	bdmg
照相机	bdmm
照样	bdmv
暗中	bdoi
影响	bdoj
暗器	bdoo
影院	bdpn
明基	bdqv
景色	bdrd
明媚	bdrd
景象	bdro
照射	bdrx
暗淡	bdsx
影集	bdti
暗伤	bdtl
影像	bdtr
照例	bdtt
明代	bdtv
赔偿	bdtw
明天	bdty
昭雪	bdue
照会	bdvf
照常	bdwn
明细	bdwq
照耀	bdww
照料	bdxd
暗杀	bdxm
影迷	bdxz
景点	bdyo
影子	bdzi
旺季	behz
旺盛	bejj
赋予	bfdt
显示器	bfoo
显示屏	bfpv
冒充	bgdg
冒进	bgfn
冒牌	bgkg
冒险	bgpv
冒雨	bgui
明目张胆	bgzd
日积月累	bhdq
暴动	bhfg
暴利	bhhn
暴力	bhji
日程表	bhlk
暴跌	bhol
暴行	bhsf
暴涨	bhsz
暴雨	bhui
暴露	bhuo
日暮途穷	bhvn
暴风	bhwx
暴发	bhya
申明	bibd
日照	bibd
日立	bidi
日月	bidi
日产	bidj
畅通	bidn
日夜	bidt
日文	bidx
申辩	bidx
日报	bifp
申报	bifp
日元	bifw
日期	bihe
日程	biho
申诉	biij
申请	biil
日语	biiw
畅谈	biix
日记	biiz
日历	bijj
日后	bijj
申斥	bijk
申奥	bijn
申办	bijv
日趋	bill
日志	bilu
申述	bimd
日本	bimt
电话机	bimw
日用	binf
日内	binv
日中	bioi
日期	biqv
日渐	bisc
畅游	bisd
日下	bity
日出	biue
日前	bivd
申请人	bivi
申领	bivj
日益	bivv
畅销	bivw
日常	biwn
日光	biww
贝类	bixy
日子	bizi
暧昧	bjbf
星星	bjbj
显而易见	bjbn
是不是	bjbt
晨曦	bjbv
星球	bjex
赔了夫人又折兵	bjfg
贩运	bjfg
晨报	bjfp
电视台	bjgo
星期日	bjhb
星期六	bjhd
星期	bjhe
星期三	bjhe
星期二	bjhf
星期四	bjhq
星期一	bjht
星期天	bjht
星期五	bjhw
赃物	bjjf
星辰	bjjf
时不我待	bjjs
星座	bjjv
暖气	bjkz
赃款	bjlf
贩毒	bjlq
电视机	bjmw
星空	bjnv
星际	bjpf
电视剧	bjpx
星期日	bjqb
星期六	bjqd
星期三	bjqe
星期二	bjqf
星期四	bjqq
星期一	bjqt
星期天	bjqt
星期	bjqv
星期五	bjqw
星河	bjst
贬低	bjtc
贬值	bjtx
赔礼道歉	bjvv
星级	bjwj
星光	bjww
星火	bjxi
贩卖	bjxj
账户	bkdp
账目	bkgi
账面	bkjq
账簿	bkks
账本	bkmt
账号	bkot
贻笑大方	bkyd
电影	blbd
昨日	blbi
电影院	blbp
昨晚	blbr
电量	blbt
电磁	blcv
电脑	bldd
晴朗	blde
野蛮	bldm
电邮	bldp
昨夜	bldt
野外	bldy
电站	bldy
电动	blfg
电报	blfp
电热	blfx
电能	blgd
电台	blgo
里程	blho
电工	blii
电话	blij
电讯	bliz
电视台	bljg
电力	blji
电厂	blji
电压	bljl
野生	bljl
电视机	bljm
里面	bljq
电视	bljy
电气	blkz
电表	bllk
电梯	blmv
电机	blmw
电网	blnx
电路	blol
电器	bloo
电阻	blpq
电池	blsc
电汇	blsc
电流	blsd
晦涩	blsd
电源	blsj
电波	blsj
电信	blti
昨天	blty
晴天	blty
野心	blui
野兽	blvq
电线	blwf
电学	blwn
电缆	blwn
电灯	blxt
明知故犯	blxx
电大	blyi
电教	blyz
电子	blzi
果然	bmdy
果树	bmma
照相机	bmmw
果实	bmnd
果品	bmoo
果园	bmqf
果汁	bmsx
日本人	bmvi
颗粒	bmxd
果断	bmxl
贮备	bnaq
遇难	bnat
愚昧	bnbf
愚弄	bneh
愚蠢	bnev
贮藏	bnhk
愚笨	bnkm
遇上	bnli
时间表	bnlk
遇见	bnnw
遇险	bnpv
遇到	bntg
映像	bntr
晕倒	bntt
是非曲直	bnux
则有	bnxd
贮存	bnxi
暴跳如雷	boru
最早	bpbx
最多	bpdd
最为	bpdj
最新	bpdm
最高	bpdo
最热	bpfx
最能	bpgd
昵称	bphr
最后	bpjj
最近	bpjj
最初	bpjk
最近	bpjk
最先	bpjl
最爱	bpjn
最不	bpjy
最长	bpki
最短	bply
最小	bpmi
最少	bpmj
最好	bprz
最深	bpsn
最低	bptc
最佳	bptl
最美	bpve
最终	bpwa
最有	bpxd
最大	bpyi
最快	bpyz
最强	bpzs
星期日	bqbi
星期六	bqdv
星期三	bqei
歇斯底里	bqjb
星罗棋布	bqmx
曼联	bqpv
星期四	bqqi
星期一	bqti
星期天	bqty
曼谷	bqvv
曙光	bqww
晚辈	bren
晚报	brfp
晚期	brhe
易如反掌	brjw
晚年	brlc
晚上	brli
晚宴	brnb
晚间	brnb
晚辈	brne
晚安	brnr
晚期	brqv
晚饭	brrl
赡养	brve
晚会	brvf
晚风	brwx
晚餐	bryd
易于	bsfi
购进	bsfn
购买	bsjd
购物	bsjf
购入	bsjn
遏制	bskn
易用	bsnf
购置	bsqx
购销	bsvw
易经	bswz
题为	btdj
量变	btdm
是非	bten
题目	btgi
是的	btgs
题词	btij
是不是	btjb
是否	btjy
量体裁衣	btld
题材	btmx
是非	btne
是啊	btop
量身	btri
量刑	btth
暴殄天物	bttj
量化	bttt
晴天霹雳	btuu
昆明	bubd
暴露无遗	bufq
昆虫	buqi
昆仑	buvt
昂首挺胸	bvfd
愚公移山	bvhe
赚钱	bvvf
赠送	bvvy
显然	bwdy
显现	bwen
显灵	bwex
显示	bwfm
显示器	bwfo
显著	bwhy
显赫	bwlm
显卡	bwly
显贵	bwqb
显得	bwsb
暴风骤雨	bwsu
显出	bwue
显露	bwuo
财务	bxaj
贿赂	bxba
早日	bxbi
早晨	bxbj
早晚	bxbr
时时	bxbx
早早	bxbx
财产	bxdj
早熟	bxdo
早就	bxdo
时效	bxdv
时刻	bxdy
早已	bxei
早退	bxek
早逝	bxfj
时报	bxfp
时势	bxfx
时期	bxhe
早期	bxhe
时节	bxhp
财税	bxhv
时评	bxit
财物	bxjf
时辰	bxjf
财力	bxji
时段	bxjk
早先	bxjl
财神	bxjy
时装	bxkl
时髦	bxks
早年	bxlc
早上	bxli
时过境迁	bxlj
早些	bxlt
时机	bxmw
时间	bxnb
时宜	bxnq
财富	bxnt
时空	bxnv
时限	bxpe
时隔	bxpt
时期	bxqv
早期	bxqv
晓得	bxsb
财源	bxsj
时候	bxti
财政	bxtl
时事	bxto
时速	bxto
时代	bxtv
时下	bxty
时分	bxvd
财会	bxvf
时弊	bxvn
时钟	bxvo
时常	bxwn
时尚	bxwn
时光	bxww
财经	bxwz
早在	bxxi
星火燎原	bxxj
早餐	bxyd
早点	bxyo
暑期	byhe
贴息	byjg
贴近	byjj
贴近	byjk
贴补	byjk
赌场	bylz
贴图	byqa
暑期	byqv
贴身	byri
赌注	bysd
贴切	bytd
暑假	bytp
贴心	byui
赌博	byxt
电子商务	bzda
轰动	cafg
轰隆	capa
辍学	cawn
轰炸	caxl
砥砺	cccj
轻车熟路	ccdo
砸了	ccji
软硬件	cctk
轰轰烈烈	cctt
石破天惊	ccty
较量	cdbt
也就是	cdbt
磅礴	cdch
硫磺	cdch
较多	cddd
较为	cddj
较高	cddo
轴承	cdje
迎刃而解	cdjr
较长	cdki
碎片	cdki
较小	cdmi
较少	cdmj
较好	cdrz
较低	cdtc
硫酸	cdug
轴心	cdui
较差	cdvf
较大	cdyi
轩然大波	cdys
较快	cdyz
较强	cdzs
较弱	cdzs
西班牙	ceci
转账	cfbk
轩辕	cfcl
转轨	cfcx
转为	cfdj
转产	cfdj
转变	cfdm
转弯	cfdm
票房	cfdp
转交	cfdv
转录	cfes
辅导	cfex
转动	cffg
转折	cffj
转播	cffj
飘摇	cffj
票据	cffp
转换	cffr
飘扬	cffz
转眼	cfge
转移	cfhd
飘荡	cfhs
转让	cfil
转告	cfjl
转入	cfjn
转而	cfjn
转向	cfjn
转载	cflc
转机	cfmw
转用	cfnf
转帖	cfni
剽窃	cfnv
辅助	cfqf
转身	cfri
转嫁	cfrn
飘逸	cfro
连云港	cfsh
飘浮	cfsj
轻描淡写	cfsn
转到	cftg
转型	cfth
转正	cftl
转速	cfto
转化	cftt
票价	cftv
飘零	cfuv
转会	cfvf
转发	cfya
转达	cfyz
兜售	cgti
匿名	chdo
斩草除根	chpm
雅观	cian
也是	cibt
车票	cicf
也要	cicr
车辆	cict
车轮	cicv
西欧	cicx
石头	cidd
西方	cidh
西施	cidh
车市	cidn
西部	cido
牙膏	cido
也就	cido
车站	cidy
西山	ciei
也能	cigd
西藏	cihk
也许	ciil
车库	cijc
西瓜	cijj
西段	cijk
车厢	cijm
车祸	cijy
也不	cijy
西装	cikl
西北	cikt
车载	cilc
牙齿	cilv
牙齿	cilw
也想	cimg
石榴	cimg
车间	cinb
也门	cini
西门	cini
西安	cinr
轻诺寡信	cint
西宁	cint
石器	cioo
西陆	cipf
牙刷	cipn
车队	cipv
西甲	ciqi
也罢	ciql
车身	ciri
也好	cirz
石油	cisd
也很	cise
西洋	cisv
也没	cisw
西湖	cisx
西侧	citb
车型	cith
车速	cito
也可	cito
石化	citt
邪恶	citw
雅典	ciuv
也会	civf
研讨会	civf
也曾	civq
车次	civr
也有	cixd
也在	cixi
西南	cixn
雅虎	ciyw
邪教	ciyz
车子	cizi
硕果	cjbm
也不是	cjbt
暂时	cjbx
破碎	cjcd
轿车	cjci
辘轳	cjcy
破产	cjdj
矿产	cjdj
矿山	cjei
暂无	cjfl
破损	cjfo
破获	cjhx
破译	cjia
破旧	cjib
矿物	cjjf
硕士	cjli
破坏	cjlj
破格	cjma
破案	cjnr
暂定	cjnt
破除	cjpv
暂且	cjqf
乐不思蜀	cjqq
破解	cjrd
暂行	cjsf
输入法	cjsl
暂停	cjtd
破裂	cjtd
暂住	cjtd
破例	cjtt
破灭	cjtx
斩首	cjvj
暂缓	cjwj
矿业	cjwt
破烂	cjxv
医务	claj
砝码	clcs
医护	clfd
医科	clhd
医药	clhw
医疗	cljj
医生	cljl
医术	clmd
医师	clnt
医嘱	clop
医院	clpn
医治	clsg
硅谷	clvv
医学	clwn
医学院	clwp
乐观	cman
乐意	cmdb
乐于	cmfi
鸦雀无声	cmfl
乐极生悲	cmjn
乐趣	cmll
乐器	cmoo
乐队	cmpv
乐园	cmqf
乐团	cmqx
乐曲	cmui
辖区	cncx
西安市	cndn
研究所	cnjj
研究生	cnjl
石家庄	cnjl
碗筷	cnky
研究员	cnob
研究院	cnpn
西安市	cnrd
碉堡	cnto
研究会	cnvf
辗转	cpcf
迎新	cpdm
迎春	cpev
迎接	cpfd
迎来	cptx
迎合	cpvt
迎战	cpyo
匮乏	cqjd
要务	craj
要是	crbt
软硬	crct
确立	crdi
转危为安	crdn
要把	crfd
要让	cril
确认	criv
确诊	criv
要么	crjg
要不	crjy
要将	crkd
要以	crld
要素	crlw
要想	crmg
软禁	crmm
要紧	crna
确实	crnd
要害	crnf
要用	crnf
要闻	crnp
软盘	crns
确定	crnt
要好	crrz
轻如鸿毛	crsj
软驱	crst
确切	crtd
要到	crtg
确信	crti
软件	crtk
软体	crtm
确保	crto
要价	crtv
要做	crtx
砍伐	crtx
要领	crvj
确凿	crwt
确有	crxd
要有	crxd
要在	crxi
要求	crxx
要点	cryo
软弱	crzs
要强	crzs
码头	csdd
车水马龙	cssx
覆灭	cstx
覆盖	csve
也没有	csxd
辅导	ctex
研讨	ctix
硬度	ctjh
硬币	ctjn
匪夷所思	ctjq
硬座	ctjv
研制	ctkn
研究生	ctnj
研究所	ctnj
硬盘	ctns
研究	ctnv
辅助	ctqf
昏天黑地	ctql
辐射	ctrx
硬件	cttk
硬化	cttt
硬仗	cttx
辅料	ctxd
昏迷	ctxz
研发	ctya
轮胎	cvdg
磋商	cvdn
碰撞	cvfd
轮换	cvfr
磁带	cvhn
碰巧	cvit
轮廓	cvjd
输入	cvjn
输血	cvjq
输入法	cvjs
磁场	cvlz
轮椅	cvmy
磁盘	cvns
轮船	cvns
输家	cvnx
轮回	cvqo
轮流	cvsd
破釜沉舟	cvsn
碰到	cvtg
输出	cvue
输送	cvvy
匹夫	cwfv
医学院	cwpn
连续剧	cwpx
匹配	cwuz
硝烟	cwxq
欧盟	cxbd
轨迹	cxdm
殴打	cxft
欧元	cxfw
区委	cxhr
区长	cxki
区域	cxlt
区间	cxnb
区别	cxoj
区号	cxot
欧阳	cxpb
欧洲	cxsy
区位	cxtd
磷酸	cxug
区分	cxvd
欧美	cxve
轨道	cxvj
区划	cxxn
西餐厅	cydj
孵化	cytt
连日	czbi
轻易	czbs
轻轻	czcz
连连	czcz
连胜	czdj
连夜	czdt
轻率	czdw
连理	czeb
连环	czej
连接	czfd
轻薄	czhs
轻工	czii
轻重	czjt
轻视	czjy
轻装	czkl
连载	czlc
连年	czlc
轻松	czmv
轻舟	czns
连同	cznt
轻微	czse
轻型	czth
连任	cztj
轻便	cztt
连锁	czvw
轻纺	czwd
连线	czwf
连绵	czwg
连续	czwx
连忙	czyd
轻快	czyz
轻盈	czzj
胳膊	dadf
胳膊	dadt
服务员	daob
胳臂	dapo
服务业	dawt
胆量	dbbt
竟是	dbbt
音量	dbbt
彰显	dbbw
音乐	dbcm
腥膻	dbdd
音效	dbdv
意义	dbdx
竟然	dbdy
意外	dbdy
章程	dbho
章节	dbhp
童话	dbij
竭诚	dbij
意识	dbio
胆识	dbio
意识到	dbit
意愿	dbjg
竭力	dbji
文明礼貌	dbjj
音质	dbjj
意向	dbjn
竟敢	dbjp
音箱	dbkm
音符	dbkt
意气	dbkz
童年	dblc
意境	dbld
意志	dblu
意见	dbnw
意味	dbof
音响	dboj
意味着	dbov
竭尽	dbpn
意图	dbqa
胆略	dbqa
意甲	dbqi
意思	dbqu
赣江	dbsi
章法	dbsl
这时候	dbti
音像	dbtr
意念	dbvj
韶关	dbvy
意料	dbxd
意大利	dbyh
音频	dbyj
胆怯	dbyl
胆子	dbzi
怨怼	dcax
头昏脑胀	dcdd
怨言	dcii
头破血流	dcjs
鸳鸯	dcny
腰包	dcse
头条	ddam
头头是道	ddbv
多时	ddbx
斗殴	ddcx
头脑	dddd
多头	dddd
多方	dddh
多月	dddi
肮脏	dddj
多方面	dddj
多变	dddm
臃肿	dddo
多名	dddo
外交部	dddo
头部	dddo
肥胖	dddv
膀胱	dddw
亭亭玉立	dded
多云	ddfg
多于	ddfi
脱胎换骨	ddfq
脉搏	ddft
多元	ddfw
头目	ddgi
肥皂	ddgt
多种	ddho
辛亥革命	ddhv
多功能	ddig
多项	ddij
多谢	ddir
头皮	ddja
头疼	ddja
肥厚	ddjb
头痛	ddjd
忍痛	ddjd
多么	ddjg
多了	ddji
多彩	ddjm
忍受	ddjn
忍耐	ddjn
多方面	ddjq
忍不住	ddjt
多重	ddjt
多边	ddjz
脑筋	ddkd
多长	ddki
头等	ddkl
多年	ddlc
头上	ddli
多年来	ddlt
斗志	ddlu
肥缺	ddlx
肝胆相照	ddmb
多少	ddmj
多极	ddmj
多样	ddmv
多家	ddnx
多吃	ddol
新产品	ddoo
头号	ddot
多层	ddpf
斗争	ddre
多久	ddrn
多媒体	ddrt
主旋律	ddse
胶水	ddsi
肥沃	ddsj
高朋满座	ddsj
脑海	ddsl
头衔	ddsv
多位	ddtd
旁敲侧击	ddtf
头顶	ddtj
多事	ddto
胶囊	ddto
头像	ddtr
脑袋	ddtv
多个	ddvi
多人	ddvi
脍炙人口	ddvo
脉冲	ddvo
多次	ddvr
多余	ddvt
多多益善	ddvv
多半	ddvx
脉络	ddwa
头绪	ddwy
朋友	ddxa
肥料	ddxd
立方米	ddxi
多数	ddxr
头盔	ddxx
头发	ddya
忍者	ddyb
肥大	ddyi
多大	ddyi
多情	ddyl
多点	ddyo
多达	ddyz
脑子	ddzi
主观	dean
主题	debt
主要	decr
主意	dedb
主义	dedx
主导	deex
主动	defg
主干	defi
主持	defl
主打	deft
主营	dehn
良种	deho
主攻	deia
朗诵	deid
端详	deiv
朗读	deix
主页	dejb
主席	dejh
主力	deji
主办	dejv
主管	dekn
端午	delx
主场	delz
主权	dema
主板	demj
主机	demw
良机	demw
主宰	dend
主帅	denn
主见	denw
端口	deoi
主妇	dere
主角	deri
良好	derz
主流	desd
主演	desn
高山流水	dess
主旨	detb
端倪	detg
新春佳节	deth
主任	detj
端正	detl
主体	detm
良心	deui
主食	devd
主人	devi
主次	devr
主编	dewd
主线	dewf
主犯	dexj
刀山火海	dexs
良性	deyj
主张	dezs
那里	dfbl
那时	dfbx
肝胆	dfdb
肝脏	dfdj
那种	dfho
那么	dfjg
腾云驾雾	dfju
那边	dfjz
那年	dflc
胸无城府	dflj
那些	dflt
新技术	dfmd
那样	dfmv
交换机	dfmw
肤色	dfrd
忍无可忍	dftd
多元化	dftt
那份	dftv
那天	dfty
那个	dfvi
主持人	dfvi
肝炎	dfxx
胸无点墨	dfyq
充电	dgbl
高瞻远瞩	dgfg
育种	dgho
竣工	dgii
熟能生巧	dgji
充斥	dgjk
脾气	dgkz
充气	dgkz
弃权	dgma
充实	dgnd
充足	dgol
充满	dgsh
充沛	dgst
充值	dgtx
充分	dgvd
育人	dgvi
充当	dgwe
胎儿	dgwi
育儿	dgwi
放电	dhbl
放映	dhbn
旋转	dhcf
施肥	dhdd
放弃	dhdg
朦胧	dhdx
旁若无人	dhfv
高科技	dhfx
放眼	dhge
旅程	dhho
方程	dhho
放荡	dhhs
施工	dhii
放手	dhjf
方向	dhjn
放入	dhjn
施加	dhjo
方面	dhjq
旅社	dhjy
旅店	dhjy
放肆	dhke
方块	dhlz
放松	dhmv
旅客	dhna
放宽	dhnh
旗帜	dhni
方案	dhnr
旗舰	dhns
旗号	dhot
施展	dhph
方略	dhqa
方圆	dhqo
放置	dhqx
旅馆	dhrl
放射	dhrx
旅游	dhsd
旋律	dhse
旅行	dhsf
施行	dhsf
放行	dhsf
旅行社	dhsj
方法	dhsl
鹏程万里	dhtb
方位	dhtd
放下	dhtd
放到	dhtg
放开	dhth
方形	dhth
方式	dhti
方正	dhtl
方可	dhto
放假	dhtp
方便	dhtt
旅伴	dhtv
放下	dhty
旗下	dhty
放出	dhue
放心	dhui
施舍	dhvf
多愁善感	dhvj
旅途	dhvt
方针	dhvx
放学	dhwn
放纵	dhwv
旋风	dhwx
放过	dhxd
放在	dhxi
放慢	dhyb
放大	dhyi
名落孙山	dhze
月票	dicf
立方	didh
月亮	dido
由衷	dido
立刻	didy
立即	dieg
凸现	dien
通讯录	dies
月球	diex
由于	difi
月刊	difn
月报	difp
多功能	digd
月薪	dihd
月季	dihz
立功	diij
立项	diij
月底	dijc
月历	dijj
月初	dijk
通讯社	dijy
刀片	diki
由此	dilt
立志	dilu
立场	dilz
高谈阔论	dini
立案	dinr
月内	dinv
通讯员	diob
月中	dioi
立足	diol
夕阳	dipb
弃旧图新	diqd
立国	diqe
月饼	dirl
立法	disl
意识到	ditg
立体	ditm
月末	ditm
月份	ditv
由来	ditx
月光	diww
月经	diwz
文不对题	djab
为难	djat
胜败	djba
产量	djbt
高质量	djbt
为时	djbx
为辅	djct
产区	djcx
头重脚轻	djdc
眉头	djdd
为主	djde
胚胎	djdg
为由	djdi
腼腆	djdu
为之	djdz
六神无主	djfd
熟视无睹	djfg
永远	djfw
亲爱的	djgs
毫不留情	djgy
为期	djhe
胜利	djhn
胜诉	djij
产物	djjf
为了	djji
产后	djjj
产生	djjl
忘乎所以	djjl
为生	djjl
永垂不朽	djjm
望而生畏	djjq
为重	djjt
永不	djjy
胜地	djlc
产地	djlc
之所以	djld
为止	djli
新加坡	djlj
为此	djlt
望而却步	djly
产权	djma
文质彬彬	djmm
为本	djmt
预选赛	djnf
忍痛割爱	djnj
义不容辞	djnj
为宜	djnq
刻不容缓	djnw
产品	djoo
变压器	djoo
为民	djpt
为国	djqe
为期	djqv
胜负	djrb
颜色	djrd
产妇	djre
永久	djrn
忍不住	djtd
放手一搏	djtf
离不开	djth
胜任	djtj
为什么	djtj
新生事物	djtj
产假	djtp
为例	djtt
为何	djtt
胜仗	djtx
产值	djtx
亲痛仇快	djty
胜出	djue
产出	djue
为人	djvi
为首	djvj
为准	djvt
产销	djvw
妄自尊大	djvy
产业	djwt
颜料	djxd
为数	djxr
永恒	djyt
衣服	dkdp
衣物	dkjf
衣架	dkjo
立竿见影	dknb
忍气吞声	dktl
衣着	dkvf
衣裳	dkwn
意气风发	dkwy
斗志昂扬	dlbf
巴西	dlci
房地产	dldj
膨胀	dldk
腹部	dldo
脚印	dlep
盲目	dlgi
赢利	dlhn
巴黎	dlhs
忘记	dliz
肚皮	dlja
忘了	dlji
通知书	dljj
由此及彼	dljs
忘却	dllg
巴士	dlli
怨声载道	dllv
妄想	dlmg
脚本	dlmt
忘本	dlmt
赢家	dlnx
妄图	dlqa
赢得	dlsb
腹泻	dlsn
多年来	dltx
站起来	dltx
脚下	dlty
望着	dlvf
亡命	dlvt
盲从	dlvv
巴结	dlwl
脚步	dlyi
肚子	dlzi
新星	dmbj
亲昵	dmbp
变量	dmbt
新贴	dmby
新车	dmci
新意	dmdb
亲朋	dmdd
新郎	dmde
变为	dmdj
变通	dmdn
新产品	dmdo
新高	dmdo
新房	dmdp
变脸	dmdv
新股	dmdw
亦然	dmdy
新建	dmef
变异	dmeh
新春	dmev
变动	dmfg
新技术	dmfm
变换	dmfr
亲热	dmfx
亲眼	dmge
新的	dmgs
新兵	dmgv
变革	dmhp
新世纪	dmhw
新药	dmhw
新秀	dmhz
新手	dmjf
亲手	dmjf
亲自	dmjg
变成	dmjj
新书	dmjj
变质	dmjj
变本加厉	dmjj
亲近	dmjk
新近	dmjk
亲戚	dmjl
新生	dmjl
亲爱	dmjn
恋爱	dmjn
变迁	dmjx
亲笔	dmkj
新年	dmlc
新款	dmlf
新城	dmlj
望梅止渴	dmls
新增	dmlv
变相	dmmg
蛮横	dmmh
新村	dmmx
亲临	dmnk
新闻	dmnp
亲密	dmnu
新宠	dmnx
弯路	dmol
亲属	dmpj
新居	dmpx
新贵	dmqb
新婚	dmrc
变色	dmrd
新娘	dmrd
胆小如鼠	dmrg
亲身	dmri
变身	dmri
迹象	dmro
新鲜	dmrt
变得	dmsb
新浪	dmsd
变法	dmsl
新潮	dmsx
变更	dmtb
亲切	dmtd
新型	dmth
新颖	dmth
变形	dmth
亲信	dmti
变焦	dmti
新华社	dmtj
新政	dmtl
新作	dmtl
新歌	dmto
变速	dmto
亦可	dmto
变化	dmtt
多样化	dmtt
新华	dmtt
弯曲	dmui
亲人	dmvi
新人	dmvi
恋人	dmvi
新锐	dmvv
变幻	dmwj
新兴	dmwv
新风	dmwx
亲友	dmxa
变态	dmyd
亲情	dmyl
恋情	dmyl
新奇	dmyt
巴格达	dmyz
亲子	dmzi
新疆	dmzs
商务	dnaj
旁观	dnan
通畅	dnbi
通电	dnbl
市里	dnbl
商量	dnbt
通车	dnci
市区	dncx
商户	dndp
市郊	dndv
勇于	dnfi
亲密无间	dnfn
市井	dnfn
通报	dnfp
商贸	dngd
旁白	dngi
市委	dnhr
通称	dnhr
商议	dnid
通话	dnij
商讨	dnix
商谈	dnix
通讯	dniz
商厦	dnjj
高官厚禄	dnjj
通告	dnjl
通向	dnjn
勇敢	dnjp
市面	dnjq
通病	dnjt
商店	dnjy
旁边	dnjz
市长	dnki
勇气	dnkz
勇士	dnli
商城	dnlj
通知	dnly
市场	dnlz
商场	dnlz
商标	dnmf
通顺	dnmj
商榷	dnmp
商机	dnmw
通用	dnnf
商用	dnnf
商定	dnnt
市内	dnnv
市容	dnnv
通宵	dnnw
商家	dnnx
通用性	dnny
商品房	dnod
通路	dnol
商品	dnoo
市中心	dnou
市民	dnpt
帝国	dnqe
商界	dnqv
通奸	dnrf
通往	dnsd
通行	dnsf
通信	dnti
市政	dntl
雍容华贵	dntq
为非作歹	dntt
通俗	dntv
市价	dntv
市值	dntx
商会	dnvf
商人	dnvi
通道	dnvj
商铺	dnvt
通关	dnvy
通常	dnwn
通缉	dnwo
商业	dnwt
通风	dnwx
通过	dnxd
勇猛	dnxj
刻舟求剑	dnxv
通宵达旦	dnyb
通用性	dnyj
商情	dnyl
通达	dnyz
高昂	dobc
高明	dobd
就是	dobt
高雅	doci
名医	docl
就医	docl
享乐	docm
哀乐	docm
就要	docr
就连	docz
高端	dode
豪放	dodh
名胜	dodj
名为	dodj
高产	dodj
高新	dodm
高高	dodo
高效	dodv
京郊	dodv
名义	dodx
高峰	doea
高山	doei
衰退	doek
名录	does
高招	dofd
竞拍	dofg
高于	dofi
毫无	dofl
敲打	doft
竞投	dofw
竞技	dofx
就能	dogd
高能	dogd
高薪	dohd
名利	dohn
名称	dohr
部委	dohr
部落	dohs
衰落	dohs
名著	dohy
名言	doii
名词	doij
敲诈	doil
就让	doil
烹调	doin
就诊	doiv
就读	doix
高手	dojf
高原	dojg
肿瘤	dojg
高度	dojh
毫升	dojh
亮度	dojh
就近	dojk
竞选	dojl
高压	dojl
享受	dojn
就座	dojv
熟悉	dojx
毫不	dojy
就不	dojy
名将	dokd
名牌	dokg
就算	dokg
部长	doki
名片	doki
高等	dokl
高管	dokn
名气	dokz
豪气	dokz
享年	dolc
就地	dolc
高地	dolc
名声	dold
名城	dolj
京城	dolj
高超	doll
就此	dolt
高龄	dolw
熟知	doly
高校	domd
竞相	domg
亮相	domg
名模	domh
豪杰	domh
剖析	domj
高档	domw
高楼	domx
高攀	domx
名额	dona
高额	dona
竞赛	donf
享用	donf
部门	doni
豪门	doni
敲门	doni
豪宅	donj
脚踏实地	donl
高官	donp
名师	dont
敲定	dont
高空	donv
名家	donx
名字	donz
哀叹	dooa
高唱	doob
高中	dooi
高喊	dooj
敲响	dooj
高呼	dooj
就叫	dool
召唤	door
高层	dopf
就职	dopo
部队	dopv
京剧	dopx
高贵	doqb
名贵	doqb
新中国	doqe
召回	doqo
部署	doqy
竞争	dore
高危	dorj
烹饪	dorl
就象	doro
就好	dorz
高温	dosb
高粱	dosd
名流	dosd
高清	dosl
高深	dosn
高潮	dosx
高涨	dosz
高低	dotc
名列	dotd
部位	dotd
高位	dotd
召开	doth
召集	doti
就任	dotj
部件	dotk
哀伤	dotl
名作	dotl
高傲	dotl
亮丽	dotn
高速	doto
敦促	doto
就像	dotr
豪华	dott
京华	dott
竞价	dotv
高价	dotv
名优	dotx
部优	dotx
就来	dotx
名下	doty
部下	doty
衷心	doui
名单	dovb
部分	dovd
高分	dovd
就会	dovf
名人	dovi
熟人	dovi
衰减	dovj
名次	dovr
高级	dowj
部级	dowj
高尚	down
就学	down
就业	dowt
熟练	dowt
高兴	dowv
名誉	dowv
享誉	dowv
就绪	dowy
就有	doxd
享有	doxd
敦煌	doxg
高雄	doxg
毫米	doxi
就在	doxi
竞猜	doxj
哀求	doxx
京都	doyb
就餐	doyd
高大	doyi
高频	doyj
亮点	doyo
高考	doys
衰老	doyt
哀悼	doyy
高达	doyz
高教	doyz
衰弱	dozs
服务	dpaj
服务员	dpao
邮电	dpbl
邮购	dpbs
邮票	dpcf
肩膀	dpdd
雇主	dpde
房产	dpdj
户外	dpdy
启迪	dpdz
启动	dpfg
启示	dpfm
启蒙	dphn
启程	dpho
房租	dphq
服药	dphw
服膺	dpjt
肇庆	dpjy
遍及	dpjz
户籍	dpke
服装	dpkl
邮箱	dpkm
服气	dpkz
遍地	dplc
房地产	dpld
房间	dpnb
启用	dpnf
服用	dpnf
雇用	dpnf
邮寄	dpny
雇员	dpob
户口	dpoi
翩跹	dpol
邮局	dppj
房屋	dppt
肩负	dprb
服饰	dprl
房源	dpsj
服役	dpsw
服刑	dpth
户型	dpth
新陈代谢	dpti
邮件	dptk
邮政	dptl
房东	dptm
雇佣	dptn
肇事	dpto
启事	dpto
邮资	dpvr
服从	dpvv
邮递	dpvz
邮编	dpwd
遍布	dpxn
启发	dpya
房子	dpzi
房改	dpzl
邮费	dpzs
胭脂	dqdt
颤抖	dqfd
颤动	dqfg
禀报	dqfp
外国语	dqiw
鹬蚌相争	dqmr
迪斯尼	dqpt
忘恩负义	dqrd
外国人	dqvi
高尔夫	drfv
多如牛毛	drkj
多媒体	drtm
变色龙	drxt
脆弱	drzs
高清晰	dsbm
哀鸿遍野	dsdb
胸部	dsdo
文汇报	dsfp
眉清目秀	dsgh
胸襟	dsjk
高水平	dstv
望洋兴叹	dswo
胸怀	dsyj
预备	dtaq
夜里	dtbl
夜晚	dtbr
柔软	dtcr
新一轮	dtcv
脂肪	dtdd
肺腑	dtdj
预示	dtfm
预报	dtfp
预留	dtgd
眉开眼笑	dtgk
眉来眼去	dtgl
预期	dthe
柔和	dtho
预警	dths
预言	dtii
名正言顺	dtim
预订	dtit
预计	dtix
为什么	dtjg
预习	dtji
矛盾	dtjj
预告	dtjl
预先	dtjl
预选	dtjl
忍俊不禁	dtjm
肺癌	dtjo
肺病	dtjt
预感	dtjt
脱颖而出	dtju
新华社	dtjy
预算	dtkg
股份制	dtkn
予以	dtld
夜间	dtnb
预览	dtnk
预案	dtnr
预定	dtnt
预见	dtnw
预防	dtpd
预期	dtqv
预置	dtqx
夜色	dtrd
预测	dtsb
预演	dtsn
预售	dtti
新一代	dttv
文件夹	dttv
预付	dttx
柔道	dtvj
预兆	dtvw
预约	dtws
预支	dtxa
预料	dtxd
肺炎	dtxx
柔情	dtyl
柔弱	dtzs
交叉	dvad
效果	dvbm
交易	dvbs
郊区	dvcx
六月	dvdi
脱产	dvdj
交通	dvdn
效率	dvdv
效率	dvdw
脱离	dvdx
交接	dvfd
交换	dvfr
盲人摸象	dvfr
交替	dvfv
效能	dvgd
盲人瞎马	dvgs
脱稿	dvhd
效劳	dvhn
脱节	dvhp
脱落	dvhs
交警	dvhs
交谈	dvix
腾讯	dviz
脸皮	dvja
效力	dvji
亡羊补牢	dvjn
效应	dvjw
脸上	dvli
腾空	dvnv
效忠	dvoi
交响	dvoj
交际	dvpf
脱险	dvpv
交界	dvqv
脸色	dvrd
交汇	dvsc
交流	dvsd
交往	dvsd
交待	dvsl
效法	dvsl
交涉	dvsy
效仿	dvtd
交互	dvtl
交融	dvto
交货	dvtt
交代	dvtv
交付	dvtx
交出	dvue
交心	dvui
交锋	dvva
脱贫	dvvd
膳食	dvvd
交钱	dvvf
交错	dvvh
率领	dvvj
脱钩	dvvs
效益	dvvv
脱销	dvvw
交纳	dvwn
交织	dvwo
交给	dvwv
交友	dvxa
六十	dvxi
交火	dvxi
交情	dvyl
交战	dvyo
腾飞	dvzv
股票	dwcf
肌肤	dwdf
畜产	dwdj
股市	dwdn
方兴未艾	dwfh
望风披靡	dwfj
股指	dwft
股评	dwit
畜牧	dwjf
股息	dwjg
率先	dwjl
这几年	dwlc
股权	dwma
股本	dwmt
肌肉	dwnv
股民	dwpt
股东	dwtm
产业化	dwtt
股份	dwtv
刀光剑影	dwvb
率领	dwvj
玄学	dwwn
义务	dxaj
这条	dxam
文明	dxbd
这里	dxbl
这是	dxbt
剂量	dxbt
这时	dxbx
文章	dxdb
文盲	dxdl
这就	dxdo
毅然	dxdy
辩护	dxfd
文摘	dxfd
就在于	dxfi
文科	dxhd
文稿	dxhd
辛劳	dxhn
这种	dxho
辛勤	dxho
文革	dxhp
文秘	dxhu
辛苦	dxhx
文艺	dxhz
这项	dxij
辨识	dxio
辩证	dxit
辩论	dxiv
辨认	dxiv
离谱	dxiv
文库	dxjc
文物	dxjf
这么	dxjg
毅力	dxji
文书	dxjj
胸有成竹	dxjk
这段	dxjk
文采	dxjm
紊乱	dxjx
这边	dxjz
这篇	dxkd
文笔	dxkj
义气	dxkz
这款	dxlf
文坛	dxlf
离去	dxlg
这些	dxlt
这场	dxlz
这块	dxlz
辣椒	dxml
文本	dxmt
这本	dxmt
这样	dxmv
文档	dxmw
这家	dxnx
离家	dxnx
文字	dxnz
辨别	dxoj
离别	dxoj
这只	dxov
文史	dxox
离职	dxpo
文具	dxqe
这回	dxqo
离婚	dxrc
辩解	dxrd
文过饰非	dxre
文过饰非	dxrn
文娱	dxro
文汇报	dxsf
这位	dxtd
离开	dxth
这一	dxti
文集	dxti
文凭	dxtj
离任	dxtj
文件	dxtk
这件	dxtk
肢体	dxtm
离休	dxtm
文体	dxtm
朋友们	dxtn
文化	dxtt
这份	dxtv
这一点	dxty
这下	dxty
辛酸	dxug
齐心	dxui
离心	dxui
齐全	dxve
这个	dxvi
文人	dxvi
这次	dxvr
离线	dxwf
这儿	dxwi
文学	dxwn
文献	dxxn
吝啬	dxxv
这类	dxxy
这点	dxyo
离奇	dxyt
文教	dxyz
脖子	dxzi
辫子	dxzi
离子	dxzi
这张	dxzs
外观	dyan
外遇	dybn
刻意	dydb
外交部	dydd
胆大妄为	dydd
外方	dydh
站立	dydi
腌臜	dydj
外衣	dydk
亦步亦趋	dydl
外商	dydn
外部	dydo
外交	dydv
外文	dydx
站岗	dyen
刻录	dyes
外接	dyfd
外援	dyfj
外挂	dyfl
外贸	dygd
站台	dygo
外科	dyhd
意大利	dyhn
站稳	dyhr
刻苦	dyhx
外语	dyiw
外设	dyiw
外貌	dyjg
然后	dyjj
外甥	dyjl
然而	dyjn
外币	dyjn
外向	dyjn
外加	dyjo
外面	dyjq
外籍	dyke
站长	dyki
外长	dyki
外地	dylc
外表	dylk
外壳	dyln
外省	dymj
外国	dyqe
外围	dyqf
外界	dyqv
外汇	dysc
外包	dyse
外行	dysf
胆大包天	dyst
外形	dyth
外伤	dytl
外事	dyto
刻画	dytq
为虎作伥	dytt
外来	dytx
外出	dyue
外公	dyvg
外人	dyvi
外资	dyvr
外销	dyvw
外线	dywf
主教练	dywt
站在	dyxi
外在	dyxi
站点	dyyo
之处	dzay
之日	dzbi
之星	dzbj
之时	dzbx
之旅	dzdh
之夜	dzdt
之外	dzdy
之二	dzfi
之势	dzfx
之谜	dzix
之夏	dzjg
之力	dzji
之后	dzjj
之初	dzjk
之所以	dzjl
之声	dzld
之上	dzli
之间	dznb
之内	dznv
之窗	dznv
之家	dznx
外强中干	dzof
之中	dzoi
之际	dzpf
之争	dzre
眉飞色舞	dzrl
之行	dzsf
之下	dztd
之一	dzti
之下	dzty
之心	dzui
之前	dzvd
肠道	dzvj
之首	dzvj
之余	dzvt
之类	dzxy
之情	dzyl
之战	dzyo
玫瑰	eaeg
理财	ebbx
理由	ebdi
璎珞	ebea
理睬	ebgj
理科	ebhd
春暖花开	ebht
理工	ebii
理论	ebiv
理应	ebjw
理智	ebly
理想	ebmg
理顺	ebmj
理喻	ebov
理解	ebrd
山明水秀	ebsh
理事	ebto
理化	ebtt
理会	ebvf
理念	ebvj
理学	ebwn
理发	ebya
理性	ebyj
岩石	ecci
崭新	ecdm
山西省	ecmj
崇文区	edcx
岁月	eddi
三头六臂	eddp
斑斓	eddx
峨眉山	edei
琼瑶	edej
斑竹	edki
崩溃	edsq
岁末	edtm
玉米	edxi
斑点	edyo
瑞星	eebj
琵琶	eeee
璀璨	eeey
瑞士	eeli
琳琅满目	eesg
瑞典	eeuv
玩乐	efcm
玩意	efdb
建立	efdi
建房	efdp
建交	efdv
玩弄	efeh
建议	efid
建设	efiw
建成	efjj
建造	efjl
玩耍	efjn
建筑	efki
玩笑	efkj
建制	efkn
建起	efll
建树	efma
建构	efms
建材	efmx
玩家	efnx
玩具	efqe
建国	efqe
建仓	efvc
玩命	efvt
即日	egbi
既是	egbt
即时	egbx
既要	egcr
即刻	egdy
既然	egdy
既能	eggd
秦皇岛	egge
即席	egjh
既不	egjy
即将	egkd
瑰宝	egne
既定	egnt
即可	egto
即使	egtt
即便	egtt
即兴	egwv
既有	egxd
巍峨	ehej
春花秋月	ehhd
异议	ehid
玩世不恭	ehjh
嵌入	ehjn
异地	ehlc
异域	ehlt
异样	ehmv
异味	ehof
异国	ehqe
弄得	ehsb
弄清	ehsl
异化	ehtt
异常	ehwn
异类	ehxy
异性	ehyj
三星	eibj
山西	eici
三轮	eicv
山区	eicx
山脉	eidd
三月	eidi
山峰	eiea
三峡	eiet
三种	eiho
三百	eijb
已成	eijj
山庄	eijl
王府	eijt
三千	eijx
已将	eikd
王牌	eikg
三等	eikl
山地	eilc
肃静	eild
理论上	eili
山上	eili
已知	eily
山川	eimi
山林	eimm
山村	eimx
三军	einc
山寨	einf
山路	eiol
三国	eiqe
王国	eiqe
已婚	eirc
三角	eiri
山水	eisi
肃清	eisl
山沟	eiss
三言两语	eiti
山顶	eitj
山东	eitm
山羊	eivf
三个	eivi
山谷	eivv
三级	eiwj
三维	eiwt
已经	eiwz
王朝	eixb
已有	eixd
三十	eixi
已在	eixi
王者	eiyb
已达	eiyz
王子	eizi
群星	ejbj
君主	ejde
玻璃	ejed
峨嵋	ejed
环球	ejex
群岛	ejge
三顾茅庐	ejhj
环节	ejhp
岸边	ejjz
环境	ejld
环城	ejlj
环卫	ejpt
群体	ejtm
环保	ejto
群众	ejvv
理所当然	ejwd
群组	ejwq
三番五次	ejwv
环绕	ejwx
群雄	ejxg
群发	ejya
君子	ejzi
退耕	ekem
退换	ekfr
退税	ekhv
恳请	ekil
退还	ekjy
珠宝	ekne
退职	ekpo
退居	ekpx
退回	ekqo
珠江	eksi
珠海	eksl
退役	eksw
恳切	ektd
三长两短	ektl
退休	ektm
退货	ektt
退化	ektt
退伍	ektw
退出	ekue
退缩	ekwn
退学	ekwn
恳求	ekxx
退步	ekyi
屹立	eldi
珐琅	eled
耕耘	emem
肃穆	emhg
耕种	emho
耕地	emlc
肃静	emld
耗材	emmx
肃清	emsl
异想天开	emtt
耗资	emvr
耗费	emzs
悲观	enan
现时	enbx
悲哀	endo
崇高	endo
现房	endp
现已	enei
班门弄斧	enev
珊瑚	enex
岁寒三友	enex
崇敬	enhs
悲痛	enjd
崇拜	enjf
现成	enjj
现状	enky
现年	enlc
现场	enlz
现实	ennd
现阶段	enpj
悲剧	enpx
灵丹妙药	enrh
现象	enro
现行	ensf
非法	ensl
山穷水尽	ensp
现役	ensw
非洲	ensy
岗位	entd
现任	entj
悲伤	entl
现代化	entt
现货	entt
现代	entv
现出	enue
现金	envi
现今	envj
非凡	enwd
非常	enwn
崇尚	enwn
现有	enxd
春寒料峭	enxe
现在	enxi
现存	enxi
悲愤	enyx
噩耗	eoem
异口同声	eonl
印章	epdb
理屈词穷	epin
印证	epit
印记	epiz
印度	epjh
现阶段	epjk
印制	epkn
崛起	epll
印刷	eppn
印尼	eppt
珠联璧合	eppv
印象	epro
印染	epsx
印发	epya
三思而后行	eqjs
三国志	eqlu
峥嵘	ereh
三角洲	ersy
录音	esdb
剥离	esdx
玛瑙	eses
逮捕	esff
逮捕	esft
既往不咎	esja
隶书	esjj
录入	esjn
录制	eskn
录用	esnf
录取	espa
斑驳陆离	espd
隶属	espj
玛丽	estn
录像	estr
剥削	eswd
剥夺	esyx
崔嵬	eteg
春华秋实	ethn
录像带	ethn
弄假成真	etjx
山东省	etmj
山东省	etmm
现代化	ettt
峡谷	etvv
三心二意	eufd
异曲同工	euni
奉劝	evaj
泰斗	evdd
泰山	evei
嵯峨	evej
珍珠	evek
秦岭	evev
玲珑	evex
春运	evfg
春兰秋菊	evhh
珍藏	evhk
春节	evhp
春秋	evhx
珍稀	evhx
春季	evhz
奉承	evje
春夏	evjg
珍爱	evjn
珍重	evjt
珍视	evjy
珍宝	evne
泰安	evnr
春联	evpv
珍贵	evqb
泰国	evqe
春色	evrd
春游	evsd
奉行	evsf
春天	evty
奉命	evvt
奉送	evvy
三令五申	evwb
春光	evww
春风	evwx
秦朝	evxb
奉献	evxn
岭南	evxn
珍惜	evyh
春光明媚	ewbr
球星	exbj
导购	exbs
灵通	exdn
嶙峋	exes
灵魂	exfg
寻找	exfx
导言	exii
灵巧	exit
导读	exix
琢磨	exjm
导向	exjn
导入	exjn
寻觅	exjn
灵感	exjt
理直气壮	exkk
岂有此理	exle
灵敏	exlq
球场	exlz
球赛	exnf
导航	exns
导师	exnt
球员	exob
寻呼	exoj
球队	expv
寻思	exqu
导游	exsd
灵活	exsj
导演	exsn
导致	extg
导出	exue
导线	exwf
寻常	exwn
寻求	exxx
球迷	exxz
导弹	exzs
崎岖	eyec
琥珀	eyeg
班长	eyki
弄虚作假	eytt
班次	eyvr
班级	eywj
三教九流	eyxs
班子	eyzi
凯旋	ezdh
岂能	ezgd
岂敢	ezjp
岂不	ezjy
凯歌	ezto
觊觎	ezvt
摊牌	fakg
指桑骂槐	faom
摊派	fasj
摊位	fatd
无条件	fatk
择优	fatx
择业	fawt
揭晓	fbbx
提早	fbbx
提要	fbcr
提高	fbdo
提名	fbdo
提交	fbdv
提示	fbfm
揭示	fbfm
提携	fbft
揭批	fbfu
提拔	fbfx
揭幕	fbhb
揭秘	fbhu
提议	fbid
打电话	fbij
提请	fbil
提升	fbjh
提成	fbjj
捏造	fbjl
担架	fbjo
提及	fbjz
披星戴月	fbld
提款	fblf
提起	fbll
提问	fbno
提案	fbnr
摄影师	fbnt
揭穿	fbnv
提取	fbpa
捍卫	fbpt
担负	fbrb
提倡	fbtb
提到	fbtg
提供	fbth
揭开	fbth
担任	fbtj
担保	fbto
提速	fbto
提价	fbtv
提醒	fbub
提出	fbue
担心	fbui
揭露	fbuo
提前	fbvd
担当	fbwe
提纲	fbwn
提纯	fbwt
提炼	fbxt
揭发	fbya
担忧	fbyx
担子	fbzi
抵抗	fcfd
抵押	fcfq
抵挡	fcfw
抵制	fckn
抑制	fckn
拓宽	fcnh
抠门	fcni
拓展	fcph
抵触	fcrq
抵御	fcsl
抵消	fcsw
抵赖	fcto
抑郁	fcxd
拈轻怕重	fcyj
抵达	fcyz
抛砖引玉	fcze
把戏	fdax
护照	fdbd
抗旱	fdbf
抗日	fdbi
摘要	fdcr
接轨	fdcx
接连	fdcz
接头	fddd
接通	fddn
招商	fddn
撤离	fddx
护理	fdeb
撤退	fdek
摘录	fdes
接班	fdey
抗拒	fdfg
拉动	fdfg
招摇	fdfj
把持	fdfl
摘抄	fdfm
招揽	fdfn
把握	fdfp
撤换	fdfr
撞击	fdfu
抗击	fdfu
接替	fdfv
拉拢	fdfx
抖擞	fdfx
抱头鼠窜	fdgn
招募	fdhb
接种	fdho
拉萨	fdhp
招租	fdhq
抗议	fdid
抽调	fdin
把手	fdjf
接手	fdjf
招手	fdjf
擅自	fdjg
摘自	fdjg
接力	fdji
接近	fdjj
接近	fdjk
接生	fdjl
招生	fdjl
挤压	fdjl
接受	fdjn
接入	fdjn
招架	fdjo
抗病	fdjt
招牌	fdkg
擅长	fdki
规章制度	fdkj
搞笑	fdkj
接管	fdkn
抽签	fdkv
接地	fdlc
护士	fdli
接收	fdli
招收	fdli
撤走	fdll
持之以恒	fdly
搞垮	fdly
护短	fdly
抽查	fdmb
招标	fdmf
拔刀相助	fdmq
把柄	fdmt
抽检	fdmv
抽样	fdmv
契机	fdmw
撤军	fdnc
搞定	fdnt
抽空	fdnv
接见	fdnw
抗灾	fdnx
接口	fdoi
招呼	fdoj
摔跤	fdol
摇旗呐喊	fdoo
接吻	fdos
抽取	fdpa
摘取	fdpa
招聘	fdpd
抽屉	fdph
撤职	fdpo
护卫	fdpt
撤回	fdqo
抗争	fdre
抽象	fdro
接触	fdrq
搞好	fdrz
搞得	fdsb
抗洪	fdsh
搞活	fdsj
接待	fdsl
招待	fdsl
抗衡	fdsr
敷衍	fdss
接洽	fdsv
搞到	fdtg
接到	fdtg
招致	fdtg
拉开	fdth
招供	fdth
拉丁	fdti
接任	fdtj
抗体	fdtm
摔倒	fdtt
抽出	fdue
撤出	fdue
抛头露面	fduj
拉链	fdvc
拉美	fdve
接着	fdvf
撤并	fdvh
撤销	fdvw
把关	fdvy
摘编	fdwd
接纳	fdwn
契约	fdws
接过	fdxd
抽烟	fdxq
抒发	fdya
抒情	fdyl
抗战	fdyo
招考	fdys
掠夺	fdyx
搬弄是非	febe
搬弄是非	febn
撰文	fedx
扫帚	feen
排球	feex
扫描	fefh
摧毁	fegi
排序	fejd
排斥	fejj
据理力争	fejr
排场	felz
捧场	felz
打印机	femw
撰写	fens
捧哏	feoe
排除	fepv
排队	fepv
扫除	fepv
排行	fesf
排泄	fesh
排列	fetd
摧残	fetd
扫兴	fewv
进退维谷	fewv
彗星	ffbj
搏斗	ffdd
挑拨离间	ffdn
扭亏为盈	ffdz
无动于衷	fffd
抚摸	fffh
扶持	fffl
捕捉	fffo
招摇撞骗	fffs
扶疏	ffjl
打抱不平	ffjt
抚顺	ffmj
扶植	ffmx
运动员	ffob
扶助	ffqf
抑扬顿挫	fftf
扶贫	ffvd
抚养	ffve
运动会	ffvf
摇摇欲坠	ffvp
井井有条	ffxa
抚恤	ffyj
拍照	fgbd
运转	fgcf
动辄	fgcp
运输	fgcv
抬头	fgdd
动脉	fgdd
抬高	fgdo
搜寻	fgex
运动	fgfg
动摇	fgfj
动武	fgfl
运动员	fgfo
拍摄	fgfp
拍打	fgft
捣毁	fggi
捣鬼	fggw
运营	fghn
动荡	fghs
动工	fgii
动词	fgij
动物	fgjf
动手	fgjf
动力	fgji
捣蛋	fgjl
云彩	fgjm
动向	fgjn
动物园	fgjq
招兵买马	fgjs
动感	fgjt
捣乱	fgjx
搜刮	fgjx
拒不	fgjy
运算	fgkg
运气	fgkz
运载	fglc
动静	fgld
抬起	fgll
拭目以待	fgls
搜查	fgmb
拍板	fgmj
动机	fgmw
运用	fgnf
动用	fgnf
动员	fgob
动听	fgoj
攫取	fgpa
搜罗	fgqd
动身	fgri
动漫	fgsb
运往	fgsd
运行	fgsf
运河	fgst
云集	fgti
搜集	fgti
动作	fgtl
运作	fgtl
动画	fgtq
云雾	fgua
云雨	fgui
动心	fgui
动人	fgvi
运销	fgvw
运送	fgvy
拒绝	fgwr
抬举	fgwv
拍卖	fgxj
搜狐	fgxj
云南省	fgxm
搜索	fgxn
云南	fgxn
动态	fgyd
运费	fgzs
动弹	fgzs
撒野	fhbl
披荆斩棘	fhct
措施	fhdh
无稽之谈	fhdi
撕毁	fhgi
搭讪	fhie
撒谎	fhih
摸底	fhjc
拱手	fhjf
措辞	fhjx
搭载	fhlc
描述	fhmd
搭档	fhmw
描写	fhns
捞取	fhpa
撒娇	fhrj
摸清	fhsl
搭配	fhuz
描绘	fhwv
摸索	fhxn
搭救	fhxx
抱薪救火	fhxx
打草惊蛇	fhyq
干旱	fibf
于是	fibt
丰硕	ficj
二月	fidi
干部	fido
干脆	fidr
丰胸	fids
干预	fidt
干扰	fifx
丰台	figo
干警	fihs
二百	fijb
丰厚	fijb
二手	fijf
二千	fijx
二等	fikl
丰收	fili
干校	fimd
干杯	fimj
丰富	fint
干吗	fios
丰田	fiqi
丰满	fish
干活	fisj
干涉	fisy
干事	fito
于今	fivj
干净	fivr
干线	fiwf
二级	fiwj
二十	fixi
干燥	fixo
二胡	fixo
二者	fiyb
二战	fiyo
干劲	fizi
折叠	fjaa
掂量	fjbt
摇晃	fjbw
摇曳	fjbx
扭转	fjcf
扼要	fjcr
违章	fjdb
授意	fjdb
播音	fjdb
摇头	fjdd
扩充	fjdg
播放	fjdh
折衷	fjdo
指鹿为马	fjds
授予	fjdt
折腾	fjdv
哲理	fjeb
扩建	fjef
拆建	fjef
排斥异己	fjez
振动	fjfg
挺进	fjfn
折扣	fjfo
无边无际	fjfp
播报	fjfp
摇摆	fjfq
抓捕	fjft
违规	fjfv
挺拔	fjfx
拆毁	fjgi
扩散	fjhd
逝世	fjhl
播种	fjho
振荡	fjhs
抓获	fjhx
拍手称快	fjhy
折旧	fjib
授课	fjib
誓言	fjii
无所谓	fjiq
无所不为	fjjd
插手	fjjf
违反	fjjj
折磨	fjjm
插入	fjjn
无所不包	fjjs
挪威	fjjt
插座	fjjv
拆迁	fjjx
无所顾忌	fjjz
折算	fjkg
托管	fjkn
摇篮	fjkn
违背	fjkt
掀起	fjll
抓起	fjll
拆卸	fjlt
拆卸	fjlx
授权	fjma
违禁	fjmm
插槽	fjmu
抓紧	fjna
挪用	fjnf
扩容	fjnv
括号	fjot
扩展	fjph
拆除	fjpv
插图	fjqa
援助	fjqf
动物园	fjqf
据了解	fjrd
拆解	fjrd
折射	fjrx
抓好	fjrz
挺好	fjrz
摇滚	fjsd
违法	fjsl
抓住	fjtd
势不两立	fjtd
誓死	fjtd
插件	fjtk
振作	fjtl
折价	fjtv
播出	fjue
扭曲	fjui
插曲	fjui
披露	fjuo
折合	fjvt
哲学	fjwn
违约	fjws
振兴	fjwv
违纪	fjwz
违犯	fjxj
扼杀	fjxm
拯救	fjxx
援救	fjxx
违者	fjyb
扩大	fjyi
振奋	fjyq
扩张	fjzs
援引	fjzs
括弧	fjzs
运筹帷幄	fknn
扬长避短	fkpl
无双	flaa
无处	flay
武昌	flbb
无意	fldb
无端	flde
无望	fldl
无名	fldo
无效	fldv
持股	fldw
远走高飞	fldz
无理	fleb
无非	flen
无损	flfo
拮据	flfp
无能	flgd
无私	flhg
拖鞋	flhp
武警	flhs
武艺	flhz
无言	flii
武功	flij
无误	flio
拟订	flit
无论	fliv
扯皮	flja
无序	fljd
无痕	flje
武力	flji
无所谓	flji
无力	flji
挂历	fljj
势均力敌	fljj
拖延	fljl
挂靠	fljl
无地自容	fljn
无敌	fljx
无不	fljy
无视	fljy
无边	fljz
挂牌	flkg
武装	flkl
无声	flld
无以复加	fllj
无知	flly
无权	flma
武术	flmd
扎根	flme
武林	flmm
持枪	flmv
无机	flmw
扎实	flnd
无非	flne
无害	flnf
无用	flnf
拟定	flnt
无穷	flnv
武器	floo
挂号	flot
无聊	flpc
无限	flpe
无耻	flpl
无尽	flpn
无罪	flqn
无畏	flqt
无期	flqv
拖累	flqw
持久	flrn
拖欠	flrv
武汉	flsa
拖沓	flsb
武汉市	flsd
无须	flsj
无法	flsl
无形	flth
无疑	fltl
无赖	flto
武侠	fltt
持平	fltv
无偿	fltw
无比	flui
无心	flui
无需	fluj
无锡	flvb
挂念	flvj
挂钩	flvs
无益	flvv
无从	flvv
无关	flvy
无线电	flwb
无线	flwf
无缘	flwl
持续	flwx
持有	flxd
挂在	flxi
武断	flxl
无故	flxo
无辜	flxo
无数	flxr
无奈	flyf
无愧	flyg
无情	flyl
无忧	flyx
示意	fmdb
未能	fmgd
示范	fmhs
未成	fmjj
示威	fmjt
二极管	fmkn
未知	fmly
未完	fmnf
未婚	fmrc
未免	fmro
示例	fmtt
未来	fmtx
未必	fmuj
未曾	fmvq
抄送	fmvy
未经	fmwz
抄袭	fmxt
示弱	fmzs
按照	fnbd
探明	fnbd
按时	fnbx
排放	fndh
丰富多彩	fndj
探望	fndl
探亲	fndm
进京	fndo
排名	fndo
控股	fndw
进站	fndy
排外	fndy
进退	fnek
排球	fnex
探寻	fnex
撺掇	fnfa
按揭	fnfb
拥挤	fnfd
拥护	fnfd
搬运	fnfg
按规定	fnfn
挖掘	fnfp
无穷无尽	fnfp
拥抱	fnfs
擦拭	fnft
按捺	fnfy
按期	fnhe
进程	fnho
探秘	fnhu
进攻	fnia
进贡	fnib
控诉	fnij
探讨	fnix
排序	fnjd
刊物	fnjf
无坚不摧	fnjf
挥手	fnjf
进度	fnjh
排斥	fnjk
控告	fnjl
按摩	fnjm
进入	fnjn
进而	fnjn
搬迁	fnjx
排版	fnkj
控制	fnkn
刊载	fnlc
进去	fnlg
进城	fnlj
按此	fnlt
进军	fnnc
进门	fnni
探究	fnnv
搬家	fnnx
进口	fnoi
刊号	fnot
井喷	fnox
进取	fnpa
进展	fnph
进阶	fnpv
排除	fnpv
排队	fnpv
探险	fnpv
排骨	fnqd
按期	fnqv
探测	fnsb
进行	fnsf
挖潜	fnsf
排污	fnsf
排行	fnsf
搁浅	fnsf
排泄	fnsh
进水	fnsi
排水	fnsi
进驻	fnst
排列	fntd
进修	fnti
控件	fntk
进化	fntt
进货	fntt
进来	fntx
进一步	fnty
按下	fnty
进出	fnue
排出	fnue
进出口	fnuo
挥霍	fnut
进食	fnvd
按键	fnve
按钮	fnvj
排练	fnwt
拥有	fnxd
探索	fnxn
刊登	fnxt
进餐	fnyd
进步	fnyi
捐赠	fobv
无足轻重	focj
捉弄	foeh
损耗	foem
扣押	fofq
扣留	fogd
无中生有	fojx
捷足先登	fojx
损失	fokv
捐款	folf
损坏	folj
操场	folz
拐杖	fomx
损害	fonf
操盘	fons
操守	fonx
扣除	fopv
捐助	foqf
拐骗	fost
元器件	fotk
操作	fotl
损伤	fotl
操心	foui
捐资	fovr
捉拿	fovt
操练	fowt
操纵	fowv
捐献	foxn
摄影	fpbd
摄氏	fpct
摒弃	fpdg
报名	fpdo
报效	fpdv
摄录	fpes
报导	fpex
报刊	fpfn
报批	fpfu
据称	fphr
报警	fphs
报请	fpil
据说	fpiv
握手	fpjf
帮手	fpjf
报告	fpjl
报应	fpjw
据悉	fpjx
报废	fpjy
报社	fpjy
摄制	fpkn
报答	fpkv
报复	fplb
报收	fpli
报表	fplk
据此	fplt
报案	fpnr
报国	fpqe
帮助	fpqf
帮派	fpsj
握住	fptd
报到	fptg
报信	fpti
摄像	fptr
报价	fptv
报偿	fptw
报仇	fptx
推陈出新	fpud
报酬	fpuy
报道	fpvj
掩耳盗铃	fpvv
报销	fpvw
报送	fpvy
报关	fpvy
报纸	fpwc
报业	fpwt
报料	fpxd
帮凶	fpxu
帮忙	fpyd
报考	fpys
押韵	fqdb
摆放	fqdh
摆脱	fqdv
撕毁	fqgi
摆设	fqiw
顽固不化	fqjt
摆满	fqsh
摆平	fqtv
替罪羊	fqvf
押金	fqvi
押送	fqvy
捆绑	fqwf
摆在	fqxi
摆布	fqxn
势如破竹	frck
挣扎	frfl
挽留	frgd
换算	frkg
换取	frpa
换届	frpd
挽回	frqo
艳丽	frtn
换来	frtx
挣钱	frvf
挽救	frxx
专电	fsbl
专题	fsbt
专辑	fsco
专区	fscx
抱怨	fsdc
专为	fsdj
专刊	fsfn
亏损	fsfo
无济于事	fsft
拘留	fsgd
专科	fshd
专稿	fshd
专利	fshn
专营	fshn
专程	fsho
专著	fshy
专访	fsid
拘谨	fsih
专项	fsij
挥洒自如	fsjr
无微不至	fsjt
专长	fski
专制	fskn
专款	fslf
专场	fslz
排行榜	fsmd
专栏	fsmv
专机	fsmw
专用	fsnf
专门	fsni
专案	fsnr
亏空	fsnv
专家	fsnx
专职	fspo
推波助澜	fsqs
抱负	fsrb
挥汗如雨	fsru
专注	fssd
专治	fssg
拘泥	fssp
拘役	fssw
专集	fsti
拘束	fsto
无与伦比	fstu
掏出	fsue
云消雾散	fsuh
专心	fsui
抱歉	fsve
抱着	fsvf
专人	fsvi
专线	fswf
专业	fswt
专卖	fsxj
专卖店	fsxj
热泪盈眶	fszg
打败	ftba
指明	ftbd
打赌	ftby
打破	ftcj
搏斗	ftdd
指望	ftdl
打通	ftdn
无价之宝	ftdn
推敲	ftdo
推理	fteb
无可奉告	ftej
打印机	ftem
推崇	ften
打印	ftep
指导	ftex
打球	ftex
打扫	ftfe
推动	ftfg
打动	ftfg
打捞	ftfh
打折	ftfj
指示	ftfm
推进	ftfn
指挥	ftfn
打进	ftfn
指控	ftfn
捕捉	ftfo
捷报	ftfp
打击	ftfu
抨击	ftfu
打扮	ftfv
打拼	ftfv
打扰	ftfx
打的	ftgs
打盹	ftgt
推移	fthd
携带	fthn
推荐	fthx
捕获	fthx
打工	ftii
推论	ftiv
携手	ftjf
打手	ftjf
干什么	ftjg
推广	ftji
打压	ftjl
打造	ftjl
推选	ftjl
指向	ftjn
无事生非	ftjn
无可厚非	ftjn
打入	ftjn
推向	ftjn
打架	ftjo
无恶不作	ftjt
推翻	ftjx
打算	ftkg
推算	ftkg
打气	ftkz
指责	ftlb
打趣	ftll
推卸	ftlx
打垮	ftly
指标	ftmf
打枪	ftmv
摄像机	ftmw
指定	ftnt
打字	ftnz
打听	ftoj
打响	ftoj
打骂	ftoo
推迟	ftpd
推迟	ftpn
指甲	ftqi
打好	ftrz
推测	ftsb
打包	ftse
推行	ftsf
指派	ftsj
打法	ftsl
打消	ftsw
捷径	ftsz
打死	fttd
打到	fttg
打开	ftth
推开	ftth
打伤	fttl
指正	fttl
指事	ftto
打假	fttp
打倒	fttt
推倒	fttt
打仗	fttx
打下	ftty
指出	ftue
打出	ftue
推出	ftue
打分	ftvd
指令	ftvj
推介	ftvn
推销	ftvw
打针	ftvx
指针	ftvx
指纹	ftwd
推举	ftwv
无可救药	ftxh
干什么	ftxj
打猎	ftxj
打断	ftxl
推断	ftxl
抹杀	ftxm
打杂	ftxm
指南	ftxn
捷克	ftxo
指数	ftxr
打发	ftya
进一步	ftyi
指点	ftyo
指教	ftyz
指引	ftzs
击败	fuba
批量	fubt
击破	fucj
击退	fuek
批示	fufm
擂台	fugo
击节	fuhp
击落	fuhs
批评	fuit
拙笨	fukm
批复	fulb
拙劣	fumj
提心吊胆	fuod
进出口	fuoi
击中	fuoi
推心置腹	fuqd
专心致志	futl
击毙	fuut
批准	fuvt
批判	fuvx
未雨绸缪	fuww
批发	fuya
击发	fuya
挫败	fvba
规则	fvbn
抢购	fvbs
挑剔	fvbs
规章	fvdb
拼音	fvdb
挫折	fvfj
替换	fvfr
拼搏	fvft
挑拨	fvfy
规程	fvho
规范	fvhs
损人利己	fvhz
替补	fvjk
抢先	fvjl
挑选	fvjl
挑衅	fvjq
抢劫	fvlg
挑起	fvll
拦截	fvlt
规矩	fvly
规格	fvma
规模	fvmh
拼写	fvns
规定	fvnt
规避	fvpo
抢险	fvpv
夫妇	fvre
挥金如土	fvrl
规律	fvse
扮演	fvsn
拦住	fvtd
夫妻	fvte
抢修	fvti
挫伤	fvtl
替代	fvtv
扮酷	fvuj
动人心弦	fvuz
夫人	fvvi
拼命	fvvt
扑朔迷离	fvxd
规划	fvxn
抢救	fvxx
投资者	fvyb
抢占	fvyo
挑战	fvyo
抢夺	fvyx
夫子	fvzi
远处	fway
远景	fwbd
投影	fwbd
无线电	fwbl
元旦	fwbt
投票	fwcf
撑腰	fwdc
投放	fwdh
远方	fwdh
元月	fwdi
投产	fwdj
远望	fwdl
远离	fwdx
捕风捉影	fwfb
顽抗	fwfd
搅拌	fwfv
远远	fwfw
无缘无故	fwfx
投稿	fwhd
远程	fwho
投诉	fwij
远近	fwjk
投靠	fwjl
投入	fwjn
投向	fwjn
元气	fwkz
元素	fwlw
投标	fwmf
投机	fwmw
元帅	fwnn
远航	fwns
远见	fwnw
元宵	fwnw
投降	fwpa
顽固	fwqx
投身	fwri
远征	fwst
远洋	fwsv
挡住	fwtd
元件	fwtk
远东	fwtm
寿终正寝	fwtn
投保	fwto
专业化	fwtt
元首	fwvj
投资	fwvr
远销	fwvw
投递	fwvz
远在	fwxi
远古	fwxo
远大	fwyi
投奔	fwyx
顽强	fwzs
执照	fxbd
热量	fxbt
执意	fxdb
势头	fxdd
抛弃	fxdg
热衷	fxdo
拔高	fxdo
无米之炊	fxdx
找寻	fxex
技能	fxgd
热能	fxgd
热带	fxhn
势利	fxhn
执勤	fxho
二十世纪	fxhw
执著	fxhy
技艺	fxhz
技工	fxii
热诚	fxij
技巧	fxit
势力	fxji
热力	fxji
热爱	fxjn
热血	fxjq
扰乱	fxjx
执迷不悟	fxjy
专卖店	fxjy
执笔	fxkj
热气	fxkz
技术	fxmd
技校	fxmd
热核	fxmd
云南省	fxmj
热闹	fxnd
热门	fxni
技师	fxnt
二十四史	fxqo
找回	fxqo
热身	fxri
热浪	fxsd
执行	fxsf
热泪	fxsg
热水	fxsi
执法	fxsl
技法	fxsl
热潮	fxsx
热烈	fxtd
找到	fxtg
抛开	fxth
抛售	fxti
执政	fxtl
垫付	fxtx
找出	fxue
热心	fxui
势必	fxuj
执着	fxvf
寿命	fxvt
热销	fxvw
热线	fxwf
执掌	fxwn
执业	fxwt
热卖	fxxj
热火朝天	fxxt
势态	fxyd
热情	fxyl
热点	fxyo
热忱	fxyp
执教	fxyz
拷贝	fybi
扑通	fydn
掩护	fyfd
拨打	fyft
扶老携幼	fyfw
掩蔽	fyhv
未卜先知	fyjl
无奇不有	fyjx
拨款	fylf
拨号	fyot
掩饰	fyrl
无懈可击	fytf
扑灭	fytx
掩盖	fyve
掉线	fywf
扑救	fyxx
拂晓	fzbx
抉择	fzfa
扔掉	fzfy
扬言	fzii
无孔不入	fzjj
迂腐	fzjt
迂回	fzqo
扬州	fzyy
白日做梦	gbtm
留影	gdbd
贸易	gdbs
能量	gdbt
留意	gddb
能为	gddj
留恋	gddm
留名	gddo
能耗	gdem
能动	gdfg
能干	gdfi
留言	gdii
邀请	gdil
能说	gdiv
留底	gdjc
能手	gdjf
能力	gdji
能耐	gdjn
眼高手低	gdjt
能否	gdjy
留神	gdjy
留用	gdnf
留守	gdnx
能源	gdsj
能够	gdso
留下	gdtd
留住	gdtd
留任	gdtj
能使	gdtt
留下	gdty
留心	gdui
留念	gdvj
留学生	gdwj
留学	gdwn
留给	gdwv
能有	gdxd
能在	gdxi
熊猫	gdxj
留情	gdyl
眼里	gebl
皇帝	gedn
眼球	geex
眼眶	gegc
眼睛	gegl
眼科	gehd
眼花	geht
眼看	gejf
眼力	geji
皇后	gejj
眼神	gejy
皇冠	genf
皇家	genx
眼中	geoi
岳阳	gepb
岳母	geqs
眼界	geqv
眼色	gerd
眼泪	gesg
眼下	gety
眼前	gevd
眼镜	gevd
岳父	gevx
眼光	geww
岳飞	gezv
乒乓球	ggex
熙熙攘攘	ggff
魄力	ggji
目的地	gglc
目瞪口呆	ggoo
目的地	ggsl
鬼鬼祟祟	gguu
瞠目结舌	ggwj
鼠目寸光	ggxw
熊熊燃烧	ggxx
兵荒马乱	ghsj
瞄准	ghvt
眼花缭乱	ghwj
白条	giam
巨星	gibj
巨石	gici
巨头	gidd
目录	gies
白云	gifg
目击	gifu
目的	gigs
目睹	gigy
鸟语花香	gihh
白菜	gihj
白痴	gijl
留言簿	giks
毁坏	gilj
目标	gimf
白板	gimj
巨额	gina
白宫	gino
丘陵	gipl
白色	gird
白酒	gisu
巨型	gith
毁灭	gitx
白天	gity
白雪	giue
目前	givd
能言善辩	givd
巨人	givi
白金	givi
白领	givj
巨资	givr
能说会道	givv
目光	giww
巨大	giyi
白费	gizs
目不暇接	gjbf
目不转睛	gjcg
睡衣	gjdk
乒乓	gjgd
能不能	gjgd
乒乓球	gjge
眨眼	gjge
睚眦	gjgl
睡眠	gjgp
兵不血刃	gjjd
兵不厌诈	gjji
迫不及待	gjjs
眼疾手快	gjjy
卑劣	gjmj
鼎力相助	gjmq
瞬间	gjnb
卑鄙	gjox
迫不得已	gjse
瞬息万变	gjtd
睡着	gjvf
睡觉	gjwn
台北市	gkdn
牟取	gkpa
瞌睡	glgj
鼠标	glmf
瞎了	gnji
目空一切	gntt
台球	goex
目中无人	gofv
台币	gojn
台北市	gokd
台北	gokt
台上	goli
台阶	gopv
台湾	gosd
台式	goti
台风	gowx
台独	goxj
怠慢	goyb
台州	goyy
瞩目	gpgi
舅舅	gqgq
兵贵神速	gqjt
舅父	gqvx
瞻顾	grjc
瞻仰	grtc
的确	gscr
泉源	gssj
白驹过隙	gsxp
泉州	gsyy
盯着	gtvf
能歌善舞	gtvl
瞒天过海	gtxs
盼望	gvdl
眺望	gvdl
参差不齐	gvjd
鬼斧神工	gvji
兵器	gvoo
兵团	gvqx
逡巡	gvsz
鬼脸	gwdv
允许	gwil
魅力	gwji
留学生	gwjl
鬼神	gwjy
魁梧	gwmw
魁伟	gwtf
鬼子	gwzi
迫在眉睫	gxdg
参观	gyan
参照	gybd
瞭望	gydl
参股	gydw
卧虎藏龙	gyhx
参谋	gyih
参看	gyjf
参赞	gyjl
参加	gyjo
参军	gync
参赛	gynf
卧室	gynt
参阅	gynv
参见	gynw
参展	gyph
参与	gysi
参政	gytl
参差	gyvf
翱翔	gyvf
参考资料	gyvx
参数	gyxr
参考	gyys
迫害	gznf
迫切	gztd
迫使	gztt
蓬莱	haht
蓬勃	haxn
昔日	hbbi
莫名	hbdo
草率	hbdv
草率	hbdw
募捐	hbfo
香皂	hbgt
萌芽	hbhc
莫斯科	hbhh
草莓	hbhl
香蕉	hbht
草莽	hbhy
草原	hbjg
幕后	hbjj
蔓延	hbjl
草地	hblc
草坪	hblt
草案	hbnr
香味	hbof
香港	hbsh
香水	hbsi
募集	hbti
香火	hbxi
香烟	hbxq
萌发	hbya
莲花	hcht
黄昏	hdct
科研	hdct
蓄意	hddb
称之为	hddj
移交	hddv
散文	hddx
黄山	hdei
移动	hdfg
科技	hdfx
散热	hdfx
科目	hdgi
黄泉	hdgs
芳香	hdhb
愁眉苦脸	hdhd
菩萨	hdhp
科委	hdhr
芭蕉	hdht
荒诞	hdij
黄页	hdjb
荒唐	hdje
散了	hdji
黄瓜	hdjj
芝麻	hdjm
科长	hdki
英文版	hdkj
芦笙	hdkj
散装	hdkl
秋高气爽	hdky
移植	hdmx
科室	hdnt
移民	hdpt
移除	hdpv
移居	hdpx
黄色	hdrd
薪水	hdsi
蓄水	hdsi
稿源	hdsj
黄海	hdsl
黄河	hdst
稿件	hdtk
薪酬	hduy
荒凉	hdvd
散会	hdvf
黄金	hdvi
科普	hdvw
移送	hdvy
稿纸	hdwc
科幻	hdwj
科学	hdwn
共产党	hdwn
科学院	hdwp
科协	hdxj
散布	hdxn
散发	hdya
散步	hdyi
和颜悦色	hdyr
科教	hdyz
稿子	hdzi
稿费	hdzs
萧条	heam
基础	hecu
藉由	hedi
期望	hedl
萧瑟	heee
基建	heef
勘探	hefn
基地	helc
基督	helm
甘肃省	hemj
基本上	heml
基本	hemt
期间	henb
其实	hend
其它	hent
其中	heoi
基层	hepf
欺负	herb
勘测	hesb
期满	hesh
期待	hesl
欺骗	hest
其他	hetc
甚至	hetg
斟酌	heus
基金	hevi
其次	hevr
其余	hevt
甘肃	hfei
甘肃	hfem
某某	hfhf
芫荽	hfhj
芙蓉	hfhn
某种	hfho
若无其事	hfht
甘愿	hfjg
劳动力	hfji
某些	hflt
若无其事	hfqt
芜湖	hfsx
甘心	hfui
邯郸	hfvb
某人	hfvi
某个	hfvi
私利	hghn
私营	hghn
勤能补拙	hgjf
私自	hgjg
私下	hgtd
私下	hgty
私心	hgui
私人	hgvi
私有	hgxd
蒸蒸日上	hhbl
葡萄牙	hhci
勤勤恳恳	hhee
移花接木	hhfm
花花世界	hhhq
积劳成疾	hhjj
草草了事	hhjt
蓬荜生辉	hhjw
共和国	hhqe
和蔼可亲	hhtd
劳燕分飞	hhvz
萎缩	hhwn
莘莘学子	hhwz
落落大方	hhyd
荒诞无稽	hifh
花言巧语	hiii
勤工俭学	hitw
菜鸟	hjgt
蒺藜	hjhh
蔬菜	hjhj
蘑菇	hjhr
葳蕤	hjhx
其貌不扬	hjjf
茂盛	hjjj
秘书长	hjki
茂密	hjnu
程序员	hjob
苏联	hjpv
英特尔	hjrm
蒸汽	hjsk
董事	hjto
芝加哥	hjto
苏醒	hjub
菜单	hjvb
蒸发	hjya
苏州	hjyy
藏匿	hkch
茱萸	hkhg
鞭长莫及	hkhj
秩序	hkjd
藏书	hkjj
荡气回肠	hkqd
燕子	hkzi
世贸	hlgd
世面	hljq
世上	hlli
世间	hlnb
世家	hlnx
世界上	hlql
世界	hlqv
共青团	hlqx
世代	hltv
世俗	hltv
世人	hlvi
世纪	hlwz
世故	hlxo
世袭	hlxt
世态	hlyd
花枝招展	hmfp
积少成多	hmjd
艺术家	hmnx
艺术品	hmoo
草木皆兵	hmug
英格兰	hmve
秒钟	hmvo
积极分子	hmvz
积极性	hmyj
劳务	hnaj
英明	hnbd
蒙昧	hnbf
英里	hnbl
带电	hnbl
蓝牙	hnci
带头	hndd
英勇	hndn
英豪	hndo
利率	hndw
英文	hndx
带动	hnfg
劳动	hnfg
利于	hnfi
带薪	hnhd
营利	hnhn
菲薄	hnhs
蒙蔽	hnhv
利税	hnhv
荣获	hnhx
稼穑	hnhx
劳工	hnii
英语	hniw
利息	hnjg
劳力	hnji
营造	hnjl
蒙受	hnjn
劳驾	hnjo
带上	hnli
英超	hnll
荣幸	hnlv
荣幸	hnly
蓝本	hnmt
英格兰	hnmv
利用	hnnf
利害	hnnf
带宽	hnnh
稠密	hnnu
利器	hnoo
英尺	hnpn
利民	hnpt
荧屏	hnpv
带队	hnpv
蓝图	hnqa
英国	hnqe
带回	hnqo
劳累	hnqw
蓝色	hnrd
利好	hnrz
英汉	hnsa
蒙混	hnsb
利润	hnsn
英俊	hntg
带到	hntg
劳作	hntl
劳保	hnto
带来	hntx
蓝天	hnty
英镑	hnvd
营养	hnve
带着	hnvf
带领	hnvj
利弊	hnvn
利益	hnvv
营销	hnvw
营业	hnwt
荣誉	hnwv
带给	hnwv
荣耀	hnww
荧光	hnww
英寸	hnxd
带有	hnxd
英雄	hnxg
英才	hnxj
利索	hnxn
蒙古	hnxo
营救	hnxx
稳定性	hnyj
种族	hodh
和亲	hodm
和服	hodp
勤恳	hoek
和睦	hogl
积蓄	hohd
莴苣	hohg
和蔼	hohi
勤劳	hohn
种种	hoho
和谐	hoiu
和谈	hoix
程序	hojd
程度	hojh
积压	hojl
和气	hokz
和声	hold
积极	homj
种植	homx
积极性	homy
积累	hoqw
和解	hord
勤勉	horo
和好	horz
苦口婆心	hosu
程式	hoti
和平	hotv
勤俭	hotv
积雪	houe
积分	hovd
和美	hove
委员会	hovf
和尚	hown
和约	hows
和数	hoxr
种类	hoxy
勤奋	hoyq
种子	hozi
燕子	hozi
和弦	hozs
节日	hpbi
革新	hpdm
鞍山	hpei
节奏	hpev
节拍	hpfg
节能	hpgd
节目	hpgi
蔚蓝	hphn
鞭辟入里	hpjb
节后	hpjj
节制	hpkn
节省	hpmj
鞋帽	hpni
慕尼黑	hpqh
鞠躬	hprz
节水	hpsi
节俭	hptv
革命	hpvt
节约	hpws
勒索	hpxn
节点	hpyo
鞋子	hpzi
苗条	hqam
莫斯科	hqhd
蔑视	hqjy
租用	hqnf
苦思冥想	hqnm
租借	hqth
租赁	hqtj
租金	hqvi
花团锦簇	hqvk
萝卜	hqyi
称为	hrdj
稳如泰山	hree
委托	hrfj
称谓	hriq
称赞	hrjl
稳妥	hrjr
稳重	hrjt
逶迤	hrlc
稳定	hrnt
委员	hrob
称呼	hroj
称号	hrot
鞠躬尽瘁	hrpj
称职	hrpo
委屈	hrpu
稳固	hrqx
委婉	hrrn
委派	hrsj
稳住	hrtd
稳健	hrte
委任	hrtj
称作	hrtl
称霸	hruh
委曲	hrui
称道	hrvj
稳当	hrwe
稳步	hryi
警备	hsaq
黎明	hsbd
敬意	hsdb
薄膜	hsdh
警方	hsdh
落户	hsdp
茫然	hsdy
落拓	hsfc
警报	hsfp
落幕	hshb
菠萝	hshq
葡萄	hshs
茫茫	hshs
菊花	hsht
薄荷	hsht
芍药	hshw
敬请	hsil
秣马厉兵	hsjg
落后	hsjj
落成	hsjj
警告	hsjl
落选	hsjl
敬爱	hsjn
落入	hsjn
艾滋病	hsjt
敬重	hsjt
敬礼	hsjy
落地	hslc
落实	hsnd
菲律宾	hsng
警官	hsnp
落空	hsnv
警察	hsnx
落网	hsnx
落叶	hsox
警卫	hspt
范围	hsqf
范畴	hsqf
敬仰	hstc
落到	hstg
警戒	hsth
范例	hstt
敬佩	hstw
落下	hsty
警钟	hsvo
敬业	hswt
落在	hsxi
警惕	hsyb
薄弱	hszs
苹果	htbm
苛刻	htdy
花鸟	htgt
花草	hthb
花香	hthb
茉莉	hthh
蓓蕾	hthu
花生	htjl
葬礼	htjy
花店	htjy
花边	htjz
董事长	htki
著作权	htma
花木	htmi
花样	htmv
花哨	htow
花园	htqf
花絮	htro
花开	htth
荷兰	htve
花钱	htvf
董事会	htvf
花丛	htvv
花纹	htwd
花儿	htwi
花朵	htwm
花卉	htxh
花费	htzs
秘方	hudh
秘诀	huiz
秘书	hujj
秘籍	huke
芯片	huki
秘笈	hukj
秘密	hunu
秘鲁	hurt
委曲求全	huxv
税务	hvaj
共享	hvdo
共产党	hvdw
税率	hvdw
共建	hvef
苍白	hvgi
芬芳	hvhd
芥蒂	hvhd
荟萃	hvhd
共和	hvho
共和国	hvhq
苍茫	hvhs
恭敬	hvhs
共识	hvio
共计	hvix
利欲熏心	hvju
茶座	hvjv
利令智昏	hvlc
税款	hvlf
税收	hvli
恭喜	hvlo
共青团	hvlq
共用	hvnf
黄金周	hvnl
共同	hvnt
共鸣	hvog
茶叶	hvox
苍蝇	hvqo
茶馆	hvrl
苍天	hvty
共创	hvvc
税金	hvvi
恭维	hvwt
邯郸学步	hvwy
共有	hvxd
共存	hvxi
共性	hvyj
移风易俗	hwbt
科学研究	hwcn
药方	hwdh
药剂	hwdx
稍纵即逝	hwef
颓势	hwfx
蕴藏	hwhk
稍稍	hwhw
稍许	hwil
药物	hwjf
稍后	hwjj
药店	hwjy
颓废	hwjy
稍等	hwkl
花红柳绿	hwmw
药材	hwmx
营业额	hwna
药用	hwnf
科学家	hwnx
药品	hwoo
科学院	hwpn
稍微	hwse
蕴含	hwvj
和风细雨	hwwu
稍有	hwxd
颓丧	hwxv
秋冬	hxad
苦难	hxat
若是	hxbt
若要	hxcr
获胜	hxdj
若干	hxfi
葫芦	hxhd
获利	hxhn
稀薄	hxhs
蔷薇	hxhs
苦苦	hxhx
秋季	hxhz
稀疏	hxjl
稀释	hxjx
获悉	hxjx
秋千	hxjx
获奖	hxkd
苦笑	hxkj
稽查	hxmb
稀少	hxmj
苦闷	hxnu
稀罕	hxnv
获取	hxpa
获得	hxsb
私有化	hxtt
秋天	hxty
获准	hxvt
获益	hxvv
秋风	hxwx
稀有	hxxd
苦恼	hxyd
稀奇	hxyt
著名	hydo
莽撞	hyfd
著称	hyhr
著作	hytl
透明	hzbd
季报	hzfp
季节	hzhp
季度	hzjh
透视	hzjy
艺术	hzmd
透析	hzmj
透彻	hzst
秀丽	hztn
透露	hzuo
秀美	hzve
透支	hzxa
透过	hzxd
译文	iadx
攻打	iaft
攻击	iafu
攻势	iafx
攻读	iaix
攻坚	iana
攻略	iaqa
攻关	iavy
攻克	iaxo
攻占	iayo
课题	ibbt
课时	ibbx
课文	ibdx
课外	ibdy
旧的	ibgs
课程	ibho
功败垂成	ibjj
说明书	ibjj
课本	ibmt
谩骂	iboo
诺贝尔	ibrm
课件	ibtk
课堂	ibwn
贡献	ibxn
诋毁	icgi
讴歌	icto
议题	idbt
巧立名目	iddg
议程	idho
该项	idij
评头论足	idio
议论	idiv
访谈	idix
访客	idna
访问	idno
议案	idnr
议员	idob
工商局	idpj
谅解	idrd
议政	idtl
议事	idto
访华	idtt
访美	idve
议会	idvf
诽谤	ieid
讲义	ifdx
讲授	iffj
讲台	ifgo
讲课	ifib
讲话	ifij
讲座	ifjv
讲述	ifmd
讲师	ifnt
讲究	ifnv
讲解	ifrd
讲演	ifsn
讲学	ifwn
讲求	ifxx
调兵遣将	igqk
诱导	ihex
谋私	ihhg
谎言	ihii
诺言	ihii
谋害	ihnf
工程师	ihnt
工程师	ihon
工艺品	ihoo
谋取	ihpa
谨防	ihpd
谋略	ihqa
诱因	ihqy
诱骗	ihst
诱惑	ihto
诱使	ihtt
诱人	ihvi
谋杀	ihxm
谋求	ihxx
诱发	ihya
谨慎	ihyx
工艺品	ihzo
诡计多端	iidd
工商	iidn
工夫	iifv
工贸	iigd
工程	iiho
诬蔑	iihq
工艺	iihz
言论	iiiv
言语	iiiw
工序	iijd
工厂	iiji
言辞	iijx
旧调重弹	iijz
工地	iilc
工场	iilz
诬陷	iipr
工具	iiqe
工期	iiqv
言行	iisf
工行	iisf
工作	iitl
工会	iivf
工人	iivi
工资	iivr
工业	iiwt
言情	iiyl
话题	ijbt
诚意	ijdb
言不由衷	ijdd
功名	ijdo
功效	ijdv
功率	ijdw
诚然	ijdy
诚恳	ijek
功耗	ijem
功夫	ijfv
诚挚	ijfx
功能	ijgd
诚邀	ijgd
项目	ijgi
功劳	ijhn
功课	ijib
谣言	ijii
诉讼	ijiv
谬论	ijiv
诉说	ijiv
话说	ijiv
词语	ijiw
话语	ijiw
诉诸	ijiy
功底	ijjc
诞辰	ijjf
功力	ijji
诞生	ijjl
诉状	ijky
诚实	ijnd
说不定	ijnt
功勋	ijob
诚聘	ijpd
话剧	ijpx
巧舌如簧	ijrk
词汇	ijsc
诚征	ijst
诚信	ijti
诚心	ijui
词典	ijuv
项链	ijvc
功绩	ijwl
词组	ijwq
词频	ijyj
话费	ijzs
计算机	ikmw
计算器	ikoo
谈笑风生	ikwj
许昌	ilbb
许多	ildd
诗文	ildx
请示	ilfm
请进	ilfn
让利	ilhn
许诺	ilih
诗词	ilij
请看	iljf
让我	iljf
请愿	iljg
许愿	iljg
诗篇	ilkd
请客	ilna
请问	ilno
让它	ilnt
请罪	ilqe
请罪	ilqn
许久	ilrn
诗句	ilso
请勿	ilss
诈骗	ilst
让他	iltc
让位	iltd
请到	iltg
诗集	ilti
诗歌	ilto
许可	ilto
请假	iltp
请柬	iltq
让你	iltr
请便	iltt
让出	ilue
计上心来	ilut
诗人	ilvi
诗经	ilwz
请求	ilxx
让步	ilyi
请教	ilyz
训练	imwt
调戏	inax
调研	inct
调离	indx
调剂	indx
调理	ineb
诧异	ineh
调动	infg
调控	infn
调换	infr
调拨	infy
调和	inho
调节	inhp
诽谤	inid
调试	init
调谐	iniu
调皮	inja
调度	injh
调入	injn
调制	inkn
调查	inmb
调用	innf
调味	inof
调遣	inqp
调解	inrd
调停	intd
调任	intj
调整	into
调侃	into
调配	inuz
调养	inve
证监会	invf
调料	inxd
调频	inyj
误时	iobx
识破	iocj
误区	iocx
误导	ioex
言听计从	ioiv
误用	ionf
识别	iooj
误解	iord
误事	ioto
误会	iovf
误差	iovf
工具书	iqej
工具书	iqjj
工具箱	iqkm
谴责	iqlb
诺基亚	iqtw
谢意	irdb
诡辩	irdx
诡秘	irhu
谄谀	irig
谢谢	irir
诡计	irix
诸如此类	irlx
谄媚	irrd
谢绝	irwr
询问	isno
证明	itbd
巧遇	itbn
订购	itbs
试题	itbt
订票	itcf
谁也	itci
订立	itdi
评为	itdj
试剂	itdx
工作站	itdy
评理	iteb
试探	itfn
证据	itfp
订报	itfp
评委	ithr
评议	itid
讹诈	itil
试试	itit
许可证	itit
评说	itiv
评论	itiv
评语	itiw
证书	itjj
评选	itjl
评奖	itkd
工作上	itll
工作者	itly
谁知	itly
评述	itmd
记事本	itmt
评审	itnb
证实	itnd
试用	itnf
评定	itnt
订阅	itnv
试听	itoj
试图	itqa
订婚	itrc
巧妙	itrm
评测	itsb
试行	itsf
试验	itst
证件	ittk
订货	ittt
评价	ittv
评估	ittx
评比	itui
订单	itvb
评分	itvd
证人	itvi
巧合	itvt
评判	itvx
试卷	itvy
证券	itvy
评级	itwj
谁都	ityb
试点	ityo
说明	ivbd
认购	ivbs
论题	ivbt
认输	ivcv
认为	ivdj
说服	ivdp
论文	ivdx
巫山	ivei
论据	ivfp
论著	ivhy
说谎	ivih
说话	ivij
谦让	ivil
论调	ivin
认识	ivio
论证	ivit
认证	ivit
说说	iviv
诊所	ivjj
诊疗	ivjj
说不定	ivjn
诠释	ivjx
论坛	ivlf
说起	ivll
论述	ivmd
说完	ivnf
访贫问苦	ivnh
谱写	ivns
认同	ivnt
认定	ivnt
详见	ivnw
详尽	ivpn
认罪	ivqn
详解	ivrd
说好	ivrz
诊治	ivsg
认清	ivsl
说法	ivsl
说到	ivtg
认可	ivto
说来	ivtx
说出	ivue
说着	ivvf
认错	ivvh
说道	ivvj
认领	ivvj
详细	ivwq
说过	ivxd
诊断	ivxl
论断	ivxl
认真	ivxq
详情	ivyl
论点	ivyo
谦虚	ivyw
谦逊	ivzm
设备	iwaq
工业区	iwcx
语音	iwdb
设施	iwdh
设立	iwdi
设为	iwdj
语文	iwdx
语录	iwes
语种	iwho
语言	iwii
语词	iwij
语调	iwin
设计	iwix
语气	iwkz
设想	iwmg
设定	iwnt
恐吓	iwot
设防	iwpd
设置	iwqx
巩固	iwqx
设法	iwsl
语法	iwsl
语句	iwso
讽刺	iwtn
工业化	iwtt
设有	iwxd
恐龙	iwxt
恐怕	iwyg
恐慌	iwyh
恐惧	iwyq
恐怖	iwyx
计量	ixbt
计时	ixbx
计较	ixcd
读音	ixdb
计委	ixhr
计谋	ixih
谈话	ixij
谈论	ixiv
讨论	ixiv
谜语	ixiw
谈谈	ixix
读物	ixjf
巧克力	ixji
读书	ixjj
讨厌	ixjy
计算	ixkg
计算机	ixkm
谈起	ixll
读写	ixns
计数器	ixoo
读取	ixpa
谜团	ixqx
讨嫌	ixrv
讨好	ixrz
谈到	ixtg
讨债	ixtl
谈心	ixui
谈判	ixvx
计划	ixxn
计数	ixxr
读者	ixyb
计费	ixzs
诸多	iydd
调虎离山	iyde
讣告	iyjl
诸如	iyro
巧夺天工	iyti
诸侯	iytz
记录	izes
记功	izij
记载	izlc
记述	izmd
诀窍	iznv
记号	izot
记得	izsb
记住	iztd
记下	izty
记过	izxd
记者	izyb
记性	izyj
记忆	izyz
皮肤	jadf
颇为	jadj
皮带	jahn
皮鞋	jahp
皮革	jahp
疼痛	jajd
皮毛	jajf
面对面	jajq
瘫痪	jajr
皮包	jase
颇有	jaxd
页码	jbcs
反败为胜	jbdd
厚望	jbdl
百灵	jbex
百里挑一	jbft
百科	jbhd
百花	jbht
厚厚	jbjb
自暴自弃	jbjd
厚度	jbjh
百度	jbjh
厕所	jbjj
厚爱	jbjn
页面	jbjq
厚重	jbjt
百年	jblc
百家	jbnx
百叶	jbox
百姓	jbrj
度日如年	jbrl
爱财如命	jbrv
千里马	jbst
百倍	jbtd
百万	jbth
百货	jbtt
百分	jbvd
百分之	jbvd
厚道	jbvj
页次	jbvr
百合	jbvt
百业	jbwt
厘米	jbxi
页数	jbxr
百强	jbzs
底部	jcdo
库房	jcdp
厄运	jcfg
底薪	jchd
底蕴	jchw
自轻自贱	jcjb
先斩后奏	jcje
顾及	jcjz
顾客	jcna
顾问	jcno
底层	jcpf
底价	jctv
底下	jcty
底线	jcwf
底细	jcwq
库存	jcxi
顾虑	jcyu
底子	jczi
重峦叠嶂	jdae
臭名昭著	jdbh
买账	jdbk
买主	jdde
买方	jddh
摩肩接踵	jdfo
厚颜无耻	jdfp
痛击	jdfu
序幕	jdhb
瓜熟蒂落	jdhh
买菜	jdhj
痛苦	jdhx
序言	jdii
疤痕	jdje
自怨自艾	jdjh
千方百计	jdji
买了	jdji
乏力	jdji
生产力	jdji
戛然而止	jdjl
自高自大	jdjy
不胜枚举	jdmw
买家	jdnx
痛哭	jdoo
序号	jdot
顾名思义	jdqd
丢卒保车	jdtc
序列	jdtd
买到	jdtg
千辛万苦	jdth
千变万化	jdtt
痛心	jdui
生产线	jdwf
买卖	jdxj
垂头丧气	jdxk
痛恨	jdye
痛快	jdyz
痕迹	jedm
承建	jeef
唐山	jeei
承担	jefb
承接	jefd
承诺	jeih
唐诗	jeil
承认	jeiv
承受	jejn
承办	jejv
康复	jelb
承载	jelc
福建省	jemj
唐突	jenv
承包	jese
承德	jesx
康佳	jetl
千山万水	jets
庸俗	jetv
唐朝	jexb
特务	jfaj
那里	jfbl
手里	jfbl
那时	jfbx
摩托车	jfci
特辑	jfco
特区	jfcx
特意	jfdb
特产	jfdj
毛衣	jfdk
看望	jfdl
手脚	jfdl
手迹	jfdm
手腕	jfdn
那就	jfdo
特效	jfdv
牲畜	jfdw
看齐	jfdx
物理	jfeb
特异	jfeh
手动	jffg
拜托	jffj
手持	jffl
特刊	jffn
手指	jfft
特技	jffx
手势	jffx
特邀	jfgd
看台	jfgo
我的	jfgs
手稿	jfhd
特稿	jfhd
犒劳	jfhn
特种	jfho
那种	jfho
物种	jfho
特警	jfhs
看透	jfhz
拜访	jfid
手工	jfii
特工	jfii
特许	jfil
手记	jfiz
应接不暇	jfjb
看看	jfjf
牺牲	jfjf
那么	jfjg
手段	jfji
看了	jfji
物力	jfji
物质	jfjj
看成	jfjj
看书	jfjj
特质	jfjj
应运而生	jfjj
手段	jfjk
那段	jfjk
威武不屈	jfjp
看病	jfjt
毛病	jfjt
看重	jfjt
那边	jfjz
特长	jfki
毛笔	jfkj
特等	jfkl
特制	jfkn
看管	jfkn
手气	jfkz
那年	jflc
拜年	jflc
特地	jflc
手表	jflk
特赦	jflm
不动声色	jflr
那些	jflt
看起来	jflt
特此	jflt
牧场	jflz
特权	jfma
手术	jfmd
我校	jfmd
我想	jfmg
手柄	jfmt
那样	jfmv
手枪	jfmv
手机	jfmw
我军	jfnc
牡丹	jfnd
毛巾	jfni
手帕	jfni
手册	jfnn
手写	jfns
特写	jfns
特定	jfnt
看见	jfnw
拜见	jfnw
我家	jfnx
看中	jfoi
手中	jfoi
特别	jfoj
手足	jfol
物品	jfoo
那只	jfov
手臂	jfpo
我国	jfqe
特困	jfqm
特色	jfrd
物色	jfrd
犄角	jfri
看好	jfrz
物流	jfsd
特派	jfsj
看法	jfsl
看待	jfsl
看清	jfsl
手法	jfsl
特征	jfst
毛泽东	jfst
特殊	jftd
手下	jftd
看到	jftg
物件	jftk
看似	jftl
看作	jftl
物体	jftm
我们	jftn
特例	jftt
特使	jftt
物价	jftv
特价	jftv
那份	jftv
看来	jftx
那天	jfty
手下	jfty
看出	jfue
看着	jfvf
奥运会	jfvf
那个	jfvi
物资	jfvr
那儿	jfwi
特级	jfwj
手无缚鸡之力	jfwj
手掌	jfwn
手绢	jfwo
特约	jfws
物业	jfwt
手续	jfwx
看过	jfxd
特有	jfxd
物料	jfxd
特卖	jfxj
力挽狂澜	jfxs
特大	jfyi
特性	jfyj
座无虚席	jfyj
手套	jfyk
特点	jfyo
看点	jfyo
疲于奔命	jfyv
特快	jfyz
那张	jfzs
夏日	jgbi
原则	jgbn
原是	jgbt
愿意	jgdb
自主	jgde
自由	jgdi
自立	jgdi
愿望	jgdl
自豪	jgdo
原名	jgdo
原文	jgdx
自然	jgdy
原理	jgeb
自理	jgeb
自动	jgfg
自动化	jgft
自卑	jggj
自私	jghg
自营	jghn
自带	jghn
自称	jghr
原著	jghy
夏季	jghz
原谅	jgid
自认	jgiv
自我	jgjf
原物	jgjf
自愿	jgjg
蛋白质	jgjj
原告	jgjl
自选	jgjl
原先	jgjl
自爱	jgjn
自重	jgjt
鼻祖	jgjy
原籍	jgke
自筹	jgkf
原版	jgkj
原装	jgkl
自制	jgkn
原地	jglc
原声	jgld
原封	jgll
自查	jgmb
自述	jgmd
刮目相看	jgmj
原本	jgmt
自用	jgnf
原定	jgnt
自家	jgnx
自卫	jgpt
自助	jgqf
原因	jgqy
自负	jgrb
原始	jgrg
自身	jgri
瘦身	jgri
自如	jgro
自行车	jgsc
自治区	jgsc
原油	jgsd
自律	jgse
自行	jgsf
自治	jgsg
自满	jgsh
鼻涕	jgsv
自传	jgtf
原形	jgth
原型	jgth
自信	jgti
原件	jgtk
原作	jgtl
原价	jgtv
原来	jgtx
夏天	jgty
原创	jgvc
自首	jgvj
自尊	jgvu
自从	jgvv
自编	jgwd
自觉	jgwn
自学	jgwn
原料	jgxd
原有	jgxd
自有	jgxd
自在	jgxi
自杀	jgxm
自古	jgxo
自救	jgxx
自发	jgya
自大	jgyi
自考	jgys
鼻子	jgzi
原子	jgzi
自己	jgzl
自费	jgzs
自强	jgzs
百花齐放	jhdd
面黄肌瘦	jhdj
升高	jhdo
不甘示弱	jhfz
升序	jhjd
不劳而获	jhjh
升起	jhll
不落窠臼	jhng
升降	jhpa
百花争艳	jhrf
升温	jhsb
席位	jhtd
度假	jhtp
升华	jhtt
升值	jhtx
席卷	jhvy
升级	jhwj
力透纸背	jhwk
升学	jhwn
度过	jhxd
鹧鸪	jhxo
广电	jibl
力量	jibt
习题	jibt
广西	jici
厂区	jicx
广为	jidj
厂商	jidn
厂房	jidp
广义	jidx
广播	jifj
力度	jijh
广度	jijh
百读不厌	jijj
广告	jijl
厂长	jiki
力气	jikz
习气	jikz
广场	jilz
甜言蜜语	jini
广阔	jins
厂家	jinx
力图	jiqa
不计其数	jiqx
了解	jird
力争	jire
了得	jisb
广泛	jisj
千言万语	jiti
广东	jitm
了事	jito
习俗	jitv
了结	jiwl
力学	jiwn
力求	jixx
广大	jiyi
习惯	jiyq
广州	jiyy
反观	jjan
后备	jjaq
疲惫	jjaq
反对	jjax
成败	jjba
近日	jjbi
成果	jjbm
后果	jjbm
反映	jjbn
质量	jjbt
历时	jjbx
所要	jjcr
疲软	jjcr
袖手旁观	jjda
神采奕奕	jjdd
病入膏肓	jjdd
后方	jjdh
成立	jjdi
成为	jjdj
盛产	jjdj
后裔	jjdk
不毛之地	jjdl
成亲	jjdm
质变	jjdm
后市	jjdn
重庆市	jjdn
成熟	jjdo
成就	jjdo
成名	jjdo
书名	jjdo
书房	jjdp
成交	jjdv
疗效	jjdv
成效	jjdv
成文	jjdx
后顾之忧	jjdy
反之	jjdz
成群	jjej
后退	jjek
反抗	jjfd
反动	jjfg
所向披靡	jjfj
所示	jjfm
书刊	jjfn
后进	jjfn
反击	jjfu
还不能	jjgd
所能	jjgd
书目	jjgi
后台	jjgo
手疾眼快	jjgy
瓜葛	jjhb
书稿	jjhd
近期	jjhe
盛世	jjhl
后世	jjhl
疲劳	jjhn
后勤	jjho
历程	jjho
殷勤	jjho
反攻	jjia
斤斤计较	jjic
成功	jjij
反诉	jjij
所谓	jjiq
质询	jjis
书评	jjit
所说	jjiv
成语	jjiw
反恐	jjiw
书记	jjiz
自顾不暇	jjjb
书库	jjjc
疲乏	jjjd
羽毛	jjjf
盛夏	jjjg
欣欣向荣	jjjh
成了	jjji
爱不释手	jjjj
书生	jjjl
反而	jjjn
视而不见	jjjn
反向	jjjn
书架	jjjo
反面	jjjq
后面	jjjq
书面	jjjq
疏而不漏	jjjs
反感	jjjt
质感	jjjt
手不释卷	jjjv
反应	jjjw
近视	jjjy
书店	jjjy
返还	jjjy
不翼而飞	jjjz
书籍	jjke
成长	jjki
所长	jjki
书签	jjkv
斥责	jjlb
反复	jjlb
质地	jjlc
历年	jjlc
成年	jjlc
所以	jjld
近年来	jjlt
返校	jjmd
反唇相讥	jjmi
反省	jjmj
原原本本	jjmm
成本	jjmt
书本	jjmt
息息相关	jjmv
质检	jjmv
成材	jjmx
面面相觑	jjmy
质朴	jjmy
盛宴	jjnb
庭审	jjnb
后门	jjni
厦门	jjni
质问	jjno
书写	jjns
戳穿	jjnv
所见	jjnw
看不见	jjnw
成家	jjnx
成员	jjob
反响	jjoj
成品	jjoo
书号	jjot
历史	jjox
历届	jjpd
所属	jjpj
书院	jjpn
庭院	jjpn
书屋	jjpt
后卫	jjpt
自我陶醉	jjpu
历险	jjpv
神乎其神	jjqj
返回	jjqo
反思	jjqu
近期	jjqv
后期	jjqv
成因	jjqy
成婚	jjrc
不了解	jjrd
反馈	jjrl
反射	jjrx
所得	jjsb
书包	jjse
盛行	jjsf
书法	jjsl
疗法	jjsl
还不够	jjso
反驳	jjst
成倍	jjtd
殷切	jjtd
所致	jjtg
盛开	jjth
成型	jjth
成形	jjth
返修	jjti
历任	jjtj
反正	jjtl
质疑	jjtl
书画	jjtq
成像	jjtr
面面俱到	jjtt
反倒	jjtt
入不敷出	jjtu
成份	jjtv
历代	jjtv
疲倦	jjtv
后代	jjtv
后来	jjtx
近来	jjtx
历来	jjtx
后天	jjty
所需	jjuj
盛典	jjuv
成分	jjvd
瓜分	jjvd
疗养	jjve
成全	jjve
盛会	jjvf
反差	jjvf
还不错	jjvh
成人	jjvi
后人	jjvi
近况	jjvo
盛况	jjvo
历次	jjvr
力不从心	jjvu
后缀	jjwa
返乡	jjwj
成绩	jjwl
欣赏	jjwn
反常	jjwn
生物学	jjwn
羽绒	jjwt
后续	jjwx
历经	jjwz
所有	jjxd
所在	jjxi
成才	jjxj
所有权	jjxm
成都	jjyb
后者	jjyb
成都市	jjyd
盛大	jjyi
后悔	jjyl
盛情	jjyl
反悔	jjyl
后劲	jjzi
反弹	jjzs
近日	jkbi
补贴	jkby
补充	jkdg
衬衣	jkdk
初恋	jkdm
初衷	jkdo
欣然	jkdy
袖珍	jkev
被动	jkfg
衬托	jkfj
被捕	jkft
被迫	jkgz
初稿	jkhd
近期	jkhe
段落	jkhs
补课	jkib
舆论	jkiv
衬衫	jkjk
襁褓	jkjk
被告	jkjl
初生	jkjl
补办	jkjv
近乎	jkjv
欣悉	jkjx
近视	jkjy
斥责	jklb
近年	jklc
欣喜	jklo
近年来	jklt
初审	jknb
被害	jknf
初中	jkoi
欣慰	jkpf
补助	jkqf
近期	jkqv
初期	jkqv
褐色	jkrd
初始	jkrg
初一	jkti
补丁	jkti
被俘	jktj
近似	jktl
裸体	jktm
千篇一律	jkts
近代	jktv
补偿	jktw
近来	jktx
裸露	jkuo
近况	jkvo
初次	jkvr
斥资	jkvr
初级	jkwj
初学	jkwn
欣赏	jkwn
补给	jkwv
补救	jkxx
初步	jkyi
补考	jkys
裤子	jkzi
袜子	jkzi
生日	jlbi
选购	jlbs
先是	jlbt
选题	jlbt
选票	jlcf
生硬	jlct
生意	jldb
生育	jldg
后起之秀	jldh
生产	jldj
生产力	jldj
疏通	jldn
造就	jldo
生效	jldv
生理	jleb
靠山	jlei
先辈	jlen
疏导	jlex
先导	jlex
选择	jlfa
压抑	jlfc
生动	jlfg
生于	jlfi
告示	jlfm
先进	jlfn
遥控	jlfn
遥远	jlfw
选拔	jlfx
造势	jlfx
丢掉	jlfy
赞扬	jlfz
蛋白	jlgi
告白	jlgi
压迫	jlgz
疏散	jlhd
延期	jlhe
庄稼	jlhn
厚此薄彼	jlhs
欣喜若狂	jlhx
疾苦	jlhx
谣言	jlii
告诉	jlij
选项	jlij
赞许	jlil
不堪设想	jlim
延误	jlio
告诫	jlit
造诣	jlit
生物	jljf
选手	jljf
不知所云	jljf
不知所措	jljf
疙瘩	jljh
压力	jlji
靠近	jljj
生成	jljj
先后	jljj
赞成	jljj
造成	jljj
靠近	jljk
先生	jljl
遥遥	jljl
生病	jljt
疾病	jljt
庄重	jljt
遥感	jljt
告辞	jljx
造福	jljy
生长	jlki
延长	jlki
压制	jlkn
顾此失彼	jlks
丢失	jlkv
告状	jlky
生气	jlkz
看上去	jllg
告知	jlly
造林	jlmm
疏松	jlmv
生机	jlmw
先机	jlmw
先辈	jlne
选用	jlnf
延安	jlnr
赞同	jlnt
选定	jlnt
告密	jlnu
赞叹	jloa
选中	jloi
告别	jloj
疾呼	jloj
痴呆	jlom
手舞足蹈	jloo
选取	jlpa
延迟	jlpn
赞助	jlqf
庄园	jlqf
延期	jlqv
先期	jlqv
告急	jlre
遥测	jlsb
先行	jlsf
生活	jlsj
选派	jlsj
生涯	jlsj
疏忽	jlss
先驱	jlst
延伸	jltb
生死	jltd
生殖	jltd
造型	jlth
先例	jltt
生化	jltt
造价	jltv
生平	jltv
庄严	jltw
近年来	jltx
先天	jlty
选出	jlue
痴心	jlui
先锋	jlva
生前	jlvd
先前	jlvd
赞美	jlve
生命力	jlvj
生命	jlvt
先决	jlvz
告终	jlwa
造纸	jlwc
生肖	jlwd
延缓	jlwj
压缩	jlwn
赞赏	jlwn
选举	jlwv
赞誉	jlwv
延续	jlwx
生存	jlxi
物以类聚	jlxp
蛋糕	jlxv
生态	jlyd
生怕	jlyg
痴情	jlyl
先声夺人	jlyv
庄子	jlzi
磨难	jmat
彩电	jmbl
采购	jmbs
彩票	jmcf
采矿	jmcj
自相矛盾	jmdj
入木三分	jmev
摩托车	jmfc
摩托	jmfj
摩擦	jmfn
磨损	jmfo
魔鬼	jmgw
采访	jmid
魔力	jmji
麻痹	jmjq
麻将	jmkd
彩妆	jmkr
床上	jmli
魔术	jmmd
麻木	jmmi
麻雀	jmmj
采样	jmmv
采用	jmnf
采取	jmpa
彩屏	jmpv
彩虹	jmqi
彩色	jmrd
魔法	jmsl
采集	jmti
彩信	jmti
磨灭	jmtx
麻醉	jmud
彩霞	jmup
床铺	jmvt
磨合	jmvt
采编	jmwd
魔幻	jmwj
采纳	jmwn
磨练	jmwt
彩绘	jmwv
原材料	jmxd
麻烦	jmxj
糜烂	jmxv
而又	jnai
而是	jnbt
受贿	jnbx
入主	jnde
入户	jndp
废寝忘食	jndv
入股	jndw
自定义	jndx
向外	jndy
奥迪	jndz
受理	jneb
而已	jnei
向导	jnex
爱护	jnfd
爱抚	jnff
奥运	jnfg
适用于	jnfi
应用于	jnfi
受损	jnfo
奥运会	jnfv
入睡	jngj
爱慕	jnhb
入世	jnhl
奥秘	jnhu
受苦	jnhx
而言	jnii
入库	jnjc
入手	jnjf
向后	jnjj
而成	jnjj
而后	jnjj
入选	jnjl
耐磨	jnjm
耐受	jnjn
受敌	jnjx
而不	jnjy
入境	jnld
而去	jnlg
向上	jnli
爱上	jnli
爱戴	jnlq
入场	jnlz
辽宁省	jnmj
受审	jnnb
而非	jnne
受害	jnnf
耐用	jnnf
入门	jnni
入网	jnnx
受灾	jnnx
司空见惯	jnny
入口	jnoi
受聘	jnpd
受阻	jnpq
爱国	jnqe
而且	jnqf
入围	jnqf
受罚	jnqi
痛定思痛	jnqj
不定期	jnqv
受累	jnqw
奥妙	jnrm
爱好	jnrz
向往	jnsd
受骗	jnst
向下	jntd
入住	jntd
入侵	jnte
受到	jntg
受伤	jntl
千军万马	jnts
入伍	jntw
向来	jntx
而来	jntx
向下	jnty
耐心	jnui
爱心	jnui
向前	jnvd
不完全	jnve
向着	jnvf
入会	jnvf
爱人	jnvi
而今	jnvj
受命	jnvt
受益	jnvv
入学	jnwn
入党	jnwn
受过	jnxd
而在	jnxi
向左	jnxi
耐烦	jnxj
入狱	jnxj
受精	jnxl
受害者	jnyb
爱惜	jnyh
爱情	jnyl
加盟	jobd
驾车	joci
不足为奇	jody
加之	jodz
加班	joey
手足无措	joff
后患无穷	jofn
加热	jofx
加工	joii
架设	joiw
自吹自擂	jojf
加压	jojl
加入	jojn
癌症	jojt
加重	jojt
加载	jolc
加以	jold
加上	joli
贺卡	joly
架构	joms
加紧	jona
加密	jonu
加剧	jopx
加固	joqx
加急	jore
加温	josb
加油	josd
自鸣得意	josd
亟待	josl
加深	josn
驾驶	jost
驾驭	jost
加倍	jotd
加速	joto
加价	jotv
加盖	jove
加拿大	jovy
加纳	jown
加大	joyi
历史性	joyj
加快	joyz
架子	jozi
加强	jozs
追寻	jpex
追捧	jpfe
敢于	jpfi
追捕	jpft
不屈不挠	jpjf
追加	jpjo
爱屋及乌	jpjs
追赶	jpll
追查	jpmb
追问	jpno
追究	jpnv
追踪	jpol
阜阳	jppb
追随	jppx
追回	jpqo
追溯	jpsv
不耻下问	jptn
追杀	jpxm
追求	jpxx
追逐	jpxz
追悼	jpyy
追忆	jpyz
面条	jqam
不畏艰险	jqap
面对	jqax
血腥	jqdb
面部	jqdo
面授	jqfj
厮打	jqft
面目	jqgi
面世	jqhl
面积	jqho
面试	jqit
粤语	jqiw
面谈	jqix
不期而遇	jqjb
面貌	jqjg
血压	jqjl
面向	jqjn
血管	jqkn
爵士	jqli
奥斯卡	jqly
面板	jqmj
面额	jqna
面临	jqnk
面容	jqnv
血肉	jqnv
面具	jqqe
自圆其说	jqqi
自欺欺人	jqqv
面色	jqrd
血液	jqsd
面包	jqse
血汗	jqsf
血清	jqsl
血型	jqth
不置可否	jqtj
面前	jqvd
不遗余力	jqvj
血统	jqwd
面纱	jqwm
面料	jqxd
厮杀	jqxm
面粉	jqxv
爱国者	jqyb
面子	jqzi
面孔	jqzl
了如指掌	jrfw
力争上游	jrls
爱尔兰	jrve
妥善	jrvf
妥当	jrwe
妥协	jrxj
爱好者	jryb
自行车	jsci
自治区	jscx
加油站	jsdy
所得税	jshv
我行我素	jsjl
不骄不躁	jsjo
驾驶员	jsob
感激涕零	jssu
毛泽东	jstm
重叠	jtaa
刁难	jtat
腐败	jtba
感冒	jtbg
重申	jtbi
重量	jtbt
重要	jtcr
重码	jtcs
重要性	jtcy
威胁	jtdj
威望	jtdl
重新	jtdm
病变	jtdm
感召	jtdo
厨房	jtdp
重启	jtdp
病房	jtdp
不可多得	jtds
病理	jteb
重建	jtef
重现	jten
不可理喻	jteo
重印	jtep
重担	jtfb
感动	jtfg
重振	jtfj
病逝	jtfj
威武	jtfl
不可能	jtgd
病菌	jthq
感言	jtii
广开言路	jtio
感谢	jtir
所作所为	jtjd
病痛	jtjd
秉承	jtje
瘌痢	jtjh
威力	jtji
不可否认	jtji
病了	jtji
重返	jtjj
病历	jtjj
适可而止	jtjl
百依百顺	jtjm
病床	jtjm
感受	jtjn
病症	jtjt
重重	jtjt
不可磨灭	jtjt
感应	jtjw
重视	jtjy
重庆	jtjy
厅长	jtki
司长	jtki
重装	jtkl
症状	jtky
重复	jtlb
还可以	jtld
病毒	jtlq
感想	jtmg
广东省	jtmj
广东省	jtmm
腐朽	jtmt
生死相依	jtmt
司机	jtmw
厉害	jtnf
重用	jtnf
感冒	jtnf
厨师	jtnt
息事宁人	jtnv
感叹	jtoa
病号	jtot
咸阳	jtpb
熏陶	jtps
病因	jtqy
病危	jtrj
腐蚀	jtrl
感触	jtrq
重温	jtsb
感激	jtsg
自来水	jtsi
司法	jtsl
威海	jtsl
司马	jtst
感染	jtsx
不仅仅	jtta
感到	jttg
重型	jtth
威信	jtti
重任	jttj
重伤	jttl
感伤	jttl
病假	jttp
病例	jttt
腐化	jttt
威严	jttw
重心	jtui
病人	jtvi
感人	jtvi
司令	jtvj
乱七八糟	jtvx
症结	jtwl
感觉	jtwn
重组	jtwq
威风	jtwx
病故	jtxo
垂直	jtxq
腐烂	jtxv
病态	jtyd
感慨	jtye
重大	jtyi
感性	jtyj
感情	jtyl
病情	jtyl
重点	jtyo
威慑	jtyp
感悟	jtyw
痴心妄想	judm
血雨腥风	judw
庇护	jufd
神出鬼没	jugs
痛心疾首	jujv
适配器	juoo
承前启后	jvdj
成人之美	jvdv
办理	jveb
座谈会	jviv
座谈	jvix
貌合神离	jvjd
疮疤	jvjd
毛遂自荐	jvjh
自命不凡	jvjw
千锤百炼	jvjx
千姿百态	jvjy
先人后己	jvjz
座椅	jvmy
办案	jvnr
办公室	jvnt
办好	jvrz
办法	jvsl
廉洁	jvsl
办事处	jvta
座位	jvtd
廉政	jvtl
办事	jvto
千差万别	jvto
乏善可陈	jvtp
廉价	jvtv
千钧一发	jvty
办公	jvvg
办公室	jvvn
不锈钢	jvvn
座次	jvvr
痊愈	jvvt
办学	jvwn
加拿大	jvyi
百分点	jvyo
应对	jwax
歪风邪气	jwck
被誉为	jwdj
应变	jwdm
不学无术	jwfm
应邀	jwgd
疫苗	jwhq
应该	jwid
应试	jwit
应承	jwje
应答	jwkv
近几年	jwlc
感兴趣	jwll
应用	jwnf
应聘	jwpd
应届	jwpd
应急	jwre
不绝如缕	jwrw
应得	jwsb
应征	jwst
系列	jwtd
千丝万缕	jwtw
应付	jwtx
应酬	jwuy
威风凛凛	jwvv
应从	jwvv
系统	jwwd
应当	jwwe
疯狂	jwxj
系数	jwxr
初学者	jwyb
疫情	jwyl
应考	jwys
敌对	jxax
千里	jxbl
番禺	jxbn
适量	jxbt
适时	jxbx
乘车	jxci
乖舛	jxdc
舌头	jxdd
释放	jxdh
翻新	jxdm
丢盔弃甲	jxdq
翻腾	jxdv
辞退	jxek
适于	jxfi
函授	jxfj
千元	jxfw
迁移	jxhd
番茄	jxhj
千秋	jxhx
翻译	jxia
适度	jxjh
癫痫	jxjn
不在乎	jxjv
适应	jxjw
翻番	jxjx
敌视	jxjy
翻版	jxkj
所在地	jxlc
辞去	jxlg
所有权	jxma
乘机	jxmw
乘客	jxna
敌军	jxnc
适用	jxnf
丑闻	jxnp
适宜	jxnq
翻案	jxnr
甜蜜	jxnu
翻唱	jxob
辞呈	jxoe
适中	jxoi
辞别	jxoj
辞职	jxpo
丑陋	jxpt
悉尼	jxpt
应有尽有	jxpx
不求甚解	jxqr
翻身	jxri
翻滚	jxsd
生龙活虎	jxsy
千真万确	jxtc
剩下	jxtd
千万	jxth
翻开	jxth
释疑	jxtl
丑恶	jxtw
剩下	jxty
辞典	jxuv
甜美	jxve
翻盖	jxve
敌人	jxvi
千金	jxvi
适合	jxvt
剩余	jxvt
乘坐	jxvv
适当	jxwe
千古绝唱	jxwo
豺狼	jxxj
庞杂	jxxm
千克	jxxo
垂直	jxxq
函数	jxxr
悉数	jxxr
庞大	jxyi
乱套	jxyk
神圣	jyal
不难	jyat
不对	jyax
不败	jyba
不明	jybd
视野	jybl
否则	jybn
不易	jybs
不是	jybt
还是	jybt
不时	jybx
不要	jycr
还要	jycr
社区	jycx
福音	jydb
不多	jydd
不忍	jydd
不良	jyde
废弃	jydg
不为	jydj
视为	jydj
不忘	jydl
不变	jydm
成都市	jydn
福州市	jydn
广州市	jydn
不高	jydo
不服	jydp
不予	jydt
社交	jydv
不然	jydy
不理	jyeb
福建	jyef
不已	jyei
社群	jyej
福建省	jyem
不灵	jyex
不动	jyfg
夭折	jyfj
还未	jyfm
不能	jygd
还能	jygd
不甘	jyhf
不利	jyhn
福利	jyhn
不菲	jyhn
不和	jyho
祥和	jyho
礼节	jyhp
神秘	jyhu
废旧	jyib
不该	jyid
庆功	jyij
神话	jyij
废话	jyij
不许	jyil
不让	jyil
否认	jyiv
社论	jyiv
不论	jyiv
不详	jyiv
不计	jyix
不顾	jyjc
不愿意	jyjd
百战百胜	jyjd
不乏	jyjd
习惯成自然	jyjd
礼物	jyjf
礼拜	jyjf
废物	jyjf
不愿	jyjg
还原	jyjg
礼貌	jyjg
祝愿	jyjg
不息	jyjg
视力	jyji
不了	jyji
不力	jyji
不成	jyjj
乘虚而入	jyjj
祖先	jyjl
不受	jyjn
祝贺	jyjo
百发百中	jyjo
庆贺	jyjo
不敢	jyjp
不妥	jyjr
丑态百出	jyju
不应	jyjw
还应	jyjw
不适	jyjx
庆祝	jyjy
祝福	jyjy
祈祷	jyjy
千奇百怪	jyjy
不及	jyjz
还将	jykd
祖籍	jyke
不算	jykg
还算	jykg
神算	jykg
社长	jyki
不等	jykl
不管	jykn
不符	jykt
不失	jykv
废气	jykz
神气	jykz
福气	jykz
不肯	jyld
不堪	jylh
废止	jyli
不止	jyli
不起	jyll
不堪	jylq
神志	jylu
不幸	jylv
庆幸	jylv
不知道	jylv
不知	jyly
不幸	jyly
庆幸	jyly
废墟	jyly
不想	jymg
不小	jymi
不少	jymj
不禁	jymm
不用	jynf
祸害	jynf
祖宗	jynf
百步穿杨	jynm
不宜	jynq
不安	jynr
神舟	jyns
不同	jynt
不定	jynt
否定	jynt
不容	jynv
不见	jynw
视察	jynx
视听	jyoj
不足	jyol
礼品	jyoo
不只	jyov
不限	jype
不尽	jypn
废除	jypv
不屑	jypw
祖国	jyqe
祖母	jyqs
视界	jyqv
社团	jyqx
不妨	jyrd
神色	jyrd
不解	jyrd
视角	jyri
不久	jyrn
不如	jyro
不免	jyro
不好	jyrz
还好	jyrz
不得	jysb
不行	jysf
不满	jysh
废水	jysi
不得不	jysj
不法	jysl
不清	jysl
还清	jysl
不够	jyso
不仅	jyta
不但	jytb
不停	jytd
礼仪	jytd
不住	jytd
神仙	jyte
憨态可掬	jytf
不到	jytg
不可能	jytg
自惭形秽	jyth
不一	jyti
不佳	jytl
不一样	jytm
不再	jytn
不可	jyto
神速	jyto
社保	jyto
不像	jytr
千虑一得	jyts
不便	jytt
厌倦	jytv
不平	jytv
不倦	jytv
厌恶	jytw
不值	jytx
不下	jyty
不出	jyue
歪曲	jyui
不比	jyui
不必	jyuj
还需	jyuj
不需	jyuj
还必须	jyus
庆典	jyuv
不配	jyuz
爱憎分明	jyvb
不单	jyvb
不分	jyvd
不会	jyvf
店铺	jyvf
还会	jyvf
社会	jyvf
不善	jyvf
不公	jyvg
不错	jyvh
社会上	jyvl
不曾	jyvq
不准	jyvt
不合	jyvt
店铺	jyvt
祖父	jyvx
否决	jyvz
不凡	jywd
不当	jywe
视线	jywf
还乡	jywj
礼堂	jywn
视觉	jywn
不觉	jywn
不绝	jywr
还给	jywv
歪风	jywx
神经	jywz
不过	jyxd
还有	jyxd
不料	jyxd
不在	jyxi
还在	jyxi
不在乎	jyxj
不断	jyxl
祈求	jyxx
广州市	jyyd
神态	jyyd
不怕	jyyg
不懂	jyyh
不惜	jyyh
不大	jyyi
视频	jyyj
神情	jyyl
视点	jyyo
不懈	jyyr
神奇	jyyt
不慎	jyyx
福州	jyyy
神州	jyyy
不快	jyyz
及时	jzbx
及早	jzbx
乳腺	jzdg
痉挛	jzdm
乳房	jzdp
及其	jzhe
百孔千疮	jzjj
自强不息	jzjj
麒麟	jzjz
边境	jzld
及格	jzma
边框	jzmc
辽宁省	jznm
辽阔	jzns
辽宁	jznt
边防	jzpd
边际	jzpf
边界	jzqv
及其	jzqv
痛改前非	jzvn
边缘	jzwl
边疆	jzzs
等量齐观	kbda
简明扼要	kbfc
笸箩	kckq
将对	kdax
将是	kdbt
将要	kdcr
奖章	kddb
篇章	kddb
将由	kddi
将就	kddo
将于	kdfi
奖项	kdij
将近	kdjj
将成	kdjj
将近	kdjk
将被	kdjk
奖励	kdjt
篱笆	kdkd
将士	kdli
将军	kdnc
篇幅	kdni
将帅	kdnn
奖品	kdoo
奖罚	kdqi
将其	kdqv
酱油	kdsd
将与	kdsi
奖惩	kdst
装腔作势	kdtf
将使	kdtt
将来	kdtx
将会	kdvf
奖金	kdvi
将领	kdvj
将从	kdvv
奖赏	kdwn
将有	kdxd
将在	kdxi
肆意	kedb
籍贯	keqx
第三者	keyb
肆虐	keyc
筹备	kfaq
筹码	kfcs
背井离乡	kfdw
筹建	kfef
筹措	kffh
筹办	kfjv
气势汹汹	kfss
筹集	kfti
筹资	kfvr
筹划	kfxn
肆无忌惮	kfzy
牌照	kgbd
算是	kgbt
笑眯眯	kggx
算计	kgix
笨鸟先飞	kgjz
算盘	kgns
算法	kgsl
算命	kgvt
牌子	kgzi
篡改	kgzl
长处	kiay
将功赎罪	kibq
牛市	kidn
长效	kidv
片刻	kidy
长辈	kien
长春	kiev
长进	kifn
长远	kifw
长寿	kifx
长期	kihe
牛皮	kija
长廊	kijd
长度	kijh
片段	kijk
片面	kijq
长篇	kikd
长城	kilj
长短	kily
牛棚	kimd
长相	kimg
竹林	kimm
笔记本	kimt
长辈	kine
长安	kinr
牛肉	kinv
长足	kiol
长跑	kiol
长虹	kiqi
长期	kiqv
长久	kirn
牛奶	kirz
长得	kisb
长江	kisi
长沙	kism
长征	kist
长假	kitp
牛仔	kitz
长途	kivt
长线	kiwf
片断	kixl
长发	kiya
长大	kiyi
长达	kiyz
片子	kizi
版主	kjde
笔迹	kjdm
制造商	kjdn
笔名	kjdo
笑脸	kjdv
简而言之	kjid
笑话	kjij
笔试	kjit
笔记	kjiz
版面	kjjq
牛皮癣	kjjr
笑声	kjld
版权	kjma
版本	kjmt
笑容	kjnv
版图	kjqa
笔墨	kjqh
版画	kjtq
笔画	kjtq
笔下	kjty
笑着	kjvf
制造业	kjwt
笔直	kjxq
笔者	kjyb
壮观	klan
装备	klaq
装运	klfg
等于	klfi
装扮	klfv
装蒜	klhf
装订	klit
等等	klkl
装载	kllc
长此以往	klls
装卸	kllx
装机	klmw
壮阔	klns
等同	klnt
装置	klqx
装饰	klrl
装潢	klsh
等待	klsl
壮烈	kltd
等到	kltg
装修	klti
等候	klti
壮丽	kltn
等你	kltr
装货	kltt
装配	kluz
等着	klvf
壮志凌云	klvf
等人	klvi
等级	klwj
壮举	klwv
装有	klxd
壮大	klyi
朱砂	kmcm
笨拙	kmfu
笨蛋	kmjl
笨重	kmjt
装模作样	kmtm
制备	knaq
简明	knbd
简易	knbs
管辖	kncn
简要	kncr
简章	kndb
等闲之辈	kndn
制服	kndp
制剂	kndx
管理	kneb
篮球	knex
制导	knex
制动	knfg
简报	knfp
简捷	knft
简称	knhr
制药	knhw
制订	knit
简讯	kniz
等闲视之	knjd
制度	knjh
制成	knjj
简历	knjj
制造	knjl
筛选	knjl
简装	knkl
管制	knkn
制裁	knld
制止	knli
简短	knly
简朴	knmy
简写	knns
制定	knnt
管家	knnx
制品	knoo
简陋	knpt
制图	knqa
简略	knqa
简洁	knsl
笑容可掬	kntf
制作	kntl
简体	kntm
简化	kntt
简便	kntt
简单	knvb
管道	knvj
简介	knvn
制冷	knvv
管线	knwf
制约	knws
简约	knws
简练	knwt
简直	knxq
筚路蓝缕	kohw
长吁短叹	kolo
管中窥豹	konj
簸箕	kqkq
气急败坏	krbl
背景	ktbd
背影	ktbd
北欧	ktcx
北京市	ktdd
背信弃义	ktdd
北方	ktdh
北京	ktdo
北部	ktdo
背离	ktdx
气吞山河	ktes
背诵	ktid
背后	ktjj
背面	ktjq
北极	ktmj
北路	ktol
符号	ktot
策略	ktqa
北国	ktqe
背负	ktrb
背包	ktse
北海	ktsl
北美	ktve
背着	ktvf
符合	ktvt
背叛	ktvx
北约	ktws
背光	ktww
策划	ktxn
北大	ktyi
失败	kvba
失明	kvbd
答题	kvbt
失望	kvdl
失恋	kvdm
签名	kvdo
失效	kvdv
答辩	kvdx
失灵	kvex
失控	kvfn
失眠	kvgp
失利	kvhn
失落	kvhs
失调	kvin
失误	kvio
签订	kvit
签证	kvit
背道而驰	kvjs
答应	kvjw
失策	kvkt
答复	kvlb
失地	kvlc
失去	kvlg
签收	kvli
箪食壶浆	kvlk
失实	kvnd
答案	kvnr
签字	kvnz
失踪	kvol
失职	kvpo
失聪	kvpv
签署	kvqy
失衡	kvsr
北冰洋	kvsv
签到	kvtg
失信	kvti
答疑	kvtl
失事	kvto
答卷	kvvy
失常	kvwn
失学	kvwn
签约	kvws
失业	kvwt
失火	kvxi
失真	kvxq
签发	kvya
奖学金	kwvi
笑逐颜开	kxdt
笼罩	kxqy
笼络	kxwa
笼统	kxwd
状元	kyfw
状况	kyvo
状态	kyyd
筷子	kyzi
第六	kzdv
第三	kzei
气球	kzex
第二	kzfi
气势	kzfx
气魄	kzgg
气节	kzhp
气功	kzij
气息	kzjg
气质	kzjj
气压	kzjl
气管	kzkn
氧气	kzkz
气氛	kzkz
气概	kzme
气味	kzof
氛围	kzqf
第四	kzqi
气象	kzro
气温	kzsb
气流	kzsd
气派	kzsj
第一	kzti
第七	kzti
气候	kzti
气体	kztm
氧化	kztt
第八	kzvi
第五	kzwi
第九	kzxi
第十	kzxi
气愤	kzyx
麦克	laxo
责备	lbaq
责难	lbat
复旦	lbbt
埋怨	lbdc
塌方	lbdh
坦率	lbdv
坦率	lbdw
坦然	lbdy
复印机	lbem
复印	lbep
坦白	lbgi
复苏	lbhj
埋藏	lbhk
坦荡	lbhs
埋葬	lbht
复议	lbid
坦言	lbii
坦诚	lbij
复习	lbji
责成	lbjj
复制	lbkn
复查	lbmb
复核	lbmd
复写	lbns
复员	lbob
复辟	lbpo
复活	lbsj
埋没	lbsw
责任	lbtj
责任制	lbtk
复仇	lbtx
埋伏	lbty
复出	lbue
责令	lbvj
复合	lbvt
责编	lbwd
复兴	lbwv
复杂	lbxm
坦克	lbxo
复发	lbya
地处	lcay
年轻人	lccv
地区	lccx
年轻	lccz
年头	lcdd
地主	lcde
地方	lcdh
年月	lcdi
年产	lcdj
地名	lcdo
地理	lceb
地球	lcex
年报	lcfp
地势	lcfx
年薪	lchd
地带	lchn
地利	lchn
地税	lchv
地皮	lcja
年底	lcjc
地毯	lcjf
地貌	lcjg
年度	lcjh
地质	lcjj
年历	lcjj
年初	lcjk
地段	lcjk
载入	lcjn
地面	lcjq
载重	lcjt
年长	lcki
年年	lclc
年青	lcld
地上	lcli
地表	lclk
地址	lcll
年均	lcls
地域	lclt
年龄	lclv
年龄	lclw
地块	lclz
地板	lcmj
年检	lcmv
年间	lcnb
年鉴	lcnk
地盘	lcns
年限	lcpe
地层	lcpf
地图	lcqa
年满	lcsh
地位	lctd
地下	lctd
地形	lcth
载体	lctm
年末	lctm
迤逦	lctn
年华	lctt
年代	lctv
年份	lctv
地下	lcty
地震	lcuj
地雷	lcuq
年会	lcvf
年轻人	lcvi
地道	lcvj
地铁	lcvk
年终	lcwa
年级	lcwj
地学	lcwn
年纪	lcwz
地支	lcxa
地狱	lcxj
地步	lcyi
地点	lcyo
声明	ldbd
靓照	ldbd
静电	ldbl
以西	ldci
声乐	ldcm
声音	lddb
静脉	lddd
培育	lddg
以为	lddj
声望	lddl
声名	lddo
以外	lddy
境外	lddy
青山	ldei
青春	ldev
声援	ldfj
声势	ldfx
青岛	ldge
青睐	ldgt
坟墓	ldhb
趋之若鹜	ldhd
以其	ldhe
青藏	ldhk
声称	ldhr
培训	ldim
声调	ldin
声讨	ldix
知名度	ldjh
喜新厌旧	ldji
以后	ldjj
以及	ldjz
以北	ldkt
青年	ldlc
境地	ldlc
静静	ldld
以上	ldli
静止	ldli
垃圾	ldlj
赤膊上阵	ldlp
以此	ldlt
声卡	ldly
青少年	ldml
培植	ldmx
裁军	ldnc
肯定	ldnt
裁定	ldnt
以内	ldnv
境内	ldnv
裁员	ldob
声响	ldoj
赤胆忠心	ldou
以防	ldpd
青蛙	ldql
境界	ldqv
以其	ldqv
声色	ldrd
靓女	ldri
以免	ldro
以往	ldsd
青海	ldsl
青海省	ldsm
以下	ldtd
以致	ldtg
以至	ldtg
以便	ldtt
以来	ldtx
以下	ldty
以前	ldvd
裁剪	ldvd
培养	ldve
裁减	ldvj
声道	ldvj
裁判	ldvx
裁决	ldvz
声誉	ldwv
以南	ldxn
青龙	ldxt
以求	ldxx
静态	ldyd
声张	ldzs
复印机	lemw
复印件	letk
责无旁贷	lfdt
地动山摇	lfef
走投无路	lffo
款项	lfij
款待	lfsl
声势浩大	lfsy
款式	lfti
却又	lgai
去处	lgay
却是	lgbt
去掉	lgfy
去世	lghl
却说	lgiv
去了	lgji
去向	lgjn
却不	lgjy
埃及	lgjz
去年	lglc
去除	lgpv
去过	lgxd
却有	lgxd
舞台	lhgo
赘述	lhmd
舞蹈	lhol
熬到	lhtg
收藏夹	lhtv
繁花似锦	lhtv
舞曲	lhui
舞会	lhvf
舞弊	lhvn
收条	liam
土星	libj
上映	libn
收购	libs
土匪	lice
上车	lici
土匪	licn
收音	lidb
上方	lidh
上月	lidi
上衣	lidk
收音机	lidm
上帝	lidn
上市	lidn
上部	lido
收效	lidv
上交	lidv
上山	liei
上岗	lien
收录	lies
上班	liey
上进	lifn
上报	lifp
收据	lifp
收拾	lifv
上扬	lifz
上台	ligo
士兵	ligv
收藏	lihk
收税	lihv
收获	lihx
上课	liib
上诉	liij
上调	liin
收买	lijd
止痛	lijd
收看	lijf
上手	lijf
上升	lijh
收成	lijj
上书	lijj
上床	lijm
收入	lijn
收受	lijn
上瘾	lijp
上面	lijq
上司	lijt
上乘	lijx
收视	lijy
上将	likd
上等	likl
上装	likl
士气	likz
收复	lilb
土地	lilc
上载	lilc
上年	lilc
土壤	lild
收款	lilf
上去	lilg
上午	lilx
上场	lilz
上述	limd
土木	limi
收割	linf
上门	lini
上周	linl
收盘	lins
上空	linv
上网	linx
上家	linx
收听	lioj
上路	liol
收取	lipa
上阵	lipc
上限	lipe
上层	lipf
收回	liqo
上界	liqv
上好	lirz
上旬	lisb
上游	lisd
上流	lisd
上行	lisf
收治	lisg
上海	lisl
上演	lisn
上马	list
上涨	lisz
上下	litd
止住	litd
上传	litf
收到	litg
上万	lith
收集	liti
上任	litj
收件	litk
土豆	lito
上来	litx
上天	lity
上下	lity
收银	live
收养	live
上次	livr
收益	livv
上当	liwe
上线	liwf
上缴	liwg
收缴	liwg
上级	liwj
上学	liwn
收缩	liwn
收支	lixa
收发	liya
收费	lizs
城里	ljbl
城区	ljcx
以不变应万变	ljdd
城市	ljdn
城建	ljef
坏了	ljji
坏蛋	ljjl
怎么办	ljjv
城管	ljkn
城墙	ljlx
以貌取人	ljpv
坏死	ljtd
坏事	ljto
城堡	ljto
坏人	ljvi
城镇	ljvx
城乡	ljwj
罄竹难书	lkaj
表明	lkbd
表彰	lkdb
喜笑颜开	lkdt
增长率	lkdw
表率	lkdw
表现	lken
表示	lkfm
表扬	lkfz
怎能	lkgd
表白	lkgi
怎么	lkjg
截长补短	lkjl
怎么样	lkjm
表面	lkjq
表格	lkma
表述	lkmd
怎样	lkmv
表妹	lkrf
表象	lkro
表演	lksn
表哥	lkto
表露	lkuo
表单	lkvb
表决	lkvz
表弟	lkvz
表态	lkyd
表情	lkyl
表达	lkyz
封条	llam
越野	llbl
越是	llbt
超时	llbx
起码	llcs
越多	lldd
起头	lldd
起立	lldi
超市	lldn
起名	lldo
走高	lldo
走遍	lldp
超脱	lldv
起义	lldx
封建	llef
超群	llej
趋于	llfi
走进	llfn
趋势	llfx
走势	llfx
起草	llhb
走私	llhg
超薄	llhs
走访	llid
起诉	llij
以毒攻毒	llil
走廊	lljd
走了	llji
走近	lljj
起初	lljk
走近	lljk
超生	lljl
起床	lljm
趋向	lljn
走向	lljn
封面	lljq
起重	lljt
超重	lljt
封装	llkl
超载	lllc
超声	llld
走上	llli
赶上	llli
超越	llll
赶赴	llll
越权	llma
超标	llmf
趁机	llmw
超额	llna
赶紧	llna
起用	llnf
封闭	llnx
起家	llnx
超员	llob
趣味	llof
走路	llol
超期	llqv
起因	llqy
起色	llrd
起始	llrg
起身	llri
越好	llrz
赶往	llsd
起源	llsj
走低	lltc
赶到	lltg
走到	lltg
起到	lltg
越来越	lltl
趣事	llto
超速	llto
走俏	lltw
起来	lltx
超值	lltx
起伏	llty
走出	llue
超出	llue
超前	llvd
超人	llvi
封锁	llvw
走红	llwi
超级	llwj
超常	llwn
走光	llww
超支	llxa
超过	llxd
走过	llxd
越过	llxd
起火	llxi
走在	llxi
封存	llxi
封杀	llxm
越南	llxn
越发	llya
起步	llyi
越大	llyi
超频	llyj
起点	llyo
赶快	llyz
起劲	llzi
超强	llzs
起飞	llzv
栽赃	lmbj
赤峰	lmea
督导	lmex
赤裸	lmjk
督办	lmjv
青梅竹马	lmks
青少年	lmlc
栽培	lmld
叔叔	lmlm
吉林省	lmmj
赤字	lmnz
赦免	lmro
督促	lmto
赤道	lmvj
矫枉过正	lmxt
短小精悍	lmxy
喜闻乐见	lncn
坍塌	lnlb
埃塞俄比亚	lntt
志同道合	lnvv
喜欢	loar
鼓动	lofg
喜鹊	lohb
吉利	lohn
喜讯	loiz
声嘶力竭	lojd
矢口否认	loji
喜爱	lojn
鼓励	lojt
吉祥	lojy
喜庆	lojy
嘉奖	lokd
喜气	lokz
鼓舞	lolh
吉林	lomm
嘉宾	long
鼓吹	loor
喜剧	lopx
喜好	lorz
吉他	lotc
喜人	lovi
鼓掌	lown
嘉兴	lowv
喜悦	loyv
鼓劲	lozi
每逢	lqaf
每条	lqam
每日	lqbi
繁多	lqdd
繁育	lqdg
每月	lqdi
每股	lqdw
毒辣	lqdx
繁琐	lqew
敏捷	lqft
繁荣	lqhn
堪称	lqhr
每页	lqjb
繁重	lqjt
敏感	lqjt
每年	lqlc
毒害	lqnf
每周	lqnl
毒品	lqoo
每回	lqqo
繁衍	lqss
繁殖	lqtd
每位	lqtd
繁体	lqtm
繁华	lqtt
每天	lqty
每个	lqvi
每人	lqvi
每次	lqvr
敏锐	lqvv
每当	lqwe
繁杂	lqxm
繁忙	lqyd
毒性	lqyj
喜怒哀乐	lrdc
坎坷	lrlt
以逸待劳	lrsh
以色列	lrtd
声色俱厉	lrtj
走马观花	lsah
均由	lsdi
志得意满	lsds
均未	lsfm
均等	lskl
上海市	lsld
均衡	lssr
均匀	lssv
上行下效	lstd
均可	lsto
均有	lsxd
此处	ltay
此时	ltbx
城下之盟	ltdb
堆放	ltdh
域名	ltdo
此文	ltdx
此外	ltdy
此刻	ltdy
截然	ltdy
域外	ltdy
声东击西	ltfc
以至于	ltfi
堆积	ltho
增值税	lthv
此项	ltij
短信息	ltjg
此后	ltjj
忐忑不安	ltjn
责任感	ltjt
责任制	ltkn
此地	ltlc
截止	ltli
越来越	ltll
此间	ltnb
此帖	ltni
此案	ltnr
截图	ltqa
起死回生	ltqj
紫色	ltrd
柴油	ltsd
截至	lttg
此事	ltto
此前	ltvd
上一个	ltvi
此人	ltvi
此次	ltvr
此举	ltwv
紫光	ltww
雌雄	ltxg
此类	ltxy
喜出望外	ludd
志愿	lujg
志向	lujn
忐忑	lutd
增量	lvbt
增多	lvdd
增产	lvdj
迄今为止	lvdl
增高	lvdo
幸运	lvfg
增援	lvfj
增进	lvfn
幸亏	lvfs
增兵	lvgv
增设	lviw
增补	lvjk
增生	lvjl
增加	lvjo
幸福	lvjy
增长率	lvkd
增长	lvki
上半年	lvlc
增收	lvli
增幅	lvni
增派	lvsj
增添	lvst
增殖	lvtd
增至	lvtg
增值	lvtx
增减	lvvj
每况愈下	lvvt
增光	lvww
增大	lvyi
增强	lvzs
齿轮	lwcv
超级市场	lwdl
青光眼	lwge
青红皂白	lwgg
麦当劳	lwhn
素质	lwjj
龌龊	lwlw
素材	lwmx
素养	lwve
素有	lwxd
罐头	lxdd
填充	lxdg
午夜	lxdt
歧义	lxdx
缺损	lxfo
填报	lxfp
缺勤	lxho
缺乏	lxjd
寺庙	lxjd
缺席	lxjh
填补	lxjk
歧视	lxjy
缺失	lxkv
缺氧	lxkz
卸载	lxlc
墙上	lxli
填表	lxlk
缺少	lxmj
缺省	lxmj
填写	lxns
填空	lxnv
缺口	lxoi
寺院	lxpn
墙壁	lxpo
缺陷	lxpr
午饭	lxrl
卸任	lxtj
缺货	lxtt
歧途	lxvt
墙纸	lxwc
午餐	lxyd
缺点	lxyo
知晓	lybx
卡车	lyci
堵车	lyci
短暂	lycj
知音	lydb
智商	lydn
卡通	lydn
知名	lydo
智慧	lyff
幸运	lyfg
幸亏	lyfs
智能	lygd
垮台	lygo
短期	lyhe
智利	lyhn
知识	lyio
短语	lyiw
短讯	lyiz
智力	lyji
幸而	lyjn
幸福	lyjy
短篇	lykd
卡片	lyki
盐城	lylj
知趣	lyll
短缺	lylx
短短	lyly
堵塞	lynf
短路	lyol
知足	lyol
卡号	lyot
矩阵	lypc
短期	lyqv
幸免	lyro
幸好	lyrz
短信	lyti
矫正	lytl
短促	lyto
知心	lyui
知道	lyvj
短线	lywf
知觉	lywn
知情	lyyl
知己	lyzl
场景	lzbd
乞讨	lzix
场所	lzjj
场面	lzjq
场地	lzlc
场馆	lzrl
乞丐	lztt
迄今	lzvj
场合	lzvt
乞求	lzxx
棋逢对手	maaj
格斗	madd
树立	madi
树脂	madt
格外	mady
权势	mafx
权利	mahn
格言	maii
格调	main
权力	maji
权威	majt
格格	mama
树木	mami
树林	mamm
树叶	maox
权限	mape
格局	mapj
权衡	masr
格式	mati
权益	mavv
查对	mbax
查处	mbay
查明	mbbd
查寻	mbex
查抄	mbfm
查找	mbfx
柳暗花明	mbhb
樱花	mbht
查获	mbhx
查询	mbis
查证	mbit
查看	mbjf
查收	mbli
查封	mbll
樱桃	mbmv
查阅	mbnv
查清	mbsl
查验	mbst
小时候	mbti
查出	mbue
栖息	mcjg
框架	mcjo
框框	mcmc
相辅相成	mcmj
枢纽	mcwj
柳州	mcyy
核对	mdax
校对	mdax
标新立异	mdde
小朋友	mddx
校外	mddy
梳理	mdeb
想方设法	mdis
述评	mdit
术语	mdiw
校庆	mdjy
核算	mdkg
校长	mdki
核查	mdmb
榜样	mdmv
核实	mdnd
校门	mdni
核定	mdnt
校内	mdnv
校园	mdqf
校正	mdtl
核心	mdui
校舍	mdvf
榜首	mdvj
核准	mdvt
校友	mdxa
小朋友	mdxa
核发	mdya
杭州市	mdyd
杭州	mdyy
橘子	mdzi
概要	mecr
小灵通	medn
概率	medv
概率	medw
棒球	meex
概括	mefj
根据	mefp
概论	meiv
木已成舟	mejn
概述	memd
根本	memt
概览	menk
根除	mepv
根基	meqv
根治	mesg
根源	mesj
概念	mevj
概况	mevo
枉费	mezs
标明	mfbd
标题	mfbt
标的	mfgs
标兵	mfgv
标识	mfio
标语	mfiw
标记	mfiz
标签	mfkv
标志	mflu
标志着	mflv
标榜	mfmd
标本	mfmt
标致	mftg
标价	mftv
相提并论	mfvi
标准	mfvt
标点	mfyo
相逢	mgaf
相对	mgax
相处	mgay
相遇	mgbn
想要	mgcr
相连	mgcz
相通	mgdn
相抵	mgfc
相接	mgfd
相干	mgfi
柜台	mggo
相称	mghr
棉花	mght
相识	mgio
相貌	mgjg
相反	mgjj
相近	mgjk
相爱	mgjn
想不到	mgjt
相应	mgjw
相片	mgki
相等	mgkl
相符	mgkt
相声	mgld
想去	mglg
想起	mgll
想想	mgmg
相机	mgmw
相册	mgnn
相同	mgnt
相见	mgnw
相距	mgol
相聚	mgpa
相助	mgqf
相思	mgqu
想象	mgro
想法	mgsl
相传	mgtf
想到	mgtg
相信	mgti
相互	mgtl
相似	mgtl
想像	mgtr
相伴	mgtv
想来	mgtx
相比	mgui
想必	mguj
相配	mguz
相差	mgvf
想念	mgvj
相邻	mgvj
相关	mgvy
棉纺	mgwd
相当	mgwe
相约	mgws
相继	mgwx
想过	mgxd
顺藤摸瓜	mhfj
模拟	mhfl
模范	mhhs
模特	mhjf
本科生	mhjl
横向	mhjn
模块	mhlz
模板	mhmj
模棱	mhml
模样	mhmv
模具	mhqe
横亘	mhtb
模仿	mhtd
模型	mhth
模式	mhti
杰作	mhtl
杰出	mhue
本草纲目	mhwg
模糊	mhxx
小时	mibx
小车	mici
小区	micx
木头	midd
小于	mifi
小指	mift
小巧	miit
小说	miiv
小康	mije
小气	mikz
小麦	mila
杠杆	mimf
小小	mimi
小样	mimv
木材	mimx
小额	mina
小吃	miol
小品	mioo
小屋	mipt
小姐	mirq
木马	mist
小型	mith
小事	mito
小偷	mitv
小心	miui
小雨	miui
小人	mivi
小资	mivr
小弟	mivz
小儿	miwi
小结	miwl
小学	miwn
小组	miwq
小孩	mizd
小子	mizi
顺畅	mjbi
少量	mjbt
极乐	mjcm
极端	mjde
极为	mjdj
省市	mjdn
极高	mjdo
少于	mjfi
劣势	mjfx
极其	mjhe
顺利	mjhn
省委	mjhr
少许	mjil
顺序	mjjd
顺手	mjjf
极度	mjjh
极力	mjji
少了	mjji
极了	mjji
劣质	mjjj
顺应	mjjw
相适应	mjjw
省长	mjki
少年	mjlc
省城	mjlj
板块	mjlz
橄榄	mjmn
板材	mjmx
少见	mjnw
极品	mjoo
极限	mjpe
省略	mjqa
极具	mjqe
少男	mjqj
极其	mjqv
少女	mjri
桥梁	mjsd
顺德	mjsx
想不到	mjtg
板式	mjti
省事	mjto
极速	mjto
顺便	mjtt
省份	mjtv
省优	mjtx
省心	mjui
顺心	mjui
顺着	mjvf
省钱	mjvf
省会	mjvf
顺道	mjvj
枷锁	mjvw
少儿	mjwi
省级	mjwj
少有	mjxd
少数	mjxr
板凳	mjxt
极大	mjyi
极点	mjyo
顺手牵羊	mjyv
省悟	mjyw
极强	mjzs
梅花	mlht
桂花	mlht
尘埃	mllg
尘土	mlli
桂林	mlmm
桂冠	mlnf
杜鹃	mlod
杜甫	mltd
杜绝	mlwr
桔子	mlzi
梦里	mmbl
禁区	mmcx
楚楚动人	mmfv
攀枝花	mmht
禁止	mmli
梦想	mmmg
林木	mmmi
森林	mmmm
禁用	mmnf
梦中	mmoi
栩栩如生	mmrj
梦游	mmsd
模棱两可	mmtt
楚楚可怜	mmty
禁令	mmvj
林林总总	mmvv
梦幻	mmwj
林业	mmwt
彬彬有礼	mmxj
焚烧	mmxx
机构改革	mmzh
禁忌	mmzl
枪林弹雨	mmzu
梦寐以求	mnlx
柠檬	mnmh
棕榈	mnmn
棺材	mnmx
检察院	mnpn
椭圆	mpqo
橡胶	mrdd
杯水车薪	msch
构建	msef
顺水推舟	msfn
根深蒂固	mshq
构成	msjj
川流不息	msjj
构造	msjl
构架	msjo
构筑	mski
相濡以沫	msls
构想	msmg
枸杞	msmz
构图	msqa
构思	msqu
横行霸道	msuv
相得益彰	msvd
本月	mtdi
本市	mtdn
本部	mtdo
相依为命	mtdv
本文	mtdx
本站	mtdy
本刊	mtfn
本报	mtfp
本能	mtgd
本科	mthd
本质	mtjj
本应	mtjw
本版	mtkj
本地	mtlc
本土	mtli
本校	mtmd
桎梏	mtmj
本周	mtnl
相形见绌	mtnw
本届	mtpd
本职	mtpo
本国	mtqe
本田	mtqi
本期	mtqv
本色	mtrd
本身	mtri
栋梁	mtsd
本行	mtsf
本溪	mtsj
本末	mttm
本事	mtto
本来	mttx
本着	mtvf
本钱	mtvf
本人	mtvi
本领	mtvj
本次	mtvr
本类	mtxy
本性	mtyj
小伙子	mtzi
楷模	mumh
楷体	mutm
栏目	mvgi
松散	mvhd
桃花	mvht
检讨	mvix
枪手	mvjf
检疫	mvjw
检视	mvjy
检查	mvmb
栏杆	mvmf
样板	mvmj
样本	mvmt
检察院	mvnp
检察	mvnx
样品	mvoo
梯队	mvpv
桃园	mvqf
检测	mvsb
检验	mvst
检修	mvti
样式	mvti
标准化	mvtt
松下	mvty
枪毙	mvut
检举	mvwv
枪杀	mvxm
检索	mvxn
松懈	mvyr
杞人忧天	mvyt
样子	mvzi
松弛	mvzs
机电	mwbl
机遇	mwbn
机时	mwbx
机票	mwcf
机车	mwci
机要	mwcr
机房	mwdp
机理	mweb
机动	mwfg
相当于	mwfi
机能	mwgd
机警	mwhs
小学生	mwjl
机床	mwjm
机箱	mwkm
机制	mwkn
机智	mwly
机场	mwlz
梧桐	mwmn
机构	mwms
机械	mwmt
桃红柳绿	mwmw
小学生	mwnj
档案	mwnr
机密	mwnu
机器	mwoo
机器人	mwov
机具	mwqe
机身	mwri
机型	mwth
机体	mwtm
机会	mwvf
档次	mwvr
相结合	mwvt
机关	mwvy
机组	mwwq
村里	mxbl
枯竭	mxdb
楼主	mxde
楼市	mxdn
楼房	mxdp
楼台	mxgo
枝节	mxhp
植物	mxjf
攀升	mxjh
材质	mxjj
植被	mxjk
村庄	mxjl
楼上	mxli
植树	mxma
枯槁	mxmd
楼梯	mxmv
楼宇	mxnf
楼盘	mxns
楼层	mxpf
村民	mxpt
楼下	mxtd
楼下	mxty
攀比	mxui
村镇	mxvx
材料	mxxd
枯燥	mxxo
攀登	mxxt
尖端	myde
杭州市	mydn
朴素	mylw
朴实	mynd
尖叫	myol
尖锐	myvv
椅子	myzi
小孩子	mzdz
李白	mzgi
杯弓蛇影	mzqb
客观	naan
客车	naci
坚硬	nact
额头	nadd
寒冬腊月	nadd
竖立	nadi
肾脏	nadj
客商	nadn
客户	nadp
客服	nadp
客房	nadp
悲欢离合	nadv
额外	nady
紧接	nafd
贤慧	naff
客运	nafg
坚韧	nafj
坚挺	nafj
坚持	nafl
紧迫	nagz
额度	najh
客厅	najt
肾病	najt
客气	nakz
闻鸡起舞	nall
紧缺	nalx
客场	nalz
客栈	namf
客机	namw
阁楼	namx
紧紧	nana
坚实	nand
坚定	nant
额定	nant
紧密	nanu
坚守	nanx
客家	nanx
紧跟	naol
客串	naoo
坚固	naqx
紧急	nare
客流	nasd
贤惠	natb
坚信	nati
紧俏	natw
阁下	naty
紧凑	nave
客人	navi
坚决	navz
紧缩	nawn
客套	nayk
坚强	nazs
紧张	nazs
寓意	nbdb
审理	nbeb
间接	nbfd
审批	nbfu
审稿	nbhd
审议	nbid
间谍	nbih
寓言	nbii
审计	nbix
审讯	nbiz
宴席	nbjh
审视	nbjy
审查	nbmb
审核	nbmd
审校	nbmd
审问	nbno
审定	nbnt
审察	nbnx
间隙	nbpm
间隔	nbpt
审美	nbve
宴会	nbvf
审判	nbvx
冠冕堂皇	nbwg
间断	nbxl
军医	nccl
军区	nccx
军旅	ncdh
军方	ncdh
军营	nchn
军委	nchr
军用	ncnf
军官	ncnp
军舰	ncns
军阀	ncnt
军民	ncpt
军队	ncpv
军团	ncqx
军衔	ncsv
军事	ncto
军人	ncvi
军令	ncvj
军火	ncxi
军费	nczs
实务	ndaj
实处	nday
实时	ndbx
见义勇为	nddd
客户端	ndde
实施	nddh
实名	nddo
实效	nddv
实现	nden
实录	ndes
实干	ndfi
安然无恙	ndfv
安之若素	ndhl
见多识广	ndij
实话	ndij
实物	ndjf
实习	ndji
实力	ndji
实质	ndjj
丹麦	ndla
实地	ndlc
丹青	ndld
实权	ndma
宰相	ndmg
实用	ndnf
实用性	ndny
实践	ndol
实际	ndpf
实际上	ndpl
闻名遐迩	ndpr
闹剧	ndpx
实行	ndsf
实验	ndst
实惠	ndtb
丹东	ndtm
实体	ndtm
闹事	ndto
实事	ndto
实例	ndtt
闭月羞花	ndvh
实况	ndvo
闹钟	ndvo
实业	ndwt
实在	ndxi
实战	ndyo
宝鸡	neag
悲观	nean
宝贝	nebi
宝石	neci
非要	necr
悲哀	nedo
非议	neid
归功	neij
宝库	nejc
悲痛	nejd
翡翠	nejj
宝座	nejv
归还	nejy
悲壮	nekl
宝地	nelc
归档	nemw
宝宝	nene
归案	nenr
归宿	nent
归口	neoi
归属	nepj
悲剧	nepx
宝贵	neqb
归国	neqe
见异思迁	neqj
非法	nesl
宝马	nest
非洲	nesy
悲伤	netl
归来	netx
非典	neuv
宝典	neuv
归公	nevg
归并	nevh
宝剑	nevt
非凡	newd
归结	newl
非常	newn
归纳	newn
归类	nexy
悲惨	neyg
悲愤	neyx
辈子	nezi
寒冬	nfad
完备	nfaq
用处	nfay
害处	nfay
冒昧	nfbf
用电	nfbl
寒暄	nfbn
寒碜	nfcg
赛车	nfci
赛区	nfcx
用意	nfdb
官运亨通	nfdd
冒充	nfdg
用户	nfdp
用于	nffi
冒进	nffn
赛程	nfho
用药	nfhw
赛季	nfhz
用工	nfii
完工	nfii
用功	nfij
用语	nfiw
用手	nfjf
用力	nfji
完了	nfji
完成	nfjj
赛后	nfjj
完蛋	nfjl
坚持不懈	nfjy
冒牌	nfkg
赛制	nfkn
用地	nflc
用以	nfld
赛场	nflz
冠军	nfnc
宇宙	nfnd
宇航	nfns
赛跑	nfol
用品	nfoo
冒号	nfot
冒险	nfpv
用具	nfqe
害虫	nfqi
豁免	nfro
完好	nfrz
寒流	nfsd
完满	nfsh
用水	nfsi
宗派	nfsj
用法	nfsl
宗旨	nftb
穿云裂石	nftc
用到	nftg
完整	nfto
赛事	nfto
寒假	nftp
用来	nftx
寒酸	nfug
用心	nfui
冒雨	nfui
完毕	nfux
完全	nfve
完美	nfve
害羞	nfvf
完善	nfvf
冒着	nfvf
用人	nfvi
用途	nfvt
寒冷	nfvv
完结	nfwl
寒风	nfwx
用过	nfxd
冒犯	nfxj
冒烟	nfxq
用餐	nfyd
害怕	nfyg
宗教	nfyz
闭目塞听	ngno
宾馆	ngrl
寥若晨星	nhbb
同甘共苦	nhhh
宽带	nhhn
宽度	nhjh
宽广	nhji
宽松	nhmv
宽阔	nhns
宽容	nhnv
宽限	nhpe
宽慰	nhpf
宽恕	nhro
宽泛	nhsj
宽余	nhvt
宽敞	nhwn
内蒙古	nhxo
宽大	nhyi
察言观色	niar
门票	nicf
闲言碎语	nici
门市	nidn
帐户	nidp
门户	nidp
门外	nidy
帐目	nigi
帷幕	nihb
门诊	niiv
幅度	nijh
门面	nijq
帐篷	nika
门将	nikd
门牌	nikg
门槛	nimn
巾帼	nini
门窗	ninv
门口	nioi
门路	niol
帐号	niot
门前	nivd
门类	nixy
帽子	nizi
帖子	nizi
同床异梦	njem
闻所未闻	njfn
门庭若市	njhd
宠辱不惊	njjy
周而复始	njlr
宁夏回族	njqd
寡妇	njre
宪法	njsl
临时	nkbx
监理	nkeb
监护	nkfd
鉴于	nkfi
监控	nkfn
牢记	nkiz
临近	nkjk
临床	nkjm
监视	nkjy
监制	nkkn
监管	nkkn
牢笼	nkkx
监督	nklm
监禁	nkmm
牢牢	nknk
鉴定	nknt
寝室	nknt
监察	nknx
鉴别	nkoj
监听	nkoj
临界	nkqv
牢固	nkqx
监测	nksb
临沂	nksj
牢骚	nkst
临汾	nksv
临终	nkwa
鉴赏	nkwn
监狱	nkxj
周日	nlbi
周易	nlbs
周转	nlcf
雕刻	nldy
周岁	nled
周折	nlfj
周刊	nlfn
周报	nlfp
周期	nlhe
周边	nljz
周年	nllc
寂静	nlld
寂寞	nlnh
寂寥	nlnj
周密	nlnu
周围	nlqf
宁缺毋滥	nlqs
周期	nlqv
闺女	nlri
周游	nlsd
周到	nltg
周末	nltm
同志们	nltn
雕像	nltr
周全	nlve
雕塑	nlvu
闲散	nmhd
闲话	nmij
闲谈	nmix
闲聊	nmpc
闲置	nmqx
守株待兔	nmsr
归根到底	nmtj
宋体	nmtm
盘根错节	nmvh
宋朝	nmxb
闲杂	nmxm
同归于尽	nnfp
寥寥无几	nnfw
窃窃私语	nnhi
删节	nnhp
闭门造车	nnjc
写字楼	nnmx
删除	nnpv
闭门思过	nnqx
空空如也	nnrc
帅哥	nnto
删减	nnvj
册子	nnzi
删改	nnzl
问题	nobt
寅吃卯粮	nocx
家喻户晓	nodb
问世	nohl
宫廷	nojl
问及	nojz
问答	nokv
问号	noot
宫殿	noph
守口如瓶	norv
问好	norz
问津	nose
问候	noti
问道	novj
问卷	novy
安居乐业	npcw
官方	npdh
官腔	npdn
闻名	npdo
官兵	npgv
官司	npjt
实际上	npli
官场	nplz
完璧归赵	npnl
官员	npob
官职	nppo
官衔	npsv
官僚	npty
宜昌	nqbb
安放	nrdh
阎王	nrei
安排	nrfe
安抚	nrff
安插	nrfj
安排	nrfn
安稳	nrhr
安详	nriv
安康	nrje
安息	nrjg
临危不惧	nrjy
安装	nrkl
安静	nrld
冤枉	nrme
坚如磐石	nrnc
冤案	nrnr
安定	nrnt
安宁	nrnt
冤家	nrnx
安家	nrnx
安阳	nrpb
安慰	nrpf
冤屈	nrpu
安居	nrpx
安置	nrqx
安危	nrrj
安娜	nrrj
安徽	nrse
安徽省	nrsm
案件	nrtk
案例	nrtt
安心	nrui
安全	nrve
案犯	nrxj
案情	nryl
写照	nsbd
写意	nsdb
盘旋	nsdh
舟山	nsei
航班	nsey
航运	nsfg
写入	nsjn
闯入	nsjn
盘算	nskg
阔气	nskz
安徽省	nsmj
盘桓	nsmt
船舶	nsns
舰艇	nsns
实验室	nsnt
航空	nsnv
写字	nsnz
船只	nsov
舰队	nspv
航行	nssf
航海	nssl
写下	nstd
写信	nsti
写作	nstl
航天	nsty
写出	nsue
航道	nsvj
同流合污	nsvs
航线	nswf
盘缠	nswj
写给	nswv
写在	nsxi
写真	nsxq
阔步	nsyi
盘点	nsyo
同盟	ntbd
定量	ntbt
同时	ntbx
定时	ntbx
同意	ntdb
同名	ntdo
富豪	ntdo
同胞	ntds
定义	ntdx
室外	ntdy
定理	nteb
富于	ntfi
宣誓	ntfj
宣扬	ntfz
它的	ntgs
定期	nthe
宣称	nthr
师范	nths
宣讲	ntif
宣言	ntii
定论	ntiv
宣读	ntix
宁愿	ntjg
宁夏	ntjg
富裕	ntjk
宣告	ntjl
师生	ntjl
定向	ntjn
同仇敌忾	ntjy
同等	ntkl
定制	ntkn
同年	ntlc
宁静	ntld
宁肯	ntld
同上	ntli
富士	ntli
同城	ntlj
同志们	ntlt
同志	ntlu
同龄	ntlw
同样	ntmv
定额	ntna
阀门	ntni
见仁见智	ntnl
室内	ntnv
同窗	ntnv
定局	ntpj
富民	ntpt
定居	ntpx
同居	ntpx
富贵	ntqb
门可罗雀	ntqm
定期	ntqv
同期	ntqv
富饶	ntrl
定律	ntse
同行	ntsf
宁波	ntsj
定位	nttd
宣传部	nttd
宣传	nttf
同仁	nttf
定型	ntth
同一	ntti
它们	nttn
同事	ntto
宁可	ntto
师傅	nttt
同化	nttt
定价	nttv
同伴	nttv
同伙	nttx
定做	nttx
定下	ntty
同心	ntui
同比	ntui
宿舍	ntvf
富翁	ntvg
定金	ntvi
同道	ntvj
师资	ntvr
富余	ntvt
宣判	ntvx
师父	ntvx
富丽堂皇	ntwg
同乡	ntwj
同级	ntwj
同学	ntwn
同业	ntwt
富有	ntxd
宣布	ntxn
同类	ntxy
师大	ntyi
同步	ntyi
定性	ntyj
同情	ntyl
定点	ntyo
宣战	ntyo
定夺	ntyx
富强	ntzs
密码	nucs
蜜月	nudi
闷热	nufx
密谋	nuih
密度	nujh
密封	null
密闭	nunx
蜜蜂	nuqa
密切	nutd
密集	nuti
同心协力	nuxj
空难	nvat
阐明	nvbd
空旷	nvbj
闪电	nvbl
容易	nvbs
容量	nvbt
突破	nvcj
究竟	nvdb
容忍	nvdd
内衣	nvdk
穿衣	nvdk
突变	nvdm
内部	nvdo
闪亮	nvdo
窗户	nvdp
突然	nvdy
内外	nvdy
窗外	nvdy
空运	nvfg
穿插	nvfj
突击	nvfu
空白	nvgi
窗台	nvgo
内幕	nvhb
内科	nvhd
窝藏	nvhk
内蒙	nvhn
容积	nvho
穷苦	nvhx
空话	nvij
内功	nvij
空调	nvin
内设	nviw
阅读	nvix
窒息	nvjg
容貌	nvjg
阅历	nvjj
内裤	nvjk
内向	nvjn
内疚	nvjr
寄人篱下	nvkt
空气	nvkz
内地	nvlc
窘境	nvld
穿上	nvli
穿越	nvll
穿戴	nvlq
空缺	nvlx
空格	nvma
内核	nvmd
阐述	nvmd
穿梭	nvmg
空想	nvmg
内阁	nvna
闪客	nvna
空间	nvnb
空军	nvnc
窍门	nvni
阅览	nvnk
空闲	nvnm
内容	nvnv
窗帘	nvnv
窈窕	nvnv
窟窿	nvnv
闪闪	nvnv
罕见	nvnw
窗口	nvoi
空中	nvoi
窃听	nvoj
容器	nvoo
窃取	nvpa
空降	nvpa
内陆	nvpf
空隙	nvpm
穷国	nvqe
突围	nvqf
穷困	nvqm
内置	nvqx
内奸	nvrf
内行	nvsf
内涵	nvsj
空洞	nvsn
内政	nvtl
肉体	nvtm
窝囊	nvto
突出	nvue
内心	nvui
空心	nvui
内需	nvuj
肉食	nvvd
空前	nvvd
穿着	nvvf
穷人	nvvi
肉欲	nvvv
内线	nvwf
空前绝后	nvwj
容纳	nvwn
闪耀	nvww
闪光	nvww
闪烁	nvxc
穿过	nvxd
闪过	nvxd
内存	nvxi
内在	nvxi
闪存	nvxi
突袭	nvxt
空袭	nvxt
肉类	nvxy
突发	nvya
内情	nvyl
内战	nvyo
空虚	nvyw
见效	nwdv
同学录	nwes
见缝插针	nwfv
见识	nwio
见证	nwit
见了	nwji
见习	nwji
见面	nwjq
冗长	nwki
见地	nwlc
见闻	nwnp
见解	nwrd
见到	nwtg
见风使舵	nwtn
见过	nwxd
闻风丧胆	nwxd
容光焕发	nwxy
家务	nxaj
宏观	nxan
灾难	nxat
家里	nxbl
家电	nxbl
刚果	nxbm
守则	nxbn
网易	nxbs
灾区	nxcx
家族	nxdh
家产	nxdj
守望	nxdl
网恋	nxdm
网通	nxdn
网站	nxdy
网球	nxex
守护	nxfd
闭幕	nxhb
灾荒	nxhd
家谱	nxiv
网页	nxjb
家底	nxjc
宠物	nxjf
察看	nxjf
家庭	nxjj
宠爱	nxjn
灾祸	nxjy
家长	nxki
网管	nxkn
灾年	nxlc
网上	nxli
网址	nxll
网卡	nxly
家用	nxnf
灾害	nxnf
闭塞	nxnf
家门	nxni
刚刚	nxnx
网吧	nxod
家中	nxoi
家口	nxoi
家属	nxpj
守卫	nxpt
网民	nxpt
灾民	nxpt
家居	nxpx
宏图	nxqa
家具	nxqe
家园	nxqf
刚好	nxrz
守法	nxsl
刚健	nxte
宏伟	nxtf
守信	nxti
家政	nxtl
家事	nxto
家伙	nxtx
家禽	nxvd
家人	nxvi
网关	nxvy
网络	nxwa
家乡	nxwj
察觉	nxwn
守业	nxwt
网友	nxxa
刚才	nxxj
宏大	nxyi
网点	nxyo
家教	nxyz
刚强	nxzs
同性恋	nydm
内忧外患	nydo
寄予	nydt
盎然	nydy
寄托	nyfj
寄语	nyiw
寄生	nyjl
刚愎自用	nyjn
闲情逸致	nyrt
央行	nysf
安步当车	nywc
寄给	nywv
寄存	nyxi
央求	nyxx
豁达大度	nyyj
字据	nzfp
字幕	nzhb
字节	nzhp
字词	nzij
坚强不屈	nzjp
字符	nzkt
字样	nzmv
字帖	nzni
字号	nzot
字母	nzqs
字体	nztm
字画	nztq
字典	nzuv
字数	nzxr
叹息	oajg
勋章	obdb
唱和	obho
员工	obii
喝了	obji
喝彩	objm
唱片	obki
呻吟	obov
喝水	obsi
喝酒	obsu
唱歌	obto
口是心非	obun
呕吐	ocol
叹为观止	odal
哪里	odbl
趾高气扬	odkf
中文版	odkj
哪些	odlt
呆头呆脑	odod
叨唠	odoh
路由器	odoo
咳嗽	odot
哆嗦	odox
嘀咕	odox
中产阶级	odpw
哪位	odtd
哪个	odvi
呼之欲出	odvu
哪有	odxd
哈巴狗	odxj
哪怕	odyg
中山市	oedn
呈现	oeen
呈报	oefp
呈上	oeli
跋山涉水	oess
味道	ofvj
史无前例	ofvt
味精	ofxl
啤酒	ogsu
唯利是图	ohbq
中秋节	ohhp
喋血	ohjq
呆若木鸡	ohma
叶落归根	ohnm
哎呀	ohoc
唠叨	ohod
哎哟	ohow
中科院	ohpn
口若悬河	ohqs
中日	oibi
口碑	oicg
中西	oici
中医	oicl
口音	oidb
口头	oidd
中方	oidh
中立	oidi
口腔	oidn
中部	oido
口服	oidp
中文	oidx
中外	oidy
中山	oiei
口岸	oiej
中专	oifs
中指	oift
中期	oihe
中共	oihv
中药	oihw
中秋	oihx
忠诚	oiij
口试	oiit
口语	oiiw
口诀	oiiz
忠厚	oijb
中原	oijg
忠告	oijl
中奖	oikd
中将	oikd
中等	oikl
口气	oikz
中年	oilc
中肯	oild
中止	oili
中毒	oilq
中午	oilx
口述	oimd
中小学	oimw
中档	oimw
中坚	oina
中间	oinb
忠实	oind
中用	oinf
中盘	oins
中央	oiny
口味	oiof
口中	oioi
口吻	oios
口号	oiot
中层	oipf
中农	oipk
中队	oipv
中国	oiqe
中期	oiqv
口角	oiri
中旬	oisb
中游	oisd
口水	oisi
口径	oisz
中型	oith
中东	oitm
中华	oitt
口袋	oitv
中亚	oitw
中下	oity
中心	oiui
中美	oive
口令	oivj
中介	oivn
中途	oivt
中线	oiwf
中级	oiwj
中学生	oiwj
中学	oiwn
中兴	oiwv
中风	oiwx
中继	oiwx
口才	oixj
中断	oixl
中南	oixn
中性	oiyj
中考	oiys
别墅	ojbl
哪里	ojbl
响亮	ojdo
别名	ojdo
另外	ojdy
别扭	ojfj
别的	ojgs
哪种	ojho
听课	ojib
听话	ojij
听证	ojit
听说	ojiv
别说	ojiv
听力	ojji
响应	ojjw
呼应	ojjw
呼声	ojld
吸收	ojli
吸毒	ojlq
哪些	ojlt
听写	ojns
听见	ojnw
咖啡	ojoe
呼啸	ojoe
呼吁	ojof
呼吸	ojoj
呼喊	ojoj
呼叫	ojol
咖啡	ojon
呼唤	ojor
吸取	ojpa
听取	ojpa
听得	ojsb
另行	ojsf
哪位	ojtd
听到	ojtg
别致	ojtg
听信	ojti
咱们	ojtn
听歌	ojto
另一个	ojtv
听着	ojvf
别人	ojvi
哪个	ojvi
听众	ojvv
听从	ojvv
哪儿	ojwi
听觉	ojwn
吸纳	ojwn
别有	ojxd
另有	ojxd
哪有	ojxd
只不过	ojxd
吹毛求疵	ojxj
吸烟	ojxq
另类	ojxy
哪怕	ojyg
吸引	ojzs
啼笑皆非	okun
踪影	olbd
嘴里	olbl
跳票	olcf
跌破	olcj
跟头	oldd
足智多谋	oldi
嘴巴	oldl
足迹	oldm
距离	oldx
足球	olex
跳动	olfg
跃进	olfn
跟进	olfn
吃亏	olfs
跳远	olfw
吃香	olhb
路程	olho
吃苦	olhx
嘴唇	oljf
跨度	oljh
吃力	olji
跑了	olji
吃了	olji
路段	oljk
跨入	oljn
路面	oljq
路边	oljz
足以	olld
足坛	ollf
跳舞	ollh
路上	olli
踏上	olli
跨越	olll
跳板	olmj
跳槽	olmu
吃紧	olna
踏实	olnd
跌幅	olni
吃喝	olob
路口	oloi
叫喊	oloj
跟踪	olol
蹒跚	olol
嘻嘻	olol
踊跃	olol
跳跃	olol
践踏	olol
蹂躏	olol
足联	olpv
跟随	olpx
跻身	olri
吃饭	olrl
叫好	olrz
跳水	olsi
足够	olso
跋涉	olsy
路径	olsz
跑到	oltg
叫做	oltx
吃醋	oluh
跟着	olvf
叫人	olvi
路途	olvt
路线	olwf
路过	olxd
足协	olxj
吃惊	olyd
跑步	olyi
蹲点	olyo
路子	olzi
吵架	omjo
吵闹	omnd
中小学	omwn
口蜜腹剑	ondv
吊唁	onoi
呐喊	onoj
喀嚓	onon
喧哗	onot
吊销	onvw
器乐	oocm
噪音	oodb
品名	oodo
蹉跎岁月	ooed
品种	ooho
器物	oojf
品质	oojj
患病	oojt
喋喋不休	oojt
品牌	ookg
噪声	oold
口口声声	ooll
品格	ooma
器械	oomt
器材	oomx
器官	oonp
品味	ooof
咒骂	oooo
器具	ooqe
器皿	ooqi
哭泣	oosd
品德	oosx
品位	ootd
器件	ootk
咄咄逼人	ootv
跃跃欲试	oovi
品尝	oown
患有	ooxd
患者	ooyb
嚣张	oozs
只限于	opfi
嘱托	opfj
嘱咐	opot
呢喃	opox
别具匠心	oqcu
虽然	oqdy
虽说	oqiv
嘿嘿	oqoq
咽喉	oqot
啰嗦	oqox
喂养	oqve
吹捧	orfe
吹牛	orki
唤起	orll
吹嘘	oroy
哈尔滨	orsn
唤醒	orub
只争朝夕	orxd
呜呼	osoj
患得患失	osok
咆哮	osoy
吻合	osvt
号码	otcs
哺育	otdg
号召	otdo
呵护	otfd
另一种	otho
号称	othr
唯恐	otiw
唯物	otjf
哺乳	otjz
喇嘛	otoj
叮咛	oton
叱咤	oton
叮嘱	otop
哽咽	otoq
呵呵	otot
喇叭	otov
咿唔	otow
吓唬	otoy
饕餮	ottd
唯一	otti
唯美	otve
另一个	otvi
号令	otvj
别出心裁	ouul
嘈杂	ouxm
只是	ovbt
只要	ovcr
只能	ovgd
只不过	ovjx
中关村	ovmx
只用	ovnf
只见	ovnw
吩咐	ovot
哈哈	ovov
只因	ovqy
哈尔滨	ovrs
叶公好龙	ovrx
只好	ovrz
只得	ovsb
哈佛	ovtz
只需	ovuj
只会	ovvf
只当	ovwe
只有	ovxd
只在	ovxi
中学生	owjl
兄长	owki
唢呐	owon
兄弟	owvz
响当当	owwe
史诗	oxil
嘲讽	oxiw
史记	oxiz
史书	oxjj
鄙视	oxjy
叶片	oxki
嘲笑	oxkj
史上	oxli
史实	oxnd
史册	oxnn
咕咚	oxoa
咕噜	oxor
喃喃	oxox
喷嚏	oxox
唏嘘	oxoy
鄙陋	oxpt
喷墨	oxqh
喷射	oxrx
喷洒	oxsc
别有洞天	oxst
鄙夷	oxtz
史料	oxxd
叶子	oxzi
嘹亮	oydo
忠贞不渝	oyjs
哮喘	oyoe
嗜好	oyrz
吸引力	ozji
取暖	pabj
取胜	padj
取名	pado
降落	pahs
取证	pait
降序	pajd
取向	pajn
隆重	pajt
取样	pamv
降幅	pani
降临	pank
降职	papo
取回	paqo
取得	pasb
降温	pasb
降水	pasi
取消	pasw
降低	patc
降到	patg
聚集	pati
聚焦	pati
降价	patv
取代	patv
取出	paue
降雨	paui
聚酯	paut
聚会	pavf
取决于	pavf
聚合	pavt
取决	pavz
取缔	pawd
降级	pawj
取悦	payv
阳台	pbgo
尼日利亚	pbht
阳痿	pbjh
阳光	pbww
阳性	pbyj
阵亡	pcdl
阵营	pchn
阵地	pclc
聊城	pclj
陕西省	pcmj
阵容	pcnv
阵阵	pcpc
聊聊	pcpc
阵列	pctd
聊天	pcty
鹤立鸡群	pdae
防备	pdaq
阴暗	pdbd
阴影	pdbd
迟早	pdbx
届时	pdbx
障碍	pdcb
防护	pdfd
防范	pdhs
阴谋	pdih
聘请	pdil
阴历	pdjj
聘书	pdjj
取之不尽	pdjp
防病	pdjt
防腐	pdjt
防疫	pdjw
防止	pdli
聘用	pdnf
陪同	pdnt
防空	pdnv
防守	pdnx
防灾	pdnx
阴阳	pdpb
防卫	pdpt
阴险	pdpv
防治	pdsg
防洪	pdsh
防水	pdsi
防御	pdsl
阴沉	pdsn
防汛	pdsz
防伪	pdtd
迟到	pdtg
聘任	pdtj
迟疑	pdtl
陪伴	pdtv
阴道	pdvj
防盗	pdvr
防线	pdwf
防火	pdxi
阴性	pdyj
限量	pebt
限于	pefi
阳春白雪	pegu
限期	pehe
限度	pejh
限制	pekn
限额	pena
限定	pent
阳奉阴违	pepf
限期	peqv
慰藉	pfhe
慰劳	pfhn
层面	pfjq
耳提面命	pfjv
陆地	pflc
陆军	pfnc
慰问	pfno
层层	pfpf
阿拉伯	pftg
屈指可数	pftx
层次	pfvr
陆续	pfwx
展区	phcx
展望	phdl
展现	phen
展示	phfm
展台	phgo
展厅	phjt
展览	phnk
展览会	phnv
展品	phoo
展位	phtd
展开	phth
展出	phue
展会	phvf
殿堂	phwn
居功自傲	pijt
耳边	pijz
耳机	pimw
陈词滥调	pisi
尸体	pitm
耳朵	piwm
尾巴	pjdl
局部	pjdo
防不胜防	pjdp
属于	pjfi
局势	pjfx
陌生	pjjl
局面	pjjq
局长	pjki
尾声	pjld
卫生间	pjnb
属实	pjnd
局限	pjpe
局促	pjto
属性	pjyj
农户	pkdp
农技	pkfx
农贸	pkgd
农药	pkhw
农历	pkjj
取长补短	pkjl
农场	pklz
农林	pkmm
农机	pkmw
农村	pkmx
农家	pknx
农民	pkpt
农田	pkqi
农行	pksf
农资	pkvr
农业	pkwt
耻辱	pljf
局域网	plnx
随机应变	pmjd
阿根廷	pmjl
尽量	pnbt
迟早	pnbx
尽早	pnbx
尽头	pndd
刷新	pndm
昼夜	pndt
耳闻目睹	pngg
尺度	pnjh
尽力	pnji
迟延	pnjl
屡见不鲜	pnjr
院长	pnki
尽管	pnkn
尽责	pnlb
院士	pnli
刷卡	pnly
院校	pnmd
迟迟	pnpn
尽职	pnpo
陀螺	pnqq
阿富汗	pnsf
迟到	pntg
迟疑	pntl
展览会	pnvf
迟钝	pnvt
迟缓	pnwj
尺寸	pnxd
尽情	pnyl
尽快	pnyz
院子	pnzi
职务	poaj
避难	poat
壁挂	pofl
职能	pogd
壁垒	pogg
职称	pohr
避讳	poif
职工	poii
职责	polb
职场	polz
职权	poma
职员	poob
职别	pooj
随叫随到	popt
避免	poro
譬如	poro
职位	potd
避开	poth
壁纸	powc
职业	powt
避风	powx
避孕	pozj
耽搁	ppfn
耿耿于怀	ppfy
耽误	ppio
隐隐约约	ppww
阻碍	pqcb
阻击	pqfu
阻拦	pqfv
阻挡	pqfw
阻挠	pqfx
阻力	pqji
阻止	pqli
阻塞	pqnf
隐晦	prbl
随身携带	prfh
隐瞒	prgh
隐私	prhg
隐藏	prhk
隐蔽	prhv
陷入	prjn
陷害	prnf
随身听	proj
隐患	proo
陷阱	prpf
隐居	prpx
隐身	prri
隐形	prth
尽如人意	prvd
隐含	prvj
隐约	prws
犀利	pshn
履历	psjj
履行	pssf
陶醉	psud
陶冶	psvg
陶瓷	psvr
随波逐流	psxs
卫星	ptbj
附则	ptbn
卫冕	ptbr
陕西	ptci
陕西省	ptcm
民意	ptdb
民主	ptde
民族	ptdh
隔离	ptdx
附录	ptes
阿拉	ptfd
尽可能	ptgd
民兵	ptgv
民营	pthn
附带	pthn
附和	ptho
民警	pths
陈旧	ptib
民工	ptii
附设	ptiw
陈设	ptiw
附近	ptjj
附近	ptjk
卫生	ptjl
民生	ptjl
附加	ptjo
民办	ptjv
卫视	ptjy
卫士	ptli
附表	ptlk
陈述	ptmd
民间	ptnb
隔阂	ptnd
民用	ptnf
民航	ptns
聊天室	ptnt
附中	ptoi
附属	ptpj
隔壁	ptpo
附图	ptqa
民国	ptqe
阿姨	ptrt
民法	ptsl
陈列	pttd
屋顶	pttj
附件	pttk
民政	pttl
民歌	ptto
民事	ptto
民俗	pttv
民心	ptui
民众	ptvv
隔绝	ptwr
民风	ptwx
附有	ptxd
隔断	ptxl
民情	ptyl
屋子	ptzi
居心叵测	pucs
屈服	pudp
屁股	pudw
屈辱	pujf
屈原	pujg
层出不穷	pujn
随心所欲	pujv
陛下	puty
联欢	pvar
聪明	pvbd
联盟	pvbd
险要	pvcr
除夕	pvdi
联通	pvdn
联名	pvdo
除外	pvdy
除非	pven
取决于	pvfi
联邦	pvfp
阶段	pvft
坠毁	pvgi
屏幕	pvhb
联营	pvhn
屏蔽	pvhv
联谊	pvin
联手	pvjf
除了	pvji
阶段	pvji
阶段	pvjk
联袂	pvjk
联系人	pvjv
联系	pvjw
队长	pvki
除去	pvlg
联想	pvmg
联军	pvnc
除非	pvne
联赛	pvnf
联网	pvnx
队员	pvob
聆听	pvoj
屏障	pvpd
阶层	pvpf
联展	pvph
联合国	pvqe
联姻	pvrq
队形	pvth
屏保	pvto
队伍	pvtw
险恶	pvtw
联合会	pvvf
隧道	pvvj
联合	pvvt
联众	pvvv
联络	pvwa
阶级	pvwj
队友	pvxa
农业部	pwdo
随处	pxay
剧照	pxbd
随时	pxbx
随意	pxdb
居多	pxdd
剧变	pxdm
居然	pxdy
随之	pxdz
随即	pxeg
居于	pxfi
堕落	pxhs
随手	pxjf
随后	pxjj
随笔	pxkj
随地	pxlc
剧增	pxlv
防火墙	pxlx
剧场	pxlz
剧本	pxmt
随机	pxmw
随同	pxnt
居室	pxnt
居家	pxnx
剧院	pxpn
居民	pxpt
屡屡	pxpx
随身	pxri
居住	pxtd
剧烈	pxtd
随便	pxtt
随心	pxui
居心	pxui
随着	pxvf
屡次	pxvr
剧组	pxwq
随风	pxwx
耿直	pxxq
剧情	pxyl
鹤发童颜	pydd
屠宰	pynd
屠杀	pyxm
阿弥陀佛	pzpt
图章	qadb
图文	qadx
图示	qafm
图谋	qaih
图库	qajc
图书	qajj
图书馆	qajr
图片	qaki
图表	qalk
图标	qamf
图样	qamv
图案	qanr
国务院	qapn
图解	qard
图象	qaro
略微	qase
图形	qath
图画	qatq
图像	qatr
图例	qatt
图纸	qawc
略有	qaxd
遗弃	qbdg
贵族	qbdh
遗产	qbdj
遗忘	qbdl
遗迹	qbdm
遗留	qbgd
遗物	qbjf
遗失	qbkv
遗址	qbll
贵客	qbna
贵宾	qbng
遗嘱	qbop
贵阳	qbpb
遗传	qbtf
遗体	qbtm
遗憾	qbyj
贵州	qbyy
墨西哥	qcto
骨碌	qdce
逻辑	qdco
骨头	qddd
胃肠	qddz
骨干	qdfi
骨折	qdfj
骨科	qdhd
骨架	qdjo
骨气	qdkz
骨肉	qdnv
胃口	qdoi
蟑螂	qdqd
骨骼	qdqd
骨髓	qdqd
骷髅	qdqd
蝙蝠	qdqt
螃蟹	qdrd
男主角	qdri
罗马	qdst
罗列	qdtd
四通八达	qdvy
男朋友	qdxa
骨灰	qdxx
国务院	qeap
具备	qeaq
国旗	qedh
国立	qedi
国产	qedj
国脚	qedl
罪名	qedo
国外	qedy
国王	qeei
悬崖峭壁	qeep
国运	qefg
国营	qehn
悬崖勒马	qehs
罪证	qeit
国语	qeiw
国库	qejc
国庆节	qejh
国度	qejh
国力	qeji
国庆	qejy
国籍	qeke
罪状	qeky
国境	qeld
国土	qeli
国内外	qend
国宝	qene
国门	qeni
国内	qenv
国家	qenx
国别	qeoj
国防	qepd
国际	qepf
国泰民安	qepn
国民	qept
国民党	qepw
罪行	qesf
国债	qetl
具体	qetm
国歌	qeto
国画	qetq
国货	qett
罪恶	qetw
国会	qevf
国人	qevi
国道	qevj
国企	qevl
具有	qexd
国有	qexd
罪犯	qexj
国情	qeyl
围观	qfan
园区	qfcx
县市	qfdn
助理	qfeb
悬崖	qfej
悬挂	qffl
因势利导	qfhe
县委	qfhr
园艺	qfhz
围攻	qfia
助手	qfjf
助力	qfji
助威	qfjt
县长	qfki
园地	qflc
县城	qflj
围墙	qflx
园林	qfmm
围棋	qfmq
悬空	qfnv
围困	qfqm
围剿	qfsb
悬浮	qfsj
悬殊	qftd
园丁	qfti
悬念	qfvj
县级	qfwj
悬赏	qfwn
助兴	qfwv
围绕	qfwx
助教	qfyz
罪魁祸首	qgjv
蚯蚓	qgqz
黑暗	qhbd
黑市	qhdn
黑夜	qhdt
默契	qhfd
黑白	qhgi
黑幕	qhhb
默认	qhiv
黑板	qhmj
黑客	qhna
蝌蚪	qhqd
默默	qhqh
黑色	qhrd
墨水	qhsi
黑洞	qhsn
黑马	qhst
黑体	qhtm
黑人	qhvi
墨盒	qhvt
蜡烛	qhxq
黑龙江	qhxs
四处	qiay
田野	qibl
四方	qidh
四月	qidi
四通	qidn
四肢	qidx
四季	qihz
四面	qijq
罚款	qilf
四川	qimi
田间	qinb
四周	qinl
四项基本原则	qiqb
田园	qiqf
四海	qisl
田径	qisz
罚单	qivb
四个	qivi
罚金	qivi
甲级	qiwj
四十	qixi
男方	qjdh
悬而未决	qjfv
国庆节	qjhp
其貌不扬	qjjf
男生	qjjl
男篮	qjkn
男士	qjli
四面楚歌	qjmt
因特网	qjnx
蟋蟀	qjqd
恩重如山	qjre
男女	qjri
图书馆	qjrl
骨瘦如柴	qjrl
四面八方	qjvd
男人	qjvi
男儿	qjwi
男友	qjxa
男性	qjyj
男孩	qjzd
男子	qjzi
罢工	qlii
罢了	qlji
因地制宜	qlkn
蜻蜓	qlqj
蜘蛛	qlqk
蚱蜢	qlqz
罢免	qlro
甲午战争	qlyr
困难	qmat
困扰	qmfx
困苦	qmhx
困乏	qmjd
因小失大	qmky
困境	qmld
基本上	qmli
四川省	qmmj
蜥蜴	qmqb
困惑	qmto
困倦	qmtv
罪名	qndo
国内外	qndy
罪证	qnit
墨守成规	qnjf
罪状	qnky
蜿蜒	qnqj
螟蛉	qnqv
罪行	qnsf
罪恶	qntw
固定资产	qnvd
罪犯	qnxj
回音	qodb
回头	qodd
回放	qodh
回旋	qodh
回族	qodh
回扣	qofo
回报	qofp
回击	qofu
圆规	qofv
回眸	qogg
回程	qoho
回落	qohs
回顾	qojc
回升	qojh
回应	qojw
蜗牛	qoki
回答	qokv
回笼	qokx
回复	qolb
回去	qolg
回收	qoli
回想	qomg
回归	qone
回帖	qoni
回师	qont
回家	qonx
回味	qoof
回避	qopo
回国	qoqe
蜈蚣	qoqv
圆圈	qoqv
回馈	qorl
圆满	qosh
回到	qotg
圆形	qoth
回来	qotx
回首	qovj
回合	qovt
回绝	qowr
圆桌	qoyb
回忆	qoyz
因陋就简	qpdk
遣返	qpjj
螳臂当车	qpwc
国民党	qpwn
螺旋	qqdh
默默无闻	qqfn
螳螂捕蝉	qqfq
蝈蝈	qqqq
螺丝	qqww
蜻蜓点水	qqys
蟾蜍	qrqv
国色天香	qrth
母亲	qsdm
黔驴技穷	qsfn
母校	qsmd
蚂蚁	qsqd
囫囵	qsqv
罪恶滔天	qtst
四平八稳	qtvh
畏缩	qtwn
思量	qubt
思科	quhd
思议	quid
思想	qumg
思路	quol
蠕虫	quqi
思潮	qusx
思念	quvj
毗邻	quvj
思维	quwt
思绪	quwy
思索	quxn
思考	quys
思虑	quyu
基石	qvci
基础	qvcu
期望	qvdl
基建	qvef
基于	qvfi
期刊	qvfn
勘探	qvfn
期盼	qvgv
欺诈	qvil
基调	qvin
其后	qvjj
界面	qvjq
基地	qvlc
基督	qvlm
勘查	qvmb
基本上	qvml
基本	qvmt
期间	qvnb
其实	qvnd
其它	qvnt
界定	qvnt
期内	qvnv
圈阅	qvnv
勘察	qvnx
其中	qvoi
界限	qvpe
期限	qvpe
基层	qvpf
蝉联	qvpv
蛤蟆	qvqh
基因	qvqy
欺负	qvrb
勘测	qvsb
期满	qvsh
期待	qvsl
欺骗	qvst
其他	qvtc
甚至	qvtg
其一	qvti
期末	qvtm
期货	qvtt
斟酌	qvus
基金	qvvi
其次	qvvr
其余	qvvt
基准	qvvt
界线	qvwf
四分五裂	qvwt
囚犯	qvxj
基数	qvxr
圈套	qvyk
基点	qvyo
圈子	qvzi
累积	qwho
累计	qwix
累加	qwjo
累赘	qwlh
螳螂	qwqd
累累	qwqw
蛛丝马迹	qwsd
团购	qxbs
贯通	qxdn
固然	qxdy
置于	qxfi
置换	qxfr
固执	qxfx
团委	qxhr
毋庸	qxje
团长	qxki
固定	qxnt
贯穿	qxnv
团员	qxob
团聚	qxpa
团队	qxpv
蝴蝶	qxqh
团圆	qxqo
置身	qxri
黑龙江	qxsi
贯彻	qxst
置顶	qxtj
团体	qxtm
固体	qxtm
团伙	qxtx
团结	qxwl
置业	qxwt
固有	qxxd
恩赐	qybb
因果	qybm
恩怨	qydc
因为	qydj
署名	qydo
固步自封	qyjl
恩爱	qyjn
因特网	qyjn
因而	qyjn
因此	qylt
因素	qylw
贵州省	qymj
因其	qyqv
畸形	qyth
罪大恶极	qytm
因故	qyxo
恩情	qyyl
因子	qyzi
奴隶	raes
努力	raji
怒气	rakz
怒吼	raoz
奴仆	raty
怒火	raxi
奴才	raxj
身败名裂	rbdt
负担	rbfb
负荷	rbht
如果说	rbiv
负面	rbjq
负重	rbjt
触景生情	rbjy
负气	rbkz
负责	rblb
负载	rblc
负伤	rbtl
负债	rbtl
负心	rbui
负有	rbxd
她的	rcgs
婚后	rcjj
婚礼	rcjy
娱乐圈	rcqv
婚姻	rcrq
她们	rctn
婚前	rcvd
婚介	rcvn
婚纱	rcwm
急转直下	rcxt
解难	rdat
妨碍	rdcb
解码	rdcs
好高骛远	rddf
解放	rddh
解放军	rddn
解剖	rddo
解雇	rddp
解脱	rddv
解散	rdhd
色带	rdhn
色调	rdin
解说	rdiv
解读	rdix
邂逅	rdjj
解压	rdjl
色彩	rdjm
嫡系	rdjw
解释	rdjx
解答	rdkv
解析	rdmj
解禁	rdmm
解放军	rdnc
妨害	rdnf
解密	rdnu
娘家	rdnx
解除	rdpv
妯娌	rdrb
女主角	rdri
色泽	rdsa
解开	rdth
解体	rdtm
解冻	rdvt
解决	rdvz
女朋友	rdxa
解数	rdxr
解救	rdxx
色情	rdyl
妒忌	rdzl
争斗	redd
争端	rede
争辩	redx
急于	refi
争执	refx
急迫	regz
妇科	rehd
争议	reid
争论	reiv
急诊	reiv
急了	reji
争先	rejl
争办	rejv
争气	rekz
争相	remg
急躁	reol
争吵	reom
争取	repa
妇联	repv
急剧	repx
妇女	reri
急流	resd
急切	retd
急件	retk
急速	reto
急促	reto
争霸	reuh
急需	reuj
争创	revc
皱纹	rewd
妇幼	rewj
争光	reww
急救	rexx
急忙	reyd
急性	reyj
争夺	reyx
奸商	rfdn
奸臣	rfgi
妩媚	rfrd
妹妹	rfrf
奸污	rfsf
奸淫	rfsj
急于求成	rfxj
始于	rgfi
鱼目混珠	rgse
始末	rgtm
始终	rgwa
始发	rgya
触目惊心	rgyu
负荆请罪	rhiq
好莱坞	rhls
如花似玉	rhte
媒体	rhtm
媒介	rhvn
身处	riay
身影	ribd
妙语连珠	rice
女童	ridb
女郎	ride
身为	ridj
身旁	ridn
身高	rido
女王	riei
女排	rifn
身世	rihl
角落	rihs
女工	riii
身手	rijf
角度	rijh
急功近利	rijh
身后	rijj
女生	rijl
女神	rijy
身边	rijz
女装	rikl
女士	rili
身上	rili
女权	rima
身材	rimx
身家	rinx
女足	riol
身躯	rirc
角色	rird
女色	rird
女婿	rirj
女娲	riro
女流	risd
身份证	riti
身体	ritm
身份	ritv
身价	ritv
身心	riui
女人	rivi
女儿	riwi
女友	rixa
角逐	rixz
女性	riyj
女孩	rizd
女子	rizi
身子	rizi
危难	rjat
姓氏	rjct
姓名	rjdo
娇艳	rjfr
如释重负	rjjr
危及	rjjz
嬉皮笑脸	rjkd
娇气	rjkz
如愿以偿	rjlt
危机	rjmw
危害	rjnf
危险	rjpv
嫉妒	rjrd
危急	rjre
媳妇	rjre
妊娠	rjrj
妖娆	rjrx
好不好	rjrz
媲美	rjve
馈赠	rlbv
饭碗	rlcn
馒头	rldd
饼干	rlfi
馆藏	rlhk
饱和	rlho
饭店	rljy
妙趣横生	rlmj
饮用	rlnf
饰品	rloo
饮品	rloo
饥饿	rlrl
娃娃	rlrl
饭馆	rlrl
饶恕	rlro
姹紫嫣红	rlrw
饱满	rlsh
饮水	rlsi
饰演	rlsn
饮酒	rlsu
饮食	rlvd
饲养	rlve
负责人	rlvi
饮料	rlxd
饲料	rlxd
饺子	rlzi
妙龄	rmlw
危机四伏	rmqt
争权夺利	rmyh
婉转	rncf
娴熟	rndo
嫁接	rnfd
久远	rnfw
婉言	rnii
身临其境	rnql
久久	rnrn
姗姗	rnrn
婉约	rnws
嫁给	rnwv
如果	robm
如是	robt
娱乐	rocm
如意	rodb
如能	rogd
如期	rohe
免税	rohv
如愿	rojg
急中生智	rojl
勉励	rojt
免疫	rojw
免去	rolg
如上	roli
如此	rolt
象棋	romh
象棋	romq
如实	rond
如同	ront
免职	ropo
免除	ropv
如图	roqa
如期	roqv
免得	rosb
象征	rost
免征	rost
如下	rotd
如一	roti
如何	rott
如下	roty
免遭	roub
如今	rovj
如常	rown
如有	roxd
如数	roxr
兔子	rozi
免费	rozs
勉强	rozs
婀娜	rprj
触电	rqbl
触动	rqfg
触摸	rqfh
姐夫	rqfv
触及	rqjz
姐妹	rqrf
姐姐	rqrq
姐弟	rqvz
姻缘	rqwl
触犯	rqxj
娓娓动听	rrfo
娓娓而谈	rrji
如鱼得水	rrss
好逸恶劳	rrth
姗姗来迟	rrtp
急流勇退	rsde
姊妹	rsrf
妈妈	rsrs
馋涎欲滴	rsvs
鲜明	rtbd
好事多磨	rtdj
鲜艳	rtfr
鲜花	rtht
鲁莽	rthy
身份证	rtit
鲜血	rtjq
鲤鱼	rtrt
鲜活	rtsj
嫌疑人	rtvi
鲜红	rtwi
兔死狗烹	rtxd
兔死狐悲	rtxn
鱼类	rtxy
鲁迅	rtzx
如雷贯耳	ruqp
欠条	rvam
欠账	rvbk
欠妥	rvjr
解铃还须系铃人	rvjv
欠款	rvlf
欠缺	rvlx
饮食男女	rvqr
婵娟	rvro
嫌疑	rvtl
争分夺秒	rvyh
躲藏	rwhk
躲避	rwpo
嫦娥	rwrj
饱经沧桑	rwsa
躲在	rwxi
触类旁通	rxdd
射击	rxfu
射手	rxjf
姑息	rxjg
射门	rxni
姑且	rxqf
姑娘	rxrd
如火如荼	rxrh
妓女	rxri
如狼似虎	rxty
煞有介事	rxvt
射线	rxwf
尔虞我诈	ryji
如虎添翼	rysj
怒发冲冠	ryvn
好处	rzay
好转	rzcf
好多	rzdd
女孩子	rzdz
好玩	rzef
好运	rzfg
好的	rzgs
煞费苦心	rzhu
好评	rzit
好看	rzjf
好手	rzjf
好了	rzji
好书	rzjj
好感	rzjt
好不	rzjy
奶牛	rzki
好笑	rzkj
好坏	rzlj
好些	rzlt
好想	rzmg
好用	rznf
好听	rzoj
好吃	rzol
好啊	rzop
好吗	rzos
好色	rzrd
好久	rzrn
好象	rzro
奶奶	rzrz
好好	rzrz
好汉	rzsa
好事	rzto
好像	rztr
好比	rzui
好心	rzui
好人	rzvi
好几	rzwi
好学	rzwn
好友	rzxa
好在	rzxi
奶粉	rzxv
好奇	rzyt
女孩子	rzzi
汉族	sadh
汉英	sahn
汉语	saiw
汉城	salj
汉字	sanz
洛阳	sapb
汉化	satt
温暖	sbbj
测量	sbbt
很明显	sbbw
得票	sbcf
得意	sbdb
得主	sbde
渴望	sbdl
得名	sbdo
温柔	sbdt
测控	sbfn
温泉	sbgs
温和	sbho
测试	sbit
测评	sbit
漫谈	sbix
温度	sbjh
湿度	sbjh
得力	sbji
温习	sbji
得了	sbji
混蛋	sbjl
混乱	sbjx
得奖	sbkd
测算	sbkg
漫长	sbki
得失	sbkv
温馨	sbld
得以	sbld
得知	sbly
温顺	sbmj
测定	sbnt
温室	sbnt
得逞	sboe
得罪	sbqe
得罪	sbqn
温饱	sbrl
漫漫	sbsb
漫游	sbsd
湿润	sbsn
测验	sbst
混沌	sbst
混淆	sbsx
得到	sbtg
得体	sbtm
漫画	sbtq
得出	sbue
得分	sbvd
混凝土	sbvl
混合	sbvt
得益	sbvv
得当	sbwe
测绘	sbwv
温存	sbxi
瀑布	sbxn
渴求	sbxx
漫步	sbyi
温情	sbyl
温州	sbyy
汇市	scdn
漂亮	scdo
洒脱	scdv
汇率	scdw
渐进	scfn
汇报	scfp
匈牙利	schn
汇款	sclf
江西省	scmj
汇聚	scpa
渐渐	scsc
漂流	scsd
漂泊	scsg
漂浮	scsj
汇演	scsn
涟漪	scsx
汇集	scti
汇总	scvo
汇编	scwd
油条	sdam
游戏	sdax
液晶	sdbb
注明	sdbd
流畅	sdbi
往日	sdbi
流星	sdbj
流量	sdbt
注意	sddb
流产	sddj
德高望重	sddj
流氓	sddl
流亡	sddl
流通	sddn
得意忘形	sddt
油腻	sddt
油脂	sddt
游玩	sdef
涌现	sden
流动	sdfg
涌动	sdfg
滚动	sdfg
游击	sdfu
涂脂抹粉	sdfx
注目	sdgi
油菜	sdhj
流利	sdhn
流程	sdho
浪花	sdht
流言	sdii
游说	sdiv
游记	sdiz
注意力	sdji
往返	sdjj
往后	sdjj
游历	sdjj
滚蛋	sdjl
液压	sdjl
海市蜃楼	sdjm
涌入	sdjn
流向	sdjn
注入	sdjn
流入	sdjn
流血	sdjq
注重	sdjt
流感	sdjt
注释	sdjx
注视	sdjy
泳装	sdkl
流失	sdkv
油气	sdkz
往复	sdlb
往年	sdlc
流毒	sdlq
流域	sdlt
洗衣机	sdmw
游客	sdna
浏览	sdnk
游览	sdnk
注册	sdnn
注定	sdnt
涪陵	sdpl
滚屏	sdpv
油田	sdqi
注解	sdrd
注射	sdrx
沼泽	sdsa
浪漫	sdsb
往往	sdsd
游泳	sdsd
滚滚	sdsd
流浪	sdsd
流行	sdsf
游行	sdsf
彷徨	sdsg
流泪	sdsg
流水	sdsi
流派	sdsj
油漆	sdsm
滂沱	sdsn
漩涡	sdso
彻头彻尾	sdsp
得意洋洋	sdss
浪潮	sdsx
流传	sdtf
混为一谈	sdti
浑然天成	sdtj
液体	sdtm
往事	sdto
油画	sdtq
游侠	sdtt
油价	sdtv
往来	sdtx
往下	sdty
流出	sdue
流露	sduo
往前	sdvd
游人	sdvi
注销	sdvw
济南市	sdxd
油料	sdxd
济南	sdxn
江郎才尽	sdxp
游刃有余	sdxv
漳州	sdyy
浪费	sdzs
微观	sean
很难	seat
微量	sebt
津贴	seby
微软	secr
很轻	secz
包裹	sedb
漫山遍野	sedb
很多	sedd
汕头	sedd
包头	sedd
包月	sedi
很高	sedo
包括	sefj
包揽	sefn
很远	sefw
微薄	sehs
包袱	sejk
很近	sejk
包庇	seju
包办	sejv
很不	sejy
很长	seki
微笑	sekj
包装	sekl
很想	semg
很小	semi
微小	semi
很少	semj
微机	semw
很紧	sena
律师	sent
包容	senv
包围	seqf
很累	seqw
微妙	serm
很久	sern
很好	serz
微微	sese
活灵活现	sese
微波	sesj
很深	sesn
徘徊	sesq
浸泡	sess
汪洋	sesv
很低	setc
微型	seth
很美	seve
很差	sevf
包含	sevj
微风	sewx
很有	sexd
微米	sexi
很大	seyi
很快	seyz
包子	sezi
很强	sezs
微弱	sezs
行星	sfbj
浅显	sfbw
行贿	sfbx
行车	sfci
行为	sfdj
汗颜	sfdj
海誓山盟	sfeb
行动	sffg
潜能	sfgd
污秽	sfhe
行程	sfho
污蔑	sfhq
浅薄	sfhs
浅谈	sfix
污辱	sfjf
潜力	sfji
漫无边际	sfjp
行长	sfki
污垢	sflj
行走	sfll
行李	sfmz
行军	sfnc
行家	sfnx
包打听	sfoj
行踪	sfol
循规蹈矩	sfol
汗水	sfsi
潜水	sfsi
污水	sfsi
浙江	sfsi
源远流长	sfsk
浙江省	sfsm
行云流水	sfss
行驶	sfst
污染	sfsx
行径	sfsz
行列	sftd
行政	sftl
行事	sfto
行使	sftt
潜伏	sfty
潜心	sfui
行人	sfvi
行销	sfvw
行当	sfwe
行业	sfwt
潜在	sfxi
行情	sfyl
激昂	sgbc
勾通	sgdn
治理	sgeb
激动	sgfg
勾搭	sgfh
激进	sgfn
渺茫	sghs
渗透	sghz
溜了	sgji
治疗	sgjj
满目疮痍	sgjj
激励	sgjt
治病	sgjt
激起	sgll
勾起	sgll
激增	sglv
激素	sglw
治安	sgnr
治国	sgqe
激怒	sgra
泪水	sgsi
激活	sgsj
激烈	sgtd
勾画	sgtq
激化	sgtt
骄兵必败	sgub
渠道	sgvj
治愈	sgvt
勾当	sgwe
勾结	sgwl
激光	sgww
激发	sgya
激情	sgyl
激战	sgyo
溜达	sgyz
水落石出	shcu
灌输	shcv
满意	shdb
满脸	shdv
港元	shfw
滞留	shgd
港台	shgo
洪荒	shhd
滞后	shjj
灌篮	shkn
泄气	shkz
泄密	shnu
洪灾	shnx
港口	shoi
满足	shol
潜移默化	shqt
潇洒	shsc
港湾	shsd
灌溉	shse
港澳台	shsg
洪水	shsi
灌水	shsi
港澳	shsj
泄漏	shsp
满天	shty
泄露	shuo
满分	shvd
滞销	shvw
满怀	shyj
水晶	sibb
水星	sibj
水电	sibl
水果	sibm
水量	sibt
江西	sici
水产	sidj
水肿	sido
水文	sidx
与之	sidz
江山	siei
水运	sifg
江苏	sihj
水稻	sihj
江苏省	sihm
水利	sihn
水库	sijc
水力	siji
水质	sijj
水面	sijq
与否	sijy
水管	sikn
江北	sikt
水上	sili
水域	silt
江门	sini
流言蜚语	sini
水灾	sinx
水中	sioi
水路	siol
与其	siqv
水流	sisd
水源	sisj
水泥	sisp
鸿沟	siss
江河	sist
江淮	sist
江湖	sisx
水位	sitd
水平	sitv
水分	sivd
与会	sivf
水准	sivt
水乡	siwj
江南	sixn
派对	sjax
源码	sjcs
波音	sjdb
源头	sjdd
派头	sjdd
洗衣	sjdk
洗衣机	sjdm
水乳交融	sjdt
添加剂	sjdx
循环	sjej
彼岸	sjej
浮现	sjen
活动	sjfg
波动	sjfg
浮动	sjfg
源于	sjfi
波折	sjfj
淡而无味	sjfo
活捉	sjfo
源泉	sjgs
须臾	sjgv
派兵	sjgv
淫秽	sjhe
淫荡	sjhs
浩荡	sjhs
洗手	sjjf
微生物	sjjf
源自	sjjg
活力	sjji
波段	sjjk
派生	sjjl
淫乱	sjjx
沥青	sjld
彼此	sjlt
须知	sjly
活塞	sjnf
澳门	sjni
渡口	sjoi
派别	sjoj
活跃	sjol
浮躁	sjol
微不足道	sjov
汲取	sjpa
洗刷	sjpn
派遣	sjqp
微乎其微	sjqs
游手好闲	sjrn
洗涤	sjsa
波浪	sjsd
源流	sjsd
浮浅	sjsf
波涛	sjsf
循序渐进	sjsf
浩渺	sjsg
渊源	sjsj
没办法	sjsl
婆娑	sjsm
泛滥	sjsn
波澜	sjsn
洗澡	sjso
派驻	sjst
洗漱	sjst
深入浅出	sjsu
洗染	sjsx
澳洲	sjsy
活泼	sjsy
得不到	sjtg
派出	sjue
浮出	sjue
涵养	sjve
涵盖	sjve
波兰	sjve
活着	sjvf
洗钱	sjvf
派人	sjvi
波纹	sjwd
漫不经心	sjwu
滚瓜烂熟	sjxd
渡过	sjxd
渊博	sjxt
浮夸	sjyf
浩大	sjyi
活性	sjyj
汽车	skci
汗牛充栋	skdm
滥竽充数	skdx
河北省	skmj
汽油	sksd
清明	slbd
清晨	slbj
清晰	slbm
待遇	slbn
法则	slbn
清早	slbx
海鸥	slcx
街头	sldd
法郎	slde
清新	sldm
清高	sldo
清脆	sldr
海外	sldy
清理	sleb
海岸	slej
清退	slek
海峡	slet
清扫	slfe
海报	slfp
法规	slfv
海拔	slfx
海岛	slge
清白	slgi
洁白	slgi
清香	slhb
徒劳	slhn
海带	slhn
清秀	slhz
法语	sliw
海底	sljc
法庭	sljj
清廉	sljv
海边	sljz
清算	slkg
法制	slkn
海地	sllc
清静	slld
海上	slli
街上	slli
海域	sllt
清查	slmb
清楚	slmm
待机	slmw
与此同时	slnb
海军	slnc
法宝	slne
海归	slne
清闲	slnm
法官	slnp
清官	slnp
法案	slnr
法定	slnt
法师	slnt
清空	slnv
法网	slnx
海啸	sloe
海口	sloi
法院	slpn
清除	slpv
法国	slqe
洁具	slqe
海螺	slqq
淑女	slri
海尔	slrm
海鲜	slrt
海滩	slsa
海湾	slsd
清澈	slsd
海浪	slsd
法律	slse
法治	slsg
海港	slsh
海水	slsi
清水	slsi
清洗	slsj
澎湃	slsj
清洁	slsl
海滨	slsn
海洋	slsv
海事	slto
清华	sltt
清代	sltv
清偿	sltw
清醒	slub
清单	slvb
清仓	slvc
清凉	slvd
清贫	slvd
法人	slvi
法令	slvj
街道	slvj
洁净	slvr
清净	slvr
海盗	slvr
海关	slvy
海绵	slwg
法学	slwn
清纯	slwt
满城风雨	slwu
清风	slwx
待续	slwx
清朝	slxb
海南省	slxm
海南	slxn
清真	slxq
清点	slyo
清爽	slyx
洛杉矶	smcw
海枯石烂	smcx
沙尘	smml
浮想联翩	smpd
漆黑	smqh
沙滩	smsa
湘潭	smsc
淋漓	smsd
沙漠	smsh
湘江	smsi
淅沥	smsj
沐浴	smsv
没想到	smtg
沙龙	smxt
沙发	smya
深处	snay
注册码	sncs
演变	sndm
深夜	sndt
演义	sndx
深刻	sndy
海内外	sndy
演奏	snev
演示	snfm
演进	snfn
深远	snfw
演技	snfx
沉睡	sngj
深蓝	snhn
沉积	snho
深秋	snhx
演艺	snhz
演讲	snif
演说	sniv
深厚	snjb
沉痛	snjd
深度	snjh
演习	snji
深造	snjl
深入	snjn
深受	snjn
深奥	snjn
沉重	snjt
深感	snjt
深圳市	snld
注册表	snlk
深圳	snlm
深知	snly
温家宝	snne
滥用	snnf
沉闷	snnu
深究	snnv
洞察	snnx
演员	snob
演唱	snob
浏览器	snoo
深层	snpf
沉默	snqh
沉思	snqu
深思	snqu
溶解	snrd
浑身	snri
溶液	snsd
沉浸	snse
深浅	snsf
深水	snsi
沉浮	snsj
深渊	snsj
深沉	snsn
沉淀	snsn
润滑	snsq
徘徊	snsq
沉没	snsw
渲染	snsx
深切	sntd
海阔天空	sntn
深化	sntt
演化	sntt
演出	snue
沉着	snvf
演绎	snwa
演练	snwt
淀粉	snxv
深情	snyl
句号	soot
演唱会	sovf
句子	sozi
沈阳市	spdn
洗耳恭听	spho
浓厚	spjb
浓度	spjh
泥土	spli
沈阳	sppb
沈阳市	sppd
泥沙	spsm
漏洞	spsn
泥泞	spsn
骄阳似火	sptx
浓缩	spwn
浓郁	spxd
邋遢	sqbj
深思熟虑	sqdy
满园春色	sqer
滑稽	sqhx
溃疡	sqjz
滑坡	sqlj
包罗万象	sqtr
滑雪	sque
滑冰	sqvs
沮丧	sqxv
衡量	srbt
涣散	srhd
沉鱼落雁	srhj
衡水	srsi
渔业	srwt
浩如烟海	srxs
沧海桑田	ssaq
津津乐道	sscv
海淀区	sscx
沟通	ssdn
忽然	ssdy
沸沸扬扬	ssff
乌云	ssfg
浑水摸鱼	ssfr
港澳台	ssgo
浩浩荡荡	sshh
汗马功劳	ssih
水泄不通	ssjd
沾沾自喜	ssjl
衍生	ssjl
法律顾问	ssjn
滴水不漏	ssjs
添油加醋	ssju
忽视	ssjy
波澜壮阔	sskn
淘气	sskz
滴水穿石	ssnc
水涨船高	ssnd
江泽民	sspt
淋漓尽致	sspt
忽略	ssqa
匆匆	ssss
泡沫	ssst
淘汰	sssy
沧海一粟	sstc
淘金	ssvi
循循善诱	ssvi
水深火热	ssxf
津津有味	ssxo
洋洋大观	ssya
匆忙	ssyd
惩处	stay
马车	stci
源代码	stcs
马匹	stcw
行政区	stcx
马脚	stdl
驯服	stdp
征服	stdp
征文	stdx
骤然	stdy
驿站	stdy
驻外	stdy
河山	stei
驱动	stfg
骚动	stfg
驻扎	stfl
骚扰	stfx
很可能	stgd
征稿	sthd
骀荡	sths
征税	sthv
征询	stis
验证	stit
征订	stit
彻底	stjc
马到成功	stji
马力	stji
驳斥	stjj
驳斥	stjk
河段	stjk
添加	stjo
深恶痛绝	stjw
骚乱	stjx
河北省	stkm
征管	stkn
河北	stkt
驻地	stlc
马上	stli
验收	stli
征收	stli
骑士	stli
征用	stnf
马路	stol
骗取	stpa
驱除	stpv
惩罚	stqi
马甲	stqi
驳回	stqo
添置	stqx
征婚	strc
河流	stsd
惩治	stsg
河水	stsi
驰骋	stst
骑马	stst
骆驼	stst
匍匐	stst
征集	stti
骄傲	sttl
水天一色	sttr
驻华	sttt
驯养	stve
骗人	stvi
河道	stvj
河谷	stvv
征兆	stvw
得天独厚	stxj
河南省	stxm
河南	stxn
马克	stxo
马克思	stxq
征求	stxx
驱逐	stxz
马虎	styw
马达	styz
骗子	stzi
得心应手	sujj
派出所	sujj
酒后	sujj
酒店	sujy
酒杯	sumj
酒楼	sumx
酒家	sunx
酒吧	suod
泌尿	sups
酒精	suxl
沧桑	svaa
涂鸦	svci
沁人肺腑	svdd
沦为	svdj
衔接	svfd
洽谈	svix
滋补	svjk
滋生	svjl
没关系	svjw
滋长	svki
混凝土	svli
浴室	svnt
滋味	svof
骇人听闻	svon
沧海	svsl
滋润	svsn
洋溢	svsv
涂料	svxd
涂改	svzl
消亡	swdl
消退	swek
消耗	swem
湖光山色	swer
浮光掠影	swfb
没能	swgd
沿革	swhp
消息	swjg
没了	swji
消磨	swjm
消失	swkv
潍坊	swld
没收	swli
消毒	swlq
消极	swmj
没用	swnf
沿用	swnf
消防	swpd
消除	swpv
没治	swsg
沿江	swsi
沿海	swsl
没法	swsl
活学活用	swsn
徜徉	swsv
没什么	swtj
没事	swto
消化	swtt
消灭	swtx
沿着	swvf
没错	swvh
没人	swvi
没关系	swvj
沿途	swvt
沿线	swwf
没有	swxd
消炎	swxx
消费品	swzo
消费	swzs
消费者	swzy
德育	sxdg
济南市	sxdn
没精打采	sxfj
得寸进尺	sxfp
淡薄	sxhs
淡季	sxhz
德语	sxiw
乌烟瘴气	sxjk
湖北省	sxkm
湖北	sxkt
温故知新	sxld
渎职	sxpo
德国	sxqe
德甲	sxqi
马克思	sxqu
湖畔	sxqv
潮湿	sxsb
潮流	sxsd
汹涌	sxsd
湖泊	sxsg
淡水	sxsi
澄清	sxsl
渤海	sxsl
淡淡	sxsx
淡化	sxtt
乌克兰	sxve
染料	sxxd
湖南省	sxxm
湖南	sxxn
湖州	sxyy
泼辣	sydx
涉外	sydy
潦草	syhb
涉世	syhl
深情厚谊	syji
涉及	syjz
沾边	syjz
濒临	synk
涉案	synr
涉足	syol
濒危	syrj
涉嫌	syrv
骄奢淫逸	sysr
淹没	sysw
沾染	sysx
沸腾	szdv
溺爱	szjn
巡视	szjy
巡礼	szjy
涨幅	szni
涨跌	szol
消费品	szoo
巡逻	szqd
巡回	szqo
汤姆	szrq
涨价	sztv
消费者	szyb
仅限	tape
仅仅	tata
仅供	tath
仅有	taxd
一条龙	taxt
但又	tbai
更难	tbat
但对	tbax
更易	tbbs
但是	tbbt
但要	tbcr
更要	tbcr
旨意	tbdb
更多	tbdd
更为	tbdj
更新	tbdm
更高	tbdo
更名	tbdo
但这	tbdx
偶然	tbdy
一日三秋	tbeh
倡导	tbex
更换	tbfr
更能	tbgd
倡议	tbid
俚语	tbiw
一日千里	tbjb
惠顾	tbjc
形影不离	tbjd
似是而非	tbje
伸手	tbjf
但愿	tbjg
似是而非	tbjn
更加	tbjo
侧面	tbjq
侧重	tbjt
更重	tbjt
平易近人	tbjv
更不	tbjy
但不	tbjy
但却	tblg
天时地利人和	tblh
伸展	tbph
但因	tbqy
偶尔	tbrm
更好	tbrz
更深	tbsn
更正	tbtl
偶像	tbtr
伸出	tbue
但从	tbvv
惠普	tbvw
伸缩	tbwn
更有	tbxd
但有	tbxd
但在	tbxi
旨在	tbxi
更大	tbyi
更快	tbyz
更改	tbzl
更强	tbzs
伸张	tbzs
低贱	tcbf
低音	tcdb
低头	tcdd
低端	tcde
俱乐部	tcdo
低于	tcfi
低能	tcgd
他的	tcgs
低落	tchs
低调	tcin
他说	tciv
他所	tcjj
低压	tcjl
低廉	tcjv
低声	tcld
停车场	tclz
他想	tcmg
低劣	tcmj
低档	tcmw
他用	tcnf
低温	tcsb
低沉	tcsn
伶牙俐齿	tctl
他们	tctn
低价	tctv
伛偻	tctx
低估	tctx
低下	tcty
他人	tcvi
低谷	tcvv
低级	tcwj
他乡	tcwj
低迷	tcxz
依照	tdbd
残暴	tdbh
烈日	tdbi
停电	tdbl
傍晚	tdbr
列车	tdci
停车	tdci
切磋	tdcv
残忍	tddd
下放	tddh
停放	tddh
天方夜谭	tddi
列为	tddj
停产	tddj
死亡	tddl
依恋	tddm
束之高阁	tddn
偏旁	tddn
住房	tddp
住户	tddp
偏离	tddx
依然	tddy
东施效颦	tddy
下岗	tden
下班	tdey
位于	tdfi
死于	tdfi
依托	tdfj
依据	tdfp
切换	tdfr
歼击	tdfu
天衣无缝	tdfw
偏远	tdfw
残留	tdgd
停留	tdgd
殊荣	tdhn
下落	tdhs
殡葬	tdht
依稀	tdhx
依旧	tdib
停工	tdii
促膝谈心	tdiu
下设	tdiw
切记	tdiz
裂痕	tdje
列席	tdjh
死了	tdji
死后	tdjj
住所	tdjj
偏袒	tdjk
残疾	tdjl
伪造	tdjl
依靠	tdjl
偏爱	tdjn
切入	tdjn
列入	tdjn
倍受	tdjn
下面	tdjq
一方面	tdjq
悠然自得	tdjs
偏重	tdjt
集腋成裘	tdjx
残废	tdjy
伪装	tdkl
仿制	tdkn
天然气	tdkz
下载	tdlc
下去	tdlg
死去	tdlg
停止	tdli
烈士	tdli
列表	tdlk
仪表	tdlk
住址	tdll
倍增	tdlv
下午	tdlx
下场	tdlz
体育场	tdlz
伪劣	tdmj
优胜劣汰	tdms
停机	tdmw
切实	tdnd
切割	tdnf
住宅	tdnj
住宿	tdnt
偏见	tdnw
下跌	tdol
仪器	tdoo
下降	tdpa
下属	tdpj
住院	tdpn
停职	tdpo
殖民	tdpt
依附	tdpt
切除	tdpv
位居	tdpx
位置	tdqx
切身	tdri
死角	tdri
体育馆	tdrl
偏好	tdrz
下旬	tdsb
偏激	tdsg
停泊	tdsg
歹徒	tdsl
依法	tdsl
残渣	tdsm
敷衍	tdss
下马	tdst
停下	tdtd
下列	tdtd
偏偏	tdtd
死刑	tdth
仪式	tdti
依赖	tdto
偏僻	tdtp
付之东流	tdts
停顿	tdtu
歼灭	tdtx
下来	tdtx
下一步	tdty
停下	tdty
仿佛	tdtz
列出	tdue
下雨	tdui
残酷	tduj
偏差	tdvf
死人	tdvi
下次	tdvr
依次	tdvr
残余	tdvt
裂缝	tdwa
下级	tdwj
再就业	tdwt
停业	tdwt
列举	tdwv
烈火	tdxi
切断	tdxl
焦头烂额	tdxn
仿古	tdxo
仿真	tdxq
倍数	tdxr
天外有天	tdxt
死者	tdyb
一夜情	tdyl
下达	tdyz
切忌	tdzl
健忘	tedl
侵扰	tefx
催眠	tegp
健康	teje
催生	tejl
侵入	tejn
催还	tejy
健壮	tekl
仙境	teld
侵权	tema
侵害	tenf
一辈子	tenz
侵略	teqa
伊始	terg
健身	teri
仙女	teri
侵蚀	terl
东山再起	tetl
催促	teto
催化	tett
侵吞	tety
健全	teve
健美	teve
伊人	tevi
健在	texi
侵犯	texj
侵袭	text
侵占	teyo
妻子	tezi
传输	tfcv
保护区	tfcx
仁义	tfdx
传导	tfex
传动	tffg
传播	tffj
传授	tffj
一干二净	tffv
传说	tfiv
传记	tfiz
传承	tfje
传入	tfjn
一掷千金	tfjv
传闻	tfnp
传阅	tfnv
传呼	tfoj
传媒	tfrh
传染	tfsx
便携式	tfti
再接再厉	tftj
万无一失	tftk
传来	tftx
传出	tfue
传单	tfvb
传颂	tfvg
七拼八凑	tfvv
传销	tfvw
传送	tfvy
传递	tfvz
传统	tfwd
伟业	tfwt
化干戈为玉帛	tfxg
伊拉克	tfxo
传真	tfxq
伟大	tfyi
传情	tfyl
传奇	tfyt
传达	tfyz
到处	tgay
致电	tgbl
到时	tgbx
伯乐	tgcm
致意	tgdb
至多	tgdd
至于	tgfi
致敬	tghs
致词	tgij
致谢	tgir
到底	tgjc
到手	tgjf
致力	tgji
到了	tgji
致病	tgjt
致辞	tgjx
致以	tgld
至上	tgli
至此	tglt
到场	tglz
至少	tgmj
致富	tgnt
到家	tgnx
到期	tgqv
致死	tgtd
到位	tgtd
到任	tgtj
傀儡	tgtq
致使	tgtt
到货	tgtt
到来	tgtx
到会	tgvf
至今	tgvj
致命	tgvt
至尊	tgvu
伯父	tgvx
一目十行	tgxs
可能性	tgyj
到达	tgyz
借条	tham
开明	thbd
供暖	thbj
万里	thbl
供电	thbl
开车	thci
开头	thdd
开朗	thde
开端	thde
开放	thdh
开刀	thdi
东莞市	thdn
开通	thdn
万户	thdp
开启	thdp
开户	thdp
万岁	thed
开垦	thek
开拓	thfc
迈进	thfn
戒指	thft
万元	thfw
形势	thfx
供热	thfx
万能	thgd
开眼	thge
邢台	thgo
开幕	thhb
开荒	thhd
供稿	thhd
开花	thht
开课	thib
开工	thii
开设	thiw
万物	thjf
一季度	thjh
形成	thjj
开庭	thjj
开采	thjm
迈向	thjn
天花乱坠	thjp
开办	thjv
供应	thjw
作茧自缚	thjw
一落千丈	thjx
万千	thjx
开店	thjy
开奖	thkd
形状	thky
借款	thlf
开封	thll
戒毒	thlq
豆蔻年华	thlt
开场	thlz
开枪	thmv
开机	thmw
借机	thmw
开赛	thnf
借用	thnf
开门	thni
借鉴	thnk
开阔	thns
开盘	thns
形容	thnv
借口	thoi
开口	thoi
万吨	thot
型号	thot
开展	thph
开局	thpj
开辟	thpo
开除	thpv
开罗	thqd
万国	thqe
借助	thqf
刑罚	thqi
开始	thrg
形象	thro
万象	thro
开往	thsd
开水	thsi
供水	thsi
开源	thsj
刑法	thsl
万万	thth
万一	thti
形式	thti
形体	thtm
刑事	thto
万事	thto
借贷	thtv
戒严	thtw
开来	thtx
开出	thue
迈出	thue
开心	thui
供需	thuj
开创	thvc
万分	thvd
供养	thve
开会	thvf
万余	thvt
供销	thvw
开销	thvw
开关	thvy
开学	thwn
开业	thwt
供给	thwv
开支	thxa
开火	thxi
借故	thxo
戒烟	thxq
供求	thxx
开发	thya
形态	thyd
迈步	thyi
开战	thyo
开张	thzs
一双	tiaa
一条	tiam
储备	tiaq
一对	tiax
一日	tibi
一颗	tibm
一则	tibn
一旦	tibt
储量	tibt
一时	tibx
售票	ticf
候车	tici
一轮	ticv
一头	tidd
七月	tidi
一月	tidi
一新	tidm
集市	tidn
一旁	tidn
一部	tido
一遍	tidp
信服	tidp
集邮	tidp
一脸	tidv
一股	tidw
一齐	tidx
一刻	tidy
修理	tieb
修建	tief
一群	tiej
一把	tifd
一二	tifi
信托	tifj
一批	tifu
悠远	tifw
悠扬	tifz
一眼	tige
一瞬	tigj
一台	tigo
丁香	tihb
储蓄	tihd
集散	tihd
储藏	tihk
一世	tihl
一带	tihn
一种	tiho
一共	tihv
一项	tiij
集训	tiim
修订	tiit
一百	tijb
一手	tijf
信息	tijg
一度	tijh
一段	tiji
一所	tijj
集成	tijj
修补	tijk
一段	tijk
候选	tijl
一生	tijl
七彩	tijm
一向	tijn
一面	tijq
一座	tijv
一番	tijx
一千	tijx
一边	tijz
一篇	tikd
一片	tiki
一等	tikl
信箱	tikm
修复	tilb
一年	tilc
一起	till
一封	till
信封	till
一些	tilt
一堆	tilt
一块	tilz
一场	tilz
一枚	tima
集权	tima
一概	time
一根	time
一杯	timj
一本	timt
式样	timv
一样	timv
一审	tinb
信用	tinf
一幅	tini
一门	tini
一览	tink
一周	tinl
悠闲	tinm
一般	tins
一定	tint
一同	tint
一家	tinx
一味	tiof
集中	tioi
一口	tioi
一路	tiol
焦距	tiol
信号	tiot
一号	tiot
一只	tiov
信阳	tipb
一阵	tipc
一回	tiqo
集团	tiqx
一贯	tiqx
一团	tiqx
焦急	tire
一角	tiri
一身	tiri
一试身手	tirj
修饰	tirl
悠久	tirn
一如	tiro
一流	tisd
一律	tise
一行	tisf
一派	tisj
一句	tiso
倏忽	tiss
一侧	titb
信仰	titc
一切	titd
一位	titd
一下	titd
一致	titg
一万	tith
七一	titi
信任	titj
信件	titk
一件	titk
修正	titl
集体	titm
一体	titm
一再	titn
信赖	tito
一顿	titu
售价	titv
一代	titv
信贷	titv
一来	titx
一天	tity
一下	tity
售出	tiue
信心	tiui
一心	tiui
修配	tiuz
一分	tivd
修剪	tivd
修养	tive
集会	tivf
集锦	tivg
一并	tivh
一个	tivi
信念	tivj
一首	tivj
一道	tivj
匕首	tivj
一次	tivr
集资	tivr
集合	tivt
一半	tivx
一线	tiwf
一级	tiwj
集结	tiwl
一朵	tiwm
集约	tiws
信誉	tiwv
一举	tiwv
修缮	tiwv
一丝	tiww
一经	tiwz
一支	tixa
一言九鼎	tixg
储存	tixi
七十	tixi
一直	tixq
修炼	tixt
一类	tixy
一步	tiyi
一套	tiyk
一点	tiyo
焦点	tiyo
焦虑	tiyu
修改	tizl
一张	tizs
任务	tjaj
任意	tjdb
顶端	tjde
顶部	tjdo
伺服	tjdp
侨胞	tjds
顶峰	tjea
两面三刀	tjed
致力于	tjfi
来自于	tjfi
凭据	tjfp
顶替	tjfv
傻眼	tjge
死不瞑目	tjgg
俯瞰	tjgj
任期	tjhe
凭证	tjit
俄语	tjiw
傻瓜	tjjj
一手遮天	tjjt
俯视	tjjy
来不及	tjjz
傻笑	tjkj
天翻地覆	tjlc
伺机	tjmw
顶尖	tjmy
任用	tjnf
一视同仁	tjnt
凭空	tjnv
传感器	tjoo
任职	tjpo
侨居	tjpx
俄国	tjqe
俄罗斯	tjqh
任期	tjqv
任免	tjro
两袖清风	tjsw
一系列	tjtd
凭借	tjth
任凭	tjtj
任何	tjtt
华盛顿	tjtu
一应俱全	tjtv
七手八脚	tjvd
凭着	tjvf
任命	tjvt
顶级	tjwj
顶风	tjwx
俘虏	tjyj
顶点	tjyo
任教	tjyz
一箭双雕	tkan
佚名	tkdo
化妆品	tkoo
死气沉沉	tkss
侏儒	tktu
债务	tlaj
政务	tlaj
疑难	tlat
作对	tlax
正是	tlbt
作乐	tlcm
正确	tlcr
正要	tlcr
正轨	tlcx
一年之计在于春	tlde
正月	tldi
作为	tldj
伤亡	tldl
政变	tldm
画地为牢	tldn
互通	tldn
天壤之别	tldo
正名	tldo
正义	tldx
作文	tldx
正文	tldx
互动	tlfg
互换	tlfr
正规	tlfv
伤势	tlfx
佳能	tlgd
似的	tlgs
伤兵	tlgv
互利	tlhn
佳节	tlhp
政委	tlhr
作秀	tlhz
佳话	tlij
正误	tlio
作证	tlit
伤痛	tljd
伤痕	tlje
侮辱	tljf
作物	tljf
正反	tljj
互补	tljk
正面	tljq
政府	tljt
伤感	tljt
似乎	tljv
万紫千红	tljw
正视	tljy
作废	tljy
正版	tlkj
政策	tlkt
正气	tlkz
佳境	tlld
作坊	tlld
债权	tlma
政权	tlma
互相	tlmg
作梗	tlmt
政客	tlna
伤悲	tlne
作用	tlnf
伤害	tlnf
正宗	tlnf
疑问	tlno
作案	tlnr
作家	tlnx
伤员	tlob
正中	tloi
伤口	tloi
作品	tloo
正品	tloo
作陪	tlpd
政局	tlpj
互联网	tlpn
互联	tlpv
互助	tlqf
作罢	tlql
政界	tlqv
佳期	tlqv
正负	tlrb
瓦解	tlrd
正如	tlro
正好	tlrz
政治	tlsg
正派	tlsj
政法	tlsl
作法	tlsl
互惠	tltb
正式	tlti
侍候	tlti
佳作	tltl
疑似	tltl
佳丽	tltn
疑惑	tlto
作假	tltp
何去何从	tltv
作价	tltv
正值	tltx
作出	tlue
伤心	tlui
疑心	tlui
正比	tlui
作曲	tlui
佳人	tlvi
正道	tlvj
作弊	tlvn
七上八下	tlvt
债券	tlvy
正统	tlwd
正当	tlwe
政绩	tlwl
佳绩	tlwl
正常	tlwn
政党	tlwn
作业	tlwt
肄业	tlwt
作风	tlwx
正经	tlwz
正在	tlxi
政协	tlxj
正直	tlxq
作怪	tlya
作者	tlyb
傲慢	tlyb
作战	tlyo
正点	tlyo
疑虑	tlyu
东盟	tmbd
体贴	tmby
东西	tmci
东欧	tmcx
体育	tmdg
东方	tmdh
体育场	tmdl
东京	tmdo
东部	tmdo
体育馆	tmdr
东山	tmei
体现	tmen
体操	tmfo
体能	tmgd
体魄	tmgg
东芝	tmhd
体积	tmho
体谅	tmid
休息	tmjg
体力	tmji
体质	tmjj
体面	tmjq
一尘不染	tmjs
体重	tmjt
体系	tmjw
体制	tmkn
东北	tmkt
体裁	tmld
体坛	tmlf
休止	tmli
体检	tmmv
休闲	tmnm
画栋雕梁	tmns
体内	tmnv
东路	tmol
末尾	tmpj
末期	tmqv
体温	tmsb
东海	tmsl
体验	tmst
东侧	tmtb
一本万利	tmth
体形	tmth
一模一样	tmtm
东东	tmtm
休整	tmto
休假	tmtp
东亚	tmtw
休养	tmve
体会	tmvf
东风	tmwx
东南	tmxn
休克	tmxo
两条	tnam
再也	tnci
两头	tndd
两端	tnde
两旁	tndn
再三	tnei
两岸	tnej
再现	tnen
凭空捏造	tnfj
一览无余	tnfv
倾家荡产	tnhd
两种	tnho
两项	tnij
再说	tniv
两手	tnjf
棘手	tnjf
再度	tnjh
再生	tnjl
两面	tnjq
一字千金	tnjv
两千	tnjx
七窍生烟	tnjx
再不	tnjy
两边	tnjz
再版	tnkj
两年	tnlc
两地	tnlc
事实上	tnli
一览表	tnlk
再起	tnll
信用卡	tnly
使用权	tnma
两栖	tnmc
两用	tnnf
再见	tnnw
两家	tnnx
两只	tnov
两国	tnqe
再婚	tnrc
刺激	tnsg
两侧	tntb
倜傥	tntw
再来	tntx
两天	tnty
再会	tnvf
两会	tnvf
两个	tnvi
一家人	tnvi
一般人	tnvi
佣金	tnvi
再次	tnvr
再有	tnxd
两者	tnyb
形同虚设	tnyi
两性	tnyj
两点	tnyo
一辈子	tnzi
事务	toaj
可观	toan
歌星	tobj
保暖	tobj
可是	tobt
或是	tobt
可乐	tocm
事端	tode
可望	todl
事迹	todm
可变	todm
速率	todw
整齐	todx
整理	toeb
保护	tofd
囊括	tofj
保持	tofl
促进	tofn
副刊	tofn
保留	togd
逗留	togd
可能	togd
堡垒	togg
可能性	togy
事项	toij
歌词	toij
或许	toil
可调	toin
可谓	toiq
保证	toit
事物	tojf
副手	tojf
歌手	tojf
速度	tojh
逼近	tojj
促成	tojj
速成	tojj
事后	tojj
逼近	tojk
可靠	tojl
事先	tojl
可选	tojl
可爱	tojn
融入	tojn
保重	tojt
豆腐	tojt
歌厅	tojt
可靠性	tojy
可否	tojy
可视	tojy
可将	tokd
可笑	tokj
保管	tokn
一口气	tokz
可以	told
歌声	told
仲裁	told
歌坛	tolf
歌舞	tolh
可喜	tolo
可知	toly
副本	tomt
整机	tomw
事实	tond
可用	tonf
事实上	tonl
事宜	tonq
保安	tonr
速写	tons
保定	tont
保密	tonu
整容	tonv
可见	tonw
保守	tonx
歌唱	toob
可口	tooi
逗号	toot
可取	topa
保障	topd
可耻	topl
副职	topo
保卫	topt
保险	topv
歌剧	topx
可贵	toqb
保姆	torq
保鲜	tort
保温	tosb
可行	tosf
可汗	tosf
整治	tosg
整洁	tosl
保洁	tosl
融洽	tosv
可行性	tosy
保健	tote
一唱一和	toth
整形	toth
逼供	toth
保修	toti
整修	toti
可信	toti
事件	totk
可疑	totl
整体	totm
副作用	totn
哥们	totn
哥哥	toto
整整	toto
促使	tott
融化	tott
事例	tott
整顿	totu
可恶	totw
保佑	totx
保值	totx
整天	toty
歌曲	toui
可比	toui
副食	tovd
事前	tovd
保养	tove
保全	tove
歌颂	tovg
整个	tovi
整人	tovi
七嘴八舌	tovj
融资	tovr
融合	tovt
整合	tovt
促销	tovw
速递	tovz
整编	towd
事儿	towi
事业	towt
束缚	towt
整风	towx
保存	toxi
事故	toxo
逼真	toxq
歌迷	toxz
或者	toyb
事态	toyd
可恨	toye
副教授	toyf
可怕	toyg
可惜	toyh
整套	toyk
事情	toyl
可怜	toyv
可达	toyz
整改	tozl
假日	tpbi
假账	tpbk
假名	tpdo
化险为夷	tpdt
假扮	tpfv
假的	tpgs
假期	tphe
假若	tphx
假说	tpiv
假设	tpiw
假装	tpkl
严阵以待	tpls
假想	tpmg
假冒	tpnf
假定	tpnt
互联网	tpnx
假期	tpqv
假如	tpro
假象	tpro
假借	tpth
假使	tptt
假货	tptt
倔强	tpzs
俱乐部	tqcd
画眉	tqdj
画报	tqfp
画廊	tqjd
画面	tqjq
集思广益	tqjv
天罗地网	tqln
画册	tqnn
画家	tqnx
俄罗斯	tqqv
画蛇添足	tqso
倾国倾城	tqtl
画像	tqtr
你就	trdo
你的	trgs
你我	trjf
像素	trlw
你想	trmg
您好	trrz
你好	trrz
万象更新	trtd
你们	trtn
偷梁换柱	tsfm
一句话	tsij
万水千山	tsje
事与愿违	tsjf
传染病	tsjt
伊甸园	tsqf
似水流年	tssl
天涯海角	tssr
戒骄戒躁	tsto
万马奔腾	tsyd
可行性	tsyj
价值观	ttan
何处	ttay
例题	ttbt
便是	ttbt
倒是	ttbt
何时	ttbx
化石	ttci
货车	ttci
东倒西歪	ttcj
华硕	ttcj
化肥	ttdd
化为	ttdj
华裔	ttdk
便衣	ttdk
顶天立地	ttdl
华文	ttdx
例外	ttdy
一下子	ttdz
使之	ttdz
华山	ttei
平顶山	ttei
倒退	ttek
偷偷摸摸	ttff
货运	ttfg
便于	ttfi
便捷	ttft
便携	ttft
倒台	ttgo
倾慕	tthb
便利	tthn
何种	ttho
使节	tthp
化工	ttii
倾诉	ttij
何许	ttil
华语	ttiw
货物	ttjf
华夏	ttjg
侃侃而谈	ttji
倾力	ttji
货币	ttjn
倾向	ttjn
货架	ttjo
何不	ttjy
化妆品	ttko
化妆	ttkr
华北	ttkt
倒塌	ttlb
何以	ttld
货款	ttlf
何止	ttli
侠客	ttna
使用	ttnf
副作用	ttnf
便宜	ttnq
倒闭	ttnx
倾听	ttoj
吞吞吐吐	ttoo
货品	ttoo
僵局	ttpj
开天辟地	ttpl
便民	ttpt
保修期	ttqv
何妨	ttrd
化解	ttrd
化身	ttri
使馆	ttrl
例如	ttro
何如	ttro
形形色色	ttrr
使得	ttsb
倾注	ttsd
例行	ttsf
货源	ttsj
化验	ttst
使他	tttc
华侨	tttj
华东	tttm
华丽	tttn
便可	ttto
可歌可泣	ttts
僵化	tttt
倒下	ttty
使出	ttue
倾心	ttui
何必	ttuj
倒霉	ttul
华美	ttve
便会	ttvf
使人	ttvi
华人	ttvi
便道	ttvj
何况	ttvo
倾斜	ttvt
使命	ttvt
倾销	ttvw
化纤	ttwj
化学	ttwn
何尝	ttwn
何在	ttxi
倒卖	ttxj
华南	ttxn
使者	ttyb
倾情	ttyl
例子	ttzi
一下子	ttzi
顿时	tubx
儒雅	tuci
死心塌地	tull
儒家	tunx
一心一意	tutd
七零八落	tuvh
平日	tvbi
平时	tvbx
代码	tvcs
平方	tvdh
代为	tvdj
伦敦	tvdo
平方米	tvdx
代理	tveb
伦理	tveb
伴奏	tvev
代替	tvfv
价目	tvgi
平台	tvgo
平和	tvho
平稳	tvhr
俗称	tvhr
两全其美	tvhv
代言	tvii
俗话	tvij
代词	tvij
代谢	tvir
事半功倍	tvit
俗语	tviw
平庸	tvje
平原	tvjg
平息	tvjg
平面	tvjq
代办	tvjv
平等	tvkl
俗气	tvkz
平坦	tvlb
平静	tvld
平壤	tvld
贷款	tvlf
代表	tvlk
代表团	tvlq
平均	tvls
价格	tvma
平板	tvmj
俭朴	tvmy
份额	tvna
万人空巷	tvnh
殊途同归	tvnn
平安	tvnr
偷窃	tvnv
代号	tvot
平局	tvpj
平民	tvpt
伴随	tvpx
融会贯通	tvqd
两全其美	tvqv
一贫如洗	tvrs
蚕食鲸吞	tvrt
平行	tvsf
偷渡	tvsj
偷漏	tvsp
平衡	tvsr
代沟	tvss
平淡	tvsx
价位	tvtd
伶俐	tvth
伴侣	tvto
平整	tvto
万众一心	tvtu
代价	tvtv
偷偷	tvtv
平平	tvtv
价值	tvtx
价钱	tvvf
一个个	tvvi
一分钟	tvvo
偷盗	tvvr
平凡	tvwd
一会儿	tvwi
平常	tvwn
平米	tvxi
夹杂	tvxm
夹克	tvxo
偷袭	tvxt
开卷有益	tvxv
一次性	tvyj
偷懒	tvyt
严明	twbd
恶果	twbm
恶意	twdb
佩服	twdp
严峻	tweg
严肃	twei
严肃	twem
严打	twft
倘若	twhx
严谨	twih
俏皮	twja
晋升	twjh
一丝不苟	twjh
恶习	twji
恶魔	twjm
严重	twjt
严厉	twjt
偿还	twjy
天经地义	twld
恶毒	twlq
严格	twma
恶劣	twmj
严禁	twmm
亚军	twnc
严寒	twnf
严密	twnu
严防	twpd
严惩	twst
亚洲	twsy
一丝一毫	twtd
严正	twtl
一举两得	twts
恶化	twtt
一五一十	twtx
恶心	twui
晋级	twwj
亚太	twyd
恶性	twyj
来电	txbl
估量	txbt
优雅	txci
优良	txde
做主	txde
优育	txdg
优胜	txdj
灭亡	txdl
优柔	txdt
优异	txeh
值班	txey
优于	txfi
优势	txfx
来稿	txhd
值勤	txho
优秀	txhz
来访	txid
做工	txii
来说	txiv
估计	txix
伙计	txix
来自	txjg
什么	txjg
来了	txji
做成	txjj
来不及	txjj
来历	txjj
优质	txjj
优先	txjl
什么样	txjm
做爱	txjn
仇敌	txjx
来函	txjx
仇视	txjy
估算	txkg
来年	txlc
来龙去脉	txld
付款	txlf
优越	txll
侥幸	txlv
死灰复燃	txlx
侥幸	txly
优劣	txmj
做梦	txmm
传真机	txmw
做客	txna
做完	txnf
来宾	txng
来临	txnk
来回	txqo
做饭	txrl
做好	txrz
值得	txsb
做得	txsb
来得	txsb
来往	txsd
优游	txsd
来源	txsj
做法	txsl
付清	txsl
优惠	txtb
来到	txtg
做到	txtg
来信	txti
做事	txto
优化	txtt
伎俩	txtt
估价	txtv
伙伴	txtv
东南亚	txtw
付出	txue
做出	txue
伙食	txvd
优美	txve
仇人	txvi
来人	txvi
做人	txvi
灭绝	txwr
做过	txxd
灭火	txxi
仇恨	txye
画龙点睛	txyg
做大	txyi
优点	txyo
付费	txzs
天赋	tybf
下贱	tybf
天时	tybx
下车	tyci
侦破	tycj
开发区	tycx
下放	tydh
开发商	tydn
天亮	tydo
天文	tydx
天然	tydy
天外	tydy
天王	tyei
天山	tyei
下岗	tyen
下班	tyey
侦探	tyfn
一大批	tyfu
伏击	tyfu
下台	tygo
下落	tyhs
下课	tyib
下调	tyin
下设	tyiw
下页	tyjb
天鹅	tyjf
下手	tyjf
伏特	tyjf
天生	tyjl
下面	tyjq
天府	tyjt
天籁	tykt
天气	tykz
天地	tylc
下载	tylc
下地	tylc
天坛	tylf
平步青云	tylf
下去	tylg
天上	tyli
下午	tylx
下场	tylz
侦查	tymb
天桥	tymj
天极	tymj
天机	tymw
下周	tynl
天空	tynv
侦察	tynx
天灾	tynx
下跌	tyol
下降	typa
下属	typj
天色	tyrd
下旬	tysb
天津市	tysd
下游	tysd
天津	tyse
下水	tysi
天涯	tysj
下海	tysl
下滑	tysq
天河	tyst
天下	tytd
下列	tytd
天仙	tyte
天体	tytm
一点一滴	tyts
天使	tytt
天平	tytv
天价	tytv
速战速决	tytv
下来	tytx
天天	tyty
天下	tyty
下雨	tyui
蚕食	tyvd
下令	tyvj
天资	tyvr
下次	tyvr
天线	tywf
下线	tywf
下级	tywj
下乡	tywj
天堂	tywn
天才	tyxj
天真	tyxq
天数	tyxr
一步登天	tyxt
下发	tyya
天性	tyyj
下达	tyyz
仍是	tzbt
仍然	tzdy
仍未	tzfm
亿元	tzfw
仍旧	tzib
仍将	tzkd
佛陀	tzpn
亿万	tzth
仔细	tzwq
仍有	tzxd
仍在	tzxi
佛教	tzyz
遭遇	ubbn
曹操	ubfo
醒目	ubgi
遭受	ubjn
心照不宣	ubjn
心旷神怡	ubjy
酣畅淋漓	ubss
遭到	ubtg
心连心	ucui
曲高和寡	udhn
心脏病	udjt
零部件	udtk
出产	uedj
出名	uedo
雪亮	uedo
出山	ueei
雪山	ueei
出现	ueen
出动	uefg
出于	uefi
出示	uefm
出击	uefu
雪白	uegi
出台	uego
出兵	uegv
出世	uehl
出勤	ueho
出租	uehq
雪花	ueht
出访	ueid
出让	ueil
出手	uejf
出息	uejg
出自	uejg
出席	uejh
出厂	ueji
出力	ueji
出了	ueji
出庭	uejj
出生	uejl
出入	uejn
出面	uejq
出血	uejq
出乎	uejv
出版	uekj
出版社	uekj
出境	ueld
出去	uelg
出土	ueli
出走	uell
出场	uelz
出门	ueni
出口	ueoi
出路	ueol
出品	ueoo
出局	uepj
出院	uepn
出国	ueqe
出具	ueqe
出色	uerd
出身	ueri
出嫁	uern
出游	uesd
出行	uesf
出水	uesi
出海	uesl
出演	uesn
出马	uest
出征	uest
出售	ueti
出任	uetj
出事	ueto
出货	uett
出来	uetx
出差	uevf
出钱	uevf
出错	uevh
出资	uevr
出众	uevv
出线	uewf
出纳	uewn
心理学	uewn
出炉	uexd
出卖	uexj
出发	ueya
出奇	ueyt
出发点	ueyy
酝酿	ufud
酸辣	ugdx
心目中	ugoi
比利时	uhbx
出租车	uhci
霸主	uhde
霸王	uhei
出其不意	uhjd
霸权	uhma
心花怒放	uhrd
毕恭毕敬	uhuh
心甘情愿	uhyj
霸占	uhyo
比照	uibd
心里	uibl
比较	uicd
心意	uidb
心头	uidd
心肝	uidf
比方	uidh
心脏	uidj
雨衣	uidk
比肩	uidp
心胸	uids
比率	uidw
心肠	uidz
心理	uieb
心灵	uiex
心动	uifg
曲折	uifj
比拟	uifl
比拼	uifv
曲目	uigi
比利时	uihb
雨季	uihz
曲调	uiin
心疼	uija
心底	uijc
心痛	uijd
心愿	uijg
心爱	uijn
曲阜	uijp
心血	uijq
心病	uijt
比重	uijt
心声	uild
心境	uild
比起	uill
心坎	uilr
心想	uimg
心机	uimw
比赛	uinf
心中	uioi
心跳	uiol
比喻	uiov
心思	uiqu
曲解	uird
比如	uiro
心得	uisb
雨水	uisi
心事	uito
比例	uitt
雨露	uiuo
比分	uivd
雨伞	uivv
曲线	uiwf
心绪	uiwy
出谋划策	uixk
心态	uiyd
心情	uiyl
必备	ujaq
比翼双飞	ujaz
必要	ujcr
需要	ujcr
必然	ujdy
雨后春笋	ujek
震动	ujfg
震撼	ujfj
酷热	ujfx
震荡	ujhs
必读	ujix
酷爱	ujjn
出神入化	ujjt
必将	ujkd
必定	ujnt
必究	ujnv
必须	ujsj
心血来潮	ujts
必需	ujuj
雷厉风行	ujws
毕加索	ujxn
需求	ujxx
震惊	ujyd
震慑	ujyp
出版物	ukjf
出版社	ukjy
雪上加霜	ulju
心安理得	unes
出口成章	uojd
心路历程	uojh
露面	uojq
露骨	uoqd
露天	uoty
露出	uoue
雪中送炭	uove
霹雳	upuj
震耳欲聋	upvx
雷电	uqbl
出其不意	uqjd
雷雨	uqui
雷霆	uquj
雷锋	uqva
雷达	uqyz
出尔反尔	urjr
心急如焚	urrm
出水芙蓉	ushh
酌情	usyl
心平气和	utkh
心心相印	uume
比比皆是	uuub
零星	uvbj
零碎	uvcd
典雅	uvci
典范	uvhs
零度	uvjh
零乱	uvjx
典礼	uvjy
典籍	uvke
典型	uvth
零售	uvti
零件	uvtk
零食	uvvd
典故	uvxo
零点	uvyo
毕竟	uxdb
心烦意乱	uxdj
心猿意马	uxds
出类拔萃	uxfh
心有余悸	uxvy
毕业	uxwt
皆大欢喜	uyal
心悦诚服	uyid
酬谢	uyir
出奇制胜	uykd
心惊肉跳	uyno
酬金	uyvi
出发点	uyyo
配备	uzaq
配电	uzbl
配方	uzdh
配股	uzdw
配制	uzkn
配额	uzna
配置	uzqx
配偶	uztb
配件	uztk
配合	uzvt
配套	uzyk
公务员	vaob
针对性	vayj
单车	vbci
单亲	vbdm
单据	vbfp
单击	vbfu
单元	vbfw
单词	vbij
单项	vbij
单调	vbin
单向	vbjn
贪赃枉法	vbms
单机	vbmw
单间	vbnb
单字	vbnz
单色	vbrd
单身	vbri
单位	vbtd
单列	vbtd
单一	vbti
单价	vbtv
单个	vbvi
单纯	vbwt
单独	vbxj
链条	vcam
创意	vcdb
创立	vcdi
创新	vcdm
前车之鉴	vcdn
创建	vcef
链接	vcfd
创刊	vcfn
仓皇	vcge
创利	vchn
仓库	vcjc
创造	vcjl
创办	vcjv
创造性	vcjy
创收	vcli
创见	vcnw
创始	vcrg
创汇	vcsc
仓储	vcti
创作	vctl
创伤	vctl
仓促	vcto
创下	vcty
创业	vcwt
创举	vcwv
分明	vdbd
前景	vdbd
剪影	vdbd
贫贱	vdbf
前日	vdbi
分贝	vdbi
钥匙	vdbt
分量	vdbt
分时	vdbx
剪贴	vdby
剪辑	vdco
分区	vdcx
镜头	vddd
前端	vdde
前方	vddh
剪刀	vddi
前夕	vddi
分立	vddi
分为	vddj
分享	vddo
分部	vddo
分辨率	vddw
分辨	vddx
分离	vddx
镶嵌	vdeh
前奏	vdev
前提	vdfb
分担	vdfb
前进	vdfn
分批	vdfu
前台	vdgo
前瞻	vdgr
分散	vdhd
前茅	vdhd
前科	vdhd
分期	vdhe
分秒	vdhm
前程	vdho
分工	vdii
前言	vdii
普通话	vdij
食谱	vdiv
铭记	vdiz
分页	vdjb
贫乏	vdjd
食物	vdjf
分手	vdjf
分成	vdjj
前后	vdjj
剪彩	vdjm
前面	vdjq
贫血	vdjq
颁奖	vdkd
分管	vdkn
盆地	vdlc
前去	vdlg
分歧	vdlx
食盐	vdly
分校	vdmd
分析	vdmj
羊肠小道	vdmv
前辈	vdne
贫寒	vdnf
分割	vdnf
食用	vdnf
前门	vdni
贫富	vdnt
食宿	vdnt
贫穷	vdnv
分别	vdoj
食品	vdoo
分局	vdpj
分院	vdpn
贫民	vdpt
前卫	vdpt
分隔	vdpt
铲除	vdpv
分居	vdpx
贫困	vdqm
分期	vdqv
前期	vdqv
分界	vdqv
分解	vdrd
前身	vdri
分娩	vdrr
前往	vdsd
分流	vdsd
前行	vdsf
分行	vdsf
分泌	vdsu
前沿	vdsw
分裂	vdtd
前列	vdtd
全方位	vdtd
分开	vdth
前任	vdtj
镜像	vdtr
分化	vdtt
前来	vdtx
前天	vdty
分配	vduz
前锋	vdva
分会	vdvf
前人	vdvi
分钟	vdvo
禽兽	vdvq
前途	vdvt
凛冽	vdvt
食欲	vdvv
前兆	vdvw
分销	vdvw
前缀	vdwa
剪纸	vdwc
前线	vdwf
分红	vdwi
食堂	vdwn
分组	vdwq
凉风	vdwx
分支	vdxa
分寸	vdxd
分布	vdxn
颁布	vdxn
分数	vdxr
分类	vdxy
颁发	vdya
前者	vdyb
凉爽	vdyx
分子	vdzi
镜子	vdzi
美观	vean
兼备	veaq
美景	vebd
全景	vebd
全区	vecx
盖章	vedb
歉意	vedb
养育	vedg
金玉良言	vedi
美眉	vedj
全新	vedm
全市	vedn
全部	vedo
美名	vedo
全文	vedx
全然	vedy
全球	veex
养护	vefd
美元	vefw
银元	vefw
全能	vegd
美的	vegs
羡慕	vehb
银幕	vehb
全程	veho
全世界	vehq
全称	vehr
美工	veii
凑巧	veit
兼顾	vejc
敝帚自珍	veje
美貌	vejg
全貌	vejg
全力	veji
养成	vejj
全书	vejj
养生	vejl
键入	vejn
全面	vejq
歉疚	vejr
养病	vejt
美感	vejt
银牌	vekg
全长	veki
全年	velc
全境	veld
全场	velz
全权	vema
美术	vemd
全校	vemd
银川	vemi
全省	vemj
美梦	vemm
全军	venc
美军	venc
键盘	vens
全盘	vens
兼容	venv
美容	venv
全家	venx
美味	veof
全局	vepj
兼职	vepo
全职	vepo
全民	vept
全屏	vepv
美国	veqe
全国	veqe
全县	veqf
银色	verd
美女	veri
全身	veri
美妙	verm
美好	verz
银行	vesf
美满	vesh
银河	vest
美酒	vesu
金玉满堂	vesw
美德	vesx
美洲	vesy
养殖	vetd
全集	veti
兼任	vetj
全体	vetm
美体	vetm
半导体	vetm
美丽	vetn
全速	veto
美化	vett
全天	vety
全心	veui
美食	vevd
全会	vevf
兼并	vevh
美人	vevi
人山人海	vevs
凑合	vevt
全线	vewf
全党	vewn
美学	vewn
美誉	vewv
金碧辉煌	vewx
兼有	vexd
全都	veyb
全套	veyk
养老	veyt
兰州	veyy
银子	vezi
坐井观天	vfat
舒畅	vfbi
会晤	vfbw
钱财	vfbx
会意	vfdb
善意	vfdb
善良	vfde
舒服	vfdp
差异	vfeh
善于	vffi
着眼	vfge
会议	vfid
会话	vfij
会诊	vfiv
会谈	vfix
会计	vfix
差不多	vfjd
着手	vfjf
着力	vfji
善后	vfjj
会后	vfjj
铸造	vfjl
会面	vfjq
舍不得	vfjs
着重	vfjt
舒适	vfjx
会长	vfki
着装	vfkl
舒坦	vflb
会上	vfli
羊城	vflj
会场	vflz
着想	vfmg
差额	vfna
着实	vfnd
会同	vfnt
羊肉	vfnv
会见	vfnw
会员	vfob
总动员	vfob
差别	vfoj
差距	vfol
着陆	vfpf
着急	vfre
剑拔弩张	vfrz
钱包	vfse
差价	vftv
前提下	vfty
差错	vfvh
总投资	vfvr
会合	vfvt
会有	vfxd
会在	vfxi
羞愧	vfyg
差点	vfyo
会战	vfyo
会考	vfys
公务	vgaj
公里	vgbl
公车	vgci
公章	vgdb
公主	vgde
公交	vgdv
公文	vgdx
公然	vgdy
公理	vgeb
公示	vgfm
公报	vgfp
公元	vgfw
公投	vgfw
颂扬	vgfz
众目睽睽	vggg
公允	vggw
公共	vghv
公证	vgit
公认	vgiv
公物	vgjf
公了	vgji
公斤	vgjj
公历	vgjj
公斤	vgjk
公告	vgjl
公司	vgjt
公办	vgjv
公敌	vgjx
公社	vgjy
公款	vglf
公寓	vgnb
公安部	vgnd
公用	vgnf
公害	vgnf
公安局	vgnp
公安	vgnr
公家	vgnx
公路	vgol
公职	vgpo
公民	vgpt
公园	vgqf
公德	vgsx
公开	vgth
公式	vgti
公顷	vgtl
公正	vgtl
公债	vgtl
公休	vgtm
公平	vgtv
公仆	vgty
公分	vgvd
冶金	vgvi
公道	vgvj
公众	vgvv
公益	vgvv
公关	vgvy
公决	vgvz
锦绣	vgwh
公约	vgws
公布	vgxn
冶炼	vgxt
公愤	vgyx
公子	vgzi
公费	vgzs
并购	vhbs
并由	vhdi
并立	vhdi
并为	vhdj
并肩	vhdp
并非	vhen
并把	vhfd
并于	vhfi
并无	vhfl
并未	vhfm
并进	vhfn
并能	vhgd
错误	vhio
并不是	vhjb
并入	vhjn
并重	vhjt
并不	vhjy
并将	vhkd
并非	vhne
并用	vhnf
含英咀华	vhot
并且	vhqf
并行	vhsf
并列	vhtd
并可	vhto
分秒必争	vhur
锋芒毕露	vhuu
公积金	vhvi
冷若冰霜	vhvu
错觉	vhwn
并举	vhwv
错过	vhxd
并有	vhxd
并存	vhxi
并发	vhya
迸发	vhya
瓶颈	vhzi
人头	vidd
八月	vidi
人为	vidj
人名	vido
个股	vidw
人文	vidx
金山	viei
人群	viej
人参	vigy
人世	vihl
人称	vihr
金秋	vihx
人工	viii
金库	vijc
人物	vijf
人手	vijf
人力	viji
八成	vijj
人质	vijj
人生	vijl
人造	vijl
人选	vijl
金奖	vikd
金牌	vikg
人气	vikz
人士	vili
八卦	vill
人均	vils
人权	vima
金桥	vimj
金额	vina
人间	vinb
金门	vini
个案	vinr
人家	vinx
金刚	vinx
人员	viob
个唱	viob
人口	vioi
个别	vioj
人品	vioo
前功尽弃	vipd
人际	vipf
金属	vipj
金陵	vipl
人民	vipt
金色	vird
铁证如山	vire
人身	viri
人流	visd
人马	vist
八一	viti
个体	vitm
人体	vitm
人们	vitn
金融	vito
人事	vito
金华	vitt
金曲	viui
人心	viui
金银	vive
金钱	vivf
个人	vivi
个个	vivi
人道	vivj
人次	vivr
人命	vivt
众说纷纭	viww
八十	vixi
人才	vixj
人数	vixr
个数	vixr
人类	vixy
人大	viyi
个性	viyj
人性	viyj
人情	viyl
金子	vizi
个子	vizi
今日	vjbi
首映	vjbn
今晚	vjbr
含量	vjbt
并不是	vjbt
首要	vjcr
减轻	vjcz
减肥	vjdd
念头	vjdd
首脑	vjdd
差不多	vjdd
减产	vjdj
美不胜收	vjdl
贪恋	vjdm
并驾齐驱	vjds
今夜	vjdt
含义	vjdx
道理	vjeb
道貌岸然	vjed
八面玲珑	vjee
减退	vjek
领导人	vjev
领导	vjex
全自动	vjfg
减损	vjfo
首批	vjfu
前所未有	vjfx
总面积	vjho
总而言之	vjid
道谢	vjir
总书记	vjiz
首页	vjjb
首席	vjjh
今后	vjjj
邻近	vjjj
邻近	vjjk
领袖	vjjk
领先	vjjl
首先	vjjl
首选	vjjl
今生	vjjl
铩羽而归	vjjn
首府	vjjt
锲而不舍	vjjv
首长	vjki
今年	vjlc
领地	vjlc
首肯	vjld
领土	vjli
道士	vjli
全力以赴	vjll
领域	vjlt
首场	vjlz
首相	vjmg
减小	vjmi
减少	vjmj
贪婪	vjmm
众所周知	vjnl
贪官	vjnp
首富	vjnt
减灾	vjnx
首家	vjnx
道路	vjol
领取	vjpa
首届	vjpd
领队	vjpv
邻居	vjpx
领略	vjqa
邻国	vjqe
道具	vjqe
全神贯注	vjqs
减负	vjrb
首饰	vjrl
减免	vjro
舍不得	vjsb
贪污	vjsf
减法	vjsl
领衔	vjsv
道德	vjsx
首倡	vjtb
减低	vjtc
首位	vjtd
领到	vjtg
首任	vjtj
人不可貌相	vjtm
减速	vjto
领事	vjto
首例	vjtt
减价	vjtv
锐不可当	vjtw
今天	vjty
首创	vjvc
道歉	vjve
领会	vjvf
全社会	vjvf
令人	vjvi
首次	vjvr
人面兽心	vjvu
减缓	vjwj
含有	vjxd
舍近求远	vjxf
锻炼	vjxt
含糊	vjxx
首发	vjya
减慢	vjyb
首都	vjyb
贪生怕死	vjyt
领悟	vjyw
减弱	vjzs
铁岭	vkev
铁证	vkit
铁路	vkol
铁饭碗	vkrc
铁道	vkvj
凌晨	vlbj
销声匿迹	vlcd
众矢之的	vldg
人声鼎沸	vlgs
企盼	vlgv
企鹅	vljf
凌驾	vljo
卷土重来	vljt
前赴后继	vljw
企管	vlkn
企图	vlqa
锦上添花	vlsh
兼收并蓄	vlvh
企业	vlwt
企划	vlxn
企求	vlxx
钞票	vmcf
单枪匹马	vmcs
银川市	vmdn
锦标赛	vmnf
铁树开花	vmth
舍本逐末	vmxt
介意	vndb
弊端	vnde
公安部	vndo
钢琴	vnee
今非昔比	vnhu
凋谢	vnir
从容不迫	vnjg
镇定自若	vnjh
介质	vnjj
介入	vnjn
弊病	vnjt
钢笔	vnkj
钢材	vnmx
公安局	vnpj
凋零	vnuv
钢铁	vnvk
铿锵	vnvk
介绍	vnwd
兼容性	vnyj
总则	vobn
总是	vobt
总量	vobt
冲破	vocj
总部	vodo
总站	vody
总之	vodz
总理	voeb
兑现	voen
冲印	voep
冲动	vofg
冷嘲热讽	vofi
兑换	vofr
冲击	vofu
总能	vogd
总和	voho
总称	vohr
总共	vohv
总攻	voia
总论	voiv
总计	voix
总书记	voji
总厂	voji
总算	vokg
总裁	vold
钟表	volk
总督	volm
总机	vomw
总额	vona
总监	vonk
冲突	vonv
总局	vopj
冲刷	vopn
总队	vopv
况且	voqf
总署	voqy
总汇	vosc
冲浪	vosd
冲洗	vosj
总体	votm
冲刺	votn
总值	votx
冲出	voue
冲锋	vova
总分	vovd
总会	vovf
道听途说	vovi
总公司	vovj
总统	vowd
总编	vowd
总经理	vowe
总线	vowf
总结	vowl
锅炉	voxd
总有	voxd
总数	voxr
钟情	voyl
人民币	vpjn
人民币	vptj
兽医	vqcl
金蝉脱壳	vqdl
善罢甘休	vqht
前因后果	vqjb
曾经	vqwz
曾有	vqxd
曾在	vqxi
全国性	vqyj
次日	vrbi
盗贼	vrbt
瓷砖	vrcf
次要	vrcr
资产	vrdj
姿势	vrfx
净利	vrhn
咨询	vris
资讯	vriz
次序	vrjd
资质	vrjj
资历	vrjj
盗版	vrkj
净土	vrli
净增	vrlv
资格	vrma
资本	vrmt
盗用	vrnf
盗窃	vrnv
资助	vrqf
资源	vrsj
资深	vrsn
净化	vrtt
钦佩	vrtw
资金	vrvi
善始善终	vrvw
资料	vrxd
次数	vrxr
姿态	vryd
资费	vrzs
冰山	vsei
冰清玉洁	vses
贪得无厌	vsfj
冰岛	vsge
禽流感	vsjt
并行不悖	vsjy
冰箱	vskm
冰川	vsmi
合法权益	vsmv
含沙射影	vsrb
钓鱼	vsrt
逆水行舟	vssn
冰雪	vsue
冰霜	vsum
冰雹	vsus
冰冻	vsvt
冰冷	vsvv
并没有	vsxd
准备	vtaq
合影	vtbd
准则	vtbn
销售量	vtbt
命题	vtbt
准时	vtbx
准确	vtcr
合肥	vtdd
命脉	vtdd
前列腺	vtdg
凝望	vtdl
命名	vtdo
准予	vtdt
合理	vteb
总代理	vteb
合群	vtej
命运	vtfg
合拍	vtfg
铺垫	vtfx
逾期	vthe
准许	vtil
铺设	vtiw
合计	vtix
前倨后恭	vtjh
合力	vtji
合成	vtjj
准入	vtjn
愈加	vtjo
合乎	vtjv
合适	vtjx
合算	vtkg
余地	vtlc
余年	vtlc
合格	vtma
叙述	vtmd
余额	vtna
销售额	vtna
合同	vtnt
合唱	vtob
途中	vtoi
命中	vtoi
凝聚	vtpa
逾期	vtqv
凝固	vtqx
凄婉	vtrn
人仰马翻	vtsj
合法	vtsl
途径	vtsz
拿到	vttg
铺开	vtth
合一	vtti
合作	vttl
铺平	vttv
拿来	vttx
合伙	vttx
拿下	vtty
拿出	vtue
冰天雪地	vtul
凄凉	vtvd
合并	vtvh
合金	vtvi
命令	vtvj
铺天盖地	vtvl
合资	vtvr
半信半疑	vtvt
冻结	vtwl
凝结	vtwl
合约	vtws
企事业	vtwt
途经	vtwz
凄惨	vtyg
钉子	vtzi
遵照	vubd
逆转	vucf
塑胶	vudd
遵义	vudx
奠基	vuhe
尊敬	vuhs
塑造	vujl
尊重	vujt
逆境	vuld
奠定	vunt
遵守	vunx
奠基	vuqv
逆流	vusd
遵循	vusj
尊严	vutw
遵命	vuvt
遵从	vuvv
塑料	vuxd
养尊处优	vvat
益处	vvay
冷暖	vvbj
冷遇	vvbn
从轻	vvcz
众叛亲离	vvdd
众多	vvdd
从头	vvdd
耸立	vvdi
欲望	vvdl
怂恿	vvdn
从未	vvfm
分道扬镳	vvfv
冷热	vvfx
冷藏	vvhk
锐利	vvhn
冷落	vvhs
坐落	vvhs
念念不忘	vvjd
半途而废	vvjj
丛书	vvjj
从而	vvjn
总公司	vvjt
从不	vvjy
冷笑	vvkj
坐失	vvkv
锐气	vvkz
冷静	vvld
铃声	vvld
冷却	vvlg
从此	vvlt
益智	vvly
坐标	vvmf
从小	vvmi
丛林	vvmm
从军	vvnc
从实	vvnd
半决赛	vvnf
冷门	vvni
从容	vvnv
关键字	vvnz
从中	vvoi
从属	vvpj
冷饮	vvrl
从善如流	vvrs
冷漠	vvsh
冷水	vvsi
冷清	vvsl
冷淡	vvsx
坐下	vvtd
从政	vvtl
从事	vvto
从来	vvtx
从优	vvtx
坐下	vvty
从前	vvvd
众人	vvvi
铝合金	vvvi
从今	vvvj
冷冻	vvvt
从业	vvwt
冷风	vvwx
坐在	vvxi
冷战	vvyo
销量	vwbt
普通话	vwdi
逃亡	vwdl
普通	vwdn
普遍	vwdp
逃脱	vwdv
逃离	vwdx
总经理	vweb
销毁	vwgi
慈爱	vwjn
慈祥	vwjy
普及	vwjz
铅笔	vwkj
错综复杂	vwlx
普查	vwmb
锁定	vwnt
企业家	vwnx
逃跑	vwol
销路	vwol
逃避	vwpo
首当其冲	vwqv
锦绣河山	vwse
普法	vwsl
曾几何时	vwtb
销售	vwti
慈善	vwvf
针对	vxax
判处	vxay
半月	vxdi
父亲	vxdm
叛变	vxdm
半夜	vxdt
半导体	vxet
半岛	vxge
全过程	vxho
资料库	vxjc
镇压	vxjl
叛乱	vxjx
半边	vxjz
半年	vxlc
镇静	vxld
父辈	vxne
镇定	vxnt
判定	vxnt
判别	vxoj
半路	vxol
判罪	vxqn
父母	vxqs
针灸	vxrd
镇江	vxsi
叛徒	vxsl
人才济济	vxss
半径	vxsz
判刑	vxth
半价	vxtv
半天	vxty
爸爸	vxvx
爷爷	vxvx
判决	vxvz
针织	vxwo
判断	vxxl
半数	vxxr
父子	vxzi
关照	vybd
钻石	vyci
钻研	vyct
券商	vydn
送交	vydv
关于	vyfi
关押	vyfq
拳击	vyfu
关节	vyhp
关税	vyhv
关爱	vyjn
卷入	vyjn
郑重	vyjt
关系	vyjw
送礼	vyjy
关机	vymw
关门	vyni
关闭	vynx
关口	vyoi
送别	vyoj
关联	vypv
关注	vysd
关切	vytd
送到	vytg
送货	vytt
送出	vyue
关心	vyui
卷曲	vyui
人怕出名猪怕壮	vyuk
关键	vyve
送给	vywv
卷烟	vyxq
郑州市	vyyd
关怀	vyyj
郑州	vyyy
决斗	vzdd
决胜	vzdj
舍己为人	vzdv
递交	vzdv
递进	vzfn
决议	vzid
决计	vzix
刽子手	vzjf
决不	vzjy
决算	vzkg
决策	vzkt
递增	vzlv
决赛	vznf
决定	vznt
决口	vzoi
决裂	vztd
决心	vzui
弟弟	vzvz
决断	vzxl
鹈鹕	vzxo
决战	vzyo
弟子	vzzi
终日	wabi
终端	wade
终于	wafi
终生	wajl
终年	walc
终止	wali
终极	wamj
终审	wanb
终究	wanv
缝隙	wapm
终身	wari
络绎	wawa
凤凰	wawg
终结	wawl
终点	wayo
光明磊落	wbch
风景区	wbcx
绅士	wbli
纸币	wcjn
缥缈	wcwg
纸张	wczs
凡是	wdbt
编辑	wdco
编码	wdcs
五颜六色	wddr
统率	wddv
统率	wddw
编印	wdep
编导	wdex
编排	wdfe
编撰	wdfe
编排	wdfn
编程	wdho
统称	wdhr
编委	wdhr
编著	wdhy
编译	wdia
统计	wdix
逍遥	wdjl
缔造	wdjl
编造	wdjl
兴高采烈	wdjt
统筹	wdkf
编纂	wdkg
编制	wdkn
编审	wdnb
编写	wdns
编号	wdot
编剧	wdpx
统治	wdsg
统一	wdti
凡事	wdto
肖像	wdtr
凡例	wdtt
统配	wduz
削减	wdvj
统统	wdwd
红外线	wdwf
缔结	wdwl
纺织	wdwo
编织	wdwo
缔约	wdws
绍兴	wdwv
编者	wdyb
统战	wdyo
削弱	wdzs
当日	webi
当晚	webr
当时	webx
当月	wedi
当然	wedy
当即	weeg
当兵	wegv
绿茶	wehv
当成	wejj
当初	wejk
当选	wejl
当面	wejq
纪录片	weki
当地	welc
当年	welc
绿地	welc
绿卡	wely
当场	welz
当家	wenx
当中	weoi
当局	wepj
绿色	werd
绿洲	wesy
当作	wetl
绿化	wett
当代	wetv
当做	wetx
当天	wety
当下	wety
当心	weui
当前	wevd
当今	wevj
当红	wewi
线条	wfam
风云变幻	wfdw
线程	wfho
绑架	wfjo
线上	wfli
学无止境	wfll
线路	wfol
绝无仅有	wftx
线索	wfxn
线性	wfyj
缓兵之计	wgdi
缴获	wghx
绵延	wgjl
绵阳	wgpb
绵羊	wgvf
绵绵	wgwg
缴纳	wgwn
缴费	wgzs
举世瞩目	whgg
绿草如茵	whrh
组委会	whvf
五花八门	whvn
儿戏	wiax
五星	wibj
红星	wibj
儿童	widb
红旗	widh
五月	widi
几率	widw
五岳	wige
儿科	wihd
红利	wihn
几种	wiho
红茶	wihv
几百	wijb
五百	wijb
几乎	wijv
几千	wijx
五千	wijx
五笔	wikj
几年	wilc
红尘	wiml
红军	winc
五官	winp
统计局	wipj
五四	wiqi
红色	wird
五色	wird
儿女	wiri
几句	wiso
几何	witt
几天	wity
风调雨顺	wium
几分	wivd
几个	wivi
五金	wivi
几次	wivr
几经	wiwz
几十	wixi
五十	wixi
红火	wixi
几点	wiyo
儿子	wizi
几张	wizs
风度翩翩	wjdd
乡亲	wjdm
举不胜举	wjdw
纽带	wjhn
缓和	wjho
幼稚	wjht
学而不厌	wjjj
凤毛麟角	wjjr
幼年	wjlc
维生素	wjlw
幻想	wjmg
乡村	wjmx
级别	wjoj
缓解	wjrd
缅甸	wjsq
风靡一时	wjtb
缓刑	wjth
缓冲	wjvo
乡镇	wjvx
缩手缩脚	wjwd
缠绵	wjwg
幼儿	wjwi
缓缓	wjwj
幼儿园	wjwq
纽约	wjws
纤维	wjwt
五彩缤纷	wjww
缠绕	wjwx
缓存	wjxi
幻灯	wjxt
缓慢	wjyb
光彩夺目	wjyg
缅怀	wjyj
幼教	wjyz
结晶	wlbb
结盟	wlbd
结账	wlbk
结果	wlbm
缘由	wldi
结巴	wldl
结交	wldv
风起云涌	wlfs
纠葛	wlhb
纸上谈兵	wlig
结识	wlio
结论	wliv
结成	wljj
结算	wlkg
缘起	wlll
结核	wlmd
结构	wlms
结实	wlnd
结案	wlnr
结局	wlpj
结尾	wlpj
风声鹤唳	wlpo
结婚	wlrc
纠正	wltl
学以致用	wltn
结束	wlto
缘何	wltt
几年来	wltx
缘分	wlvd
纠错	wlvh
结合	wlvt
纠缠	wlwj
绘声绘色	wlwr
结业	wlwt
纠纷	wlwv
缘故	wlxo
纵横捭阖	wmfn
举棋不定	wmjn
绿林好汉	wmrs
纵横驰骋	wmss
缘木求鱼	wmxr
常务	wnaj
党务	wnaj
赏赐	wnbb
缩影	wnbd
学时	wnbx
纲要	wncr
党章	wndb
绽放	wndh
常熟	wndo
常理	wneb
党建	wnef
党群	wnej
尚无	wnfl
尚未	wnfm
掌控	wnfn
掌握	wnfp
常规	wnfv
兴师动众	wnfv
堂皇	wnge
党的	wngs
学科	wnhd
学期	wnhe
党委	wnhr
常委	wnhr
纳税	wnhv
综艺	wnhz
常识	wnio
赏识	wnio
尝试	wnit
学说	wniv
学习	wnji
学历	wnjj
学生	wnjl
纳入	wnjn
学籍	wnke
学制	wnkn
掌管	wnkn
学年	wnlc
常年	wnlc
掌声	wnld
学士	wnli
缩短	wnly
学校	wnmd
学术	wnmd
综述	wnmd
缩小	wnmi
赏析	wnmj
常用	wnnf
学问	wnno
绯闻	wnnp
缩写	wnns
党内	wnnv
常见	wnnw
觉察	wnnx
党员	wnob
党中央	wnon
党史	wnox
学院	wnpn
赏罚	wnqi
学期	wnqv
学好	wnrz
觉得	wnsb
缩水	wnsi
党派	wnsj
学徒	wnsl
学位	wntd
学到	wntg
敞开	wnth
常任	wntj
党政	wntl
堂倌	wntn
觉醒	wnub
学分	wnvd
学会	wnvf
常人	wnvi
纲领	wnvj
缩减	wnvj
综合	wnvt
常常	wnwn
学堂	wnwn
党组	wnwq
学业	wnwt
缤纷	wnwv
党风	wnwx
学友	wnxa
纳米	wnxi
学者	wnyb
党性	wnyj
觉悟	wnyw
学子	wnzi
学费	wnzs
举足轻重	wocj
削足适履	wojp
兴味盎然	wond
党中央	wony
绳索	woxn
凿壁偷光	wptw
细则	wqbn
细胞	wqds
细腻	wqdt
组建	wqef
细节	wqhp
细菌	wqhq
组成	wqjj
组长	wqki
细长	wqki
组装	wqkl
细小	wqmi
组图	wqqa
组团	wqqx
细微	wqse
细致	wqtg
组件	wqtk
细心	wqui
组合	wqvt
组织部	wqwd
组织	wqwo
细细	wqwq
绝对	wrax
绝望	wrdl
绝招	wrfd
绝不	wrjy
绝非	wrne
绝密	wrnu
绝妙	wrrm
绝缘	wrwl
五角大楼	wrym
风驰电掣	wsbk
约旦	wsbt
约为	wsdj
约定	wsnt
五湖四海	wsqs
绚丽	wstn
约束	wsto
风流倜傥	wstt
约会	wsvf
经济学	wswn
约翰	wsxb
约有	wsxd
约占	wsyo
业务	wtaj
业主	wtde
练就	wtdo
业已	wtei
维护	wtfd
维持	wtfl
纯利	wthn
维和	wtho
举一反三	wtje
夙愿	wtjg
练习	wtji
当仁不让	wtji
维权	wtma
纯朴	wtmy
业内	wtnv
纯属	wtpj
业界	wtqv
纯洁	wtsl
风平浪静	wtsl
纷至沓来	wtst
光天化日	wttb
风华正茂	wtth
维修	wtti
纯正	wttl
当事人	wtvi
纯净	wtvr
业余	wtvt
业绩	wtwl
纯粹	wtxd
纯真	wtxq
业者	wtyb
纯情	wtyl
风雨飘摇	wucf
风雨交加	wudj
风雨无阻	wufp
风雨同舟	wunn
风雨如晦	wurb
纰漏	wusp
纸醉金迷	wuvx
赏心悦目	wuyg
纵观	wvan
兴旺	wvbe
誉为	wvdj
兴衰	wvdo
给予	wvdt
纵然	wvdy
兴建	wvef
举动	wvfg
举措	wvfh
举报	wvfp
举世	wvhl
给我	wvjf
兴盛	wvjj
纵向	wvjn
举重	wvjt
举办	wvjv
兴办	wvjv
绘制	wvkn
举止	wvli
兴趣	wvll
兴起	wvll
举起	wvll
纵横	wvmh
纵览	wvnk
纪念品	wvoo
绘图	wvqa
给她	wvrc
纷争	wvre
纪念馆	wvrl
举行	wvsf
纵深	wvsn
给他	wvtc
风卷残云	wvtf
兴致	wvtg
绘画	wvtq
给你	wvtr
举例	wvtt
纵使	wvtt
给出	wvue
给养	wvve
纷纷	wvwv
风姿绰约	wvww
纵火	wvxi
纵情	wvyl
兴奋	wvyq
纷飞	wvzv
光明	wwbd
光景	wwbd
光照	wwbd
光电	wwbl
光碟	wwch
幽雅	wwci
丝毫	wwdo
光亮	wwdo
光环	wwej
幽灵	wwex
耀眼	wwge
光芒	wwhd
光荣	wwhn
光顾	wwjc
光彩	wwjm
络绎不绝	wwjw
幽静	wwld
光临	wwnk
光盘	wwns
纺织品	wwoo
光阴	wwpd
幼儿园	wwqf
幽默	wwqh
光泽	wwsa
光滑	wwsq
光驱	wwst
兴风作浪	wwts
堂堂正正	wwtt
光华	wwtt
风风雨雨	wwuu
幽会	wwvf
光线	wwwf
光纤	wwwj
光学	wwwn
光缆	wwwn
丝绸	wwwn
光辉	wwww
辉煌	wwxg
五光十色	wwxr
绰绰有余	wwxv
风风火火	wwxx
终结者	wwyb
光大	wwyi
风景	wxbd
风暴	wxbh
风韵	wxdb
风头	wxdd
风扇	wxdp
风云	wxfg
风范	wxhs
继承	wxje
风貌	wxjg
风度	wxjh
风力	wxji
风采	wxjm
风靡	wxjm
风向	wxjn
继而	wxjn
风筝	wxkr
风气	wxkz
风声	wxld
风趣	wxll
风格	wxma
风尘	wxml
缜密	wxnu
风味	wxof
风吹	wxor
风险	wxpv
风湿	wxsb
风流	wxsd
风行	wxsf
风水	wxsi
风波	wxsj
风沙	wxsm
风骚	wxst
风潮	wxsx
续集	wxti
继任	wxtj
风速	wxto
风俗	wxtv
风雪	wxue
风雨	wxui
风霜	wxum
风雷	wxuq
风铃	wxvv
风尚	wxwn
风光	wxww
继续	wxwx
纨绔	wxwy
绕过	wxxd
风情	wxyl
续费	wxzs
绪言	wyii
绰号	wyot
光怪陆离	wypd
举步维艰	wywa
绰约	wyws
缭绕	wywx
纪要	wzcr
经意	wzdb
经由	wzdi
经商	wzdn
经理	wzeb
纪录	wzes
纪元	wzfw
经贸	wzgd
经营	wzhn
经委	wzhr
纪委	wzhr
经历	wzjj
经书	wzjj
经受	wzjn
经办	wzjv
经管	wzkn
纪检	wzmv
纪实	wznd
经济	wzsd
纪律	wzse
经验	wzst
经典	wzuv
纪念	wzvj
经销	wzvw
经纬	wzwf
经常	wzwn
经纶	wzwv
经纪	wzwz
经过	wzxd
经费	wzzs
支票	xacf
翅膀	xadd
支部	xado
支离	xadx
烙印	xaep
支援	xafj
支持	xafl
有备无患	xafo
支撑	xafw
友谊	xain
有条不紊	xajd
友爱	xajn
支架	xajo
支应	xajw
支柱	xamd
支队	xapv
友好	xarz
支流	xasd
支付	xatx
支出	xaue
支配	xauz
友人	xavi
支线	xawf
支吾	xawo
友情	xayl
旭日	xbbi
斡旋	xbdh
朝夕	xbdi
焊接	xbfd
朝向	xbjn
朝气	xbkz
乾坤	xblb
乾隆	xbpa
朝阳	xbpb
韩国	xbqe
翰墨	xbqh
朝鲜	xbrt
爆满	xbsh
有时候	xbti
朝代	xbtv
朝着	xbvf
爆炸	xbxl
爆发	xbya
过日子	xbzi
火车站	xcdy
南辕北辙	xckc
过量	xdbt
有时候	xdbt
过时	xdbx
过早	xdbx
有时	xdbx
支离破碎	xdcc
过硬	xdct
有意	xddb
过多	xddd
有效期	xddh
有望	xddl
南京市	xddn
过高	xddo
有名	xddo
有效期	xddq
燃眉之急	xddr
有效	xddv
料理	xdeb
有理	xdeb
煽动	xdfg
过于	xdfi
有无	xdfl
过热	xdfx
有的	xdgs
过期	xdhe
有利于	xdhf
过世	xdhl
有利	xdhn
过程	xdho
有种	xdho
过节	xdhp
有功	xdij
有误	xdio
有序	xdjd
过度	xdjh
有力	xdji
有了	xdji
过了	xdji
有所	xdjj
有成	xdjj
过后	xdjj
过瘾	xdjp
有感	xdjt
有病	xdjt
过重	xdjt
过剩	xdjx
过奖	xdkd
南腔北调	xdki
过失	xdkv
燃气	xdkz
过年	xdlc
过去	xdlg
有趣	xdll
有喜	xdlo
过敏	xdlq
有毒	xdlq
有些	xdlt
有志	xdlu
有幸	xdly
有权	xdma
料想	xdmg
有机	xdmw
过客	xdna
有用	xdnf
有害	xdnf
过问	xdno
郁闷	xdnu
有空	xdnv
有别	xdoj
断章取义	xdpd
有限	xdpe
有助于	xdqf
有助	xdqf
有罪	xdqn
过期	xdqv
有效期	xdqv
有色	xdrd
有如	xdro
过得	xdsb
过往	xdsd
燃油	xdsd
粮油	xdsd
过激	xdsg
过渡	xdsj
有待	xdsl
有没有	xdsx
过滤	xdsy
过低	xdtc
焕然一新	xdtd
有可能	xdtg
料到	xdtg
有形	xdth
有事	xdto
有何	xdtt
有偿	xdtw
过来	xdtx
有心	xdui
过分	xdvd
粮食	xdvd
有着	xdvf
有钱	xdvf
过错	xdvh
有个	xdvi
有人	xdvi
过人	xdvi
有余	xdvt
有益	xdvv
有关	xdvy
过关	xdvy
有线	xdwf
有缘	xdwl
炫耀	xdww
燃料	xdxd
有过	xdxd
过火	xdxi
有数	xdxr
燃烧	xdxx
过大	xdyi
有情	xdyl
有点	xdyo
勃然大怒	xdyr
粒子	xdzi
故弄玄虚	xedy
朝三暮四	xehq
登峰造极	xejm
灿烂	xexv
十二月	xfdi
十二月	xfdo
烘云托月	xffd
颠扑不破	xfjc
数据库	xfjc
博物馆	xfjr
祭祀	xfjy
博士	xfli
有的放矢	xgdl
雄辩	xgdx
过眼云烟	xgfx
有目共睹	xghg
雄厚	xgjb
雄壮	xgkl
雄伟	xgtf
雄心	xgui
雄风	xgwx
煤矿	xhcj
煤炭	xhex
有利于	xhfi
煤气	xhkz
粪便	xhtt
火星	xibj
存贮	xibn
存量	xibt
火车	xici
在意	xidb
存放	xidh
九月	xidi
十月	xidi
存亡	xidl
十六	xidv
在外	xidy
在理	xieb
在即	xieg
火山	xiei
十三	xiei
十二	xifi
在于	xifi
存折	xifj
火热	xifx
在世	xihl
火种	xiho
火花	xiht
左手	xijf
直言不讳	xiji
胡言乱语	xiji
火力	xiji
存入	xijn
在乎	xijv
在座	xijv
左边	xijz
火箭	xikv
十年	xilc
存款	xilf
在此	xilt
火柴	xilt
在场	xilz
存档	ximw
在内	xinv
火灾	xinx
在家	xinx
十字	xinz
十足	xiol
存取	xipa
在职	xipo
十四	xiqi
在其	xiqv
米饭	xirl
在行	xisf
九江	xisi
存活	xisj
左侧	xitb
在下	xitd
十万	xith
十一	xiti
存储	xiti
十佳	xitl
存储器	xito
火速	xito
存货	xitt
火化	xitt
在下	xity
九天	xity
十分	xivd
在前	xivd
米兰	xive
十八	xivi
十个	xivi
火锅	xivo
胡说八道	xivv
在编	xiwd
在线	xiwf
十五	xiwi
十几	xiwi
在业	xiwt
火爆	xixb
火炬	xixg
存在	xixi
九十	xixi
十九	xixi
左右	xixo
火焰	xixr
九龙	xixt
火烧	xixx
九州	xiyy
狂欢	xjar
糖果	xjbm
独立	xjdi
狂妄	xjdl
协商	xjdn
犹豫	xjdt
狭义	xjdx
数不胜数	xjdx
烦琐	xjew
才干	xjfi
狠抓	xjfj
狙击	xjfu
犯规	xjfv
狂热	xjfx
才能	xjgd
独白	xjgi
协和	xjho
协议	xjid
狡诈	xjil
协调	xjin
精疲力竭	xjjd
独特	xjjf
独自	xjjg
协力	xjji
獬豸	xjji
协办	xjjv
才气	xjkz
独裁	xjld
猛增	xjlv
才智	xjly
猜想	xjmg
狭小	xjmi
协定	xjnt
协同	xjnt
烦闷	xjnu
狭窄	xjnv
猪肉	xjnv
独家	xjnx
烦躁	xjol
狭隘	xjpv
犯罪	xjqe
协助	xjqf
犯罪	xjqn
猪圈	xjqv
博物馆	xjrl
犹如	xjro
猜测	xjsb
卖淫	xjsj
犯法	xjsl
逛街	xjsl
猛烈	xjtd
朝不保夕	xjtd
独到	xjtg
协作	xjtl
猜疑	xjtl
才华	xjtt
熄灭	xjtx
独创	xjvc
协会	xjvf
才会	xjvf
烦人	xjvi
猎人	xjvi
独资	xjvr
卖给	xjwv
狂风	xjwx
才有	xjxd
独有	xjxd
左顾右盼	xjxg
狠狠	xjxj
狐狸	xjxj
狡猾	xjxj
狼狈	xjxj
猖獗	xjxj
烦恼	xjyd
犹太	xjyd
卖点	xjyo
独占	xjyo
猴子	xjzi
狮子	xjzi
有气无力	xkfj
九牛二虎之力	xkfj
朝气蓬勃	xkhx
粗制滥造	xksj
九牛一毛	xktj
精明	xlbd
精确	xlcr
精良	xlde
尤为	xldj
精通	xldn
断然	xldy
断肠	xldz
精灵	xlex
精干	xlfi
炸毁	xlgi
精兵	xlgv
尤其	xlhe
精英	xlhn
炸药	xlhw
断言	xlii
精诚	xlij
精巧	xlit
精度	xljh
精力	xlji
精选	xljl
博士生	xljl
精彩	xljm
直截了当	xljw
精神	xljy
精装	xlkl
精简	xlkn
精制	xlkn
断定	xlnt
精密	xlnu
精品	xloo
断层	xlpf
精辟	xlpo
精髓	xlqd
尤其	xlqv
精深	xlsn
精湛	xlsq
断裂	xltd
精致	xltg
精华	xltt
精心	xlui
精美	xlve
精准	xlvt
精锐	xlvv
断送	xlvy
断线	xlwf
精细	xlwq
断绝	xlwr
精练	xlwt
尴尬	xlxl
真知灼见	xlxn
精炼	xlxt
断点	xlyo
炸弹	xlzs
刹车	xmci
杂交	xmdv
炒股	xmdw
杂文	xmdx
杂技	xmfx
杀菌	xmhq
杂谈	xmix
杀手	xmjf
刹那	xmjf
杀戮	xmjj
杂乱	xmjx
杀毒	xmlq
杂志	xmlu
杀害	xmnf
杂沓	xmsb
刹住	xmtd
杀死	xmtd
有机可乘	xmtj
炒作	xmtl
杀伤	xmtl
火树银花	xmvh
杀人	xmvi
粗枝大叶	xmyo
南昌	xnbb
布景	xnbd
索赔	xnbd
索要	xncr
南京市	xndd
南方	xndh
南京	xndo
南部	xndo
博览群书	xnej
丈夫	xnfv
划拨	xnfy
献计	xnix
南瓜	xnjj
布告	xnjl
献血	xnjq
献礼	xnjy
南北	xnkt
献策	xnkt
献上	xnli
南极	xnmj
南非	xnne
南宁	xnnt
划定	xnnt
索取	xnpa
南阳	xnpb
布局	xnpj
索尼	xnpt
南国	xnqe
布置	xnqx
熔解	xnrd
献身	xnri
南海	xnsl
九寨沟	xnss
南洋	xnsv
南开	xnth
熔化	xntt
南亚	xntw
南下	xnty
布雷	xnuq
划分	xnvd
南美	xnve
布线	xnwf
献给	xnwv
南风	xnwx
求同存异	xnxe
勃勃	xnxn
博闻强记	xnzi
索引	xnzs
故意	xodb
古巴	xodl
古迹	xodm
克服	xodp
古文	xodx
精忠报国	xofq
有口无心	xofu
炽热	xofx
古董	xohj
胡说	xoiv
右手	xojf
故而	xojn
右边	xojz
古籍	xoke
古装	xokl
克制	xokn
故土	xoli
古城	xolj
故宫	xono
胡同	xont
克隆	xopa
故障	xopd
故居	xopx
辜负	xorb
右侧	xotb
故事	xoto
古代	xotv
胡来	xotx
古典	xouv
右键	xove
古人	xovi
古今	xovj
古镇	xovx
故乡	xowj
古怪	xoya
古老	xoyt
胡子	xozi
糖尿病	xpjt
精卫填海	xpls
有限公司	xpvj
狗尾续貂	xpwj
直观	xqan
粗暴	xqbh
真是	xqbt
直辖	xqcn
颠覆	xqcs
真意	xqdb
矗立	xqdi
直通	xqdn
直率	xqdv
直率	xqdw
真理	xqeb
直接	xqfd
有助于	xqfi
直播	xqfj
直指	xqft
直击	xqfu
直拨	xqfy
直白	xqgi
烟台	xqgo
真的	xqgs
烟草	xqhb
朝思暮想	xqhm
烟花	xqht
真诚	xqij
胡思乱想	xqjm
真爱	xqjn
直面	xqjq
颠簸	xqkh
粗壮	xqkl
颠簸	xqkq
真相	xqmg
真实	xqnd
真空	xqnv
直属	xqpj
粗略	xqqa
烟具	xqqe
直角	xqri
粗鲁	xqrt
真好	xqrz
直流	xqsd
颠沛	xqst
直径	xqsz
真切	xqtd
真伪	xqtd
直到	xqtg
真正	xqtl
真假	xqtp
颠倒	xqtt
粗俗	xqtv
烟雾	xqua
粗心	xqui
真心	xqui
直销	xqvw
直线	xqwf
直觉	xqwn
粗细	xqwq
卖国求荣	xqxh
粗糙	xqxj
粗犷	xqxj
左思右想	xqxm
真情	xqyl
直奔	xqyx
直爽	xqyx
直达	xqyz
数量	xrbt
粉身碎骨	xrcq
数码	xrcs
数据库	xrfj
数控	xrfn
数据	xrfp
数目	xrgi
数百	xrjb
数千	xrjx
数额	xrna
数字	xrnz
狗急跳墙	xrol
数位	xrtd
数万	xrth
数值	xrtx
数学	xrwn
数十	xrxi
焕发	xrya
龙争虎斗	xryd
炮轰	xsca
烟消云散	xsfh
炮制	xskn
颠沛流离	xssd
有没有	xsxd
龙马精神	xsxj
龙潭虎穴	xsyn
炮弹	xszs
颠倒是非	xtbe
颠倒是非	xtbn
独到之处	xtda
龙头	xtdd
博弈	xtdm
十一月	xtdo
登山	xtei
登录	xtes
袭击	xtfu
有可能	xtgd
登台	xtgo
登记	xtiz
博彩	xtjm
博爱	xtjn
博物馆	xtjr
灯笼	xtkx
登载	xtlc
博士	xtli
登上	xtli
登场	xtlz
才华横溢	xtms
博客	xtna
胡作非为	xtnd
真凭实据	xtnf
博览	xtnk
聋哑	xtot
登陆	xtpf
灯具	xtqe
料事如神	xtrj
灯饰	xtrl
灯泡	xtss
九死一生	xttj
登出	xtue
灯光	xtww
灯火	xtxi
垄断	xtxl
十万火急	xtxr
博大	xtyi
狐假虎威	xtyj
狼吞虎咽	xtyo
古典文学	xudw
九霄云外	xufd
真心诚意	xuid
凶手	xujf
糟蹋	xuol
凶器	xuoo
凶恶	xutw
独出心裁	xuul
狼心狗肺	xuxd
凶狠	xuxj
凶猛	xuxj
灰心丧气	xuxk
凶杀	xuxm
糟糕	xuxv
粉碎	xvcd
朝令夕改	xvdz
十拿九稳	xvjh
丧生	xvjl
丧失	xvkv
丧气	xvkz
求全责备	xvla
翘首以待	xvls
烂漫	xvsb
胡锦涛	xvsf
丧偶	xvtb
粉末	xvtm
丧事	xvto
粉红	xvwi
十拿九稳	xvxh
十全十美	xvxv
精益求精	xvxx
糕点	xvyo
狂风暴雨	xwbu
登堂入室	xwjn
灯红酒绿	xwsw
煽风点火	xwyx
求购	xxbs
求是	xxbt
求医	xxcl
希腊	xxdh
希望	xxdl
救亡	xxdl
狼狈为奸	xxdr
博古通今	xxdv
救护	xxfd
救援	xxfj
求援	xxfj
独断专行	xxfs
炎热	xxfx
烧毁	xxgi
炎黄	xxhd
郁郁葱葱	xxhh
求和	xxho
过犹不及	xxjj
求生	xxjl
求爱	xxjn
炎症	xxjt
求知	xxly
灰尘	xxml
郁郁寡欢	xxna
求实	xxnd
真才实学	xxnw
救灾	xxnx
求职	xxpo
救国	xxqe
求助	xxqf
救助	xxqf
盔甲	xxqi
灰色	xxrd
求得	xxsb
救济	xxsd
救治	xxsg
糊涂	xxsv
烧伤	xxtl
救命	xxvt
求学	xxwn
兢兢业业	xxww
支支吾吾	xxww
炯炯有神	xxxj
灰烬	xxxp
迷迷糊糊	xxxx
烧烤	xxxy
求教	xxyz
寸步难行	xyas
粘贴	xyby
粘膜	xydh
类推	xyft
独占鳌头	xyld
类别	xyoj
类型	xyth
类似	xytl
博大精深	xyxs
迷恋	xzdm
克己奉公	xzev
迷茫	xzhs
迷失	xzkv
逐年	xzlc
逐渐	xzsc
迷津	xzse
迷信	xzti
逐一	xzti
迷惑	xzto
迷你	xztr
迷雾	xzua
逐个	xzvi
迷人	xzvi
逐级	xzwj
龙飞凤舞	xzwl
迷糊	xzxx
逐步	xzyi
迷惘	xzyn
发明	yabd
发电	yabl
发财	yabx
发票	yacf
发音	yadb
发育	yadg
发放	yadh
发亮	yado
怪异	yaeh
发现	yaen
发抖	yafd
发动	yafg
发誓	yafj
发挥	yafn
发掘	yafp
发报	yafp
发热	yafx
发扬	yafz
发芽	yahc
发愁	yahx
发言	yaii
发言人	yaiv
怪物	yajf
发自	yajg
发力	yaji
发生	yajl
发病	yajt
发疯	yajw
发表	yalk
发起	yall
发紫	yalt
发帖	yani
发家	yanx
恪守	yanx
发展	yaph
慢条斯理	yaqe
发射	yarx
发行	yasf
发泄	yash
发源	yasj
发型	yath
发信	yati
发售	yati
发作	yatl
怪事	yato
发货	yatt
发出	yaue
发酵	yauy
发送	yavy
发觉	yawn
发给	yawv
发光	yaww
发火	yaxi
发布	yaxn
发烧	yaxx
发愤	yayx
发达	yayz
都是	ybbt
都要	ybcr
都市	ybdn
鹌鹑	ybdo
贞操	ybfo
都能	ybgd
卓著	ybhy
都说	ybiv
桌面	ybjq
都不	ybjy
都将	ybkd
桌上	ybli
都城	yblj
卓越	ybll
都督	yblm
桌椅	ybmy
都好	ybrz
慢速	ybto
都可	ybto
都来	ybtx
都会	ybvf
都有	ybxd
都在	ybxi
慢慢	ybyb
慢性	ybyj
惺忪	ybyv
桌子	ybzi
虐待	ycsl
惭愧	ycyg
忙碌	ydce
太多	yddd
太高	yddo
教育部	yddo
大多数	yddx
惊动	ydfg
忙于	ydfi
惊艳	ydfr
态势	ydfx
惊讶	ydic
惊诧	ydin
惊恐	ydiw
太原	ydjg
态度	ydjh
太后	ydjj
餐厅	ydjt
忙乱	ydjx
惊喜	ydlo
太小	ydmi
太少	ydmj
太极	ydmj
太空	ydnv
大刀阔斧	ydnv
惊叹	ydoa
大部分	ydov
太阳	ydpb
惊险	ydpv
餐具	ydqe
虎头蛇尾	ydqp
教育界	ydqv
恼怒	ydra
餐馆	ydrl
餐饮	ydrl
太好	ydrz
惊骇	ydst
太湖	ydsx
太平洋	ydts
大腹便便	ydtt
太平	ydtv
惊醒	ydub
惊雷	yduq
大部分	ydvd
大义凛然	ydvd
忙着	ydvf
惊人	ydvi
恼火	ydxi
大多数	ydxr
餐桌	ydyb
憧憬	ydyb
太太	ydyd
惊慌	ydyh
太大	ydyi
惊奇	ydyt
恍然大悟	ydyy
情投意合	yfdv
大势所趋	yfjl
夸赞	yfjl
夸奖	yfkd
大规模	yfmh
发动机	yfmw
奈何	yftt
大打出手	yfuj
大规模	yfvm
夸耀	yfww
夸大	yfyi
夸张	yfzs
惨白	yggi
惨痛	ygjd
愧疚	ygjr
惨重	ygjt
惨案	ygnr
惨淡	ygsx
惨遭	ygub
奇花异草	yheh
教科书	yhjj
慌乱	yhjx
懂得	yhsb
懂事	yhto
大获全胜	yhvd
慌忙	yhyd
大观	yian
大旱	yibf
大量	yibt
大连	yicz
大胆	yidb
大意	yidb
大多	yidd
大脑	yidd
大头	yidd
丫头	yidd
大腿	yide
大方	yidh
大为	yidj
大衣	yidk
大腕	yidn
大名	yido
大部	yido
大亨	yido
大户	yidp
大理	yieb
大王	yiei
大山	yiei
大把	yifd
大于	yifi
大专	yifs
大批	yifu
大夫	yifv
大势	yifx
大臣	yigi
步兵	yigv
大蒜	yihf
大功	yiij
大话	yiij
大计	yiix
大唐	yije
大力	yiji
大厦	yijj
大选	yijl
步入	yijn
大厅	yijt
大庆	yijy
大言不惭	yijy
大将	yikd
大肆	yike
大片	yiki
大笑	yikj
大气	yikz
大坝	yilb
大地	yilc
大年	yilc
大声	yild
大款	yilf
大赦	yilm
大增	yilv
大校	yimd
大概	yime
大小	yimi
大桥	yimj
步枪	yimv
大楼	yimx
大军	yinc
大赛	yinf
大幅	yini
大门	yini
大案	yinr
大盘	yins
大师	yint
大同	yint
大家	yinx
大字	yinz
大路	yiol
大叫	yiol
大陆	yipf
大局	yipj
大院	yipn
步履	yips
大队	yipv
大国	yiqe
大嫂	yirg
大象	yiro
大姐	yirq
大妈	yirs
大好	yirz
大汉	yisa
大梁	yisd
步行	yisf
老谋深算	yisk
大海	yisl
大街	yisl
大法	yisl
步骤	yist
大河	yist
大洋	yisv
大潮	yisx
大致	yitg
大型	yith
大作	yitl
大体	yitm
大事	yito
大豆	yito
大哥	yito
大使	yitt
步伐	yitx
大雪	yiue
大雨	yiui
大全	yive
大会	yivf
大人	yivi
大道	yivj
大众	yivv
大半	yivx
大爷	yivx
大红	yiwi
大学	yiwn
大纲	yiwn
大约	yiws
大举	yiwv
大风	yiwx
大有	yixd
大火	yixi
大米	yixi
大炮	yixs
大都	yiyb
大大	yiyi
大步	yiyi
步步	yiyi
大战	yiyo
性腺	yjdg
频率	yjdv
频率	yjdw
大自然	yjdy
怀抱	yjfs
性能	yjgd
大面积	yjho
怀旧	yjib
惦记	yjiz
性质	yjjj
情不自禁	yjjm
性爱	yjjn
奋不顾身	yjjr
性感	yjjt
性病	yjjt
大庭广众	yjjv
恬不知耻	yjlp
频繁	yjlq
性格	yjma
性别	yjoj
老百姓	yjrj
频传	yjtf
怀疑	yjtl
怀着	yjvf
怀念	yjvj
频道	yjvj
性命	yjvt
老生常谈	yjwi
惟我独尊	yjxv
懊丧	yjxv
懊恼	yjyd
慷慨	yjye
频频	yjyj
性情	yjyl
忏悔	yjyl
怀孕	yjzj
虎背熊腰	ykgd
套装	ykkl
老气横秋	ykmh
大奖赛	yknf
套餐	ykyd
情景	ylbd
情理	yleb
情操	ylfo
情报	ylfp
大智若愚	ylhb
情节	ylhp
情话	ylij
情诗	ylil
情谊	ylin
情调	ylin
情愿	yljg
情书	yljj
情爱	yljn
情感	yljt
情境	ylld
情趣	ylll
奔走相告	ylmj
情色	ylrd
情妇	ylre
情形	ylth
情歌	ylto
情侣	ylto
情人	ylvi
老年人	ylvi
情况	ylvo
情结	ylwl
情缘	ylwl
情绪	ylwy
情怀	ylyj
大本营	ymhn
大材小用	ymmn
老板娘	ymrd
牵连	yncz
牵头	yndd
牵动	ynfg
牵挂	ynfl
大幅度	ynij
情同手足	ynjo
牵制	ynkn
恫吓	ynot
牵涉	ynsy
大富翁	ynvg
牵线	ynwf
悱恻	ynyb
惋惜	ynyh
惆怅	ynyk
牵引	ynzs
牵强	ynzs
大器晚成	yobj
点头	yodd
战斗	yodd
战胜	yodj
发号施令	yodv
点球	yoex
点播	yofj
占据	yofp
战报	yofp
点击	yofu
点拨	yofy
点评	yoit
战后	yojj
战乱	yojx
点将	yokd
占地	yolc
战士	yoli
战场	yolz
战术	yomd
战机	yomw
占用	yonf
点距	yool
战略	yoqa
战国	yoqe
战争	yore
点滴	yosd
战役	yosw
大中型	yoth
战俘	yotj
战事	yoto
点歌	yoto
点心	youi
占领	yovj
点钟	yovo
战况	yovo
点缀	yowa
战线	yowf
战绩	yowl
战友	yoxa
占有	yoxd
点燃	yoxd
战火	yoxi
点火	yoxi
点数	yoxr
占卜	yoyi
点点	yoyo
点子	yozi
耷拉	ypfd
情随事迁	yptj
奋斗	yqdd
奋勇	yqdn
奋进	yqfn
奋力	yqji
奋起	yqll
惯例	yqtt
奋发	yqya
惧怕	yqyg
惯性	yqyj
奋战	yqyo
老奸巨猾	yrgx
恰如其分	yrhv
恰如其分	yrqv
发行量	ysbt
考研	ysct
考勤	ysho
考试	ysit
考证	ysit
老马识途	ysiv
考生	ysjl
考上	ysli
考场	yslz
考查	ysmb
考核	ysmd
考察	ysnx
考取	yspa
大行其道	ysqv
考验	ysst
惨淡经营	yswh
考古	ysxo
考虑	ysyu
奇观	ytan
恒星	ytbj
老头	ytdd
奇迹	ytdm
老外	ytdy
奇异	yteh
恒山	ytei
惊天动地	ytfl
老挝	ytfx
老鼠	ytgl
奇兵	ytgv
老旧	ytib
惟恐	ytiw
奇特	ytjf
老百姓	ytjr
老将	ytkd
老牌	ytkg
老年	ytlc
老龄	ytlw
老板	ytmj
老实	ytnd
奇闻	ytnp
老师	ytnt
老家	ytnx
老兄	ytow
大使馆	ytrl
奇妙	ytrm
老婆	ytsj
太平洋	ytsv
惟一	ytti
大使馆	yttr
老化	yttt
老伴	yttv
恒心	ytui
性价比	ytui
老公	ytvg
老人	ytvi
老总	ytvo
老弟	ytvz
奇幻	ytwj
老乡	ytwj
惟有	ytxd
奇怪	ytya
憔悴	ytyd
老大	ytyi
奇形怪状	ytyk
老虎	ytyw
懒惰	ytyx
老子	ytzi
惊心动魄	yufg
忧心如焚	yurm
恰巧	yvit
老羞成怒	yvjr
大逆不道	yvjv
悦耳	yvpi
恰好	yvrz
恰当	yvwe
憎恨	yvye
怜惜	yvyh
怜悯	yvyn
恰恰	yvyv
愉悦	yvyv
愉快	yvyz
悄然	ywdy
虚岁	ywed
虚拟	ywfl
虚报	ywfp
虚荣	ywhn
大学生	ywjl
虚构	ywms
虚实	ywnd
虎门	ywni
大学生	ywnj
虎穴	ywnv
虚伪	ywtd
虚假	ywtp
虚心	ywui
老当益壮	ywvk
虚幻	ywwj
恍惚	ywys
悄悄	ywyw
虚弱	ywzs
奔放	yxdh
奔腾	yxdv
忧愁	yxhx
怀才不遇	yxjb
慎重	yxjt
恢复	yxlb
愤青	yxld
奔赴	yxll
奔走	yxll
夺冠	yxnf
慎用	yxnf
奔跑	yxol
忧患	yxoo
夺取	yxpa
愤怒	yxra
夺得	yxsb
奔流	yxsd
奔波	yxsj
奔驰	yxst
忧伤	yxtl
忧郁	yxxd
愤慨	yxye
愤恨	yxye
忧虑	yxyu
恢弘	yxzs
夸夸其谈	yyhi
虚怀若谷	yyhv
惊慌失措	yykf
大惊失色	yykr
夸夸其谈	yyqi
发奋图强	yyqz
奢侈	yytd
虚情假意	yytd
奄奄一息	yytj
大快人心	yyvu
老态龙钟	yyxv
战战兢兢	yyxx
教务	yzaj
教条	yzam
达观	yzan
快车	yzci
快乐	yzcm
快要	yzcr
教研	yzct
快意	yzdb
教育	yzdg
惊弓之鸟	yzdg
教导	yzex
教授	yzfj
快报	yzfp
快捷	yzft
教程	yzho
教委	yzhr
教课	yzib
教诲	yzil
教训	yzim
快讯	yziz
快了	yzji
达成	yzjj
教书	yzjj
快感	yzjt
虚张声势	yzlf
达标	yzmf
教材	yzmx
教案	yznr
快艇	yzns
教师	yznt
教室	yznt
教员	yzob
教唆	yzog
牵强附会	yzpv
快活	yzsj
达到	yztg
快速	yzto
快来	yztx
教养	yzve
教会	yzvf
教父	yzvx
快递	yzvz
教学	yzwn
教堂	yzwn
教练	yzwt
快慢	yzyb
快餐	yzyd
快点	yzyo
教改	yzzl
张牙舞爪	zclj
孩子	zdzi
飞黄腾达	zhdy
孤芳自赏	zhjw
飞利浦	zhst
劲头	zidd
乙肝	zidf
劲旅	zidh
孑孓	zijn
子宫	zino
子女	ziri
子弟	zivz
劲爆	zixb
子孙	zizm
子弹	zizs
乃是	zjbt
孕育	zjdg
孤立	zjdi
孤拐	zjfo
盈亏	zjfs
盈利	zjhn
弱不禁风	zjmw
孕妇	zjre
乃至	zjtg
孤僻	zjtp
孤单	zjvb
盈余	zjvt
孤独	zjxj
改观	zlan
改良	zlde
改为	zldj
改变	zldm
改名	zldo
改建	zlef
改动	zlfg
改进	zlfn
改换	zlfr
改革	zlhp
改称	zlhr
改成	zljj
改造	zljl
改版	zlkj
改装	zlkl
改制	zlkn
孔雀	zlmj
改用	zlnf
改写	zlns
改期	zlqv
忌妒	zlrd
改正	zltl
改善	zlvf
改编	zlwd
改组	zlwq
改过	zlxd
孔子	zlzi
孙子	zmzi
孤家寡人	znnv
弱肉强食	znzv
引吭高歌	zodt
孤陋寡闻	zpnn
弹尽粮绝	zpxw
飞蛾扑火	zqfx
引申	zsbi
张贴	zsby
强硬	zsct
费率	zsdw
弹劾	zsdy
弹奏	zsev
引导	zsex
引进	zsfn
强势	zsfx
弱势	zsfx
张扬	zsfz
弘扬	zsfz
强迫	zsgz
引擎	zshs
弹药	zshw
引荐	zshx
强攻	zsia
引诱	zsih
引言	zsii
强项	zsij
强调	zsin
强度	zsjh
费力	zsji
强力	zsji
弹力	zsji
强盛	zsjj
弥补	zsjk
引向	zsjn
引入	zsjn
强加	zsjo
弹簧	zskh
强壮	zskl
强制	zskn
引起	zsll
弱智	zsly
疆场	zslz
强权	zsma
引述	zsmd
弱小	zsmi
费用	zsnf
引用	zsnf
引路	zsol
引号	zsot
强国	zsqe
强奸	zsrf
弥漫	zssb
强行	zssf
强烈	zstd
张开	zsth
强化	zstt
引来	zstx
引出	zsue
弹出	zsue
费心	zsui
引人	zsvi
引领	zsvj
强盗	zsvr
引资	zsvr
引爆	zsxb
强有力	zsxj
引发	zsya
强者	zsyb
强大	zsyi
弹性	zsyj
弱点	zsyo
费劲	zszi
强劲	zszi
强弱	zszs
飞扬	zvfz
飞舞	zvlh
飞越	zvll
飞檐	zvmr
飞机	zvmw
飞船	zvns
飞跃	zvol
飞鱼	zvrt
飞往	zvsd
飞行	zvsf
飞速	zvto
飞天	zvty
飞翔	zvvf
飞过	zvxd
飞龙	zvxt
飞奔	zvyx
飞快	zvyz
改朝换代	zxft
强有力	zxji
迅速	zxto
迅猛	zxxj
孜孜不倦	zzjt
孜孜以求	zzlx
