颡	aaab
逄	aciz
螽	addq
夂	aii
攵	aii
怼	axdu
昝	ayb
昴	bcjp
暾	bdoa
旰	bf
晡	bf
晡	bfu
旰	bfu
旰	bfui
晡	bfuj
勖	bgj
晟	bjjx
曛	bjth
昃	bjv
夥	bmdd
贶	bow
赆	bpnd
昵	bpt
韪	btli
晗	bvjo
炅	bx
炅	bxbn
暌	bxty
赕	bxx
赇	bxxd
磉	caam
辂	cao
硌	cao
硌	caoo
辂	caoo
砗	cc
砑	ccij
轹	ccm
轹	ccmi
砗	ccu
砗	ccui
匦	ccx
砬	cd
磔	cdcm
碲	cdni
轺	cdo
碚	cdo
礅	cdoa
碚	cdoo
碥	cdph
砬	cdut
磙	cdvk
矸	cf
矸	cfui
碜	cgys
硭	chdl
礞	chnx
礴	chsd
砹	chx
礤	chxm
匚	cii
迓	cijz
硪	cjfx
椠	cjjm
硇	cjqx
鄄	clp
碡	clqs
砣	cnt
碇	cntl
硐	cnto
碹	cntt
軎	co
軎	cobo
轵	cov
磲	csgm
礓	ctqt
砘	ctul
鸱	ctvt
硖	ctvv
墼	cuwl
辁	cve
砼	cvi
轸	cvs
砜	cwx
轱	cxo
硗	cxtw
轳	cyp
砀	czs
砩	czsn
胂	dbi
腽	dbq
歆	dbrv
鄣	dbxp
眢	dcg
膪	ddno
袤	ddtk
胲	ddyv
腠	devy
肼	dfn
肟	dfs
朊	dfw
旃	dhld
旆	dhli
旄	dhll
旒	dhlm
邡	dhp
於	dhvd
丶	dii
亠	dii
鹛	djgt
翊	djj
胍	djjn
臁	djvm
昶	djxb
脬	djz
腈	dld
腈	dldj
胙	dlk
臌	dloa
蠃	dlod
邙	dlp
胩	dly
栾	dmm
脔	dmnv
娈	dmr
腙	dnfm
脘	dnfw
腚	dntl
肭	dnv
膣	dnvl
劭	doj
劭	dojj
鹫	domt
脶	donv
臊	doom
腭	doos
瓿	dotd
憝	dozu
綮	dpam
扃	dpno
脲	dps
肷	drv
肜	ds
朐	dso
瞀	dtjg
蝥	dtjq
蟊	dtjq
婺	dtjr
鹜	dtjt
鹬	dtjt
鍪	dtjv
胨	dtm
竦	dtom
胗	dvs
腧	dvtn
脞	dvvl
塍	dvyl
媵	dvyr
颃	dwjb
饔	dwjk
脒	dx
膦	dxdi
鬯	dxdt
齑	dxji
脎	dxm
腩	dxnx
腩	dxny
脒	dxui
肽	dyd
颏	dyvb
胫	dzi
峄	eaf
峄	eafi
岈	ecij
峁	ecjp
崾	ecr
琏	ecz
嶂	edbx
璇	edhl
嵋	edjg
岜	edl
刿	edn
崞	edoz
珏	eed
玮	efji
嵬	egwg
崂	ehnj
珙	ehv
肀	ei
彐	eii
瑗	ejfa
遄	ejnz
珈	ejo
珈	ejoo
璁	ejqu
嵊	ejxv
峤	ejyn
耩	emfl
耢	emhj
耱	emjc
耠	emvo
耥	emwo
耧	emxr
耔	emz
琬	endc
蜚	eneq
琮	enfm
璐	eolo
珥	ep
珉	eptv
珥	epu
琚	epxo
岬	eq
崽	equ
崮	eqxo
峋	esb
珩	esfi
岣	eso
逯	esz
逯	eszd
玎	et
岍	eth
嶷	etll
岽	etm
珂	eto
岢	eto
岢	etoi
珂	etoi
崃	etx
玢	evd
嵛	evtn
珧	evwv
嵫	evww
嶙	exdi
岵	exo
嵝	exr
嵴	exvd
琰	exx
琰	exxn
崦	eybl
屺	ezl
屺	ezll
搡	faam
撄	fbbr
抻	fbi
砉	fc
揠	fcbr
砉	fcob
掊	fdo
掊	fdoo
掮	fdpd
恝	fdu
捃	fejo
酆	ffep
抟	ffsd
捭	fgjx
揲	fhlm
亍	fi
亍	fib
扌	fii
顸	fjb
擤	fjgn
韫	fjiq
摺	fjjg
踅	fjjl
搋	fjjw
捱	fjll
攥	fkgm
掾	fljx
嫠	fmar
亓	fn
亓	fnbi
揎	fntt
觏	fntw
撺	fnvi
挹	fodl
邗	fp
搌	fphk
擗	fpox
揶	fpp
邗	fpu
邗	fpui
擐	fqtk
掼	fqxb
撸	frtb
拶	fsd
攮	ftok
拊	ftxd
掭	ftyd
攉	futi
搛	fvem
揄	fvtn
搠	fvud
鼋	fwol
戋	fx
戋	fxav
擀	fxbf
贽	fxdb
絷	fxdm
鸷	fxdt
掎	fyto
摅	fyu
逋	fz
逋	fzc
逋	fzcj
搦	fzsv
眍	gcx
眵	gdd
敫	gdha
盱	gf
瞍	ggia
眙	ggo
矍	ggta
氍	ggtl
睃	ggva
舁	gh
厶	gii
厶	giis
睚	gjll
郫	gjxp
皤	gjxq
鹎	gjxt
赜	glb
鼢	gldd
鼷	gldy
眭	gll
眦	glt
邰	gop
炱	gox
眈	gpl
舄	gsh
鹱	gtha
眄	gtlj
逡	gvaz
凫	gw
凫	gwb
魃	gwgd
魈	gwgd
瞵	gxdi
毵	gysl
菖	hbb
莳	hbxd
茜	hc
茜	hcbo
蔸	hcgw
芪	hctv
薏	hdbu
蒯	hddn
莨	hdek
稂	hdek
茺	hdgw
菸	hdhd
蔟	hdhy
蒡	hdnh
苕	hdo
穰	hdok
藁	hdom
葶	hdot
蓣	hdtb
茭	hdvx
蓠	hdxg
苄	hdy
茛	hek
茚	hep
蓁	hevh
綦	hevm
荨	hexd
葜	hfdy
芫	hfw
菝	hfxd
蔸	hgcw
萆	hgjx
茑	hgt
葚	hhel
萁	hhev
苷	hhf
藜	hhss
艹	hii
灬	hii
蒇	hjbx
苊	hjc
荬	hjdy
蓐	hjfd
莪	hjfx
苈	hjj
蓼	hjjs
蒺	hjly
莛	hjlz
蘼	hjme
蘖	hjpm
荽	hjr
秭	hjsj
葳	hjtx
芊	hjx
芊	hjxi
菡	hjxu
荞	hjyn
苤	hjyt
莩	hjz
稃	hjz
稃	hjzi
莩	hjzi
芨	hjzn
蕻	hkhv
芏	hl
贳	hlb
芏	hlbt
苡	hldv
葑	hlld
薹	hlol
蘩	hlqm
莰	hlrv
茈	hlt
秫	hmd
葙	hmg
菥	hmjt
菘	hmvg
菪	hnc
菀	hndc
蔻	hnfa
萜	hnio
苘	hno
荥	hns
茼	hnto
芮	hnv
蓥	hnv
芮	hnvj
蓥	hnvt
茕	hnzx
堇	hol
稆	hoo
葺	hop
蕺	hopx
鞲	hpfl
鞴	hphf
鞴	hphi
鞒	hpjn
荩	hpnd
鞔	hprw
鞫	hpsi
苠	hptv
蒉	hqb
苴	hqf
苴	hqft
鹋	hqgt
瞢	hqng
葸	hqu
萁	hqv
葚	hqvl
蒽	hqyu
萏	hrg
薅	hrjd
芡	hrv
蒗	hsdk
荇	hsfi
蕖	hsgm
茳	hsi
秭	hsij
黧	hsjh
蒎	hsjk
蓰	hsll
菹	hsqf
蘅	hsri
芴	hss
薤	htdt
萑	hti
莜	htia
劐	htin
茌	htl
颟	htnb
蔌	htov
苻	htxd
茯	htyd
荑	htzv
秕	hu
蒈	hug
薷	hujn
藿	huti
荜	hux
蕲	hvbt
蒹	hvem
荟	hvfg
芩	hvj
蔹	hvta
莶	hvtw
蒴	hvud
苁	hvv
荭	hwi
芗	hwj
莼	hwtl
荮	hwxd
艽	hx
茇	hxad
艽	hxbz
芄	hxd
莸	hxjd
蕤	hxjl
稹	hxqv
蒌	hxr
茏	hxtd
荛	hxtw
萘	hyfm
蓍	hytb
蘧	hyxz
艿	hzj
芑	hzl
芤	hzl
芎	hzs
诓	ice
讴	icx
谝	idph
诔	iem
讵	ig
诶	igly
诒	igo
丨	iii
讠	iii
诩	ijj
诜	ijlw
诖	ill
诨	inc
谔	ioos
邛	ip
诹	ipa
谡	iqva
诎	iue
谫	ivdd
谘	ivro
谥	ivvq
觋	ivvw
跫	iwdl
蛩	iwdq
銎	iwdv
诼	ixd
诼	ixdv
谳	ixnd
谑	iyct
瘙	jadq
瘿	jbbr
廛	jbll
厍	jc
厍	jcci
瘭	jcfm
癔	jdbu
疰	jde
廪	jdqm
痃	jdw
癍	jede
犏	jfdh
瘛	jfdu
犍	jfez
牿	jfjo
庑	jfl
氇	jflb
氆	jflb
毪	jfli
毳	jfll
犋	jfqv
掰	jfvf
搿	jfvf
牾	jfwo
癯	jggi
庳	jgjx
齄	jgqt
鼽	jgqx
瘐	jgv
瘼	jhby
貘	jhby
癀	jhdv
廑	jhol
庹	jhpn
丿	jii
疒	jii
豸	jii
瓞	jjgv
疬	jjj
瘳	jjjs
貔	jjqu
颀	jjtb
鹨	jjvt
衤	jk
裰	jkaa
衩	jkad
袼	jkao
裼	jkbs
裢	jkcz
裉	jkek
褙	jkkd
裱	jklk
襻	jkmf
裥	jknb
璺	jknd
衲	jknv
裎	jkoe
裾	jkpo
襦	jkun
衿	jkvj
袷	jkvo
裣	jkvw
袢	jkvx
襁	jkzq
眚	jlg
廒	jlha
痄	jlk
郜	jlop
繇	jlxm
麽	jmmg
縻	jmmm
痫	jnm
鸸	jnnt
恧	jnnu
汆	jns
籴	jnx
哿	joto
邝	jp
疖	jp
癃	jpal
疖	jpc
疖	jpci
瘕	jpfa
癜	jpha
邝	jpu
邝	jpui
衄	jqjt
瘰	jqwm
囟	jqx
痼	jqxo
廨	jrdi
痧	jsmj
疔	jt
乇	jt
庀	jt
疔	jtci
庀	jtcl
庥	jtm
貅	jtm
瘌	jton
瘗	jtvl
痖	jtwt
瘊	jtzy
瘅	jvbx
瘥	jvfi
痤	jvvl
痦	jwo
庋	jxa
瘃	jxd
瘃	jxdv
虢	jxdw
瘵	jxfm
歃	jxgv
鸹	jxot
卺	jxtc
礻	jy
岙	jye
禊	jyfy
祛	jylg
祢	jyrm
孬	jyrz
邳	jytp
禚	jyvh
祧	jywx
祓	jyxd
祜	jyxo
麈	jzne
麇	jznh
郛	jzp
簟	kcbx
篼	kcgw
篥	kcm
篚	kcne
笸	kco
笤	kdo
罅	keyi
箨	kfaf
筢	kfdl
篝	kfnl
筘	kfo
篼	kgcw
箬	khxo
爿	kii
筇	kip
笊	kj
篪	kjjw
筅	kjlw
笳	kjo
笫	kjsj
笥	kjto
笾	kjz
笈	kjzn
簏	kjzu
箦	klb
箐	kld
邾	kmp
箢	kndc
箜	knvi
箅	kqtn
髟	ks
髫	ksdo
鬏	kshx
笫	ksij
笱	kso
鬟	ksqk
笏	kss
髹	kstm
鬈	ksvc
筻	ktbx
笄	kth
筱	ktia
筚	kux
筌	kve
筲	kwd
簖	kxlt
簦	kxtv
氡	kzad
氙	kze
氕	kzj
氚	kzm
氘	kzn
氪	kzxw
墁	lbqa
埸	lbss
堙	lcl
坻	lctd
堋	ldd
謦	ldji
垴	ldxu
埽	leni
埭	les
垲	lezl
獒	lhad
螯	lhaq
鳌	lhat
骜	lhat
鏊	lhav
堞	lhlm
墉	ljei
塬	ljgm
坂	ljja
埏	ljlz
垧	ljno
彘	ljtt
彖	ljx
埒	ljxd
迮	lkz
趱	lljb
趄	llqf
趔	lltn
恚	llu
趑	llvv
圪	llz
垸	lnfw
坨	lnt
彀	lnta
觳	lnta
垌	lnto
悫	lnwu
甏	lovd
坭	lpt
堀	lpue
塄	lqdh
坶	lqs
纛	lqsm
鳘	lqst
堍	lrod
墚	lsdm
砦	ltc
垤	ltgl
塥	ltoy
觜	ltr
垭	ltwt
忐	lu
忐	lub
忐	lubv
埝	lvju
龅	lvue
龆	lvuo
龀	lvut
龆	lwdo
坳	lwj
龅	lwse
龀	lwt
埴	lxqe
垅	lxtd
罅	lxui
迕	lxz
埯	lybl
榘	lygm
坫	lyo
坫	lyoo
垆	lyp
矬	lyvl
矧	lyzi
圮	lzl
杈	mad
柽	mal
柘	mc
榧	mcee
栎	mcm
榱	mdok
椋	mdom
檩	mdqm
楗	mefz
楱	mevy
桤	mezl
柰	mfm
柰	mfmi
桕	mg
桕	mgut
槔	mgyx
椹	mhel
槿	mhol
楸	mhx
槠	miyb
椴	mjia
枥	mjj
皙	mjjg
梏	mjlo
橛	mjvv
棰	mjxf
栝	mjxo
桴	mjz
枨	mk
樾	mllx
楂	mmbt
棼	mmvd
桉	mnr
柁	mnt
柁	mntl
楦	mntt
枘	mnv
檫	mnxm
榀	mooo
枵	mots
枳	mov
樨	mpsi
榍	mpwd
椐	mpxo
椤	mqd
椹	mqvl
桷	mr
槲	mrdx
桫	msmj
杩	mst
桎	mtgl
杌	mtw
桠	mtwt
樗	mufs
檑	muq
檎	mvdg
槎	mvfi
柃	mvjd
橼	mwlx
樘	mwnl
榉	mwvf
桄	mww
栊	mxtd
尜	mym
栌	myp
栲	mys
栳	myt
阊	nbb
宕	nc
宕	ncb
宕	ncbo
皲	ncja
郓	ncp
阍	nctb
阆	ndek
阏	ndhd
闶	ndw
闫	ne
闫	necj
蜚	neeq
勖	nfgj
謇	nfni
褰	nfnk
蹇	nfnl
阋	ngw
阒	ngyd
帱	nifd
刂	nii
冂	nii
冖	nii
宀	nii
帔	nija
帙	nikv
帻	nilb
幄	nipl
幞	niwv
阌	njna
阚	njpa
鹇	nmgt
逭	npzz
阃	nqm
舾	nsc
舳	nsd
艟	nsdl
舣	nsdx
艨	nshx
舡	nsi
舴	nslk
舯	nsoi
艉	nspl
舸	nsto
舭	nsu
艚	nsub
艏	nsvg
艄	nswd
舻	nsyp
阈	ntox
宓	nuj
甯	nunf
穸	nvd
窨	nvdb
窳	nvjn
窆	nvjz
窀	nvtl
窬	nvvn
窭	nvxr
宄	nx
宄	nxbz
闼	nyz
呗	ob
黾	obl
喁	obng
嘬	obpa
呗	obu
呗	obud
哐	oce
嘌	ocfm
咂	ocni
喑	odb
嗵	oddz
啷	odep
嗵	odnz
唼	odr
啐	odvx
哜	odxn
哕	oed
嘣	oedd
哏	oek
唪	oevf
嗪	oevh
哳	ofjt
呒	ofl
呋	ofv
嗖	ogia
哞	ogki
唣	ogt
嚆	ohdo
喵	ohq
嗬	ohto
喏	ohxo
嗄	ojga
呖	ojj
哌	ojjk
吒	ojt
吒	ojtl
噘	ojvv
唛	ola
跖	olc
跞	olcm
蹁	oldh
踉	oldk
踣	oldo
踺	olez
蹀	olhm
躜	oljb
蹰	oljd
踽	oljg
躔	oljl
趿	oljn
踮	oljo
跏	oljo
蹯	oljq
跣	oljw
跹	oljz
跬	olll
哧	olm
嘭	olos
趵	olsd
躐	olsv
呲	olt
跗	oltd
趼	olth
跄	olvc
躞	olxa
咔	oly
踔	olyx
跽	olzu
噻	onfl
嘧	onue
呙	onv
嚓	onxm
鹗	ooft
鼍	ooql
唰	opnn
噼	opox
唿	ossu
囔	otok
吡	ou
吣	ou
喈	oug
嚯	outi
呤	ovjd
噌	ovqb
嗍	ovud
唑	ovvl
唢	owb
呦	owj
哚	owm
咣	oww
咝	owwt
嗔	oxqv
噔	oxtv
哓	oxtw
咴	oxx
卟	oy
喹	oyll
卟	oyu
卟	oyui
哒	oyz
哒	oyzd
吲	ozsi
颞	paab
陧	pbl
隰	pbwh
陔	pdyv
隗	pgwg
卩	pii
阝	pii
阼	plk
聃	pnl
聍	pnt
聍	pnti
甓	podd
嬖	podr
鐾	podv
聩	pqb
隈	pqtk
屣	psll
耵	pt
耵	ptu
耵	ptui
阢	ptw
尻	px
尻	pxcz
隳	pxid
陟	py
阽	pyo
骘	pyst
蛏	qal
蜾	qbm
螵	qcfm
蚰	qd
疃	qdbl
骶	qdcd
鹘	qdgt
蝣	qdhz
骺	qdjo
髂	qdno
髌	qdnv
蚰	qdu
蚰	qduo
骱	qdvn
螭	qdxg
蛴	qdxn
蝽	qevb
螓	qevh
雎	qfti
蚨	qfv
蠼	qgga
螋	qgia
蜱	qgjx
蛑	qgki
黟	qhdd
黥	qhdm
蟥	qhdv
蜞	qhev
黢	qhga
黪	qhgs
蝾	qhnm
蠓	qhnx
蠛	qhqx
蠖	qhta
螨	qhtv
詈	qi
詈	qib
詈	qibo
囗	qii
螗	qjeo
螈	qjgm
螅	qjgu
畈	qjja
蠊	qjvm
罘	qjy
蜉	qjz
虬	ql
蝮	qlba
圊	qld
圊	qldo
罴	qlgh
蟛	qlos
虼	qlz
畹	qndc
蚺	qnl
蛳	qnti
蚋	qnv
圜	qqtk
蜞	qqv
囡	qr
蟓	qrbx
蟓	qrox
町	qt
蟪	qtbu
罡	qtl
蜮	qtox
蛱	qtvv
蚍	qu
螬	qub
蛘	qvf
蜣	qvfl
蟮	qvfo
囹	qvjd
蚧	qvn
蚧	qvni
罾	qvqb
畛	qvs
囵	qvt
蜍	qvtm
蝤	qvu
綦	qvwm
虮	qw
蛸	qwd
蚴	qwj
罱	qxnx
蝻	qxnx
蝰	qyll
胬	ranv
孥	raz
妲	rbt
嫜	rdbx
妫	rdjd
嬗	rdqt
嫫	rhby
觚	rjjn
嫒	rjna
姝	rkm
饣	rl
婧	rld
馔	rlev
馓	rlha
馍	rlhy
饫	rljy
饩	rlkz
馇	rlmt
馀	rlvm
馐	rlvt
饽	rlxz
饧	rlzs
姹	rnjt
鲦	rtam
鳋	rtaq
鲥	rtbd
鳎	rtbj
鲲	rtbu
鲂	rtdh
鳊	rtdh
鲚	rtdn
鲟	rted
婕	rtel
鳇	rtge
鲐	rtgo
鲵	rtgw
鳓	rthj
鲽	rthm
鳙	rtji
鲕	rtjn
鳐	rtju
鲮	rtla
鳆	rtla
鲒	rtlo
鲣	rtnl
鲩	rtnw
觫	rtom
鲰	rtpa
鲴	rtqo
鲻	rtsq
鲋	rttd
鲡	rttd
鲆	rtti
鲠	rttx
鳕	rtue
鳢	rtuv
鳟	rtvd
鲶	rtvu
娅	rtwt
鲼	rtxb
鲅	rtxd
鲇	rtyo
鲺	rtzq
媸	ruiq
媸	rulq
觯	rvbx
觥	rww
嫱	rxvo
觖	rzv
洚	saci
汊	sad
汩	sb
灏	sbdb
溻	sbjj
郇	sbp
汩	sbuo
泺	scm
淝	sddl
鎏	sdgv
沩	sdjd
泫	sdw
汜	se
徵	seta
溱	sevh
沣	sf
滟	sfrl
沣	sfui
徼	sgda
溲	sgia
濉	sgti
浜	sgv
潢	shdv
澌	shet
泔	shf
渫	shlm
滢	shnd
潆	shnm
潲	shwd
湫	shx
漭	shyh
訇	si
訇	sic
勹	sii
彳	sii
彡	sii
氵	sii
巛	sii
浒	silx
溏	sjeo
溽	sjfd
濞	sjgn
徭	sjlu
澉	sjpa
鋈	sjyv
漉	sjzu
洙	skm
沲	slc
澍	slod
汔	slz
沭	smd
挲	smjf
漤	smmr
渖	snbi
溟	snbv
浣	snfw
涫	snpz
鸲	sogt
浞	sol
漶	soou
滠	spaa
泐	spj
甾	sq
甾	sqbo
徂	sqf
涠	sqfi
洄	sqo
溷	sqx
洇	sqy
洳	sro
浼	srow
淼	sss
邬	sstp
骒	stbm
骟	stdj
骧	stdk
骀	stgo
骝	stgq
骖	stgs
骐	sthv
骢	stju
涑	stom
骣	stpz
驵	stqf
驺	stre
骓	stti
骅	sttx
涞	stx
凼	su
凼	suc
凼	suci
湓	svdq
浍	svfg
溆	svta
瀹	svth
泮	svx
滏	svxv
後	swa
後	swan
浯	swo
浯	swow
潴	sxjb
瀵	sxqv
泷	sxtd
浠	sxxi
浈	syb
瀣	sydt
滹	syji
佟	tadd
傩	tati
倮	tbm
伢	tcij
伛	tcx
伛	tcxl
殛	tdjt
殍	tdjz
殪	tdlv
殒	tdob
僦	tdod
殂	tdqf
俜	tdts
忑	tdu
殄	tdvs
佼	tdvx
殚	tdvx
仨	te
仨	teut
侔	tgki
郅	tglp
甙	thfv
劢	thj
虿	thq
儆	thsa
劁	tihn
鹪	tiht
亻	tii
雠	tiii
隼	tix
仂	tj
仫	tjg
恁	tjlu
佶	tlo
鄢	tlsp
仵	tlx
佧	tly
仡	tlz
鸫	tmgt
鸺	tmgt
丌	tn
鹂	tndt
倜	tnlo
邴	tnvp
橐	toim
俣	toty
豇	tovi
佴	tp
伲	tpt
儇	tqtk
儋	trji
颍	tsjb
僬	ttih
佤	ttld
忒	tuv
牮	tvki
郏	tvvp
麴	tvvx
仉	tw
戬	twtx
仉	twu
赉	txb
傺	txfm
鸨	txgt
偾	txhb
垡	txl
偻	txr
俅	txxd
倬	tybx
侉	tyfs
醍	ubtl
醌	ubu
酏	uc
醯	udgq
醅	udo
粜	uex
酐	uf
屮	ui
凵	uii
醣	ujeo
醪	ujjs
醑	ujld
酰	ujlw
颥	ujnb
酹	ujxd
酢	ulk
酲	uoe
酃	uoop
霈	usti
酯	utb
酾	utnd
醭	uwtv
酎	uxd
酤	uxo
醐	uxod
醢	uxoq
醵	uyx
锝	vbfd
锞	vbm
钽	vbt
锝	vbtd
冁	vbxk
镡	vcbx
铘	vcip
钷	vco
戗	vcx
钺	vcx
镱	vdbu
钭	vddx
锒	vdek
锍	vdgm
铳	vdgw
钫	vdh
镟	vdhl
镅	vdjg
坌	vdl
钯	vdl
铈	vdni
翦	vdnj
锫	vdo
镦	vdoa
锿	vdok
钪	vdw
钰	ved
鹣	vemt
锓	vena
铠	vezl
羝	vfcd
羰	vfex
羧	vfga
郐	vfgp
佘	vfm
畲	vfmq
鄯	vfvp
羟	vfzi
钜	vg
钼	vg
镏	vgdq
锼	vgia
钼	vgu
钜	vgul
钼	vguo
镆	vhby
铹	vhnj
锘	vhxo
仝	vi
仝	vib
仝	vibt
钅	vii
冫	vii
钌	vj
瓴	vjdd
衾	vjdk
镛	vjei
锇	vjfx
馘	vjgx
铖	vjjx
铥	vjlg
锆	vjlo
冼	vjlw
铤	vjlz
锺	vjtl
钌	vjui
镢	vjvv
锊	vjxd
锸	vjxg
钚	vjy
钆	vl
钍	vl
锖	vld
钆	vlu
钍	vlu
钆	vlul
钍	vlut
钔	vn
锏	vnb
镔	vngv
蹩	vnml
铊	vnt
锎	vnth
镧	vntm
钔	vnu
钔	vnuj
镩	vnvi
镓	vnx
镲	vnxm
镓	vnxv
锃	voe
铞	voni
铒	vp
锔	vpjo
铌	vpt
锕	vpto
甑	vqbd
锶	vqu
铟	vqy
钕	vr
铯	vrdl
铷	vro
镥	vrtb
钐	vs
锪	vssu
钐	vsu
钐	vsuj
铴	vszs
毹	vtdl
钲	vtl
冱	vtlt
钶	vto
龛	vtod
龠	vtoh
钶	vtoi
铧	vttx
铽	vtuv
铗	vtvv
佥	vtw
铼	vtx
锴	vug
槊	vujm
遒	vuz
鹆	vvot
蠲	vvqq
镎	vvtf
铪	vvto
鑫	vvv
镨	vvwb
铫	vvwv
锩	vvyc
镤	vwtv
鼗	vwva
鹚	vwwt
钬	vx
铕	vxd
铩	vxm
镫	vxtv
钬	vxu
钬	vxun
锬	vxx
钛	vyd
钛	vydn
桊	vym
鲞	vyrt
铑	vyt
锛	vyxh
钇	vz
镄	vzsb
镪	vzsq
鹈	vzst
殳	wa
殳	wab
殳	wabn
绺	wayo
绲	wbu
纾	wdt
缡	wdxg
绐	wgo
绀	whf
纟	wii
纩	wj
缛	wjfd
缵	wjlb
缒	wjpz
纩	wjuj
缬	wlob
缃	wmg
绯	wnee
喾	wnjo
泶	wns
缲	woom
缗	wptb
缋	wqb
缱	wqpz
缳	wqtk
缌	wqu
绗	wsfi
绠	wtbx
缏	wttx
黻	wtvd
黼	wtvf
黹	wtvm
缑	wtzy
绻	wvyc
绨	wvzj
绡	wwd
绱	wwno
纨	wxd
飑	wxse
飚	wxxx
绔	wyfs
糌	xayb
熳	xbqa
粞	xc
炻	xc
粼	xdck
鬯	xddt
炷	xde
粑	xdl
熵	xdno
煸	xdph
糅	xdtm
煺	xekz
炜	xfji
熘	xgdq
犭	xj
猸	xjdg
猱	xjdm
獍	xjdw
觌	xjdw
猝	xjdx
犴	xjf
狻	xjga
糗	xjgd
狁	xjgw
猊	xjgw
獾	xjhi
猁	xjhn
狺	xji
煅	xjia
熠	xjjg
獯	xjjh
狃	xjjt
糈	xjld
猹	xjmt
猬	xjqd
爝	xjqd
獬	xjri
狍	xjse
犸	xjst
粝	xjth
狨	xjtx
狴	xjul
狯	xjvg
烀	xjvi
狳	xjvm
猞	xjvo
猃	xjvw
犰	xjx
猢	xjxd
燔	xjxq
獠	xjym
橥	xjym
猗	xjyo
猕	xjzm
狲	xjzm
狒	xjzn
尥	xlsd
煊	xntt
鹁	xnzt
鹕	xodt
嘏	xopa
砻	xtdc
烨	xttx
糇	xtzy
鬯	xut
炝	xvc
馗	xvjg
焓	xvjo
赍	xvvb
麴	xvvx
糍	xvww
焐	xwo
逑	xxdz
郄	xxgp
剡	xxn
郗	xxnp
欷	xxnv
煳	xxod
郯	xxp
焱	xxx
燹	xxx
糨	xzsq
攴	ya
怿	yaf
翥	ybjj
悝	ybl
怄	ycx
忉	yd
粲	ydax
怊	ydo
忉	yduj
忭	ydy
刳	yfsn
悛	ygva
忄	yii
虍	yii
虍	yiih
恹	yjyd
怍	ylk
愫	ylwm
忤	ylx
夼	ym
憷	ymml
恽	ync
悱	ynee
忡	yoi
鸬	ypgt
愦	yqb
悃	yqm
鹾	yqxi
卣	yqz
恂	ysb
剞	yton
欹	ytov
怦	ytvi
慊	yvem
惝	ywno
觑	ywtw
忮	yxa
怙	yxo
巯	zidm
廴	zii
辶	zii
刭	zin
戤	zjax
鼐	zjgk
尕	zjm
勐	zqj
孢	zse
艴	zsnl
犟	zsoi
鬻	zsxy
弪	zszi
叒	aaa
叕	aaaa
敠	aaaa
敪	aaaa
鵽	aaah
毲	aaal
剟	aaan
欼	aaav
歠	aaav
顙	aaav
逫	aaaz
夅	aci
夆	af
蠭	afzq
鳮	agh
覌	agw
頚	aljv
敋	aoa
鵅	aogh
頟	aojv
洜	aos
邍	aqez
処	aw
夈	ax
昸	badd
昍	bb
晿	bbb
赑	bbb
曡	bbbf
曟	bbbk
曐	bbbl
曑	bbbs
暻	bbdm
晘	bbf
赗	bbg
暒	bbjl
暘	bbjs
晹	bbss
暘	bbts
焸	bbx
曋	bcbx
旫	bd
曈	bdbl
暲	bdbx
曻	bdci
曨	bdde
琞	bded
昉	bdh
昘	bdh
暆	bdhc
暶	bdhl
昹	bdjx
暠	bdoo
顥	bdov
昈	bdp
昗	bdv
晈	bdvx
晬	bdvx
昡	bdw
旻	bdx
旼	bdx
焽	bdx
猒	bdyd
晐	bdyv
旵	be
暃	bene
曃	besz
暟	betv
暙	bevb
旴	bf
暳	bffe
晣	bfjt
昛	bg
曒	bgda
昪	bgh
毷	bgjl
晙	bgva
晛	bgw
晲	bgw
煚	bgx
暭	bgxx
暤	bgyx
暯	bhby
曂	bhdv
畢	bhf
鷝	bhfh
曣	bhkh
暪	bhnd
暪	bhnn
曚	bhnx
暎	bhny
曣	bhoh
暵	bhov
曔	bhsa
曄	bhtf
曅	bhtf
晎	bhv
謈	bhvi
暢	bibs
昮	bij
昻	bip
畃	bisd
朄	bitm
迧	biz
鷐	bjfh
昿	bjg
暞	bjgm
暊	bjgv
曍	bjgx
昇	bjh
曞	bjhg
曠	bjhv
敭	bjja
昄	bjja
毾	bjjl
昜	bjjs
晠	bjjx
逿	bjjz
甠	bjl
晧	bjlo
暚	bjlu
曖	bjna
晑	bjno
昅	bjzn
暣	bkzx
圼	bl
	bld
黒	blh
晆	bll
曉	bllw
曀	blnv
暿	bloo
旿	blx
時	blxd
黙	blyh
顆	bmjv
褁	bmk
晽	bmm
敤	bmya
暈	bnc
暉	bnc
晼	bndc
暃	bnee
赗	bnfg
晥	bnfw
颙	bngb
顒	bngv
晭	bnlo
赒	bnlo
晍	bnto
曢	bnym
冔	bof
曮	booa
暺	boox
曯	bpsq
昷	bq
鄤	bqap
曎	bqlx
曎	bqly
曪	bqwi
妟	br
晩	brbw
曕	brji
欥	brv
旳	bsd
暀	bsde
昫	bso
昒	bss
敡	bssa
鶍	bssh
惖	bssu
逷	bssz
鶡	bsvh
暰	bsvl
毼	bsvl
鹖	bsvt
暷	btbd
鴠	btgh
晊	btgl
昰	btl
晸	btla
鶗	btlh
韙	btli
尟	btlj
題	btlv
遈	btlz
昩	btm
昁	btni
曬	btnu
昞	btnv
昺	btnv
鼌	btol
曧	btoq
鼂	btq
暕	btqm
昜	btss
逿	btsz
旽	btul
昢	bue
曓	buex
曇	bufg
鵾	bugh
鹍	bugt
曘	bujn
曤	buti
晪	buv
昐	bvd
暛	bvfi
昖	bvg
暡	bvgj
昑	bvj
昣	bvs
晀	bvwv
晜	bvzj
曏	bwjp
曭	bwnh
曗	bwtm
顕	bwtv
歞	bwwv
顯	bwwv
旪	bx
炚	bx
曵	bxd
暽	bxdi
暩	bxfm
暁	bxhw
暔	bxnx
暔	bxny
昽	bxtd
晱	bxx
旲	by
暏	byb
晻	bybl
晫	bybx
晇	byfs
昦	byn
曥	byqq
暅	bytt
暐	bzii
昲	bzsn
曊	bzsv
唘	cao
碭	cbjs
辒	cbq
匽	cbr
鶠	cbrh
碮	cbtl
碭	cbts
礘	cbwh
鷣	cbxh
匜	cc
砳	cc
硨	cc
輟	ccaa
軽	ccal
輅	ccao
輵	ccbl
輠	ccbm
輼	ccbq
輰	ccbs
輥	ccbu
磹	ccbx
轟	ccc
軧	cccd
軭	ccce
轟	ccch
軝	cccv
轋	cccz
軸	ccd
轍	ccda
軔	ccdd
輣	ccdd
軴	ccde
輬	ccdm
輮	ccdm
軺	ccdo
輆	ccdv
較	ccdx
軶	ccdz
軕	cce
軖	cce
輫	ccee
轃	cceh
輲	ccen
輑	cceo
輳	ccey
軒	ccf
輔	ccf
轊	ccfe
転	ccfg
磦	ccfm
軩	ccgo
輽	ccgq
轞	ccgq
輗	ccgw
轥	cchi
轕	cchl
輁	cchv
車	ccic
暫	ccjb
磛	ccjc
軛	ccjc
輧	ccjf
輴	ccjg
轁	ccjg
軤	ccji
斬	ccjk
塹	ccjl
蹔	ccjl
軞	ccjl
軠	ccjl
轣	ccjl
槧	ccjm
軱	ccjn
輀	ccjn
轎	ccjo
轓	ccjq
轇	ccjs
斬	ccjt
慙	ccju
轆	ccju
轗	ccju
鏨	ccjv
覱	ccjw
輱	ccjx
輭	ccjy
軼	cckv
軋	ccl
輘	ccla
輹	ccla
輤	ccld
轅	cclk
輫	ccne
輞	ccnl
輖	ccno
轄	ccno
輈	ccns
軜	ccnv
輐	ccnw
軮	ccny
輨	ccnz
輯	ccop
軹	ccov
軦	ccow
輙	ccpa
輾	ccpk
輒	ccpl
轏	ccpz
轘	ccqk
轀	ccqq
轠	ccqq
輡	ccrg
軟	ccrv
輓	ccrw
軳	ccse
輷	ccsi
轈	ccsm
軥	ccso
輜	ccsq
輺	ccsq
碈	cctb
軵	cctd
輔	cctd
輛	cctd
轉	cctd
輌	ccte
軯	ccti
輕	ccti
軘	cctl
輊	cctl
軻	ccto
輻	cctq
輺	cctq
軾	cctv
鑋	cctv
軏	cctw
輏	ccu
轌	ccue
轜	ccun
輸	ccv
軨	ccvd
輇	ccve
軿	ccvh
輪	ccvh
軡	ccvj
輸	ccvn
輍	ccvo
軫	ccvs
輶	ccvu
轙	ccvx
軗	ccwa
軓	ccwd
輎	ccwd
轛	ccwd
撃	ccwf
軪	ccwj
繋	ccwm
轢	ccwm
轐	ccwv
輄	ccww
匭	ccx
軌	ccx
軷	ccxd
轔	ccxi
軲	ccxo
轖	ccxo
轒	ccxv
輚	ccxx
軑	ccy
軙	ccya
轑	ccym
輢	ccyo
轤	ccyq
軐	cczx
礲	cdde
硧	cddi
砫	cde
硠	cdek
砽	cdi
硛	cdm
硧	cdnf
辌	cdom
碻	cdoo
碠	cdot
砨	cdpz
砯	cds
匟	cdw
砊	cdw
砇	cdx
硋	cdyv
匤	ced
砡	ced
磞	cedd
硉	cef
硦	ceh
硸	cejf
硍	cek
邼	cep
磪	ceti
碋	ceto
磑	cetv
磮	cevh
硶	cevj
硙	cezl
碶	cfdy
硏	cff
碔	cflv
勡	cfmj
翲	cfmj
彯	cfms
顠	cfmv
砆	cfv
磗	cfxd
砶	cg
礥	cgav
礉	cgda
覈	cgda
磂	cgdq
匷	cggi
磣	cggs
匥	cgh
礛	cgkq
磶	cgsh
賈	cgv
硯	cgw
磈	cgwg
碏	chb
礍	chbl
磡	chej
碪	chel
礡	chfd
礷	chgq
礚	chlq
碤	chny
礶	choi
覇	chpd
覊	chph
覉	chpo
礣	chqx
礡	chtd
匶	chtg
硴	chtt
硔	chv
匞	ci
矼	ci
碽	cigv
匸	cii
覀	cii
車	cii
	cii
鴉	cijh
劯	cj
砈	cjc
覂	cjdz
磤	cjea
磄	cjeo
磭	cjfd
砿	cjg
碩	cjgv
礪	cjhg
礰	cjhl
礦	cjhv
碫	cjia
磤	cjja
碷	cjjg
磖	cjjg
磟	cjjs
礩	cjjv
磃	cjjw
礖	cjkv
硞	cjlo
磘	cjlu
礸	cjlv
磩	cjlx
硟	cjlz
礳	cjmc
碝	cjny
礇	cjny
乮	cjpz
磓	cjpz
磇	cjqu
矺	cjt
硾	cjtl
劯	cjuz
磎	cjwy
硾	cjxf
磻	cjxq
硚	cjyn
礄	cjyo
砐	cjzn
匴	ckgh
匨	ckl
硃	ckm
垔	cl
砋	cl
砤	clc
碃	cld
磧	clgv
磝	clha
磽	cllw
硳	clm
硈	clo
礂	cloo
匵	clqv
歅	clrv
碐	clva
殹	clya
瑿	clyd
瞖	clyg
鷖	clyh
黳	clyh
繄	clym
嫛	clyr
鹥	clyt
悘	clyu
醫	clyu
毉	clyv
贀	clyv
矻	clz
鷅	cmgh
碄	cmm
礎	cmml
砵	cmt
硹	cmvg
矵	cn
碦	cnao
磵	cnb
砃	cnd
礀	cnd
砽	cnf
碂	cnfm
磍	cnfo
辀	cns
礗	cntv
碙	cnve
硡	cnxg
磒	cogv
敺	cooa
毆	cooa
礹	cooa
甌	cood
鷗	cooh
剾	coon
區	cooo
歐	coov
匰	coox
磾	coox
毄	cowa
尀	coxd
卬	cp
碬	cpfa
確	cpii
礔	cpox
碿	cpwd
磆	cqd
匱	cqgv
碅	cqh
礋	cqlx
礋	cqly
硱	cqm
硘	cqo
碢	cqo
礧	cqqq
砪	cqs
碨	cqtk
磥	cqwm
匛	crd
碀	crei
硊	crjc
覅	crss
砅	cs
碼	csh
礟	cshx
礮	cshx
碯	csjx
匢	css
匫	cssb
匯	csti
磫	csvl
矴	ct
磚	ctbd
磗	ctdd
揅	cthf
磼	ctim
砙	ctld
礙	ctll
砞	ctm
砢	cto
硜	ctsi
鴟	ctvh
帋	ctvi
匧	ctvv
硤	ctvv
氒	ctvx
矹	ctw
磢	ctxv
覄	ctyd
匩	cuie
礝	cujn
礵	cumg
礌	cuq
礭	cuti
礊	cuwc
轚	cuwc
擊	cuwf
檕	cuwm
繫	cuwm
蟿	cuwq
罊	cuwu
碒	cv
砏	cvd
硂	cve
礢	cvek
磏	cvem
礒	cvex
磰	cvfo
硑	cvh
砛	cvj
砱	cvjd
砎	cvn
磳	cvqb
碖	cvth
硢	cvtm
匬	cvtn
匼	cvto
硆	cvto
匳	cvtv
礆	cvtv
磸	cvuy
磀	cvuz
硲	cvvo
礠	cvwu
礈	cvxz
兂	cw
旡	cw
砓	cwa
朁	cwcb
蠶	cwcq
兓	cwcw
鬵	cwcy
鴄	cwgh
礫	cwgm
炁	cwh
碸	cwjq
礃	cwnf
礑	cwnq
礏	cwtm
硄	cww
磯	cwwx
戉	cx
軣	cx
硺	cxd
磜	cxfm
鴎	cxgh
硥	cxld
磌	cxqv
砕	cxx
碊	cxx
磱	cxxj
礯	cxxm
轪	cy
硽	cybl
遷	cyez
碵	cygv
匲	cyoo
毈	cypa
贕	cypv
磠	cyqd
硵	cyqx
硓	cyt
碕	cyto
匧	cyvv
硤	cyvv
磢	cyxx
硣	cyz
乭	cz
廼	cz
矷	cz
連	cz
硁	czi
砄	czv
腏	daaa
胮	daci
肞	dad
膖	dafz
韸	dbaf
韼	dbaz
鶕	dbgh
頀	dbha
韺	dbhy
腸	dbjs
竜	dbl
勭	dblj
裏	dblk
氃	dbll
亰	dbm
腂	dbm
腢	dbng
韻	dbov
嬜	dbrr
韴	dbti
腸	dbts
恴	dbu
韷	dbue
鷾	dbuh
竸	dbww
戠	dbx
竷	dbxa
戇	dbxu
贑	dbxv
贛	dbxv
遧	dbxz
夗	dc
肔	dc
鴛	dcgh
衺	dcik
膒	dcoo
盌	dcq
妴	dcr
駌	dcsh
竝	dd
暜	ddb
腤	ddb
朣	ddbl
膧	ddbl
膱	ddbx
椉	ddcm
刕	ddd
肕	ddd
脋	dddd
朧	ddde
臍	dddh
袲	dddk
歰	dddl
斘	dddx
朖	ddek
鵬	ddgh
翗	ddjj
夡	ddlo
蜰	ddlq
腣	ddni
脝	ddoj
朜	ddoz
卶	ddp
礱	ddsc
龍	ddse
龖	ddse
龘	ddse
驡	ddsh
鸗	ddsh
龏	ddsh
讋	ddsi
襲	ddsk
壟	ddsl
郺	ddsl
龒	ddsm
夠	ddso
聾	ddsp
蠪	ddsq
龔	ddsv
龑	ddsy
丒	ddt
礱	ddtc
龍	ddte
龖	ddte
龘	ddte
驡	ddth
鸗	ddth
龏	ddth
讋	ddti
襲	ddtk
壟	ddtl
腬	ddtm
龒	ddtm
腗	ddtn
聾	ddtp
蠪	ddtq
龔	ddtv
龑	ddty
脺	ddvx
膟	ddvx
胘	ddw
膟	ddwx
乧	ddxz
齊	ddyh
齋	ddym
劑	ddyn
齍	ddyq
韲	ddyt
齏	ddyt
齎	ddyv
齌	ddyx
迻	ddz
裦	dedk
褏	dedk
勆	degj
塱	degl
郒	degl
剆	degn
欴	degv
褎	dehk
腨	dejn
郞	dekp
郎	dekp
裵	denk
襃	deok
膗	deti
殶	dewa
迬	dez
肨	df
	dfsd
胉	dg
臔	dgav
逳	dgdz
臞	dggi
鳭	dgh
鴗	dgh
棄	dghm
膄	dgia
竢	dgly
袬	dgok
夣	dgqd
朘	dgva
脧	dgva
腉	dgw
褢	dgwk
竎	dh
臈	dhbl
堃	dhdl
旈	dhdm
旘	dhdx
膵	dhdx
旔	dhez
腜	dhfm
鴋	dhgh
旀	dhgm
旙	dhjq
頯	dhjv
臙	dhkh
臟	dhkx
朑	dhl
旇	dhla
旝	dhlb
旊	dhld
旍	dhld
旓	dhld
鷟	dhlh
斾	dhli
旚	dhlm
旛	dhlq
旂	dhlt
旜	dhlt
旐	dhlv
旟	dhlv
膐	dhlv
斻	dhlw
斿	dhlz
旞	dhlz
遊	dhlz
朠	dhny
臙	dhoh
腇	dhr
臒	dhta
瓬	dhtd
斺	dhvn
旕	dhvt
乻	dhvz
旑	dhyo
	dii
邎	dijz
竡	djb
竰	djbl
亷	djem
膅	djeo
腁	djff
竓	djfl
膬	djfl
脜	djg
鶥	djgh
郿	djgp
頔	djgv
竔	djh
腶	djia
為	djjh
脇	djjj
脈	djjk
産	djjl
剷	djjn
膠	djjs
肵	djjt
臎	djjx
肵	djk
亹	djkf
夝	djl
臢	djlv
脠	djlz
脡	djlz
胹	djnn
腝	djny
竬	djog
膇	djpz
膍	djqu
脮	djr
胏	djsj
顔	djsv
遃	djsz
臐	djth
腄	djtl
腫	djtl
膎	djwy
竏	djx
脟	djxd
腄	djxf
膰	djxq
肧	djy
脴	djyo
臕	djzh
膔	djzu
脹	dk
胅	dkv
袠	dkvk
朚	dlbd
膓	dlbs
胣	dlc
脌	dlci
岊	dle
胠	dlg
膴	dlhh
衁	dljq
腞	dljx
脿	dlk
胿	dll
膮	dllw
巟	dlm
吂	dlo
臝	dlod
贏	dlod
驘	dlod
鸁	dlod
驘	dloh
鸁	dloh
臝	dlom
巼	dlot
贏	dlov
蝱	dlqq
褻	dlvk
膆	dlwm
遙	dlxz
肐	dlz
変	dma
鵉	dmgh
親	dmgw
竗	dmj
亪	dmz
亣	dn
刄	dn
腪	dnc
覫	dndw
裵	dnek
冑	dnf
勈	dnfj
髙	dnfo
臗	dnhd
鶙	dnnh
遆	dnnz
竩	dnqf
竚	dnt
腟	dntl
臏	dntv
朒	dnvv
敵	dnxa
甋	dnxd
竤	dnxg
啇	dnxo
歒	dnxv
適	dnxz
胦	dny
咅	do
敨	doa
亯	dob
裛	dodk
巶	doe
脭	doe
竒	doi
勏	doj
鶁	domh
鷲	domh
勍	domj
蹵	doml
剠	domn
刟	don
毃	dona
稁	donh
稾	donh
髜	donh
鶮	donh
髝	donj
槀	donm
髞	donm
歊	donv
髚	donw
亴	donx
髛	donx
勷	dooj
郶	dool
卲	dop
綤	dopm
畗	doq
欩	dorv
膢	dotr
脵	doty
胑	dov
競	doww
撉	dozf
鶉	dozh
墪	dozl
鐜	dozv
亸	dozx
嚲	dozx
夘	dp
邜	dp
晵	dpab
鵩	dpah
棨	dpam
啓	dpao
扅	dpdd
鵳	dpdh
扆	dpdk
顅	dpdv
戺	dpe
肁	dpef
焈	dpex
腵	dpfa
鳸	dpgh
扄	dpjo
騗	dpnh
鶣	dpnh
帍	dpni
啟	dpoa
胒	dpt
腛	dptl
顧	dptv
竮	dpvh
肈	dpxf
啔	dpxo
腒	dpxo
扊	dpxx
戻	dpy
扂	dpyo
戹	dpz
腘	dqed
畆	dqg
膭	dqgv
腡	dqo
皽	dqoa
稟	dqoh
鸇	dqoh
勯	dqoj
氈	dqol
亶	dqot
鹯	dqot
顫	dqov
邅	dqoz
畝	dqrn
胟	dqs
褱	dqsk
臅	dqsq
腲	dqtk
膕	dqtx
畒	dqv
膃	dqvq
圅	dqvx
竧	dr
肗	dr
脃	drdl
竫	drei
膽	drji
脕	drow
氷	ds
肑	dsd
袌	dsek
褜	dsek
胻	dsfi
褭	dshk
胏	dsij
腦	dsjx
竘	dso
胊	dso
臘	dsqv
肳	dss
脗	dsso
竱	dtbd
膞	dtbd
腖	dtbm
亱	dtbt
鵺	dtdh
脻	dtel
膩	dtfv
胵	dtgl
脽	dti
膲	dtih
臇	dtim
敄	dtja
矡	dtja
暓	dtjb
矠	dtjb
矝	dtjd
矟	dtjd
嵍	dtje
騖	dtjh
鶔	dtjh
鶩	dtjh
鷸	dtjh
務	dtjj
堥	dtjl
氄	dtjl
楘	dtjm
劀	dtjn
矞	dtjo
鞪	dtjp
愗	dtju
預	dtjv
熃	dtjx
奦	dtjy
遹	dtjz
畁	dtn
脼	dtnd
胢	dto
脨	dtom
腷	dtoq
竵	dtoy
甹	dts
脛	dtsi
脦	dtuv
胓	dtvi
脥	dtvv
胕	dtxd
朏	due
胐	due
膤	due
膿	dujk
臛	duti
刅	dv
朌	dvd
竕	dvd
肦	dvd
膁	dvem
羘	dvf
肣	dvj
朎	dvjd
竛	dvjd
袞	dvok
兗	dvow
脫	dvow
竲	dvqb
膾	dvtb
腀	dvth
肹	dvts
臉	dvtv
竴	dvud
雜	dvvi
腳	dvvp
顇	dvvv
朓	dvwv
脁	dvwv
肸	dvx
鵁	dvxh
効	dvxj
	dvxt
頝	dvxv
虠	dvxw
腃	dvyc
膡	dvyg
騰	dvyh
鰧	dvyh
黱	dvyh
幐	dvyi
謄	dvyi
勝	dvyj
榺	dvym
縢	dvym
螣	dvyq
	dvyt
竌	dw
竐	dwa
孶	dwdz
劥	dwj
甕	dwjd
膷	dwjp
颯	dwjq
罋	dwju
頏	dwjv
玈	dwlk
玅	dwmj
邟	dwp
鄐	dwqp
脳	dwxu
迒	dwz
竍	dx
肍	dx
豙	dx
攱	dxa
胈	dxad
肒	dxd
斒	dxdh
斏	dxdk
辡	dxdx
辧	dxdx
辬	dxdx
贇	dxfv
鳼	dxgh
鴍	dxgh
斍	dxgw
斉	dxh
剤	dxhn
膹	dxhv
辯	dxix
膸	dxiz
斖	dxjf
斎	dxji
產	dxjl
彥	dxjs
顏	dxjv
顡	dxjv
辦	dxjx
乵	dxl
肬	dxld
斕	dxnm
斊	dxp
蚉	dxq
螡	dxqq
斔	dxqv
螤	dxqv
彣	dxs
﨎	dxta
竳	dxtv
膯	dxtv
忞	dxu
朡	dxua
離	dxui
膌	dxvd
辮	dxwx
脄	dxx
腅	dxx
対	dxxd
脙	dxxd
脪	dxxi
朥	dxxj
爒	dxym
斈	dxz
竨	dybx
肰	dyd
劑	dydn
牽	dyni
胋	dyo
夞	dyot
臚	dyqq
膫	dyvm
郂	dyvp
欬	dyvv
脥	dyvv
賌	dyvv
頦	dyvv
迯	dyz
廸	dz
肊	dz
辺	dz
迌	dz
胇	dzsn
膙	dzsq
攺	ea
峂	eadd
瑵	eadq
峯	eaf
琒	eaf
峈	eao
峉	eao
琩	ebb
琝	ebdx
珅	ebi
瑆	ebjl
崵	ebjs
瑒	ebjs
嵵	ebld
嵎	ebng
瑥	ebq
嵑	ebsl
崼	ebtl
瑅	ebtl
崵	ebts
瑒	ebts
崐	ebu
崑	ebu
峫	ecip
珋	ecjp
嶃	ecjt
嶄	ecjt
瑮	ecm
嶇	ecoo
岇	ecp
崏	ectb
琘	ectb
岻	ectd
嶜	ecwb
璉	ecz
夛	ed
屶	ed
岄	ed
岦	ed
峀	ed
玊	ed
峕	edb
璄	edbw
嵥	edcm
屻	edd
岃	edd
巃	edde
巄	edde
瓏	edde
璾	eddh
剻	eddn
崀	edek
珫	edgw
崺	edhc
瑂	edjg
翙	edjj
嵼	edjl
嵃	edjs
瑤	edlu
嵭	ednh
崹	edni
瓋	ednz
岧	edo
岹	edo
玿	edo
琣	edo
巐	edoh
嵜	edoi
嵪	edoo
嵉	edot
瓌	edqk
璮	edqt
瑈	edtm
嵜	edto
璚	edto
﨑	edto
峧	edvx
崒	edvx
崪	edvx
珓	edvx
琗	edvx
玹	edw
峷	edx
珳	edxs
玣	edy
峐	edyv
屾	ee
璱	eeej
峍	eef
珒	eef
選	eehz
璕	eeid
璛	eeik
璶	eeiq
峮	eejo
珺	eejo
峎	eek
珢	eek
璶	eelq
琹	eem
琲	eene
琭	ees
瓗	eeto
嵦	eetv
巺	eetv
珡	eev
瑃	eevb
琫	eevf
瑧	eevh
琌	eevj
亗	ef
屽	ef
峬	ef
玕	ef
玗	ef
玤	ef
璷	efda
衋	efjq
珷	eflv
琎	efnz
嶊	efti
玞	efv
瓉	efvv
岏	efw
岠	eg
岴	eg
岶	eg
鱀	egch
塈	egcl
璬	egda
嵧	egdq
瑠	egdq
崲	ege
瑝	ege
鵖	eggh
嵾	eggs
峅	egh
嶋	egh
嶌	egh
鳿	egh
崥	egjx
琕	egjx
璼	egkq
珆	ego
堲	egpl
瑔	egs
珼	egv
崱	egvn
巊	egvr
瓔	egvr
峴	egw
玧	egw
現	egw
嶱	ehbl
嵙	ehdx
嵁	ehel
璂	ehel
玵	ehf
璓	ehhj
玴	ehl
瓂	ehlq
峲	ehn
璊	ehnd
嵽	ehni
璊	ehnn
巏	ehoi
瓘	ehoi
巈	ehpx
崣	ehr
璥	ehsa
瓈	ehss
瓁	ehta
璍	ehtf
瑹	ehvm
嵽	ehwi
琇	ehzj
屸	ei
玒	ei
琂	ei
訔	ei
鬫	eiea
鬪	eied
鬥	eiei
鬧	eiei
鬮	eiel
鬮	eieq
鬬	eiet
鬭	eiet
鬨	eiev
鬩	eiew
鬦	eiex
鬮	eiex
鹔	eijt
鷫	eikh
肅	eikk
歗	eikv
彠	eioa
尋	eiod
鄩	eiop
	eit
盡	eitq
賮	eitv
屴	ej
屵	ej
玏	ej
岥	eja
崢	ejei
嵣	ejeo
嵻	ejes
嵻	ejex
嵈	ejfa
峩	ejfx
珴	ejfx
瑫	ejg
夓	ejga
巎	ejga
嵲	ejgm
崸	ejgv
頊	ejgv
巁	ejhg
瓑	ejhl
瑖	ejia
嶾	ejiu
珝	ejj
岅	ejja
嶍	ejjg
珕	ejjj
嵺	ejjs
璆	ejjs
岓	ejjt
瓆	ejjv
峸	ejjx
珹	ejjx
璻	ejjx
岓	ejk
嶼	ejkv
璵	ejkv
珄	ejl
崕	ejll
峼	ejlo
巑	ejlv
瓚	ejlv
珗	ejlw
珽	ejlz
璦	ejna
瓇	ejna
剬	ejnn
峏	ejnn
珦	ejno
歂	ejnv
顓	ejnv
瑌	ejny
羣	ejof
瑀	ejog
焄	ejoh
鵘	ejoh
帬	ejoi
裠	ejok
頵	ejov
覠	ejow
巋	ejpi
瑡	ejpi
嶭	ejpx
瓇	ejqa
嵟	ejti
崜	ejtl
嵅	ejtx
嵗	ejtx
珬	ejtx
瑊	ejtx
嶏	ejul
嶡	ejvv
嶥	ejvv
嵠	ejwy
崜	ejxf
嶓	ejxq
璠	ejxq
崡	ejxu
岆	ejy
嶠	ejyo
岯	ejyt
琈	ejz
嵨	ejzh
瑦	ejzh
岋	ejzn
嶈	ekdd
璳	ekmv
乢	el
玌	el
	el
書	elb
晝	elbt
崝	eld
璈	elha
璑	elhh
盡	elhq
賮	elhv
嶹	eljd
璹	eljd
瓙	eljh
琁	eljl
璏	eljt
瑑	eljx
岝	elk
岞	elk
崶	elld
嶢	ellw
嶤	ellw
琡	elma
劃	elqn
珻	elqs
瑇	elqs
畫	elqt
畵	elqu
瓄	elqv
玼	elt
峠	eltd
嶻	eltx
崚	elva
玝	elx
珤	elxu
玔	em
嵖	embt
嵀	emde
耲	emdk
耟	emg
耛	emgo
耯	emha
耤	emhb
耚	emja
耰	emja
耞	emjo
頛	emjv
巀	emjx
耫	emlv
崊	emm
璴	emml
鹔	emnt
耬	emor
耝	emqf
	emqg
耡	emqj
	emqt
耓	emt
耣	emvh
耭	emwx
耮	emxj
嶘	emxx
彚	enbm
琿	enc
璭	encz
玬	end
輩	enec
猆	ened
琲	enee
餥	enek
靟	enel
棐	enem
剕	enen
婓	ener
奜	eney
琓	enfw
瑸	engv
帇	eni
珃	enl
琱	enlo
峖	enr
珘	ens
岮	ent
琔	entl
瓓	entm
峝	ento
瑄	entt
璌	entv
璸	entv
岤	env
崗	enve
瑏	envj
嵱	envo
瑢	envo
峵	enxg
岟	eny
琄	eod
珵	eoe
珿	eol
巖	eooa
巗	eooa
璪	eoom
嵓	eooo
崿	eoos
嶯	eopx
嶉	eoti
嶁	eotr
岲	eow
邖	ep
嶐	epal
嶎	epfd
瑘	epp
瑉	eptb
崫	epue
崌	epxo
瓍	epxz
玾	eq
嶵	eqee
岨	eqf
珇	eqf
璝	eqgv
嶧	eqlx
嶧	eqly
嶵	eqne
瓃	eqqq
嵔	eqtk
環	eqtk
琾	eqvn
崓	eqxo
瑻	eqxv
珚	eqy
崅	er
嶑	erbx
嶰	erdi
琤	erei
峗	erjc
峞	erjc
嶦	erji
珎	erm
瓊	erna
瑍	erny
嶑	erox
汖	es
玙	es
崉	esb
珣	esb
璅	esbm
玓	esd
玸	ese
嶶	esea
嵂	esef
璖	esgm
瑪	esh
埊	esl
崻	esld
琺	eslg
玽	eso
崰	esq
盝	esq
岉	ess
嵷	esvl
嵸	esvl
瑽	esvl
瑼	etbd
崠	etbm
崬	etbm
峘	etbt
璤	etbu
峺	etbx
璢	etcq
璷	etda
峬	etdd
峛	etdn
峢	etdn
崨	etel
峌	etgl
巓	etgv
崋	ethf
琟	eti
峳	etia
嶕	etih
嶣	etih
嶲	etim
巂	etio
酅	etip
璡	etiz
巎	etja
嵿	etjv
珁	etld
璢	etnq
敱	etoa
敳	etoa
獃	etod
剴	eton
瓎	etov
豈	etov
顗	etov
凱	etow
覬	etow
琙	etox
瑓	etqm
岼	etvi
玶	etvi
崍	etvm
琜	etvm
峽	etvv
屼	etw
峓	etzv
玭	eu
嶆	eub
嶀	eufs
瑎	eug
珌	euj
嶩	eujk
嶿	eujn
瓀	eujn
琠	euv
兲	ev
崟	ev
崯	ev
玐	ev
琻	ev
	ev
惷	evbu
玱	evc
岎	evd
瑐	evdn
嵢	evdo
瑲	evdo
峑	eve
嵰	evem
嶬	evex
嵄	evey
珜	evf
嵳	evfi
瑳	evfi
琷	evfl
玜	evg
嵡	evgj
憃	evgu
岒	evj
玪	evj
巙	evja
岺	evjd
琀	evjo
巕	evjr
嶺	evjv
峜	evl
巙	evla
岕	evn
玠	evn
嶒	evqb
璔	evqb
嶔	evrv
璯	evtb
崘	evth
崙	evth
嶖	evtj
崳	evtn
峆	evto
峇	evto
珨	evto
嶮	evtv
崄	evtw
崷	evu
嶟	evud
璲	evxz
珶	evzj
琑	ewd
珰	ewe
瓅	ewgm
瑣	ewgv
岰	ewj
巌	ewja
嵐	ewjq
瑺	ewni
璫	ewnq
峿	ewo
珸	ewo
珱	ewr
珟	ewtd
嶪	ewtm
嶫	ewtm
珖	eww
蠿	ewwq
璣	ewwx
峟	exd
珛	exd
彟	exda
珔	exiz
嶽	exjd
嶳	exll
粛	exn
嵮	exqv
巔	exqv
璒	extv
峣	extw
嵏	exua
嵕	exua
彛	exvh
崍	exvv
琜	exvv
彞	exwh
琖	exx
琋	exxi
嶗	exxj
嶸	exxm
巆	exxo
琽	eyb
琸	eybx
輋	eyc
峚	eyl
岾	eyo
瓐	eyqq
峔	eyt
珯	eyt
巘	eytd
巚	eytd
瓛	eytd
巇	eytx
嶚	eyvm
嶛	eyvm
璙	eyvm
峽	eyvv
辿	ez
迋	ez
瑋	ezii
屷	ezj
玚	ezs
岪	ezsn
嵹	ezsq
嵶	ezsv
玦	ezv
叐	fa
攼	fa
	faa
扠	fad
摓	fafz
挌	fao
掻	faq
拠	faw
揝	fayb
抇	fb
撔	fbdm
擝	fbdq
捜	fbia
搨	fbjj
揚	fbjs
捚	fbl
捑	fbly
捰	fbm
掦	fbss
掲	fbst
揚	fbts
掍	fbu
扡	fc
拪	fc
捙	fc
搟	fcf
摽	fcfm
捓	fcip
摲	fcjt
搮	fcm
剨	fcn
摳	fcoo
擓	fcsi
捪	fctb
扺	fctv
抈	fd
摬	fdbw
搩	fdcm
扨	fdd
拸	fdd
掤	fdd
攏	fdde
擠	fddh
旉	fdh
揓	fdhc
懯	fdhu
摌	fdjl
挔	fdk
攍	fdld
搖	fdlu
齧	fdlu
栔	fdm
搒	fdnh
揥	fdni
擿	fdnz
撴	fdoa
揨	fdot
揙	fdph
蛪	fdq
觢	fdr
洯	fds
挍	fdvx
擁	fdwi
絜	fdwm
摛	fdxg
攡	fdxi
抃	fdy
撁	fdyi
抂	fe
揤	fegp
摡	fegw
挵	feh
撏	feid
掃	feni
捸	fes
攜	feto
摏	fevg
搸	fevh
挦	fexd
扜	ff
扞	ff
拝	ff
揳	ffdy
豒	ffej
艷	ffel
豓	ffeq
豔	ffeq
豐	ffev
熭	ffex
抎	ffg
麉	ffju
抺	ffm
栞	ffm
挷	ffp
郉	ffp
扝	ffs
弐	ffv
攆	ffvc
攅	ffvv
摫	ffvw
抏	ffw
払	fg
拞	fg
挋	fg
摼	fgal
撽	fgda
捳	fge
揘	fge
搗	fge
叇	fgez
撡	fggd
摻	fggs
鳱	fgh
鵏	fgh
揑	fgi
叆	fgja
攬	fgkw
捠	fgv
捘	fgva
攖	fgvr
貮	fgvv
抁	fgw
挸	fgw
掜	fgw
撪	fgyc
擖	fhbl
撗	fhdv
揕	fhel
掑	fhev
拑	fhf
擛	fhhm
抴	fhl
摕	fhni
攤	fhoi
擹	fhov
搑	fhp
捼	fhr
撶	fhtf
摕	fhwi
攃	fhxm
掿	fhxo
擆	fhyb
摃	figv
擫	fjbd
掋	fjcd
抸	fjdz
掙	fjei
掶	fjev
抙	fjf
搙	fjfd
揺	fjfu
拡	fjg
搯	fjg
搝	fjgd
頇	fjgv
抍	fjh
攊	fjhl
擴	fjhv
韨	fjia
挧	fjj
晢	fjjb
硩	fjjc
搚	fjjd
揗	fjjg
撝	fjjh
焎	fjjh
拹	fjjj
挀	fjjk
裚	fjjk
埑	fjjl
梊	fjjm
娎	fjjr
摎	fjjs
悊	fjju
擨	fjjv
銴	fjjv
鋬	fjjv
烲	fjjx
乴	fjjz
攑	fjkf
攪	fjkw
揟	fjld
捁	fjlo
攢	fjlv
摵	fjlx
挻	fjlz
採	fjm
攠	fjme
擵	fjmf
扖	fjn
擾	fjna
擙	fjny
拁	fjo
夀	fjod
搥	fjpz
擾	fjqa
摠	fjqu
扥	fjt
捬	fjtd
挿	fjti
揷	fjti
揰	fjtl
揻	fjtx
扷	fjy
抔	fjy
撟	fjyo
抷	fjyt
捊	fjz
摀	fjzh
攈	fjzh
攟	fjzh
摝	fjzu
攗	fjzx
扸	fk
掁	fk
摪	fkdd
擌	fktv
抶	fkv
擶	fkvn
撘	fkvo
扗	fl
摥	flbs
掯	fld
抾	flg
撫	flhh
擣	fljd
攭	fljq
撓	fllw
掛	flly
捇	flm
掓	flma
撎	flnv
擡	flol
擷	flov
挴	flqs
挊	fltd
擮	fltx
鵡	flvh
虣	flvw
撻	flvz
紥	flwm
拤	fly
扢	flz
逰	flzz
剺	fmad
犛	fmai
氂	fmal
釐	fmal
斄	fmam
漦	fmas
斄	fmav
孷	fmaz
祘	fmfm
挘	fmjj
毮	fmjl
礼	fml
捫	fn
揢	fnao
擱	fnao
揮	fnc
丼	fnd
撊	fnd
捥	fndc
刱	fndv
撋	fne
攐	fnfk
攓	fnfl
搳	fnfo
攇	fnfu
捖	fnfw
挓	fnjt
坓	fnl
抩	fnl
捾	fnpz
汬	fns
拕	fnt
摍	fntb
冓	fntl
攔	fntm
挏	fnto
擯	fntv
顜	fntv
覯	fntw
斠	fntx
擰	fnut
抐	fnv
揬	fnvd
摉	fnvd
攨	fnvn
搈	fnvo
攛	fnvv
抭	fnw
	fnx
邫	fodl
挰	foe
損	fogv
捛	foo
撣	foox
擑	fopx
喸	fot
擻	fota
摟	fotr
抧	fov
拀	fow
挕	fp
邘	fp
郙	fp
掫	fpa
搱	fpdx
幚	fpgi
捤	fpjl
挶	fpjo
択	fpn
攝	fppp
摨	fpsi
抳	fpt
摂	fpx
撱	fpxd
盙	fq
搰	fqd
抯	fqf
擺	fqgt
撌	fqgv
擇	fqlx
擇	fqly
撾	fqoz
攌	fqqk
攂	fqqq
擉	fqsq
揋	fqtk
摑	fqtx
揌	fqu
掑	fqv
摜	fqxv
捔	fr
擼	frhb
擔	frji
換	frny
攙	frod
亐	fs
	fsc
抅	fsg
揈	fsi
挱	fsmj
揔	fssu
抣	fsv
摐	fsvl
迃	fsz
摶	ftbd
挭	ftbx
挒	ftdn
捿	fter
挃	ftgl
捯	ftgn
	ftia
撨	ftih
擕	ftim
斲	ftjk
拰	ftjl
斲	ftjt
擬	ftll
掚	ftnd
拺	ftnm
攦	ftnu
抲	fto
捒	ftom
揊	ftoq
摗	ftov
攋	ftov
掝	ftox
搹	ftoy
揀	ftqm
挳	ftsi
挾	ftvv
擟	ftvx
搢	ftwb
掗	ftxt
摤	ftxv
挗	ftzv
忈	fu
抋	fu
摴	fufs
擃	fujk
擩	fujn
捵	fuv
捦	fv
摿	fvdb
扵	fvdd
揃	fvdn
搶	fvdo
攁	fvek
輦	fvfc
撯	fvfg
捨	fvfo
鄻	fvfp
鄼	fvfp
賛	fvfv
鳺	fvgh
槼	fvgm
嫢	fvgr
捴	fvgu
規	fvgw
鬹	fvgy
搇	fvjk
扴	fvn
椝	fvnm
鬶	fvny
搃	fvou
挩	fvow
捝	fvow
邞	fvp
撳	fvrv
抮	fvs
掄	fvth
揜	fvth
捈	fvtm
掵	fvtp
撿	fvtv
揂	fvu
擲	fvup
搤	fvvq
攕	fvvx
掽	fvwt
捲	fvyc
搼	fvyf
挮	fvzj
擽	fwgm
兘	fwgo
抝	fwj
頑	fwjv
坖	fwl
挆	fwm
撧	fwml
刓	fwn
攩	fwnh
撐	fwnj
摚	fwnl
擋	fwnq
撹	fwnw
邧	fwp
黿	fwq
擈	fwtm
撲	fwtv
挄	fww
扏	fx
抜	fxa
撠	fxbx
尃	fxd
撛	fxdi
摖	fxfm
覝	fxgw
拵	fxiz
拋	fxlj
摋	fxma
刬	fxn
扙	fxn
擜	fxnd
抪	fxni
挬	fxnz
搷	fxqv
攧	fxqv
撜	fxtv
拻	fxx
掞	fxx
捄	fxxd
撈	fxxj
攚	fxxo
撥	fxza
捗	fy
摦	fyfn
揁	fygv
摢	fyji
摣	fyqf
擄	fyqj
攎	fyqq
攄	fyqu
搘	fytb
揯	fytt
搄	fytt
挾	fyvv
據	fyx
捹	fyxh
摤	fyxx
撦	fyyb
乶	fz
迀	fz
挅	fzjm
搎	fzjm
摾	fzsq
扟	fzx
敀	ga
臤	ga
硻	gac
竪	gad
腎	gad
賢	gagv
掔	gajf
堅	gal
蜸	gaq
婜	gar
豎	gatv
鋻	gav
緊	gawm
孯	gaz
贠	gb
皔	gbf
睅	gbf
眒	gbi
睲	gbjl
睗	gbss
睼	gbtl
瞫	gcbx
瞘	gcoo
睧	gctb
眡	gctd
眂	gctv
眓	gcx
眀	gd
瞕	gdbx
矓	gdde
朢	gde
瞮	gdga
鄮	gdgp
貿	gdgv
眆	gdh
鸄	gdhh
譥	gdhi
睸	gdjg
眿	gdjx
裊	gdk
皅	gdl
盳	gdl
眧	gdo
眳	gdo
皜	gdoo
睙	gdpd
鶹	gdqh
鹠	gdqt
斵	gdtk
瞲	gdto
螚	gdtq
斵	gdtt
態	gdtu
熋	gdtx
劉	gdvn
睟	gdvx
盿	gdx
瞝	gdxg
島	ge
巸	ge
皩	gebw
睷	gefz
媐	ger
皠	geti
皚	getv
睶	gevb
盰	gf
盽	gf
眃	gfg
眎	gfm
眛	gfm
瞡	gfvw
盶	gfw
厸	gg
臦	gg
皦	ggda
厽	ggg
皛	ggg
瞐	ggg
叅	gggd
叄	ggge
亝	gggf
毿	gggl
皨	gggl
絫	gggm
剼	gggn
參	gggs
遪	gggz
瞗	ggh
矈	ggnh
鷪	ggnh
瞾	ggni
斚	ggnx
鸜	ggth
戵	ggtx
愳	ggu
貟	ggv
睍	ggw
煛	ggx
燛	ggx
瞁	ggyd
臩	ggyn
皞	ggyx
鳥	gh
鴤	ghad
鴼	ghao
鵿	ghbh
鸔	ghbs
瞙	ghby
鷻	ghda
鵦	ghes
鵔	ghga
鴘	ghgh
鶃	ghgw
鸌	ghha
瞸	ghhm
鶀	ghhv
鳨	ghj
鶳	ghji
鷈	ghjw
瞞	ghnd
瞞	ghnn
鴕	ghnt
鴥	ghnv
矇	ghnx
矔	ghoi
鄥	ghp
矒	ghqg
鷌	ghsh
矆	ghta
皣	ghtf
瞱	ghtf
鴚	ghto
鴏	ghtv
鵌	ghvm
鸃	ghvx
鳧	ghw
睰	ghxo
矁	ghxu
鳦	ghz
鴃	ghzv
鄋	giap
遚	giaz
劰	gj
巪	gj
睜	gjei
瞊	gjeo
皒	gjfx
睋	gjfx
矏	gjgh
頣	gjgv
頤	gjgv
皥	gjgx
矋	gjhg
矌	gjhv
眅	gjja
瞃	gjjg
矅	gjji
眽	gjjk
盺	gjjt
盺	gjk
皧	gjna
瞹	gjna
皭	gjqd
矄	gjth
鵯	gjxh
皫	gjzh
覧	gkgw
鴾	gkih
劺	gkij
監	gkq
擥	gkqf
譼	gkqi
鑒	gkqv
覽	gkqw
眣	gkv
鍳	gkv
癿	gl
皘	gld
鼫	gldc
鼲	gldc
鼣	gldd
鼥	gldd
鼨	gldd
鼭	gldd
鼱	gldd
鼳	gldd
鼵	gldd
鼪	gldl
鼸	gldm
鼦	gldo
鼩	gldo
鼺	gldq
鼴	gldr
鼧	gldt
鼰	gldv
鼶	gldw
鼤	gldx
鼮	gldz
皟	glgv
瞔	glgv
賾	glgv
瞴	glhh
皢	gllw
県	glm
瞦	gloo
臨	gloo
睵	glox
郻	glsp
皉	glt
睖	glva
毀	glwa
盬	glxq
鹽	glyq
欸	glyv
逘	glyz
厼	gm
梟	gm
鄡	gmp
瞷	gnb
睴	gnc
瞯	gnd
睕	gndc
瞤	gne
睆	gnfw
帠	gni
緜	gnim
矙	gnja
皗	gnlo
睭	gnlo
眝	gnt
眮	gnto
睻	gntt
瞚	gntv
矉	gntv
矃	gnut
眏	gny
睊	god
辝	godx
睈	goe
贒	goiv
乨	gol
枲	gom
刣	gon
矂	goom
瞣	goou
瓵	gotd
瞜	gotr
眖	gow
眲	gp
睱	gpfa
朂	gpj
矚	gpsq
屔	gpt
眤	gpt
畠	gq
瞶	gqgv
睏	gqm
螶	gqq
睤	gqtn
矎	grna
睌	grow
眴	gsb
矀	gsea
灥	gsgs
舃	gsh
眗	gso
盷	gsv
瞛	gsvl
皀	gt
墍	gtcl
槩	gtcm
曁	gtct
旣	gtcw
眰	gtgl
眐	gtl
皍	gtlp
皌	gtm
眜	gtm
矖	gtnu
眪	gtnv
卽	gtp
睞	gtvm
眱	gtzv
皬	guti
矐	guti
睓	guv
臥	gv
貝	gv
夋	gva
敗	gva
鵕	gvah
賂	gvao
賵	gvbg
賜	gvbs
貤	gvc
貾	gvcd
贉	gvcx
贚	gvde
賠	gvdo
賅	gvdv
貥	gvdw
斞	gvdx
賋	gvdx
賥	gvdx
賰	gveb
贐	gveq
賎	gvex
眻	gvf
賻	gvfd
購	gvfl
賦	gvfv
貦	gvfw
賐	gvga
贁	gvga
甖	gvgd
鵙	gvgh
鸎	gvgh
鸚	gvgh
譻	gvgi
瞈	gvgj
貽	gvgo
嬰	gvgr
贂	gvgs
罌	gvgu
賏	gvgv
贔	gvgv
鑍	gvgv
皏	gvh
贎	gvhg
贜	gvhx
販	gvja
貱	gvja
賘	gvjd
賑	gvjk
貹	gvjl
賍	gvjl
賉	gvjq
賿	gvjs
貶	gvjz
賬	gvk
贓	gvkx
	gvld
贖	gvlv
賳	gvlx
則	gvn
賱	gvnc
賵	gvng
賝	gvnm
賩	gvnm
賙	gvno
貯	gvnt
賗	gvoi
貺	gvow
郥	gvp
贍	gvri
眕	gvs
賯	gvsz
瞺	gvtb
賻	gvtd
睔	gvth
睮	gvtn
蠈	gvtq
盻	gvts
瞼	gvtv
賊	gvtx
惥	gvu
賟	gvuv
贈	gvvb
賆	gvvh
睉	gvvl
賒	gvvm
賖	gvvm
賺	gvvm
賶	gvvo
賹	gvvq
贌	gvwv
贘	gvwv
戝	gvx
眫	gvx
賄	gvxd
賕	gvxd
財	gvxj
賤	gvxx
賧	gvxx
眹	gvy
賭	gvyb
睠	gvyc
贆	gvyd
貼	gvyo
兒	gw
皃	gw
見	gw
鳬	gw
鬾	gwga
魎	gwgd
魓	gwgf
鶂	gwgh
魋	gwgi
皪	gwgm
魐	gwgm
魒	gwgm
魀	gwgn
鬽	gwgs
鬿	gwgt
魖	gwgt
魌	gwgv
覞	gwgw
魊	gwgx
魕	gwgx
眑	gwj
矊	gwmi
矘	gwnh
郳	gwp
覹	gwsa
瞨	gwtv
覐	gwxx
覎	gwz
皁	gx
	gxr
睞	gxvv
毇	gxwa
皐	gxx
睒	gxx
睎	gxxi
翶	gxxj
奙	gybl
軬	gyc
狊	gyd
鶪	gydh
郹	gydp
	gydt
貵	gygv
睳	gyll
矑	gyqq
鷎	gyxh
乬	gz
廹	gz
芆	had
苳	hadd
莑	haf
茖	hao
蕌	hbbb
馤	hbbl
馧	hbbq
馡	hbee
稈	hbf
萺	hbg
鵲	hbgh
馫	hbhb
蓽	hbhf
皵	hbja
斮	hbjk
斮	hbjt
馟	hbjz
荲	hbl
蒔	hbld
葃	hblk
菒	hbm
菓	hbm
剒	hbn
荝	hbn
馡	hbne
萬	hbng
勱	hbnj
躉	hbnl
蠆	hbnq
馪	hbnv
邁	hbnz
穝	hbpa
馜	hbpt
蒀	hbq
菎	hbu
馝	hbuj
馚	hbvd
馦	hbvm
馠	hbvo
茰	hbx
馛	hbxa
馩	hbxv
馢	hbxx
馞	hbxz
驀	hbyh
謩	hbyi
馣	hbyl
鄚	hbyp
蟇	hbyq
逪	hbz
莗	hc
藞	hccc
蓒	hcf
蔈	hcfm
蕥	hcii
蔪	hcjt
薽	hcld
蘙	hclj
蓲	hcoo
葽	hcr
秪	hctd
茋	hctd
秖	hctv
蘻	hcum
苉	hcw
蓮	hcz
秞	hd
芀	hd
芕	hd
苖	hd
苙	hd
萻	hdb
穜	hdbl
蕫	hdbl
﨟	hdbl
蔁	hdbx
荈	hdci
稝	hdd
茤	hdd
萠	hdd
茘	hddd
蘢	hdde
穧	hddh
薺	hddh
萉	hddl
虀	hddt
荵	hddu
蓪	hddz
蓢	hded
蓈	hdep
葹	hdhc
蔙	hdhl
苚	hdi
荕	hdj
葿	hdjg
蒍	hdjh
葄	hdlk
莣	hdlu
藽	hdmw
蔏	hdno
蔐	hdno
蓪	hdnz
藡	hdnz
稖	hdo
藳	hdoh
蘘	hdok
稤	hdom
蔀	hdop
薧	hdot
藃	hdov
稕	hdoz
茒	hdp
菺	hdpd
稨	hdph
蔰	hdpl
菨	hdr
葋	hdso
蒟	hdso
芧	hdt
鶜	hdth
蓩	hdtj
葇	hdtm
蕷	hdtv
黈	hdve
虅	hdvh
鷬	hdvh
蕂	hdvj
黅	hdvj
穣	hdvk
蓘	hdvk
蔉	hdvk
蕵	hdvk
黆	hdvl
黊	hdvl
黇	hdvo
萒	hdvw
斢	hdvx
稡	hdvx
秔	hdw
苀	hdw
稸	hdwq
芠	hdx
藙	hdxa
萕	hdxh
蘺	hdxi
秈	he
茟	hef
莭	hegp
穊	hegw
蔇	hegw
蕁	heid
蕭	heik
藎	heiq
芛	hej
蔒	hejh
莙	hejo
藎	helq
菷	heni
韮	hent
蕜	henu
蘁	heoo
菉	hes
萶	hevb
夦	hevd
朞	hevd
菶	hevf
諅	hevi
尠	hevj
棊	hevm
剘	hevn
蜝	hevq
蟴	hevq
惎	hevu
歁	hevv
卙	hevx
秿	hf
芉	hf
萚	hfaf
菈	hfd
菗	hfd
萔	hfdo
稧	hfdy
蒱	hff
蔧	hffe
荴	hffv
蘴	hffv
秐	hfg
甛	hfjo
葀	hfjo
苿	hfm
莏	hfmj
蘀	hfqx
蘀	hfqy
芌	hfs
蒱	hftd
蓷	hfti
蓵	hftl
蒪	hfxd
秬	hg
苩	hg
茊	hg
茝	hg
茞	hg
菣	hga
藖	hgav
薂	hgda
藰	hgdn
蒥	hgdq
葟	hge
藠	hggg
穇	hggs
蔘	hggs
穒	hgh
萛	hgh
蔦	hgh
蓃	hgia
蘤	hgjh
薡	hgkk
藍	hgkq
秮	hgo
葈	hgom
葲	hgs
菂	hgsd
蕮	hgsh
稄	hgva
荾	hgva
萴	hgvn
蘡	hgvr
莧	hgw
萖	hgw
萈	hgwd
蒐	hgwg
藥	hgwm
蔝	hgx
薬	hgxm
藈	hgxy
繤	hgym
	hgys
秝	hh
稓	hhb
稥	hhb
萫	hhb
藒	hhbl
蘣	hhde
藊	hhdh
蘳	hhdl
穔	hhdv
萪	hhdx
蘛	hhed
藄	hhem
稘	hhev
薭	hhgx
蘒	hhjx
薐	hhla
葉	hhlm
蔕	hhni
萂	hho
蓳	hhol
穁	hhp
蘜	hhpx
蒩	hhqf
蘶	hhrg
蘓	hhrh
蘒	hhrl
菞	hhsj
蔾	hhsm
穫	hhta
蕛	hhvj
蕱	hhwd
蔕	hhwi
蘈	hhwv
萩	hhx
萟	hhxd
藹	hibl
丱	hii
卄	hii
卝	hii
艸	hii
	hii
蘐	hija
莁	hivv
蔎	hiwa
茿	hiwd
虊	hiwm
蒆	hiwr
藷	hiyb
艻	hj
秛	hja
蘷	hjba
薶	hjbl
菧	hjcd
薍	hjdl
荗	hjdx
蓎	hjeo
穅	hjes
穏	hjeu
菮	hjev
穅	hjex
萲	hjfa
莀	hjfk
秏	hjfl
芼	hjfl
蓞	hjg
藱	hjgg
蒝	hjgm
虈	hjgo
蒠	hjgu
蔵	hjgx
蕆	hjgx
蓆	hjhi
藶	hjhl
穬	hjhv
葮	hjia
稲	hjib
穩	hjiu
蒑	hjja
蔿	hjjh
藋	hjji
苽	hjjn
蓏	hjjn
茩	hjjo
荿	hjjx
菦	hjjz
虋	hjkd
穥	hjkv
藇	hjkv
苼	hjl
稰	hjld
龝	hjll
蘨	hjlm
穳	hjlv
龝	hjlx
莚	hjlz
藦	hjmf
蔴	hjmm
薆	hjna
蕣	hjni
稱	hjnl
荋	hjnn
稬	hjny
薁	hjny
莵	hjod
萭	hjog
蒒	hjpi
蘬	hjpi
躠	hjpl
糵	hjpx
龝	hjq
穱	hjqd
蔥	hjqu
秅	hjt
薫	hjth
蘍	hjtj
種	hjtl
菙	hjtl
葴	hjtx
苸	hjvi
蓙	hjvl
薕	hjvm
蒵	hjwy
秊	hjx
菙	hjxf
秳	hjxo
秗	hjy
芺	hjy
蓭	hjyl
穚	hjyo
蕎	hjyo
秠	hjyt
蒧	hjyx
穮	hjzh
薦	hjzh
藨	hjzh
薼	hjzl
蔍	hjzu
蘪	hjzx
萇	hk
蔣	hkdd
蕼	hkef
荘	hkl
莊	hkl
秼	hkm
鷰	hkoh
酀	hkop
嬊	hkor
苝	hkt
苵	hkv
蘠	hkxo
芞	hkz
稪	hlba
勚	hlbj
蘾	hldk
勩	hlgj
蓋	hlgq
積	hlgv
蔶	hlgv
貰	hlgv
蔜	hlha
蕪	hlhh
荍	hlia
薵	hljd
穢	hljx
蒃	hljx
薉	hljx
秨	hlk
苲	hlk
茥	hll
蕋	hlll
蘃	hllm
穘	hllw
蕘	hllw
枼	hlm
茮	hlm
薣	hloa
薳	hloz
藚	hlqv
荺	hlsv
稜	hlva
蕔	hlva
蓺	hlvd
蓻	hlvd
藝	hlvg
爇	hlvh
稑	hlvl
薘	hlvz
秲	hlxd
蒛	hlxv
蕔	hlya
蓻	hlyd
迣	hlz
藲	hmco
蒁	hmdz
荰	hml
蓕	hmll
菻	hmm
莕	hmo
萙	hmpl
藮	hmth
繭	hmwq
菛	hn
蕳	hnb
蓂	hnbv
葷	hnc
蕑	hnd
韮	hnet
蕜	hneu
苚	hnf
荢	hnf
蔲	hnfa
蒄	hnfd
藆	hnff
萺	hnfg
鸏	hnfh
氋	hnfl
萗	hnfm
鹲	hnft
藛	hngh
芇	hni
顢	hniv
秺	hnjt
藼	hnlu
帯	hnni
帶	hnni
慸	hnnu
遰	hnnz
蔄	hno
萓	hnqf
荌	hnr
蔅	hnr
蒬	hnrd
蒰	hnsa
苧	hnt
藺	hnti
蘭	hntm
秱	hnto
穦	hntv
蔩	hntv
薲	hntv
悡	hnu
蒏	hnu
蕄	hnu
蔤	hnue
藌	hnuq
薴	hnut
茓	hnv
鋫	hnv
葖	hnvd
	hnvj
菵	hnvl
穃	hnvo
藭	hnvs
萞	hnvu
鶧	hnyh
藔	hnym
茡	hnz
難	hofi
艱	hofk
菋	hofm
囏	hofo
戁	hofu
歎	hofv
臡	hofv
蒷	hogv
莂	hojn
鷰	hokh
酀	hokp
嬊	hokr
莡	hol
斳	holk
蕗	holo
斳	holt
懃	holu
歏	holv
覲	holw
鸛	hooh
雚	hooi
勸	hooj
虈	hooo
鄿	hoop
酄	hoop
飌	hooq
蕚	hoos
蘄	hoot
歡	hoov
顴	hoov
觀	hoow
蕇	hoox
藪	hota
蓶	hoti
蔞	hotr
茣	hoty
惒	hou
荶	hovj
菆	hpa
靫	hpad
蕯	hpal
藂	hpax
鞸	hpbf
韅	hpbh
鞨	hpbl
鞮	hpbl
鞰	hpbq
韆	hpcz
靭	hpdd
薩	hpdl
靱	hpdn
鞀	hpdo
鞛	hpdo
鞹	hpdp
稺	hpdx
蘵	hpdx
鞟	hpdz
鞎	hpek
鞬	hpez
靬	hpf
鞡	hpfd
藯	hpfu
蕸	hpfz
鞞	hpgx
鞂	hph
韄	hpha
鞾	hphf
韉	hphh
靾	hphl
鞢	hphm
韊	hphm
鞳	hpho
鞦	hphx
韈	hphx
蒮	hpii
鞁	hpja
鞱	hpjg
韀	hpjh
荱	hpjl
鞽	hpjo
鞖	hpjr
靵	hpjt
蘟	hpju
鞵	hpjy
靯	hpl
鞐	hpld
鞊	hplo
韇	hplv
韃	hplz
鞚	hpni
靹	hpnv
鞙	hpod
鞓	hpoe
鞻	hpor
靻	hpqf
藬	hpqv
鞼	hpqv
鞇	hpqy
韂	hpri
鞜	hpsb
靮	hpsd
鞄	hpse
穉	hpsi
秜	hpt
苨	hpt
靪	hpt
蔯	hptm
靺	hptm
韁	hptt
鞆	hptv
靰	hptw
鞕	hptx
蔭	hpvg
鞥	hpvh
靲	hpvj
蒢	hpvm
鞈	hpvo
鞧	hpvu
鞉	hpvv
靽	hpvx
靿	hpwj
鞺	hpwl
鞩	hpwn
鞝	hpwo
鞿	hpwx
苢	hpz
鞃	hpzg
靷	hpzi
盉	hq
虄	hqal
稩	hqd
蓇	hqd
莇	hqfj
鶓	hqgh
藣	hqgt
蕒	hqgv
蕢	hqgv
稛	hqh
穓	hqhv
藅	hqin
莮	hqj
蘮	hqjn
薗	hqlk
稇	hqm
蘉	hqna
夢	hqnd
鄸	hqnp
顭	hqnv
薎	hqnx
萵	hqo
薖	hqoz
蘲	hqql
蘽	hqqm
虆	hqqm
藟	hqqq
苺	hqs
薥	hqsq
葨	hqtk
蔮	hqtx
稘	hqv
苬	hqv
蔨	hqvc
莔	hqvn
蒕	hqvq
蘿	hqwi
蔂	hqwm
稒	hqxo
秵	hqy
穐	hrbl
蔛	hrdx
犩	hrgi
萯	hrgv
覣	hrgw
穭	hrhb
蘚	hrhf
蘇	hrhh
薊	hrhn
薝	hrji
葪	hrn
藑	hrna
蒘	hrof
葂	hroj
蕠	hrom
莬	hrow
葌	hrrr
穞	hrtb
瓾	hrtd
蕅	hsbg
蕰	hsbq
蘯	hsbq
蕩	hsbs
薸	hscm
藫	hscx
蓅	hsdm
菬	hsdo
薃	hsdo
蓡	hsea
薓	hsea
藢	hsea
葎	hsef
葏	hsef
芶	hsg
菃	hsg
萡	hsg
菭	hsgo
蘫	hsgq
葓	hshv
剓	hsjd
睝	hsjg
鯬	hsjh
鵹	hsjh
犂	hsji
棃	hsjm
萿	hsjo
蔢	hsjr
蕦	hsjv
錅	hsjv
邌	hsjz
蔋	hsla
蕧	hsla
蔳	hsld
蓗	hsll
蘌	hslm
蓹	hslp
莯	hsm
茍	hso
驚	hsoh
蟼	hsoq
憼	hsou
莐	hspl
菑	hsq
薀	hsqq
茐	hssd
萢	hsse
葕	hssi
薻	hssm
蒞	hstd
蔔	hstq
蒭	hsuj
蓱	hsvh
蓯	hsvl
蒣	hsvm
蒤	hsvm
蕍	hsvn
虃	hsvx
莈	hswa
蒅	hsxm
艼	ht
蓴	htbd
菄	htbm
荁	htbt
穂	htbu
稉	htbx
莄	htbx
芐	htd
苆	htd
秿	htdd
蒪	htdd
薞	htdk
塟	htdl
茢	htdn
薚	htds
穂	htdu
黃	htdv
苮	hte
葠	htea
萐	htel
芢	htf
蘏	htfv
葰	htga
秷	htgl
荎	htgl
菿	htgn
茾	hth
華	hthf
鷨	hthh
荊	hthn
蘔	hthv
雈	hti
蒦	htia
蓨	htid
舊	htig
穛	htih
穕	htim
蓧	htim
蓚	htis
秹	htjl
蒨	htld
莋	htlk
薿	htll
茠	htm
蓛	htna
茦	htnm
蕀	htnm
莿	htnn
穲	htnu
苪	htnv
稶	htod
虉	htoh
茽	htoi
藵	htok
菫	htol
稫	htoq
葍	htoq
荳	htov
藾	htov
稢	htox
蒚	htoy
藗	htoz
萰	htqm
薑	htqt
莖	htsi
葝	htsj
葘	htsq
蒊	httt
萅	htub
芚	htul
蕐	htvf
萊	htvm
莢	htvv
穪	htvx
薾	htvx
茷	htx
稏	htxt
茙	htxx
菾	htyd
芿	htzj
葔	htzy
莤	hu
蓸	hub
蘎	hudl
蕓	hufg
稭	hug
苾	huj
穠	hujk
蕽	hujk
穤	hujn
蘦	huoo
虂	huoo
蘂	huum
蕶	huvd
蓜	huzl
秂	hv
芅	hv
菳	hv
輂	hvc
秎	hvd
葥	hvdn
蒼	hvdo
葐	hvdq
蓔	hveh
稴	hvem
葁	hver
蒫	hvfi
薬	hvgm
荓	hvh
虁	hvja
秢	hvjd
拲	hvjf
莟	hvjo
菍	hvju
蓤	hvla
苶	hvm
虌	hvnq
稅	hvow
莌	hvow
蛬	hvq
薋	hvrv
芲	hvt
蘞	hvta
薈	hvtb
稐	hvth
菕	hvth
葊	hvth
蘥	hvth
鷋	hvth
稌	hvtm
剳	hvtn
萮	hvtn
秴	hvto
荅	hvto
薟	hvtv
蘝	hvtv
蓌	hvva
葅	hvvf
莝	hvvl
遳	hvvz
稵	hvww
秚	hvx
穟	hvxz
菤	hvyc
稊	hvzj
禿	hw
芁	hw
芃	hwd
莦	hwd
萷	hwdn
鵚	hwgh
藥	hwgm
苭	hwj
薌	hwjp
葻	hwjq
頹	hwjv
頽	hwjv
藧	hwma
蘰	hwma
葤	hwmd
葯	hwmd
蒶	hwmd
蔠	hwmd
葒	hwmi
蒓	hwml
蕝	hwml
蕬	hwmm
虊	hwmm
藴	hwmq
蘊	hwmq
蒳	hwmv
蘕	hwmz
帶	hwni
遰	hwnz
穨	hwqv
薱	hwtd
穙	hwtv
茪	hww
茲	hww
穖	hwwx
炗	hx
苂	hx
秓	hxa
苃	hxa
秡	hxad
蔊	hxbf
秇	hxd
穄	hxfm
鴱	hxgh
鶖	hxgh
鹙	hxgt
蕡	hxhv
蕿	hxja
蕏	hxjb
揫	hxjf
莥	hxjt
蕕	hxju
薠	hxjv
嵆	hxle
諬	hxli
蔱	hxma
苅	hxn
萳	hxnx
萳	hxny
秙	hxo
穯	hxoo
鄀	hxop
蠚	hxoq
逽	hxoz
蝵	hxq
稙	hxqe
蒖	hxqv
媝	hxr
湬	hxs
甃	hxtd
醔	hxu
稯	hxua
葼	hxua
鍫	hxv
穡	hxvo
薔	hxvo
萊	hxvv
菚	hxx
菼	hxx
莍	hxxd
莃	hxxi
藀	hxxx
蘱	hxyv
蒾	hxz
蓫	hxz
蕟	hxza
芖	hy
荹	hy
菴	hybl
蘹	hydk
葢	hydq
薒	hydx
荂	hyfs
蘋	hyjv
秥	hyo
蓾	hyqd
蔖	hyqf
蘆	hyqq
藘	hyqu
荖	hyt
莢	hyvv
萀	hyw
莾	hyxh
荙	hyz
秄	hz
芓	hz
稦	hzii
葦	hzii
蓀	hzjm
萾	hzjq
莻	hzjt
頺	hzjv
苰	hzsg
虇	hzsi
苐	hzsj
茀	hzsn
葞	hzsp
蒻	hzsv
芵	hzv
児	ibw
讱	idd
鬥	ieei
诪	ifxd
頥	igjv
貢	igv
慐	igvu
	ihkh
	ihoh
諁	iiaa
訍	iiad
謾	iiba
誯	iibb
訷	iibi
諟	iibl
謁	iibl
謃	iibl
課	iibm
諹	iibs
詚	iibt
訑	iic
諙	iicb
譖	iicb
詆	iicd
誆	iice
訝	iicj
諲	iicl
謤	iicm
謳	iico
譚	iicx
謰	iicz
譈	iida
諳	iidb
訒	iidd
誃	iidd
註	iide
誦	iidf
謧	iidg
訪	iidh
諞	iidh
謗	iidh
諦	iidi
謆	iidj
誏	iidk
譲	iidk
讓	iidk
譅	iidl
諒	iidm
謋	iidm
詔	iido
詺	iido
謞	iido
謪	iido
謫	iido
譎	iido
諺	iids
諪	iidt
譠	iidt
認	iidu
謠	iidu
譩	iidu
該	iidv
詃	iidw
詠	iidx
誶	iidx
識	iidx
譹	iidx
諄	iidz
讁	iidz
訕	iie
誛	iiea
誹	iiee
詪	iiek
誄	iiem
諯	iien
讍	iieo
讗	iieo
譔	iiev
訐	iif
譛	iifb
詽	iiff
講	iifl
譿	iifu
讃	iifv
詎	iig
誜	iiga
謏	iiga
譤	iiga
譭	iiga
諻	iige
謉	iigg
詒	iigo
謲	iigs
諛	iigv
誢	iigw
誽	iigw
諀	iigx
誒	iigy
訸	iih
護	iiha
諎	iihb
謻	iihd
詌	iihf
譁	iihf
讛	iihg
讌	iihh
讙	iihi
誘	iihj
詍	iihl
諶	iihl
謹	iihl
譪	iihl
諜	iihm
謀	iihm
謊	iihm
誗	iihn
諾	iiho
諽	iihp
諉	iihr
誮	iiht
諆	iihv
謨	iihy
亅	iii
訁	iii
訌	iii
誩	iii
譶	iii
誣	iiiv
詖	iija
諼	iija
譀	iija
訴	iijd
諝	iijd
諈	iijf
詯	iijg
謟	iijg
謵	iijg
謶	iijh
譌	iijh
詡	iijj
誫	iijk
諈	iijl
諥	iijl
讈	iijl
謜	iijm
譧	iijm
訯	iijn
詞	iijo
詬	iijo
話	iijo
誥	iijo
譑	iijo
譒	iijq
謬	iijs
託	iijt
訢	iijt
謡	iiju
謥	iiju
讚	iijv
詵	iijw
謕	iijw
誐	iijx
誠	iijx
諴	iijx
訞	iijy
謑	iijy
誔	iijz
誕	iijz
誅	iikm
譗	iiko
詄	iikv
訨	iil
諔	iila
謸	iila
詩	iild
請	iild
譸	iild
詓	iilg
譕	iilh
訆	iili
讟	iili
詐	iilk
諘	iilk
詿	iill
詰	iilo
譆	iilo
誨	iils
訿	iilt
誌	iilu
謮	iilv
讀	iilv
読	iilw
譊	iilw
許	iilx
訖	iilz
訓	iim
訹	iimd
訬	iimj
諃	iimm
諢	iinc
譋	iind
誹	iine
誼	iinf
讇	iing
誷	iinl
諚	iinl
誴	iinm
讕	iinm
詗	iino
詷	iino
調	iino
讅	iinq
詑	iint
詝	iint
詫	iint
諠	iint
訥	iinv
詇	iiny
讝	iioa
訲	iioi
譟	iiom
諿	iiop
謱	iior
諤	iios
詋	iiow
譂	iiox
誤	iioy
誀	iip
諏	iipa
誳	iipe
訦	iipl
訳	iipn
讘	iipp
讔	iipu
謘	iipx
訵	iiq
譝	iiq
謖	iiqa
謂	iiqd
詛	iiqf
譞	iiqk
諣	iiqo
讄	iiqq
諰	iiqu
諆	iiqv
謴	iiqv
譯	iiqx
譯	iiqy
譴	iiqz
讉	iiqz
詉	iira
讂	iira
詭	iirc
謝	iird
讒	iird
諂	iirg
諍	iiri
譫	iiri
詢	iisb
誻	iisb
訋	iisd
謅	iisj
訽	iiso
詾	iisu
諊	iisx
訂	iit
謢	iita
詣	iitb
詂	iitd
訮	iith
譙	iith
評	iiti
誙	iiti
誰	iiti
訰	iitl
証	iitl
誈	iitl
誱	iitl
譺	iitl
誎	iitm
誺	iitm
諌	iitm
諫	iitm
訶	iito
謌	iito
諨	iitq
訛	iitt
譓	iitu
試	iitv
誡	iitx
訫	iiu
詜	iiua
詘	iiue
諧	iiug
譨	iiuk
譳	iiun
謐	iiuq
謣	iius
譄	iivb
譜	iivb
譮	iivb
訜	iivd
詅	iivd
謭	iivd
譐	iivd
詮	iive
詳	iivf
訟	iivg
誁	iivh
論	iivh
讑	iivh
訡	iivj
譾	iivj
詤	iivm
謙	iivm
諭	iivn
詥	iivo
誝	iivo
諮	iivo
謒	iivo
諡	iivq
謚	iivq
診	iivs
諩	iivt
諗	iivu
誂	iivv
譣	iivv
說	iivw
説	iivw
詊	iivx
議	iivx
讖	iivx
譢	iivz
設	iiwa
訉	iiwd
誚	iiwd
譵	iiwd
讜	iiwh
語	iiwo
諷	iiwq
譡	iiwq
譏	iiwx
訅	iix
計	iix
詸	iix
討	iixd
訙	iixd
訧	iixd
詙	iixd
詴	iixd
誵	iixd
諑	iixd
謿	iixd
誑	iixe
詁	iixo
訩	iixu
誺	iixv
謓	iixv
證	iixv
訤	iixx
詼	iixx
談	iixx
諓	iixx
諵	iixx
諵	iixy
誖	iixz
謎	iixz
訃	iiy
諸	iiyb
譇	iiyb
讞	iiyd
謯	iiyf
謼	iiyi
詀	iiyo
誇	iiys
謔	iiyt
譃	iiyt
諕	iiyw
詶	iiyy
誟	iiyz
訠	iizi
諱	iizi
記	iizl
誋	iizu
訣	iizv
誸	iizw
訊	iizx
巭	ijfv
項	ijgv
	ijjt
	ijk
谞	ijld
讬	ijt
谉	inbi
诇	ino
卭	ip
瓨	itld
悥	iu
鵐	ivvh
鹀	ivvt
覡	ivvw
凣	iw
聓	iwdp
鞏	iwdp
巬	iwfv
讻	ixu
這	iz
庝	jadd
皯	jaf
頗	jajv
皹	janc
皰	jase
厬	jbao
厭	jbdd
靨	jbdf
魘	jbdg
黶	jbdh
饜	jbdk
壓	jbdl
檿	jbdm
厴	jbdq
嬮	jbdr
懕	jbdu
貋	jbf
痩	jbia
皕	jbjb
瘍	jbjs
鄽	jblp
庽	jbng
痬	jbss
瘍	jbts
厙	jc
庫	jc
厊	jcij
庌	jcij
疨	jcij
頋	jcjv
貙	jcoo
廤	jcot
痻	jctb
厎	jctd
疷	jctd
疧	jctv
戼	jctz
痑	jdd
痭	jdd
龎	jdde
龐	jdde
癠	jddh
鳰	jdgh
瘯	jdhy
甪	jdi
廫	jdjs
庡	jdk
亂	jdnl
覶	jdnw
辭	jdnx
廍	jdop
廩	jdqh
癛	jdqh
癝	jdqm
癕	jdwi
厗	jdx
糴	jdxi
痎	jdyv
鴔	jdzh
屲	je
鷛	jedh
貄	jef
廄	jega
爭	jei
鶶	jeih
鄌	jeip
貒	jejn
貇	jek
墾	jekl
懇	jeku
厞	jene
鶊	jevh
鹒	jevt
賡	jevv
厈	jf
庯	jf
牜	jf
痡	jf
豻	jf
	jf
鶢	jfah
犦	jfbs
牰	jfd
犜	jfda
牣	jfdd
牥	jfdh
牤	jfdl
犝	jfdl
緳	jfdm
犃	jfdo
牨	jfdw
犉	jfdz
犑	jfgd
犙	jfgs
犕	jfhf
犕	jfhi
犐	jfhx
劧	jfj
牞	jfj
甁	jfjd
幷	jfjf
掱	jfjf
犡	jfjg
犥	jfjh
牬	jfjj
犞	jfjo
逬	jfjz
敐	jfka
脣	jfkd
牪	jfki
鄏	jfkp
犔	jfkx
毥	jflb
氌	jflb
毢	jflc
毴	jfle
毜	jflm
毺	jfln
毰	jflo
毝	jfls
毶	jfls
氊	jflt
毸	jflu
犢	jflv
毨	jflw
覒	jflw
毧	jflx
毩	jflx
毱	jflx
氁	jfly
犅	jfne
犗	jfno
牸	jfnz
犌	jfpa
牭	jfq
牳	jfqs
犤	jfqt
觕	jfr
疞	jfs
牬	jfsj
犓	jfsj
惣	jfsu
犣	jfsv
牼	jfti
牱	jfto
犪	jfva
犈	jfvc
牷	jfve
鶏	jfvh
犠	jfvx
犧	jfvx
牫	jfx
庪	jfxa
牻	jfxd
犆	jfxe
鵝	jfxh
鵞	jfxh
広	jg
貃	jg
廇	jgdq
辠	jgdx
熈	jgeh
貜	jgga
瘮	jggs
鳫	jgh
廋	jgia
螷	jgjq
蠯	jgjq
臮	jgjv
痺	jgjx
貏	jgjx
臫	jgl
夒	jgla
癙	jglv
臲	jgmc
甈	jgmd
鷍	jgmh
厵	jgmm
願	jgmv
臱	jgnh
邊	jgnz
邉	jgnz
郋	jgp
齀	jgqd
齅	jgqd
齇	jgqf
鼼	jgqi
齈	jgqk
齉	jgqk
齃	jgql
齆	jgql
齁	jgqo
齂	jgqs
鼿	jgqw
厡	jgs
廏	jgta
臰	jgtt
廐	jgtw
鄎	jgup
頁	jgv
痠	jgva
厠	jgvn
廁	jgvn
顨	jgvn
廮	jgvr
癭	jgvr
覓	jgw
貎	jgw
廆	jgwg
瘣	jgwg
鷱	jgxh
翺	jgxj
臯	jgxx
奡	jgyn
鄓	jgyp
瘆	jgys
剫	jhan
庴	jhb
瘄	jhb
厲	jhbg
癘	jhbg
勵	jhbj
鄺	jhdp
懬	jhdu
廣	jhdv
瘎	jhel
廝	jhet
厤	jhh
曆	jhhb
磿	jhhc
鷓	jhhh
歷	jhhl
疶	jhl
廭	jhlv
廗	jhni
癱	jhoi
貛	jhoi
厪	jhol
瘽	jhol
庿	jhq
貓	jhq
庻	jhvv
痜	jhw
廗	jhwi
瘔	jhxo
痵	jhz
疘	ji
丆	jii
乛	jii
爫	jii
	jii
	jj
翨	jjbl
翴	jjcz
翋	jjd
翞	jjdm
翯	jjdo
翣	jjdr
疺	jjdz
乕	jjfi
逓	jjfz
庅	jjg
習	jjg
廈	jjga
瓝	jjgd
瓟	jjge
癟	jjgh
翵	jjgh
瓥	jjgq
瘜	jjgu
翫	jjgw
癧	jjhl
羾	jji
劦	jjj
翍	jjja
脅	jjjd
爲	jjjh
爳	jjjj
毣	jjjl
噕	jjjo
鄬	jjjp
姭	jjjr
庍	jjjt
頨	jjjv
庍	jjk
翐	jjkv
覛	jjkw
翚	jjnc
翬	jjnc
翑	jjso
厇	jjt
鸐	jjth
劤	jjtj
劶	jjtj
厜	jjtl
垕	jjtl
巵	jjtl
瘇	jjtl
劕	jjtn
啠	jjto
邤	jjtp
郈	jjtp
斶	jjtq
斦	jjtt
翜	jjtv
質	jjtv
頎	jjtv
翭	jjty
翂	jjvd
鷚	jjvh
雡	jjvi
勠	jjvj
剹	jjvn
鄝	jjvp
翏	jjvs
顟	jjvv
貕	jjwy
翄	jjxa
翪	jjxa
瞂	jjxd
翇	jjxd
厜	jjxf
鶞	jjxh
郕	jjxp
貭	jjxv
翆	jjxx
鷉	jjyh
豾	jjyt
	jjyt
歋	jjyv
虒	jjyw
遞	jjyz
戶	jjz
廘	jjzu
乺	jjzz
痮	jk
袶	jkai
褬	jkam
衵	jkb
襊	jkba
裮	jkbb
襅	jkbf
褟	jkbj
裡	jkbl
褆	jkbl
褞	jkbq
襮	jkbs
裩	jkbu
衪	jkc
袥	jkc
袛	jkcd
褼	jkce
褾	jkcm
褗	jkcr
輿	jkcv
褳	jkcz
袳	jkdd
襱	jkde
褵	jkdg
褅	jkdi
裗	jkdm
袑	jkdo
襢	jkdt
袨	jkdw
襯	jkdw
襑	jked
裶	jkee
褍	jken
癤	jkep
襈	jkev
衦	jkf
衧	jkf
補	jkf
褠	jkfl
衭	jkfv
褉	jkfy
袙	jkg
襤	jkgq
襂	jkgs
褦	jkgt
襔	jkhd
襼	jkhg
袣	jkhl
褋	jkhm
襽	jkhm
襺	jkhq
褀	jkhv
襪	jkhx
劤	jkj
褑	jkja
袹	jkjb
褲	jkjc
襷	jkjf
褯	jkji
斦	jkjk
裖	jkjk
褈	jkjl
衱	jkjn
袻	jkjn
襣	jkjn
啠	jkjo
裇	jkjq
襎	jkjq
襸	jkjv
質	jkjv
頎	jkjv
襖	jkjy
裫	jkkk
袾	jkkm
袟	jkkv
裬	jkla
複	jkla
袘	jklc
裃	jkld
褃	jkld
褹	jkld
袪	jklg
褤	jklk
袿	jkll
袮	jklm
袺	jklo
襀	jklv
襩	jklv
襭	jklv
襓	jklw
褖	jklx
襶	jklx
襇	jknb
裈	jknc
褌	jknc
臖	jknd
袇	jknd
襉	jknd
釁	jknd
裶	jkne
舋	jknf
衻	jknf
袡	jknl
襕	jknm
襴	jknm
痸	jknn
褣	jkno
袉	jknt
興	jknv
袕	jknv
爂	jknx
裐	jkod
衶	jkoi
襙	jkom
褸	jkor
襌	jkox
邤	jkp
衴	jkpl
襵	jkpp
	jkqb
袓	jkqf
裍	jkqm
斶	jkqq
襡	jkqq
襬	jkqt
	jkqv
襗	jkqx
裀	jkqy
襗	jkqy
裑	jkr
襜	jkri
袽	jkro
襐	jkrx
礜	jksc
轝	jksc
擧	jksf
舉	jksf
鸒	jksh
裄	jksi
譽	jksi
褷	jksl
袧	jkso
裪	jksu
歟	jksv
與	jksv
袀	jksv
袝	jktd
補	jktd
裲	jktd
袵	jktl
襋	jktm
襍	jktm
袔	jkto
褔	jktq
褄	jktr
襹	jktu
裋	jktv
裌	jktv
襥	jktv
襫	jktv
襰	jktv
裓	jktx
襧	jktx
褿	jkub
袦	jkue
袐	jkuj
襛	jkuk
襒	jkva
襘	jkvb
裷	jkvc
衯	jkvd
袊	jkvd
衳	jkvg
褨	jkvi
衸	jkvn
袗	jkvs
襝	jkvv
裞	jkvw
襳	jkvx
襚	jkvz
襨	jkwd
袎	jkwj
襠	jkwq
襆	jkwv
褝	jkwx
斅	jkxa
斆	jkxa
衼	jkxa
襏	jkxa
礐	jkxc
袚	jkxd
嶨	jkxe
鱟	jkxh
鷽	jkxh
袏	jkxi
雤	jkxi
壆	jkxl
嚳	jkxo
觷	jkxr
澩	jkxs
黌	jkxv
覺	jkxw
燢	jkxx
裧	jkxx
學	jkxz
袸	jkxz
袯	jkyd
裺	jkyl
袩	jkyo
裿	jkyo
袴	jkys
裭	jkyw
褘	jkzi
劜	jl
圧	jl
坕	jl
	jl
	jl
疍	jlbt
庒	jld
廅	jlgq
厫	jlha
廡	jlhh
甧	jljd
甡	jljl
厏	jlk
厓	jll
慼	jlmu
顣	jlmv
廚	jlod
鵠	jloh
勂	jloj
頶	jlov
痗	jlqs
庛	jlt
疎	jltm
庱	jlva
兏	jlw
劗	jlwn
酂	jlwp
酇	jlwp
贊	jlwv
兟	jlww
庤	jlxd
鷂	jlxh
颻	jlxq
厒	jlxu
飖	jlxx
龜	jlzl
郔	jlzp
蜑	jlzq
頲	jlzv
龜	jlzx
廂	jmg
黀	jmma
暦	jmmb
黁	jmmb
厯	jmmd
爢	jmmh
穈	jmmh
犘	jmmi
塺	jmml
歴	jmml
劘	jmmn
麿	jmmo
黂	jmmv
麼	jmmw
辤	jnax
癎	jnb
瘒	jnc
癇	jnd
屳	jne
厞	jnee
甪	jnf
憂	jnfa
鄾	jnfp
戞	jnfx
粵	jnjs
奧	jnjy
兦	jnl
爯	jnl
鴯	jnnh
耏	jnns
肏	jnnv
耎	jnny
逈	jnoz
痯	jnpz
蠫	jnqq
貈	jns
痌	jnto
愛	jnua
豽	jnv
貁	jnv
廀	jnxa
嶴	jnxe
糴	jnxi
込	jnz
叾	jo
焏	joah
凾	joau
鴐	jogh
賀	jogv
毠	jojl
厛	jojt
鄅	jonp
癉	joox
貚	joox
妿	jor
駕	josh
厑	jot
廔	jotr
瘻	jotr
貗	jotr
疻	jov
嗧	jovh
兎	jowd
乫	joz
饏	jpak
廳	jpeu
貑	jpfa
癮	jpju
廦	jpox
痆	jpt
痾	jpto
瘺	jpu
廕	jpvg
癊	jpvg
廰	jpxu
聼	jpxu
廜	jpyb
峊	jpze
鴭	jpzh
帥	jpzi
師	jpzi
歸	jpzi
蛗	jpzq
頧	jpzv
顊	jpzv
庘	jq
甶	jq
痋	jq
龜	jq
衉	jqao
衂	jqdd
悤	jqdu
憂	jqfa
鄾	jqfp
戞	jqfx
癦	jqhl
廙	jqhv
衊	jqhx
瘝	jqid
瘝	jqiv
衇	jqjk
衆	jqjv
衃	jqjy
靤	jqne
勔	jqnj
蠠	jqnq
靧	jqnv
靦	jqnw
痐	jqo
瘑	jqo
靣	jqo
卹	jqp
衈	jqp
癳	jqqm
欰	jqrv
瘝	jqs
囪	jqsd
癏	jqtk
衆	jqtv
衆	jqx
恖	jqxu
顖	jqxv
鵎	jrgh
廯	jrhf
癬	jrhf
癚	jrji
瘓	jrny
爮	jse
癓	jsea
癥	jsea
癁	jsla
痀	jso
豿	jso
廱	jsoi
癰	jsoi
瘲	jsvl
孒	jt
庁	jt
疕	jt
濌	jtbb
勲	jtbh
動	jtbj
貆	jtbt
憅	jtbu
癅	jtcq
疜	jtd
庯	jtdd
痡	jtdd
鴈	jtgh
厔	jtgl
庢	jtgl
痓	jtgl
贗	jtgv
甀	jthd
乗	jthm
郵	jthp
痽	jti
癄	jtih
埀	jtkl
庼	jtlb
癡	jtll
廎	jtlv
癅	jtnq
廲	jtnu
瘷	jtoa
觱	jtor
瘶	jtov
癩	jtov
顑	jtov
覗	jtow
孠	jtoz
勳	jtqj
痙	jtsi
鷹	jtth
譍	jtti
噟	jtto
應	jttu
贋	jttv
庉	jtul
瘞	jtvl
庲	jtvm
瘱	jtvu
瘂	jtxt
癋	jtxu
烕	jtxx
焤	jtxx
庮	ju
応	ju
疪	ju
豼	ju
貀	jue
癑	jujk
癗	juq
癨	juti
痶	juv
庂	jv
瘡	jvdo
癢	jvek
劆	jven
庺	jvgm
庰	jvh
乯	jviz
庈	jvj
庎	jvn
痥	jvow
廞	jvrv
瘹	jvsd
廥	jvtb
庩	jvtm
貐	jvtn
癒	jvtu
厱	jvtv
鷢	jvuh
蹷	jvul
橜	jvum
蟨	jvuq
憠	jvuu
瘚	jvuv
疭	jvv
貖	jvvq
庣	jvwv
乥	jvz
凢	jw
痟	jwd
瘋	jwjq
癴	jwmf
乿	jwml
癵	jwmv
厰	jwna
廠	jwna
蠿	jwwq
鷄	jwyh
雞	jwyi
氶	jx
叐	jxa
廟	jxbd
寽	jxd
疛	jxd
痏	jxd
頱	jxdv
臿	jxg
敮	jxga
甀	jxhd
剰	jxhn
郵	jxhp
圱	jxl
厖	jxld
庬	jxld
痝	jxld
刋	jxn
鴰	jxoh
舏	jxoi
舚	jxoi
舑	jxol
舙	jxoo
舓	jxos
頢	jxov
舕	jxox
釈	jxpn
鷭	jxqh
勫	jxqj
厧	jxqv
瘨	jxqv
癲	jxqv
飜	jxqv
釋	jxqx
釋	jxqy
厐	jxtd
脀	jxtd
廃	jxth
烝	jxth
巹	jxtl
廃	jxtl
忎	jxu
顄	jxuv
廧	jxvo
谸	jxvo
庲	jxvv
疩	jxx
癆	jxxj
廢	jxza
癈	jxza
瘏	jyb
禑	jybg
禢	jybj
痷	jybl
禔	jybl
祼	jybm
禓	jybs
禵	jybv
祂	jyc
祏	jyc
禋	jycl
嫑	jycr
瘧	jyct
禫	jycx
祊	jydh
禘	jydi
祒	jydo
禞	jydo
祽	jydx
祲	jyea
禣	jyfd
祎	jyfi
祙	jyfm
鴀	jygh
鴁	jygh
覔	jygw
視	jygw
禆	jygx
禥	jyhl
禖	jyhm
禐	jyja
禲	jyjg
祤	jyjj
祳	jyjk
祍	jyjl
祰	jyjo
禟	jyjo
禶	jyjv
禠	jyjw
祅	jyjy
禙	jykd
祩	jykm
祑	jykv
祾	jyla
禱	jyld
祣	jylk
祮	jylo
祿	jylx
禒	jylx
禈	jync
禂	jyno
呑	jyo
痁	jyo
敽	jyoa
敿	jyoa
鷮	jyoh
祌	jyoi
勪	jyoj
喬	jyoo
禪	jyox
祦	jyoy
盃	jyq
禝	jyqa
祵	jyqm
祻	jyqo
禍	jyqo
廬	jyqq
禗	jyqu
禩	jyqv
祪	jyrc
礿	jysd
禡	jysh
祃	jyst
祹	jysu
祔	jytd
禣	jytd
祬	jytl
祴	jytx
禰	jytx
祕	jyuj
禯	jyuk
禮	jyuv
禬	jyvb
禴	jyvh
祶	jyvj
療	jyvm
祄	jyvn
祫	jyvo
禉	jyvu
祱	jyvw
禌	jyvw
禭	jyvz
祋	jywa
禨	jywx
禃	jyxe
禷	jyxv
禎	jyyv
庨	jyz
痚	jyz
禕	jyzi
礽	jyzj
嗠	jzao
疓	jzj
慶	jzna
麚	jzna
麣	jzna
麘	jznb
麅	jzne
麆	jznf
廌	jznh
麃	jznh
麕	jznh
麡	jznh
麎	jznk
塵	jznl
麍	jznm
麖	jznm
麜	jznm
麏	jzno
麐	jzno
麔	jzno
麢	jzno
鄜	jznp
麛	jznp
麀	jznt
麠	jznt
麤	jznu
麑	jznw
麙	jznx
麞	jznx
麌	jzny
﨤	jznz
瘬	jzsk
疿	jzsn
烏	jzth
鄔	jztp
歍	jztv
疦	jzv
笗	kadd
筿	kam
笿	kao
筸	kbf
篳	kbhf
篂	kbjl
箟	kbu
竾	kc
簵	kcao
範	kcc
筺	kced
篻	kcfm
笌	kcij
笷	kcjp
籈	kcld
筪	kcq
籄	kcqv
簐	kcrv
篋	kctv
篭	kdbl
籠	kdde
筩	kddi
筤	kdek
鷑	kdgh
簲	kdgx
箷	kdhc
箊	kdhd
簱	kdhv
籏	kdhv
篃	kdjg
簅	kdjl
笀	kdl
籝	kdld
籯	kdld
筩	kdnf
牓	kdnh
篣	kdnh
牊	kdo
箁	kdo
簑	kdok
篰	kdop
籇	kdox
箙	kdpa
牑	kdph
簄	kdpl
簔	kdtk
籘	kdvm
筊	kdvx
箤	kdvx
笐	kdw
將	kdxd
獎	kdxd
籬	kdxi
墏	kdxl
槳	kdxm
螀	kdxq
螿	kdxq
漿	kdxs
醬	kdxu
奬	kdxy
笇	kdy
簨	keev
筆	kef
節	kegp
蠞	kegq
筭	keh
簫	keik
篅	kejn
筙	kem
箒	keni
箺	kevb
簘	kexn
筓	kff
篲	kffe
簼	kffl
篺	kfgx
簎	kfhb
箉	kfoj
簠	kfq
籜	kfqx
籜	kfqy
籒	kftq
簮	kfvb
籡	kfvv
笎	kfw
籰	kgga
笲	kgh
籃	kgkq
篎	kgmj
兠	kgtw
筫	kgv
筧	kgw
覑	kgw
篹	kgyc
簒	kgyg
籑	kgyk
簃	khdd
簊	khel
簛	khet
篏	khfv
笹	khl
牃	khlm
筣	khn
籆	khta
篍	khx
笁	ki
篢	kigv
長	kii
镸	kii
	kii
犇	kiji
犇	kiki
吿	kio
笻	kip
簭	kivo
遾	kivz
篫	kiwf
築	kiwm
竻	kj
牅	kjei
箏	kjei
篖	kjeo
籩	kjgz
籊	kjji
笟	kjjn
斨	kjjt
筬	kjjx
斨	kjk
籅	kjkv
筶	kjlo
籫	kjlv
筳	kjlz
簉	kjlz
篩	kjpi
牕	kjqu
箽	kjtl
簾	kjvm
牐	kjxg
篜	kjxh
筈	kjxo
醤	kjxu
奨	kjxy
镺	kjy
簥	kjyo
簶	kjys
筟	kjz
簰	kkgx
镻	kkv
壯	kl
裝	kldk
笖	kldv
籖	klex
篕	klgq
簀	klgv
弉	klh
籌	kljd
筀	kll
篈	klld
籖	klnx
籉	klol
牘	klqv
娤	klr
欫	klrv
銺	klv
焋	klx
笶	kly
牀	km
篐	kmci
鴸	kmgh
籕	kmgq
簯	kmhv
箵	kmjg
箖	kmm
鼄	kmq
簡	knb
簢	kndx
簆	knfa
簺	knfl
筦	knfw
製	knik
簓	knls
筞	knm
笧	knnt
箮	kntt
笍	knv
箆	knvu
筼	kob
篔	kogv
簬	kolo
筥	koo
簞	koox
箿	kop
籔	kota
簍	kotr
筽	koty
箃	kpa
篧	kpii
簈	kpjf
箼	kptl
笢	kptv
镼	kpue
箳	kpvh
篨	kpvm
笚	kq
笽	kq
笝	kqa
笡	kqf
筯	kqfj
簣	kqgv
簤	kqgv
箘	kqh
簻	kqoz
簂	kqtx
簚	kqtx
籮	kqwi
箇	kqxo
筃	kqy
妝	kr
笯	kra
镹	krn
筎	kro
髼	ksaf
鬔	ksaz
筍	ksb
鬘	ksba
篞	ksbl
簜	ksbs
鬄	ksbs
箰	ksbz
笵	ksc
筂	ksc
髢	ksc
鬅	ksdd
髣	ksdh
髳	ksdj
鬤	ksdk
簗	ksdm
笣	kse
鬊	kseb
箻	ksef
筕	ksfi
髨	ksfw
箈	ksgo
鬖	ksgs
鬂	ksgv
篤	ksh
鬗	kshd
髰	kshl
鬁	kshn
篊	kshv
髸	kshv
鬕	kshy
箥	ksja
髲	ksja
髵	ksjn
髺	ksjo
籓	ksjq
髬	ksjt
箲	ksjw
簁	ksll
籞	kslm
篽	kslp
髤	ksm
鬆	ksmg
鬝	ksnb
鬜	ksnd
髥	ksnf
鬡	ksnt
鬢	ksnv
髶	ksp
鬛	ksqv
髱	ksse
髿	kssj
牎	kssu
鬚	kssv
髩	kstj
鬎	kstn
髷	ksu
篘	ksuj
鬞	ksuk
笉	ksv
鬙	ksvb
鬠	ksvb
鬀	ksvj
篵	ksvl
髽	ksvl
鬑	ksvm
鬋	ksvn
髠	ksw
髾	kswd
髪	ksxa
鬉	ksxa
髮	ksxd
鬌	ksxd
鬍	ksxd
鬒	ksxv
鬐	ksyb
髴	kszn
篿	ktbd
軰	ktc
牔	ktdd
鄁	ktdp
簠	ktdq
箑	ktel
箌	ktgn
篗	ktia
瓺	ktld
篟	ktld
篶	ktlh
筰	ktlk
籎	ktll
箣	ktnn
籭	ktnu
牁	kto
笴	kto
筗	ktoi
籟	ktov
丠	ktt
箯	kttx
笩	ktv
箂	ktvm
筴	ktvv
籋	ktvx
镾	ktvx
笓	ku
筁	ku
笜	kue
籗	kuti
籱	kuti
籂	kvdi
篒	kvdk
牄	kvdo
篬	kvdo
籙	kves
牂	kvf
篯	kvfx
鴩	kvgh
劮	kvj
笒	kvj
笭	kvjd
籦	kvjl
筨	kvjo
籢	kvta
筡	kvtm
劄	kvtn
牏	kvtn
箚	kvtn
簽	kvtv
籨	kvtv
籲	kvtv
怣	kvu
籤	kvvx
筄	kvwv
牉	kvx
籛	kvxx
箞	kvyc
竼	kwd
箾	kwdn
筜	kwe
箹	kwmd
簹	kwnq
籪	kwwt
簳	kxbf
笂	kxd
簙	kxfd
箶	kxod
簙	kxtd
牆	kxvo
箂	kxvv
牋	kxx
笅	kxx
箋	kxx
簩	kxxj
篴	kxz
狀	kyd
笘	kyo
籚	kyqq
簝	kyvm
镽	kyvm
筴	kyvv
箎	kyw
簴	kywv
籧	kyxz
氜	kzb
氠	kzbi
氱	kzbs
氥	kzc
箛	kzjn
刏	kzn
氝	kznv
氳	kzqq
笰	kzsn
氫	kzti
氭	kztm
氬	kztt
氞	kztv
忥	kzu
気	kzx
氣	kzx
坆	la
埄	laf
塳	lafz
麺	lajf
垎	lao
麹	lasx
垾	lbf
場	lbjs
塒	lbld
堁	lbm
堣	lbng
堨	lbsl
場	lbts
堒	lbu
壜	lbug
坧	lc
墰	lcbx
墂	lcfm
鵇	lcih
塛	lcm
塸	lcoo
坁	lctv
載	lcx
逇	lcz
圡	ld
堷	ldb
墥	ldbl
墇	ldbx
垑	ldd
壠	ldde
埇	lddi
埌	ldek
鶄	ldgh
	ldgt
靚	ldgw
殸	ldja
韾	ldjb
撀	ldjf
堳	ldjg
靜	ldji
毊	ldjo
聲	ldjp
漀	ldjs
鏧	ldjv
靝	ldkx
靔	ldkz
埇	ldnf
塝	ldnh
墑	ldno
塙	ldoo
墎	ldop
埻	ldoz
郬	ldp
壈	ldqh
壞	ldqk
壇	ldqt
靘	ldrl
壌	ldvk
埣	ldvx
靗	ldww
垶	ldx
圸	le
塴	ledd
垏	lef
壗	leiq
堓	lejf
壗	lelq
埐	lena
韯	lenx
墔	leti
塏	letv
堾	levb
埁	levj
隷	lfms
垹	lfp
坃	lfw
坵	lg
歫	lg
朅	lgbl
刧	lgd
墽	lgda
刼	lgdd
塯	lgdq
堭	lge
墋	lggs
弆	lgh
壏	lgkq
刦	lgn
坮	lgo
唟	lgot
叝	lgpa
鼁	lgq
垻	lgv
責	lgv
埈	lgva
勣	lgvj
垷	lgw
堄	lgw
塊	lgwg
迲	lgz
嶅	lhae
摮	lhaf
驁	lhah
鰲	lhah
鷔	lhah
謷	lhai
嗸	lhao
嫯	lhar
贅	lhav
塻	lhby
塃	lhdm
墴	lhdv
墈	lhej
無	lhh
甒	lhhd
鷡	lhhh
鄦	lhhp
壒	lhlq
橆	lhmm
墆	lhni
壦	lhoi
墐	lhol
墷	lhtf
埖	lhtt
垬	lhv
塨	lhvd
塂	lhve
墆	lhwi
墸	lhyb
収	lia
丄	lii
乚	lii
	lii
	lii
垿	ljdt
垍	ljg
塪	ljg
頉	ljgv
墌	ljhh
壢	ljhl
壙	ljhv
壽	ljid
魗	ljig
燾	ljih
翿	ljij
斲	ljik
斲	ljit
坬	ljjn
墭	ljjq
壻	ljld
堐	ljll
墄	ljlx
埰	ljm
圦	ljn
堧	ljny
墺	ljny
辪	ljpx
垖	ljpz
塠	ljpz
壥	ljql
斲	ljsk
斲	ljst
圫	ljt
彑	ljt
壎	ljth
彜	ljth
翽	ljtj
埵	ljtl
堹	ljtl
歱	ljtl
彙	ljtm
剝	ljtn
剶	ljtn
劌	ljtn
劙	ljtn
盠	ljtq
彔	ljts
顪	ljtv
堿	ljtx
歲	ljtx
歳	ljtx
垀	ljvi
圲	ljx
埓	ljxd
埵	ljxf
鶨	ljxh
剶	ljxn
劙	ljxn
塖	ljxv
墧	ljyo
垺	ljz
塢	ljzh
塶	ljzu
圠	ll
圵	ll
歨	ll
玍	ll
趕	llbf
趧	llbl
塲	llbs
趆	llcd
赿	llcv
埥	lld
趇	lld
趍	lldd
﨣	lldx
赸	lle
趢	lles
歵	llgv
趞	llhb
墲	llhh
趪	llhv
劸	llj
赲	llj
壔	lljd
趐	lljj
趏	lljo
趫	lljo
赾	lljt
趲	lljv
堟	lljx
趎	llkm
趃	llkv
壵	lll
歮	lll
翹	lllj
顤	lllv
堯	lllw
墝	lllw
趬	lllw
奊	llly
遶	lllz
埱	llma
赻	llmj
刲	lln
趤	llnc
趗	llol
郌	llol
趮	llom
塩	lloq
邽	llp
趘	llpl
鼃	llq
趩	llqv
趂	llrm
赼	llrv
趀	llsj
趨	llsj
赹	llsv
趜	llsx
垰	lltd
趭	llth
趡	llti
趚	lltm
趰	lltx
趉	llue
趛	llv
堎	llva
赺	llvj
趖	llvl
趦	llvo
趝	llvu
趥	llvu
趒	llvv
墶	llvz
趙	llwd
塐	llwm
趓	llwm
歭	llxd
幇	llxi
幫	llxi
犎	llxi
堼	llxl
鞤	llxp
垁	lly
趈	llyo
趠	llyx
赽	llzv
尓	lm
尗	lm
裻	lmak
惄	lmau
錖	lmav
歩	lmj
頳	lmjv
赮	lmpa
赨	lmq
赩	lmrl
赥	lmrv
敊	lmya
赪	lmyb
赬	lmyv
墹	lnb
塓	lnbv
堚	lnc
槖	lncm
蠧	lncq
埦	lndc
韯	lnex
豰	lnfa
塜	lnfx
靑	lnit
垞	lnjt
靑	lnl
坰	lno
壷	lnot
垵	lnr
壛	lnrg
歬	lns
坾	lnt
壱	lnt
嗀	lnta
榖	lnta
殼	lnta
瑴	lnta
皼	lnta
瞉	lnta
穀	lnta
糓	lnta
縠	lnta
轂	lnta
鷇	lnta
鷧	lnth
亄	lntl
螜	lntq
塇	lntt
壸	lntt
壼	lntt
愨	lntu
坹	lnv
堗	lnvd
堈	lnve
埪	lnvi
堔	lnvm
埛	lnvo
塎	lnvo
胾	lnvx
坈	lnw
売	lnw
殻	lnwa
慤	lnwu
垨	lnxd
塚	lnxd
壺	lnxt
坱	lny
埍	lod
鴶	logh
塤	logv
翓	lojj
頡	lojv
遠	lokz
喆	lolo
嚞	lolo
臺	lonl
壧	looa
堮	loos
墠	loox
郆	lop
欯	lorv
塿	lotr
壴	lov
敼	lova
皷	lova
鼔	lova
尌	lovd
鼕	lovd
壾	lovg
鼘	lovk
鼚	lovk
鼞	lovl
嚭	lovo
鼛	lovo
蟚	lovq
鼜	lovq
噽	lovt
憙	lovu
歖	lovv
鼟	lovv
迼	loz
壭	lp
墛	lpfd
壀	lpox
垊	lptv
塀	lpvh
壣	lpwh
埧	lqev
坥	lqf
皾	lqga
賣	lqgv
覿	lqgw
壝	lqgz
墿	lqlx
墿	lqly
堝	lqo
夁	lqqo
鰵	lqsh
勄	lqsj
緐	lqsm
瀪	lqss
慜	lqsu
堽	lqtl
堺	lqvn
毎	lqx
毐	lqx
蛓	lqx
堌	lqxo
埆	lr
埩	lrei
埳	lrg
垝	lrjc
塮	lrxd
圴	lsd
垉	lse
垳	lsfi
堖	lsjx
坸	lso
圽	lss
鋆	lsvv
圢	lt
塼	ltbd
歶	ltbg
埬	ltbm
圷	ltd
祡	ltfm
眥	ltg
鴜	ltgh
塡	ltgv
貲	ltgv
臷	ltgx
墕	ltlh
坘	ltlt
欫	ltlv
胔	ltnv
呰	lto
堢	ltom
啙	ltoo
堛	ltoq
堜	ltqm
壃	ltqt
姕	ltr
鮆	ltrh
坉	ltul
鈭	ltv
飺	ltvk
埉	ltvv
坿	ltxd
埡	ltxt
垘	ltyd
凷	lu
垇	lu
墵	lufg
堦	lug
覟	lugw
壩	luhd
壖	lujn
酨	lux
仧	lv
夌	lva
坋	lvd
垟	lvf
墡	lvfo
達	lvfz
塕	lvgj
垪	lvh
坅	lvj
坽	lvjd
坴	lvl
暬	lvlb
埶	lvld
摰	lvlf
熱	lvlh
驇	lvlh
鵱	lvlh
勎	lvlj
勢	lvlj
槷	lvlm
燅	lvlx
圿	lvn
鼀	lvq
増	lvqb
埨	lvth
堬	lvtn
垥	lvto
墖	lvtq
墫	lvud
壿	lvud
龂	lvut
龁	lvuz
齱	lvva
齰	lvvb
齳	lvvc
齡	lvvd
齙	lvve
齟	lvvf
齨	lvvg
齲	lvvg
齵	lvvg
齖	lvvj
齺	lvvj
齚	lvvk
齦	lvvk
齓	lvvl
齛	lvvl
齪	lvvl
齷	lvvl
齼	lvvl
齫	lvvm
齽	lvvm
齘	lvvn
齝	lvvo
齠	lvvo
齣	lvvo
齬	lvvo
齮	lvvo
﨏	lvvo
塧	lvvq
齸	lvvq
齴	lvvs
齶	lvvs
齔	lvvt
齗	lvvt
齜	lvvt
齭	lvvt
齒	lvvu
齞	lvvv
齻	lvvv
齯	lvvw
齥	lvvx
齩	lvvx
齕	lvvz
垗	lvwv
坢	lvx
報	lvxa
執	lvxd
摯	lvxf
騺	lvxh
鷙	lvxh
謺	lvxi
褺	lvxk
墊	lvxl
縶	lvxm
瓡	lvxn
盩	lvxq
蟄	lvxq
漐	lvxs
慹	lvxu
贄	lvxv
逹	lvxz
埢	lvyc
堘	lvyl
赱	lvz
圥	lw
坄	lwa
垱	lwe
壪	lwis
堸	lwjq
龂	lwjt
龁	lwlz
繛	lwmx
埫	lwno
壋	lwnq
墣	lwtv
垙	lww
灻	lx
	lx
墘	lxbz
邿	lxdp
墳	lxhv
堶	lxid
勧	lxij
歓	lxiv
観	lxiw
壊	lxqk
墱	lxtv
欫	lxtv
歯	lxu
堫	lxua
缻	lxud
罇	lxud
齢	lxud
罁	lxue
罎	lxug
缹	lxuh
缾	lxuh
缿	lxuo
缷	lxup
罏	lxuq
缽	lxut
缼	lxuv
罀	lxuv
罆	lxuv
罈	lxux
塉	lxvd
墻	lxvo
啎	lxwo
埮	lxx
烖	lxx
墢	lxza
圤	ly
夨	ly
盩	lyaq
鴙	lygh
矱	lyha
瓡	lyjn
矯	lyjo
矨	lyjy
逺	lykz
矪	lyns
聟	lyop
鼅	lyoq
報	lypa
塷	lyqd
壚	lyqq
矲	lyqt
埼	lyto
堩	lytt
矰	lyvb
埉	lyvv
壉	lyx
執	lyxd
摯	lyxf
騺	lyxh
鷙	lyxh
謺	lyxi
褺	lyxk
墊	lyxl
縶	lyxm
蟄	lyxq
漐	lyxs
慹	lyxu
贄	lyxv
逹	lyz
垜	lzjm
刉	lzn
斲	lzsk
坲	lzsn
斲	lzst
棳	maaa
槡	maam
栙	maci
柊	madd
桻	maf
槰	mafz
椙	mbb
橸	mbbb
桿	mbf
棏	mbfd
柛	mbi
鸉	mbjh
楊	mbjs
梩	mbl
榯	mbld
樶	mbpa
榅	mbq
槾	mbqa
楬	mbsl
柦	mbt
皶	mbta
棏	mbtd
鸉	mbth
楊	mbts
榥	mbww
栧	mbx
杝	mc
槚	mcb
椻	mcbr
橝	mcbx
標	mcfm
檦	mcfn
檟	mcgv
樞	mcoo
枊	mcp
櫃	mcqv
楆	mcr
棔	mctb
桰	mcto
橬	mcwb
樮	mcx
櫏	mcyz
梿	mcz
槤	mcz
朷	md
枂	md
柆	md
	md
槞	mdbl
橦	mdbl
檍	mdbu
樈	mdbw
樴	mdbx
桝	mdci
榤	mdcm
杒	mdd
櫳	mdde
櫅	mddh
橠	mddk
梕	mddu
樋	mddz
樃	mded
桹	mdek
梛	mdfp
棛	mdgd
橀	mdgq
椸	mdhc
棜	mdhd
堏	mdhl
檹	mdho
楌	mdjs
栐	mdjx
櫬	mdmw
楴	mdni
樀	mdno
樋	mdnz
柖	mdo
棓	mdo
橔	mdoa
梈	mdoj
欀	mdok
槨	mdop
楟	mdot
檺	mdox
枦	mdp
栁	mdp
桞	mdp
棴	mdpa
棙	mdpd
椖	mdph
楄	mdph
槴	mdpl
檁	mdqh
櫰	mdqk
椄	mdr
柕	mdtj
壄	mdtl
楙	mdtm
楺	mdtm
棭	mdtn
梬	mdts
櫲	mdtx
怸	mdu
橳	mdvj
椊	mdvx
槒	mdwq
樆	mdxg
橪	mdyh
鶐	mdzh
杣	me
榋	meee
楖	megp
櫭	megt
梇	meh
樳	meid
橚	meik
椯	mejn
桾	mejo
梫	mena
棑	mene
櫮	meoo
椂	mes
椂	mesl
槯	meti
欈	meto
榿	metv
梤	mevd
樁	mevg
梣	mevj
桟	mex
桪	mexd
杅	mf
槥	mffe
櫘	mffu
枟	mfg
隸	mfms
歀	mfmv
構	mfnl
杇	mfs
柡	mfs
枎	mfv
櫕	mfvv
槻	mfvw
杬	mfw
榑	mfxd
栕	mg
樫	mgal
橮	mgdv
楻	mge
槝	mge
檓	mgea
欔	mgga
欋	mggi
槮	mggs
樢	mgh
椑	mgjx
桙	mgki
檙	mgkk
檻	mgkq
欖	mgkw
枱	mgo
楾	mgs
梍	mgt
梎	mgt
槪	mgtw
梖	mgv
梹	mgv
楰	mgv
櫻	mgvr
梘	mgw
棿	mgw
覍	mgw
櫆	mgwx
槹	mgxx
椮	mgys
桳	mgyx
柇	mh
樥	mhaf
棤	mhb
楿	mhb
橗	mhbd
櫙	mhco
櫣	mhcz
橵	mhda
櫹	mhek
樭	mhel
櫀	mhem
楳	mhfm
欌	mhkx
枻	mhl
楪	mhlm
梸	mhn
樠	mhnd
欗	mhnm
樠	mhnn
楧	mhny
權	mhoi
欟	mhow
榵	mhp
櫗	mhqx
槆	mhsb
欂	mhsd
檧	mhsu
檴	mhta
﨓	mhtd
樺	mhtf
欍	mhtg
櫵	mhth
椛	mhtt
橫	mhtv
栱	mhv
檋	mhvc
榙	mhvo
櫒	mhxm
楉	mhxo
杢	mi
槓	migv
朩	mii
桏	mip
櫧	miyb
朸	mj
枛	mj
柀	mja
櫇	mjav
栢	mjb
枙	mjc
柉	mjdz
槦	mjei
榶	mjeo
槺	mjes
椩	mjev
槺	mjex
杽	mjf
楥	mjfa
槈	mjfd
桭	mjfk
枆	mjfl
梛	mjfp
槄	mjg
榎	mjga
櫋	mjgh
榞	mjgm
順	mjgv
橰	mjgx
枡	mjh
櫔	mjhg
樜	mjhh
櫪	mjhl
櫎	mjhv
櫽	mjim
蠽	mjiq
檼	mjiu
晳	mjjb
楯	mjjg
槢	mjjg
栃	mjjh
栛	mjjj
梔	mjjl
毟	mjjl
椞	mjjm
柧	mjjn
蜤	mjjq
樛	mjjs
惁	mjju
櫍	mjjv
榹	mjjw
榳	mjjz
櫸	mjkf
欅	mjkf
栍	mjl
楈	mjld
櫉	mjld
櫥	mjld
櫷	mjll
櫾	mjlm
櫷	mjlt
欑	mjlv
槉	mjly
梴	mjlz
棌	mjm
杁	mjn
櫌	mjna
橓	mjni
栭	mjnn
楀	mjog
極	mjot
桘	mjpz
桖	mjq
櫷	mjq
櫌	mjqa
樬	mjqu
桵	mjr
柹	mjsj
杔	mjt
椨	mjtd
櫄	mjth
棅	mjtm
柌	mjto
椷	mjtx
楲	mjtx
榽	mjwy
杄	mjx
櫠	mjxa
橎	mjxq
杻	mjxt
橻	mjxt
枖	mjy
榊	mjyi
桮	mjyo
橋	mjyo
柸	mjyt
櫦	mjza
樚	mjzu
棖	mk
樦	mkde
櫛	mkep
橷	mkgw
檱	mkhv
梉	mkl
橁	mksb
棩	mktk
柣	mkv
櫤	mkvn
櫡	mkyb
杫	ml
椱	mlba
榸	mlbl
柂	mlc
棈	mld
榼	mlgq
樍	mlgv
橅	mlhh
朻	mli
檮	mljd
欚	mljq
檅	mljx
橈	mllw
栴	mlnd
樹	mlod
榬	mlok
檯	mlol
橲	mloo
蚻	mlq
櫝	mlqv
桛	mltd
橴	mltm
梽	mlu
槸	mlvd
橽	mlvz
榡	mlwm
紮	mlwm
権	mlxi
鬱	mlxs
椥	mlyo
杚	mlz
杊	mm
椘	mmdz
辳	mmjk
埜	mml
檚	mmml
棾	mmnw
樷	mmpa
榃	mmq
梺	mmtd
棽	mmvj
檒	mmwq
椚	mn
楁	mnao
櫊	mnao
橺	mnb
榠	mnbv
楎	mnc
橌	mnd
椀	mndc
榟	mndx
橍	mne
棑	mnee
枏	mnf
櫶	mnfu
柵	mnh
柟	mnl
椆	mnlo
尙	mno
櫚	mnoo
椬	mnqf
櫩	mnrg
樎	mntb
榁	mntl
欄	mntm
檳	mntv
樒	mnue
橣	mnuf
橣	mnui
櫁	mnuq
檸	mnut
柼	mnv
棡	mnve
椌	mnvi
棢	mnvl
棎	mnvm
榢	mnx
	mnx
柍	mny
槣	mnyo
枴	mod
梋	mod
桯	moe
柺	moj
梠	moo
欕	mooa
梙	mooi
楍	mooo
槵	moou
樿	moox
檝	mopx
櫢	mota
樓	motr
柷	mow
栮	mp
棷	mpa
椵	mpfa
榐	mphk
梶	mpjl
梮	mpjo
檉	mpoe
檘	mpox
欇	mppp
欘	mpsq
柅	mpt
楃	mptl
樄	mptm
橢	mpxd
樼	mpzz
柶	mq
榾	mqd
椢	mqed
檌	mqee
柤	mqf
査	mqf
樻	mqgv
棞	mqh
檡	mqlx
檡	mqly
檌	mqne
楇	mqo
檛	mqoz
螙	mqq
欙	mqqm
櫑	mqqq
栂	mqs
檲	mqtd
椳	mqtk
檈	mqtk
槶	mqtx
楒	mqu
楐	mqvn
榲	mqvq
欏	mqwi
樏	mqwm
棝	mqxo
樌	mqxv
栶	mqy
檞	mrdi
栬	mrdl
棦	mrei
櫓	mrhb
櫯	mrhh
杦	mrn
欃	mrod
梚	mrow
杴	mrv
栒	msb
樔	msbm
桚	msd
樑	msdm
枹	mse
榪	msh
柹	msij
椔	msq
椼	mssi
楤	mssu
枃	msv
樅	msvl
椈	msx
朼	mt
朾	mt
栺	mtb
槫	mtbd
棟	mtbm
橞	mtbu
橊	mtcq
桺	mtcz
榑	mtdd
栵	mtdn
棲	mter
樲	mtfv
椡	mtgn
槇	mtgv
杤	mth
枅	mth
欆	mtia
樇	mtid
槜	mtij
樤	mtim
檇	mtim
栻	mtiv
翉	mtjj
栣	mtjl
桺	mtjz
柾	mtl
枑	mtlt
枺	mtm
杮	mtni
栜	mtnm
橊	mtnq
欐	mtnu
欜	mtok
梀	mtom
椺	mtom
楅	mtoq
梪	mtov
樕	mtov
櫴	mtov
棫	mtox
槅	mtoy
橿	mtqt
桱	mtsi
杹	mtt
楩	mttx
杶	mtul
棶	mtvm
梜	mtvv
檷	mtvx
榗	mtwb
栰	mtx
梾	mtx
柎	mtxd
椏	mtxt
樉	mtxv
栿	mtyd
梻	mtzn
桋	mtzv
杺	mu
梄	mu
柮	mue
樰	mue
橒	mufg
槱	muh
欛	muhd
柲	muj
檂	mujk
欁	mujm
檽	mujn
榓	mujq
梐	mul
櫺	muoo
欞	muov
椣	muv
朲	mv
朳	mv
杙	mv
椫	mvbx
枌	mvd
椕	mvdm
椾	mvdn
槍	mvdo
榚	mveh
檭	mvek
槏	mvem
様	mves
檨	mvev
樣	mvex
檥	mvex
橏	mvfo
枩	mvg
檪	mvgm
棇	mvgu
栟	mvh
枔	mvj
梒	mvjo
檤	mvjz
柗	mvo
梲	mvow
棁	mvow
橧	mvqb
栨	mvrv
栤	mvs
桼	mvs
厀	mvsp
檜	mvtb
棆	mvth
楡	mvtk
梌	mvtm
椧	mvtp
枍	mvts
検	mvtv
檢	mvtv
楢	mvu
橂	mvuy
桽	mvvl
榏	mvvq
櫼	mvvx
柈	mvx
檖	mvxz
栚	mvy
棬	mvyc
椦	mvyj
杸	mwa
杋	mwd
櫟	mwgm
柪	mwj
楓	mwjq
檰	mwmi
櫞	mwmx
欓	mwnh
橕	mwnj
橖	mwnm
檔	mwnq
桜	mwr
欉	mwta
檏	mwtm
樸	mwtv
﨔	mwvf
檵	mwwl
機	mwwx
朹	mx
柭	mxad
檊	mxbf
橶	mxbx
栯	mxd
椓	mxd
橉	mxdi
枾	mxh
枿	mxh
橨	mxhv
楕	mxid
栫	mxiz
梑	mxjx
榝	mxma
樧	mxma
柨	mxni
桲	mxnz
楜	mxod
槗	mxoo
橭	mxox
槙	mxqv
櫈	mxtw
楑	mxty
椶	mxua
檣	mxvo
棶	mxvv
枠	mxx
棧	mxx
棪	mxx
礬	mxxc
欎	mxxd
欝	mxxd
桸	mxxi
橯	mxxj
棥	mxxm
檆	mxxo
櫿	mxxo
蠜	mxxq
鬰	mxxs
鐢	mxxv
橩	mxxx
燓	mxxx
橃	mxza
杕	my
槕	mybm
檶	myco
枤	myd
榩	mydx
槬	myfn
桍	myfs
楨	mygv
楏	myll
枮	myo
樐	myqd
樝	myqf
櫨	myqq
櫖	myqu
榰	mytb
橑	myvm
梜	myvv
椃	myw
樉	myxx
栦	myyy
朰	mz
杍	mz
椲	mzii
桗	mzjm
槂	mzjm
梞	mzlu
杛	mzs
柫	mzsn
榒	mzsv
榌	mzvv
愙	naou
額	naov
宻	nave
鄍	nbdp
鼆	nbdq
覭	nbdw
鷼	nbgh
覸	nbgw
阘	nbjj
寔	nbtl
軍	nc
鶤	ncgh
皸	ncja
顐	ncjv
鄆	ncp
運	ncz
肎	nd
鵷	ndch
鹓	ndct
惌	ndcu
寵	ndde
宔	nde
鴅	ndgh
鷳	ndgh
覵	ndgw
雘	ndha
賔	ndjv
寴	ndmw
刐	ndn
宍	ndv
囘	ne
輩	neec
猆	need
餥	neek
靟	neel
棐	neem
剕	neen
婓	neer
奜	neey
宭	nejo
寚	nelu
寶	nelv
帰	neni
寳	nerv
実	nev
闿	nezl
冃	nf
冄	nf
闬	nf
冐	nfd
寷	nffv
崈	nfme
鶎	nfmh
賨	nfmv
宑	nfn
寋	nfnc
騫	nfnh
鶱	nfnh
弿	nfns
賽	nfnv
鶷	nfoh
冦	nfwa
鵍	nfwh
宼	nfwr
冡	nfx
宧	ng
禸	ng
鼏	ngkk
冩	ngsh
寫	ngsh
冟	ngt
冊	nh
冪	nhbi
宐	nhdt
寬	nhgd
寛	nhgw
刪	nhn
訚	ni
幆	nibl
幜	nibm
幖	nicm
帊	nidl
帹	nidr
幟	nidx
幓	nigs
幉	nihm
帺	nihv
幪	nihx
幭	nihx
幙	nihy
乀	nii
門	nii
幊	niiv
帞	nijb
幮	nijd
帲	nijf
幍	nijg
帪	nijk
幒	niju
幁	nijv
帳	nik
幯	nikp
幬	nild
幠	nilh
幘	nilv
帵	ninc
幱	ninm
幰	ninu
幎	ninv
幏	ninx
幧	niom
幝	niox
幈	niph
帎	nipl
幗	niqx
幨	niri
円	nit
帄	nit
帓	nitm
帿	nity
帉	nivd
帡	nivh
帢	nivo
帨	nivw
帩	niwd
幥	niwf
帗	nixd
幩	nixv
帴	nixx
帾	niyb
幀	niyv
幃	nizi
宒	njfl
寪	njjh
寙	njjn
宬	njjx
寀	njm
內	njn
寕	njqt
宷	njx
審	njxq
覾	njxw
宎	njy
寢	nkea
寣	nki
寱	nkjm
寎	nktv
円	nl
寈	nld
翢	nljj
鵰	nloh
郮	nlop
彫	nlos
週	nloz
憲	nlqu
鷴	nmgh
閣	nnao
間	nnb
閶	nnbb
闒	nnbj
閺	nnbx
閳	nnc
閽	nncb
閕	nncj
闉	nncl
闄	nncr
閒	nnd
閚	nnd
闇	nndb
閼	nndd
閍	nndh
閙	nndi
閬	nndk
閡	nndv
閌	nndw
閔	nndx
閗	nndx
閆	nne
閊	nne
閏	nne
閠	nned
闓	nnev
閈	nnf
闚	nnfw
閰	nng
闅	nnga
闝	nnga
闃	nngd
閞	nngh
闎	nngs
閴	nngv
闀	nnhe
閧	nnhv
誾	nni
門	nnim
閁	nnj
閿	nnja
闞	nnja
閐	nnjl
闑	nnjm
閮	nnjz
閨	nnll
闔	nnlq
闥	nnlz
闧	nnlz
閑	nnm
闁	nnn
問	nno
閭	nnoo
闆	nnoo
闡	nnox
聞	nnp
闢	nnpx
閘	nnq
閩	nnq
闤	nnqk
閫	nnqm
闠	nnqv
閻	nnrg
	nnri
閖	nns
闖	nnsh
閯	nnsj
闊	nnso
閂	nnt
閅	nnt
閇	nntd
闘	nntd
開	nnth
閛	nnti
閵	nnti
闌	nntm
閜	nnto
閸	nntt
閥	nntx
閾	nntx
悶	nnu
閟	nnuj
闦	nnuv
閃	nnv
閄	nnv
闂	nnvc
閝	nnvd
闟	nnvj
	nnvl
閤	nnvo
閦	nnvv
闕	nnvv
閱	nnvw
閲	nnvw
関	nnvy
闗	nnwh
關	nnwh
闛	nnwl
闏	nnwq
闣	nnwq
焛	nnx
閎	nnxg
閉	nnxj
闐	nnxv
闋	nnxy
闍	nnyb
閹	nnyl
闈	nnzi
冋	no
宮	nojo
宲	nom
宺	notm
寠	notr
冣	npa
悹	npzu
阓	nqb
冝	nqf
阛	nqtk
實	nqxv
	nrei
鴳	nrgh
鞌	nrhp
頞	nrjv
寏	nrny
寃	nrod
艂	nsaf
舽	nsai
艒	nsbg
艃	nsbl
舠	nsd
艑	nsdh
艕	nsdh
艩	nsdh
艆	nsdk
舥	nsdl
艈	nsdm
舮	nsdp
寖	nsea
艎	nsge
鵃	nsgh
艊	nsgi
艦	nsgq
鸼	nsgt
艧	nsha
艜	nshi
艓	nshm
舼	nshv
艔	nsja
舧	nsjd
艁	nsjo
艀	nsjz
艞	nskv
艒	nsng
艛	nsor
艥	nsox
郍	nsp
艍	nspo
舺	nsq
艪	nsrb
艬	nsrd
艭	nsta
艝	nsue
舲	nsvd
舩	nsvg
艖	nsvi
艅	nsvm
艙	nsvo
艗	nsvq
艌	nsvu
艤	nsvx
舤	nswd
搫	nswf
幋	nswi
褩	nswk
縏	nswm
鞶	nswp
盤	nswq
艡	nswq
螌	nswq
媻	nswr
鎜	nswv
艐	nsxa
艢	nsxo
艠	nsxv
舦	nsyd
艣	nsyj
艫	nsyq
舿	nsys
翧	ntbj
寭	ntbu
戭	ntdx
寑	ntea
寁	ntel
寉	nti
寯	ntim
賓	ntiv
顮	ntiv
賓	ntjv
顮	ntjv
宱	ntlk
寲	ntll
顁	ntlv
冨	ntoq
迵	ntoz
迱	ntz
寗	nujl
寍	nuq
鸋	nuqh
寜	nuqi
寧	nuqt
窡	nvaa
窤	nvbu
窌	nvcp
窔	nvdx
窣	nvdx
岡	nve
剛	nven
穻	nvf
穽	nvfn
窛	nvfr
窺	nvfw
窫	nvfy
窅	nvg
竅	nvga
窵	nvgh
鴪	nvgh
梥	nvgm
窎	nvgt
窓	nvgu
竄	nvgv
鵼	nvih
竊	nvjg
竁	nvjl
窊	nvjn
窰	nvju
窻	nvju
窚	nvjx
穾	nvjy
窂	nvki
窹	nvko
窐	nvll
竃	nvll
竈	nvlq
窾	nvlv
竇	nvlv
穼	nvm
罙	nvm
冏	nvo
窶	nvor
窷	nvpp
窩	nvqo
窞	nvrg
竆	nvro
窮	nvrs
窇	nvse
窏	nvsf
窪	nvsl
窼	nvsm
窱	nvtm
窉	nvtv
窽	nvtv
竀	nvtw
窢	nvtx
窋	nvue
窯	nvvh
	nvvl
彮	nvvs
宨	nvwv
窴	nvxv
窲	nvxx
鶟	nvyh
竂	nvym
窧	nvyx
窙	nvyz
穵	nvz
宂	nw
	nw
鴧	nwgh
觃	nwz
冞	nx
宩	nx
叜	nxa
翝	nxgj
寘	nxqv
羀	nxxq
阇	nyb
宊	nyd
鴦	nygh
寊	nygv
宯	nyz
宆	nzs
宖	nzsg
呚	oa
喒	oayb
喅	obd
哻	obf
嗶	obhf
嚗	obhs
啺	objs
嗢	obq
啺	obts
嘾	ocbx
嘔	ocoo
喓	ocr
呧	octd
囀	octd
噆	ocwb
嗹	ocz
叧	od
肙	od
噇	odbl
噷	odbv
嚨	odde
嚌	oddh
呌	oddx
鵑	odgh
唹	odhd
喭	odjs
噺	odmt
剈	odn
嗙	odnh
噋	odoa
噈	odod
嗃	odoo
喨	odow
啍	odoz
呝	odpz
瓹	odtd
噊	odto
囃	odvi
呟	odw
噰	odwi
呅	odx
囄	odxi
嘫	odyh
噀	oeev
哢	oeh
嚍	oeiq
吚	oej
嘨	oeji
嘊	oejl
嚍	oelq
唚	oena
嗺	oeti
嘯	oexk
噄	ofdm
囓	ofdu
喫	ofdy
嘒	offe
嚖	offu
呍	ofg
呩	ofm
咑	oft
噭	ogda
嚠	ogdn
喤	oge
嘇	oggs
鳴	ogh
嚂	ogkq
囕	ogkw
嘄	ogm
咍	ogo
喞	ogtp
員	ogv
唄	ogv
囎	ogvb
鶰	ogvh
勛	ogvj
鄖	ogvp
嚶	ogvr
哯	ogw
唲	ogw
唕	ogx
噑	ogxx
咊	oh
唶	ohb
噧	ohbg
囆	ohbq
嗼	ohby
啿	ohel
唭	ohev
哶	ohf
嚥	ohkh
呭	ohl
囈	ohlg
別	ohn
唎	ohn
囒	ohnm
啝	oho
嚥	ohoh
嚾	ohoi
嘆	ohov
嚡	ohpl
唩	ohr
囌	ohrh
嘩	ohtf
嗏	ohvm
唀	ohzj
叿	oi
唝	oib
嗊	oigv
○	oiio
迚	oiz
咟	ojb
嚈	ojbd
嘃	ojei
喛	ojfa
嗕	ojfd
嚊	ojgn
嘷	ojgx
呏	ojh
嚦	ojhl
嚝	ojhv
嗋	ojjd
噅	ojjh
嚁	ojji
嗁	ojjw
噿	ojjx
啀	ojll
哠	ojlo
嗂	ojlu
囋	ojlv
唌	ojlz
嚰	ojmc
嚒	ojmw
叺	ojn
噯	ojna
嚘	ojna
呂	ojo
嚘	ojqa
喕	ojqf
嘠	ojqx
哸	ojr
嚑	ojth
喠	ojtl
呞	ojto
喴	ojtx
嗘	ojwy
吀	ojx
哷	ojxd
喢	ojxg
咶	ojxo
吜	ojxt
吥	ojy
嘺	ojyo
哹	ojz
嗚	ojzh
啂	ojzl
咮	okm
呹	okv
	ol
鷺	olah
跭	olai
蹕	olbf
踶	olbl
踼	olbs
跩	olbx
跴	olc
蹮	olce
哖	olci
蹥	olcz
躚	olcz
啨	old
跀	old
蹾	olda
跢	oldd
跓	olde
躘	olde
趽	oldh
蹨	oldh
躋	oldh
踴	oldj
躟	oldk
跁	oldl
蹱	oldl
跡	oldm
蹢	oldo
蹫	oldo
踥	oldr
踤	oldx
踳	oleb
蹖	oleg
蹆	olez
趶	olf
跊	olfm
呿	olg
踆	olga
躈	olga
躩	olga
躣	olgi
嘖	olgv
踖	olhb
躤	olhb
蹣	olhd
嘸	olhh
蹛	olhi
躪	olhi
跇	olhl
踸	olhl
蹃	olho
踒	olhr
嚽	olhv
踑	olhv
踿	olhx
嚋	oljd
跅	oljd
躕	oljd
踲	oljg
蹠	oljh
躍	olji
蹻	oljo
蹗	olju
躓	oljv
躦	oljv
蹏	oljw
噦	oljx
蹡	olkd
唗	oll
踜	olla
踧	olla
跱	olld
躊	olld
躌	olli
跿	olll
踛	olll
踋	ollp
踇	olls
跐	ollt
蹟	ollv
嘵	ollw
蹺	ollw
躂	ollz
嚇	olmm
蹅	olmt
蹜	olnb
踠	olnc
躙	olni
躢	olnj
躥	olnv
踀	olol
踙	olpa
蹍	olpk
踂	olpl
躡	olpp
跜	olpt
躃	olpx
跙	olqf
踻	olqo
蹪	olqv
蹝	olsl
蹤	olsl
跔	olso
踘	olsx
踁	olti
踓	olti
跮	oltl
踕	oltl
喍	oltm
踈	oltm
跒	olto
踾	oltq
躧	oltu
跠	oltv
蹞	oltv
躎	oltx
蹧	olub
躨	olva
跉	olvd
跧	olve
跰	olvh
踚	olvh
趻	olvj
蹹	olvj
踨	olvl
踰	olvn
跲	olvo
蹌	olvo
躑	olvp
跈	olvs
嚙	olvu
踗	olvu
啈	olvx
跘	olvx
噠	olvz
踃	olwd
躖	olwi
蹚	olwl
躒	olwm
躖	olwt
吘	olx
跂	olxa
蹳	olxa
蹐	olxd
嚹	olxi
蹸	olxi
跍	olxo
噛	olxu
蹎	olxv
踐	olxx
啈	oly
踄	oly
踷	olyb
蹽	olym
跕	olyo
踦	olyo
躆	olyx
踍	olyz
跥	olzm
趹	olzv
唽	omjt
槑	omom
呠	omt
喖	omxo
喗	onc
啘	ondc
嗐	onfo
唍	onfw
翤	onhj
	onja
	onja
吶	onjn
哰	onki
呥	onl
咹	onr
嚪	onrg
咜	ont
哃	onto
嚀	onut
噾	onvb
啌	onvi
咉	ony
吅	oo
鷤	oobh
囅	oobk
辴	oobk
鄲	oobp
單	oobx
戰	oobx
唈	oodl
鶚	oofh
卾	oofp
咢	oofs
顎	oofv
覨	oofw
遌	oofz
嚚	oogo
噐	ooio
嚴	ooja
哵	oojn
嚻	oojo
囂	oojo
哫	ool
嘂	oolo
丳	oon
	oonv
斝	oonx
碞	oooc
喦	oooe
嵒	oooe
氉	oool
喿	ooom
鄵	ooop
嘽	ooox
郘	oop
獸	ooqd
嘼	ooqo
鼉	ooqq
駡	oosh
嘍	ootr
呺	oots
呮	oov
遻	oovz
呪	oow
喌	ooyy
咠	op
咡	op
囁	oppp
囑	opsq
呡	optv
啒	opue
呬	oq
啯	oqed
嘪	oqgv
嘳	oqgv
墤	oqgv
嚜	oqhl
嚸	oqho
呣	oqs
噣	oqsq
嚃	oqsz
雖	oqti
噮	oqtk
嘓	oqtx
唭	oqv
嚺	oqvz
囉	oqwi
唃	or
嘝	ordx
嚕	orhb
噡	orji
喚	orny
嚵	orod
焁	orvx
咰	osb
哘	osfi
嗎	osh
嘙	osjr
唦	osmj
呴	oso
喣	osoh
嗈	osol
呉	ostv
呁	osv
哅	osxu
吳	osy
咺	otbt
咃	otc
啑	otel
啛	oter
咞	oth
鷕	otih
咓	otld
嘕	otlh
啢	otnd
囇	otnu
唡	otnv
數	otoa
甊	otod
鷜	otoh
氀	otol
婁	otor
唖	otot
遱	otoz
鴞	otsh
飸	otsk
號	otsw
吪	ott
哬	otto
噸	otuv
哛	otvd
呯	otvi
唊	otvv
啞	otxt
噁	otxu
唒	ou
噥	oujk
唺	ouv
唫	ov
啴	ovbx
嘦	ovcr
嗆	ovdo
嗛	ovem
嗴	ovfg
唴	ovfl
唅	ovjo
唸	ovju
嗿	ovjv
哾	ovow
噲	ovtb
啽	ovth
喩	ovtk
唋	ovtm
噞	ovtv
噂	ovud
唂	ovvo
咷	ovwv
嗞	ovww
咲	ovy
啳	ovyc
吺	owa
嚛	owgm
嗩	owgv
喲	owmd
嚩	owmd
噝	owmm
嚐	ownb
嘡	ownl
噹	ownq
嚉	owtd
嘰	owwx
吙	ox
哊	oxd
吰	oxg
噴	oxhv
唙	oxjx
哤	oxld
咘	oxni
嚔	oxnl
哱	oxnz
啚	oxqo
嘜	oxva
唻	oxvv
嘮	oxxj
唵	oybl
啅	oybx
咵	oyfs
嘑	oyji
嚬	oyjv
呫	oyo
噳	oyoy
嚧	oyqq
咾	oyt
囐	oytd
嚱	oytx
唊	oyvv
噓	oywt
喯	oyxh
嘋	oyza
吇	oz
喡	ozii
吷	ozv
焣	pah
埾	pal
棸	pam
郰	pap
屃	pb
陽	pbjs
陽	pbts
阤	pc
陣	pc
隁	pcbr
塦	pcl
陻	pcl
阺	pctd
陿	pctv
卪	pd
隌	pdb
職	pdbx
陊	pdd
隴	pdde
隮	pddh
阧	pddx
埅	pdhl
隡	pdjl
聤	pdot
阸	pdpz
屖	pdx
遟	pdxz
陫	pene
隑	petv
聽	pexu
陠	pf
耺	pfg
陚	pflv
叞	pfma
犚	pfmi
螱	pfmq
陦	pfxd
叚	pfza
﨩	pge
隝	pgh
鳲	pgh
鵈	pgh
隉	pgi
聛	pgjx
鸤	pgt
屓	pgv
陖	pgva
屭	pgvv
聣	pgw
阭	pgw
聭	pgwg
屟	phlm
壂	phvl
臋	phvv
隺	pii
鶴	piih
阞	pj
阨	pjc
隠	pjeu
屗	pjfd
屛	pjff
屒	pjfk
陙	pjfk
毦	pjfl
阩	pjh
陹	pjhb
陞	pjhl
檃	pjim
隱	pjiu
聕	pjlo
聏	pjnn
陑	pjnn
陾	pjny
隩	pjny
聥	pjog
聰	pjqu
隀	pjtl
隇	pjtx
阫	pjy
隖	pjzh
屫	pkjo
陎	pkm
冘	pl
耴	pl
阯	pl
陁	plc
聙	pld
阹	plg
鴆	plgh
隞	plha
隯	pljd
墬	pljl
隢	pllw
聐	plo
邥	plp
瓭	pltd
屆	plu
陸	plvl
聅	ply
阣	plz
杘	pm
隲	pmjh
刵	pn
陫	pnee
耼	pnf
聢	pntl
聹	pnut
屄	pnv
聜	pnvi
聺	pnxm
屪	pnym
礕	podc
鷿	podh
鸊	podh
幦	podi
躄	podl
繴	podm
鼊	podq
	podt
憵	podu
孹	podz
聖	poe
隕	pogv
屢	potr
聑	pp
隦	ppox
聶	ppp
顳	pppv
屇	pq
聵	pqgv
隤	pqgv
陥	prib
陒	prjc
聸	prji
阥	ps
隟	psbm
屜	pshl
屧	pshm
屩	psjo
遲	pskz
屨	psor
斸	psqk
劚	psqn
屬	psqq
斸	psqt
聦	pssu
陱	psx
敶	ptba
陳	ptbm
螴	ptbq
陠	ptdd
屍	ptdt
剭	ptgn
陮	pti
陝	ptjv
聇	ptl
阷	ptl
陃	ptnv
娿	ptor
聝	ptox
陘	ptsi
敃	ptva
敯	ptva
昬	ptvb
暋	ptvb
睯	ptvg
鴖	ptvh
刡	ptvn
蟁	ptvq
聗	ptvv
陜	ptvv
隬	ptvx
迡	ptz
屚	pu
恥	pu
阰	pu
聉	pue
鶌	pueh
階	pug
隭	pujn
恥	puuc
聁	pvd
隒	pvem
遅	pvfz
聬	pvgj
聡	pvgu
聠	pvh
耹	pvj
阾	pvjd
陰	pvjg
隂	pvk
層	pvqb
聄	pvs
陯	pvth
隃	pvtn
険	pvtv
險	pvtv
聎	pvwv
隊	pvx
墜	pvxl
鐆	pvxv
凥	pw
陗	pwd
聈	pwj
隚	pwnl
聨	pwwh
聮	pwwh
聯	pwwh
聫	pwwy
聀	px
阦	px
陏	pxd
隣	pxdi
褧	pxdk
際	pxfm
耾	pxg
隫	pxhv
嶞	pxie
隓	pxii
墮	pxil
隨	pxiz
鶋	pxoh
聴	pxqu
隥	pxtv
聧	pxty
陼	pyb
鷵	pybh
陓	pyfs
騭	pysh
陭	pyto
隵	pytx
聗	pyvv
陜	pyvv
阠	pzx
畷	qaaa
罬	qaaa
蝃	qaaa
畧	qao
蛒	qao
蚎	qb
蝿	qbbl
蝐	qbg
罼	qbhf
畼	qbjs
蝪	qbjs
蝹	qbq
蟃	qbqa
蠍	qbsv
蝭	qbtl
畼	qbts
蝪	qbts
蜫	qbu
虵	qc
蛼	qc
蝘	qcbr
蟫	qcbx
螹	qcjt
蠮	qclj
蚳	qctd
蚔	qctv
虭	qd
蚏	qd
罿	qdbl
蟙	qdbx
蛥	qdd
蠬	qdde
蠐	qddh
髈	qddh
髇	qddo
骯	qddw
図	qddx
罜	qde
蜋	qdek
骬	qdf
骭	qdf
髆	qdfd
蜟	qdgd
鶻	qdgh
蚄	qdh
髒	qdhh
骳	qdja
蝞	qdjg
髍	qdjm
骽	qdjr
顝	qdjv
畩	qdk
甿	qdl
蚆	qdl
骴	qdlt
髐	qdlw
骵	qdmt
髖	qdnd
螪	qdno
髕	qdnv
蛁	qdo
蠰	qdok
髏	qdor
蝏	qdot
蠔	qdox
蜳	qdoz
蜧	qdpd
髉	qdpi
蟺	qdqt
骲	qdse
髆	qdtd
罞	qdtj
蝚	qdtm
骾	qdtx
體	qduv
骮	qdv
骿	qdvh
髊	qdvi
蜶	qdvx
囥	qdw
蚢	qdw
蚿	qdw
骪	qdwd
骩	qdx
骫	qdxd
髄	qdxz
髗	qdyq
骻	qdys
畡	qdyv
囯	qe
蚟	qe
蟤	qeev
蝍	qegp
蟳	qeid
蟰	qeik
圌	qejn
蛝	qek
螁	qekz
圕	qelb
縣	qemm
懸	qemu
蠵	qeto
螘	qetv
蜯	qevf
虶	qf
虷	qf
蜅	qf
囩	qfg
鴡	qfgh
刞	qfn
囲	qfn
畊	qfn
畉	qfv
蚖	qfw
圑	qfxd
囜	qg
蚷	qg
羆	qgdh
罶	qgdq
罷	qgdt
蠷	qggi
圎	qggv
鴨	qgh
鴫	qgh
蟂	qgm
囼	qgo
蛽	qgv
貴	qgv
買	qgv
畯	qgva
鷶	qgvh
蠳	qgvr
遺	qgvz
蜆	qgw
蜺	qgw
螝	qgwg
圗	qgxf
囷	qh
蠇	qhbg
羃	qhbi
黫	qhcl
黖	qhcw
蟏	qhei
蠨	qhek
蟏	qhen
蟖	qhet
黲	qhgs
黮	qhhl
蠂	qhhm
黬	qhjx
黣	qhls
黷	qhlv
黦	qhnc
蟎	qhnd
螮	qhni
蟍	qhnm
蟎	qhnn
蜹	qhnv
蝧	qhny
蠸	qhoi
螼	qhol
羈	qhph
黕	qhpl
羇	qhpo
蠴	qhqb
蜲	qhr
黵	qhri
黗	qhtl
異	qhv
黓	qhv
黭	qhvh
螮	qhwi
黰	qhxv
蠎	qhyh
黤	qhyl
點	qhyo
蜏	qhzj
圁	qi
冎	qii
罒	qii
黽	qii
罰	qin
眔	qivv
罸	qixd
蠩	qiyb
蚾	qja
蛨	qjb
蚅	qjc
蝯	qjfa
蜄	qjfk
螑	qjgd
蝢	qjgv
蠣	qjhg
眾	qjin
眾	qjiv
翈	qjj
蛡	qjj
蚸	qjjd
蟡	qjjh
蠗	qjji
蛠	qjjj
畖	qjjn
罛	qjjn
蛌	qjjn
疁	qjjs
蟉	qjjs
蚚	qjjt
螔	qjjw
蚚	qjk
﨡	qjl
蝑	qjld
螏	qjly
蝡	qjny
蝺	qjog
螄	qjpi
蝒	qjqf
螕	qjqu
蟌	qjqu
虴	qjt
蟵	qjtd
畽	qjtl
蝩	qjtl
蝛	qjtx
蝷	qjvj
蟩	qjvv
螇	qjwy
蛶	qjxd
罽	qjxn
蜬	qjxu
囨	qjy
蟜	qjyo
蚽	qjyt
罦	qjz
螐	qjzh
螰	qjzu
蝂	qkja
蜵	qktk
蛈	qkv
蜐	qlgj
圔	qlgq
蟱	qlhh
虯	qli
疇	qljd
蜁	qljl
蝝	qljx
罣	qll
蟯	qllw
罫	qlly
蛣	qlo
園	qlok
瞏	qlok
蟢	qloo
畮	qlqs
蝳	qlqs
蟕	qltr
蠘	qltx
斁	qlva
鸅	qlvh
歝	qlvv
睪	qlvx
蟽	qlvz
螦	qlwm
畤	qlxd
睪	qly
斁	qlya
鸅	qlyh
歝	qlyv
蚞	qm
罧	qmm
蜙	qmvg
蚒	qnd
囬	qnf
蚦	qnf
螛	qnfo
廽	qnfz
逥	qnfz
畘	qnl
畳	qnqf
蝊	qntl
蝖	qntt
螾	qntv
蠙	qntv
蝄	qnvl
蛧	qnxx
咼	qo
旤	qocw
罥	qod
蜎	qod
圓	qogv
蚛	qoi
剮	qon
蟬	qoox
歄	qorv
螻	qotr
圖	qoxo
廻	qoz
迴	qoz
過	qoz
鄳	qp
蝦	qpfa
罻	qpfd
蚇	qpn
蟶	qpoe
蠾	qpsq
蚭	qpt
囻	qptv
罠	qptv
蜛	qpxo
畕	qq
蠅	qq
蝟	qqd
螖	qqd
圐	qqdh
罝	qqf
圚	qqgv
蜠	qqh
蟔	qqh
圛	qqlx
蠌	qqlx
圛	qqly
蠌	qqly
蜖	qqnf
蝸	qqo
畾	qqq
蟲	qqq
礨	qqqc
疊	qqqf
鸓	qqqh
壘	qqql
壨	qqql
氎	qqql
櫐	qqqm
纍	qqqm
蠝	qqqq
蠱	qqqq
疉	qqqt
罍	qqqu
奰	qqqy
蠋	qqsq
蠉	qqtk
蟈	qqtx
罳	qqu
蠏	qrdi
蜭	qrg
蝜	qrgv
蛫	qrjc
畂	qrn
囦	qs
眔	qs
罺	qsbm
毑	qsc
虳	qsd
袰	qsdk
蚫	qse
蟝	qsgm
罵	qsh
螞	qsh
蜪	qslu
蚼	qso
蜔	qsq
斀	qsqa
鸀	qsqh
劅	qsqn
蠟	qsqv
斣	qsqx
畇	qsv
蚐	qsv
甼	qt
虰	qt
團	qtbd
蝀	qtbm
圑	qtdd
蜅	qtdd
蛚	qtdn
蛜	qtej
蜨	qtel
蚈	qth
蜼	qti
蟭	qtih
螩	qtim
囸	qtl
蜽	qtnd
蛃	qtnv
爴	qtoj
翾	qtoj
睘	qtok
國	qtox
罭	qtox
螎	qtoy
還	qtoz
疅	qtqt
蛵	qtsi
囮	qtt
蚮	qtv
蚲	qtvi
眾	qtvv
蛺	qtvv
蟘	qtvv
蚹	qtxd
蛦	qtzv
毘	qu
蝔	qug
顋	qujv
蜌	qul
畟	qva
朞	qvd
罖	qvd
蚡	qvd
蠄	qvdg
圀	qvdh
螥	qvdo
螊	qvem
蟻	qvex
螉	qvgj
蛢	qvh
諅	qvi
蚙	qvj
圙	qvjf
蛿	qvjo
蟴	qvjq
囶	qvl
夦	qvld
尠	qvlj
歁	qvlv
卙	qvlx
棊	qvm
剘	qvn
囧	qvn
畍	qvn
朙	qvnd
蛻	qvow
蜝	qvq
蠀	qvrv
圇	qvth
蜦	qvth
畭	qvtm
惎	qvu
螠	qvvq
蚥	qvx
圏	qvyl
畻	qvyl
罤	qvzj
羂	qwmd
羅	qwmi
圝	qwmm
圞	qwmm
羉	qwmm
羄	qwmx
邏	qwmz
蟐	qwni
蟷	qwnq
蝋	qwwf
蟣	qwwx
圂	qx
毌	qx
蚑	qxa
蛂	qxad
団	qxd
蛕	qxd
疄	qxdi
貫	qxgv
遦	qxgz
蟦	qxhv
塁	qxl
蚘	qxld
蛖	qxld
疂	qxnf
慁	qxu
蝬	qxua
蛷	qxxd
蟧	qxxj
蠑	qxxm
虲	qy
蝫	qyb
盢	qydq
蝆	qyif
蛅	qyo
蠦	qyqq
欭	qyrv
蛯	qyt
螧	qytb
蟟	qyvm
蛺	qyvv
囙	qz
虸	qz
圍	qzii
蚗	qzv
娺	raaa
砮	rac
鴑	ragh
拏	rajf
觡	rao
駑	rash
亀	rbbl
娨	rbf
媢	rbg
妽	rbi
婸	rbjs
婐	rbm
躶	rbm
媀	rbng
嫚	rbqa
觛	rbt
媞	rbtl
婸	rbts
婫	rbu
妬	rc
嫟	rcho
嬺	rchu
嫕	rclu
嫗	rcoo
軀	rcoo
婹	rcr
觝	rctd
觗	rctv
嬑	rdbu
嬂	rdbx
軄	rdbx
姼	rdd
躵	rddu
妵	rde
躴	rdek
嫏	rdep
嫙	rdhl
媯	rdjh
妑	rdl
嫎	rdnh
媂	rdni
妱	rdo
姳	rdo
婄	rdo
孃	rdok
婛	rdom
媥	rdph
媃	rdtm
嬢	rdvk
妔	rdw
妶	rdw
妏	rdx
粂	rdx
觪	rdx
姟	rdyv
奾	re
嬧	reiq
婩	rejf
媏	rejn
嬧	relq
嫿	relt
婔	rene
婦	reni
娽	res
觮	res
媺	reta
嬍	reta
觽	retm
孈	reto
觿	reto
媋	revb
嫀	revh
妦	rf
姸	rff
妘	rfg
娬	rflv
妌	rfn
妋	rfv
妧	rfw
姖	rg
姫	rg
臽	rg
姢	rgd
嬓	rgda
嬼	rgdn
媹	rgdq
媓	rge
鵮	rggh
鹐	rggt
鵢	rgh
鵤	rgh
娭	rgly
婂	rgni
欿	rgrv
娦	rgv
負	rgv
孆	rgvr
娊	rgw
婗	rgw
觬	rgw
媿	rgwg
姀	rh
魚	rh
鮗	rhad
鮥	rhao
鯦	rhao
鰠	rhaq
魯	rhb
鰻	rhba
鯧	rhbb
鱪	rhbb
鰣	rhbd
鰅	rhbg
鰨	rhbj
鯉	rhbl
鯷	rhbl
鯹	rhbl
鰛	rhbq
鯣	rhbs
鰑	rhbs
鯤	rhbu
鮖	rhc
鰾	rhcm
鰸	rhco
鰋	rhcr
鱏	rhcx
鰱	rhcz
魛	rhd
鮋	rhd
鯲	rhdd
鯒	rhdf
魴	rhdh
鯿	rhdh
鰟	rhdh
鱭	rhdh
鯒	rhdi
鯍	rhdm
鯨	rhdm
鰇	rhdm
鮉	rhdo
鰝	rhdo
鱊	rhdo
魲	rhdp
鯜	rhdr
魣	rhdt
鱣	rhdt
嫹	rhdv
觵	rhdv
魧	rhdw
鮌	rhdw
魰	rhdx
鮫	rhdx
鱆	rhdx
鯙	rhdz
鮼	rhea
鰴	rhea
鰆	rheb
鱘	rhed
鯡	rhee
鯞	rhei
鱐	rhek
媅	rhel
鮶	rheo
鱷	rheo
鮣	rhep
鯽	rhep
娸	rhev
鰎	rhez
姏	rhf
鯆	rhf
鮇	rhfm
魭	rhfw
鮊	rhg
鮔	rhg
鮻	rhga
鰉	rhge
鷠	rhgh
鰹	rhgl
鰂	rhgn
鮐	rhgo
鰡	rhgq
鯵	rhgs
鰁	rhgs
鰺	rhgs
鯢	rhgw
鱡	rhgx
穌	rhh
鱯	rhha
魽	rhhf
鱹	rhhi
鰳	rhhj
鰈	rhhm
鯏	rhhn
鰙	rhho
鯘	rhhr
鯕	rhhv
鱑	rhhv
鰍	rhhx
鱴	rhhx
鯚	rhhz
魟	rhi
魬	rhja
鮍	rhja
鰀	rhja
鱫	rhja
鯳	rhjd
鰼	rhjg
鱱	rhjg
鰞	rhjh
鰤	rhji
鰰	rhji
鱅	rhji
鮙	rhjj
嬞	rhjl
魹	rhjl
鮏	rhjl
鯀	rhjm
魞	rhjn
魥	rhjn
鮞	rhjn
鮜	rhjo
鯌	rhjo
鱎	rhjo
鱕	rhjq
鮾	rhjr
鱇	rhjs
魠	rhjt
魾	rhjt
鰩	rhju
鱤	rhju
鱖	rhjv
鱮	rhjv
鯎	rhjx
鰄	rhjx
鰔	rhjx
鯅	rhjz
魸	rhk
鱂	rhkd
嬿	rhkh
觾	rhkh
鮢	rhkm
鯯	rhkn
鱵	rhkx
鯪	rhla
鰒	rhla
鯖	rhld
魼	rhlg
鮓	rhlk
鮭	rhll
鯐	rhll
鯥	rhll
媟	rhlm
鮛	rhlm
鮚	rhlo
鱚	rhlo
鰪	rhlq
鰿	rhlv
鱙	rhlw
鱥	rhlx
魦	rhmj
娳	rhn
魝	rhn
鯶	rhnc
鯡	rhne
鰘	rhnl
孏	rhnm
鯮	rhnm
鮦	rhno
鯛	rhno
鰫	rhno
鮟	rhnr
鮀	rhnt
鰚	rhnt
魶	rhnv
鯇	rhnw
媖	rhny
嬿	rhoh
觾	rhoh
孉	rhoi
嫤	rhol
鱢	rhom
鰐	rhos
嫨	rhov
鱓	rhox
媶	rhp
鯫	rhpa
鰕	rhpa
魫	rhpl
鮿	rhpl
媌	rhq
魻	rhq
鱦	rhq
鱰	rhqb
鰃	rhqk
鱞	rhqk
鮰	rhqo
鯝	rhqo
鰮	rhqq
鰥	rhqs
鰓	rhqu
鮂	rhqv
婑	rhr
躷	rhr
鯓	rhr
鮠	rhrc
鱻	rhrh
鮸	rhrw
鱌	rhrx
魡	rhsd
鮑	rhse
鰢	rhsh
鯋	rhsj
鮈	rhso
鯔	rhsq
魩	rhss
嬳	rhta
鮨	rhtb
鮒	rhtd
鮲	rhtd
鯆	rhtd
鱄	rhtd
嬅	rhtf
魳	rhti
鮃	rhti
魨	rhtl
鮴	rhtm
鯟	rhtm
鯠	rhtm
鰊	rhtm
鰷	rhtm
鯻	rhtn
魺	rhto
鰏	rhtq
婲	rhtt
魤	rhtt
魱	rhtt
鱺	rhtu
鮘	rhtv
鮧	rhtv
鯁	rhtx
鯾	rhtx
鯸	rhty
魮	rhu
鯂	rhu
鰽	rhub
鱈	rhue
鮅	rhuj
鱬	rhun
鱩	rhuq
鱧	rhuv
娂	rhv
魜	rhv
鱛	rhvb
鱠	rhvb
魵	rhvd
魿	rhvd
鱒	rhvd
鮮	rhvf
鮩	rhvh
鯩	rhvh
鮷	rhvj
鱶	rhvk
鮽	rhvm
鰜	rhvm
魪	rhvn
鮯	rhvo
鱔	rhvo
鱃	rhvt
鯰	rhvu
鰌	rhvu
鮡	rhvv
鮵	rhvw
鰦	rhvw
鱨	rhwb
鮹	rhwd
鱳	rhwm
鯃	rhwo
鱜	rhwp
鯼	rhxa
鱍	rhxa
魷	rhxd
鮁	rhxd
鮪	rhxd
鯄	rhxd
鰖	rhxd
鰗	rhxd
鯑	rhxi
鱗	rhxi
鰶	rhxm
婼	rhxo
鮕	rhxo
鯠	rhxv
鱝	rhxv
鱁	rhxz
鯺	rhyb
鰭	rhyb
鮎	rhyo
鱸	rhyq
鮬	rhys
鮳	rhys
鮱	rhyt
鱋	rhyt
鯱	rhyw
鰬	rhyx
魢	rhzl
鮄	rhzn
鯭	rhzq
鯴	rhzq
鰯	rhzv
亇	ri
妅	ri
娮	ri
	rii
觨	ris
厃	rj
頠	rjcv
姂	rjdz
嫞	rjei
嫝	rjes
躿	rjes
嫝	rjex
躿	rjex
媷	rjfd
嫍	rjg
嬶	rjgn
嫬	rjhh
嬀	rjjh
嬥	rjji
婬	rjjl
嫪	rjjs
娍	rjjx
嬩	rjkv
嬹	rjkv
娾	rjll
媱	rjlu
姺	rjlw
矦	rjly
娗	rjlz
娫	rjlz
婇	rjm
孊	rjme
嫲	rjmm
嬤	rjmw
嬡	rjna
姠	rjno
媆	rjny
媔	rjqf
娞	rjr
奼	rjt
軅	rjti
娷	rjtl
媑	rjtl
軈	rjtu
媙	rjtx
甔	rjvd
嬚	rjvm
奷	rjx
娷	rjxf
姡	rjxo
嬏	rjxq
妚	rjy
娝	rjyo
嬌	rjyo
娐	rjz
觙	rjzn
麁	rjzu
躼	rk
孂	rkeq
婣	rktk
妷	rkv
饹	rlao
馃	rlbm
觴	rlbs
姩	rlci
饻	rldk
馎	rlfd
馂	rlga
嫧	rlgv
嫵	rlhh
觓	rli
嬦	rljd
軇	rljd
饦	rljt
妰	rlk
觟	rll
馌	rllq
嬈	rllw
婌	rlma
嬄	rlnv
姞	rlo
媴	rlok
嬯	rlol
馉	rlqd
嬻	rlqv
饤	rlt
馎	rltd
饾	rltv
娡	rlu
饳	rlue
婈	rlva
饸	rlvo
婞	rlvx
嫊	rlwm
婞	rly
覙	rmgw
躰	rmt
嫇	rnbv
媈	rnc
嫺	rnd
婔	rnee
軉	rnev
媢	rnfg
婃	rnfm
姍	rnh
嬸	rnjq
姌	rnl
婤	rnlo
嫻	rnm
婠	rnpz
姲	rnr
婝	rntl
孄	rntm
姛	rnto
媗	rntt
嬪	rntv
嬣	rnut
妠	rnv
夐	rnva
敻	rnva
躻	rnvi
嫆	rnvo
烉	rnvx
奐	rnvy
姎	rny
鴽	rogh
妕	roi
挐	rojf
娖	rol
桇	rom
帤	roni
躳	roo
孍	rooa
嬠	room
嬋	roox
觶	roox
軃	roox
娯	rosv
娛	rosy
軁	rotr
劖	roun
酁	roup
鵵	rowh
勨	roxj
邚	rp
娵	rpa
婽	rpfa
妉	rpl
躭	rpl
孎	rpsq
媉	rptl
姄	rptv
嫷	rpxd
婮	rpxo
媦	rqd
嬇	rqgv
嫼	rqh
嬽	rqiy
娚	rqj
嬕	rqlx
嬕	rqly
媧	rqo
觸	rqsq
嬛	rqtk
媤	rqu
娸	rqv
媼	rqvq
婟	rqxo
奻	rr
婙	rrei
姧	rrf
媍	rrgv
姽	rrjc
觤	rrjc
奺	rrn
嫓	rrnu
婏	rrod
嬎	rrol
嬔	rrol
姦	rrr
姰	rsb
媽	rsh
姁	rso
媰	rsuj
婅	rsx
躹	rsx
媣	rsxm
奵	rt
嫥	rtbd
鳀	rtbl
娻	rtbm
鳁	rtbq
姮	rtbt
鱽	rtd
鲉	rtd
鲬	rtdf
鳑	rtdh
鲬	rtdi
鲃	rtdl
鳣	rtdt
	rteb
鲪	rteo
	rtep
鲌	rtg
鲹	rtgs
鳈	rtgs
鳠	rtha
鲯	rthv
婎	rti
孇	rtia
嫶	rtih
觹	rtim
鲏	rtja
鳛	rtjg
姙	rtjl
鲘	rtjo
鳡	rtju
鳉	rtkd
鳤	rtkz
姃	rtl
鲊	rtlk
娰	rtlv
姉	rtni
鲖	rtno
孋	rtnu
妸	rto
娕	rtom
媬	rtom
嫰	rtov
嬾	rtov
鳚	rtpd
鳂	rtqk
媡	rtqm
婳	rtqu
娙	rtsi
鲀	rttl
鲄	rtto
鲾	rttq
鲙	rtvg
婡	rtvm
鳒	rtvm
	rtvu
嬭	rtvx
鲿	rtwg
婭	rtxt
娀	rtxx
婖	rtyd
鲓	rtys
鱾	rtzl
嫮	rufs
媘	rug
妼	ruj
嬬	rujn
軆	rutv
婰	ruv
妢	rvd
躮	rvd
媊	rvdn
姾	rve
觲	rvei
嬟	rvex
媄	rvey
躾	rvey
觧	rvf
嫅	rvfi
嫸	rvfo
妐	rvg
姈	rvjd
娢	rvjo
妎	rvn
娧	rvow
嬒	rvtb
婨	rvth
媕	rvth
嬆	rvtj
婾	rvtk
媮	rvtn
姶	rvto
嬐	rvtv
媨	rvu
孅	rvvx
嬨	rvwu
嬘	rvxz
婘	rvyc
娋	rwd
觻	rwgm
嬵	rwmi
娪	rwo
姵	rwti
姯	rww
妭	rxad
姷	rxd
嫾	rxdi
媠	rxid
娏	rxld
婻	rxnx
婻	rxny
媩	rxod
娔	rxow
嫴	rxox
嫃	rxqv
嬁	rxtv
嬙	rxvo
婡	rxvv
婒	rxx
觩	rxxd
軂	rxxj
嬫	rxxm
媎	ryb
觰	ryb
媫	ryel
姱	ryfs
媜	rygv
嫭	ryji
婍	ryto
觭	ryto
躸	ryto
嫽	ryvm
婋	ryw
媁	rzii
躱	rzjm
嫋	rzsv
娹	rzsw
恏	rzu
妜	rzv
汷	sa
涰	saaa
泈	sadd
溞	sadq
浲	saf
漨	safz
湰	satl
淐	sbb
澋	sbdm
灝	sbdv
渂	sbdx
涆	sbf
淂	sbfd
滭	sbhf
璗	sbjd
湦	sbjl
盪	sbjq
湯	sbjs
燙	sbjx
溡	sbld
濹	sbll
淉	sbm
鄛	sbmp
湡	sbng
澷	sbqh
渇	sbst
泹	sbt
淂	sbtd
璗	sbtd
徥	sbtl
湜	sbtl
盪	sbtq
湯	sbts
燙	sbtx
淏	sbty
忁	sbus
銞	sbv
濕	sbwh
灦	sbwv
滉	sbww
洩	sbx
濐	sbyb
迿	sbz
彵	sc
徆	sc
氾	sc
沯	sc
沰	sc
洭	sce
徱	scfm
魙	scjg
壍	scjl
聻	scjp
嬱	scjr
漸	scjt
漚	scoo
涽	sctb
彽	sctd
滙	scti
汦	sctv
瀭	scvn
潛	scwb
灊	scwy
泧	scx
潥	scx
漣	scz
匇	sd
湆	sdb
徸	sdbl
滝	sdbl
澺	sdbu
灨	sdbv
滰	sdbw
滐	sdcm
淜	sdd
湇	sdd
徿	sdde
瀧	sdde
濟	sddh
湧	sddj
澀	sddl
慂	sddu
乼	sdez
徹	sdga
淯	sdgd
瑬	sdgd
勶	sdgj
汸	sdh
湤	sdhc
浐	sdj
溈	sdjh
滻	sdjl
濓	sdjm
匄	sdl
汒	sdl
灜	sdld
洂	sdm
澵	sdmt
瀙	sdmw
湙	sdmy
湧	sdnj
滳	sdno
慂	sdnu
濥	sdnv
洺	sdo
潡	sdoa
湻	sdob
涥	sdoj
忀	sdok
滖	sdok
瀼	sdok
涼	sdom
滈	sdoo
漷	sdop
渟	sdot
湸	sdow
淚	sdpd
徧	sdph
滬	sdpl
淭	sdpm
涙	sdpy
澟	sdqh
瀤	sdqk
淁	sdr
汿	sdt
沀	sdt
渘	sdtm
潏	sdto
涄	sdts
澦	sdtv
滧	sdva
滾	sdvk
渷	sdvw
洨	sdvx
澭	sdwi
滀	sdwq
済	sdxh
灕	sdxi
彺	se
溄	seaf
潉	sebu
漰	sedd
徴	seea
濏	seej
潖	seel
堻	sefl
徤	sefz
湕	sefz
匓	sega
炰	seh
徾	seia
潯	seid
潚	seik
濜	seiq
幑	seja
漄	sejl
涒	sejo
泿	sek
濜	selq
澅	selt
洡	sem
渄	sene
漴	senm
澂	seta
黴	seta
漼	seti
懲	setu
溰	setv
湷	sevb
淎	sevf
溙	sevs
潂	sevt
湊	sevy
湠	sexx
勻	sf
汙	sf
湱	sfc
潔	sfdm
衎	sffi
灧	sffl
灩	sffq
灃	sffv
沄	sfg
鴴	sfih
鸻	sfit
沶	sfm
汫	sfn
溝	sfnl
盓	sfq
湁	sfvo
濽	sfvv
衏	sfwi
洍	sg
洰	sg
瀏	sgdn
衐	sgfi
忂	sggi
灈	sggi
滲	sggs
鵆	sghi
湼	sgi
澔	sgjo
渒	sgjx
洠	sgki
濎	sgkk
濫	sgkq
灠	sgkw
瀶	sglo
涘	sgly
淿	sgni
湶	sgs
澙	sgsh
漑	sgtw
浿	sgv
測	sgvn
瀴	sgvr
瀃	sgvs
濺	sgvx
沇	sgw
涀	sgw
淣	sgw
溾	sgwg
湨	sgyd
滜	sgyx
馬	sh
沒	sha
馭	sha
駇	sha
駱	shao
騒	shaq
騷	shaq
徣	shb
馹	shb
駻	shbf
驆	shbf
澫	shbg
濗	shbi
騔	shbl
騠	shbl
騍	shbm
騴	shbr
騉	shbu
馳	shc
驃	shcm
驅	shco
駠	shcp
騕	shcr
駆	shcx
驔	shcx
駎	shd
潵	shda
驐	shda
駐	shde
淓	shdh
騙	shdh
騯	shdh
騸	shdj
駺	shdk
驤	shdk
騥	shdm
駋	shdo
驈	shdo
馿	shdp
騁	shds
驙	shdt
駭	shdv
馼	shdx
駮	shdx
騂	shdx
騿	shdx
徔	shdz
駸	shea
騑	shee
瀟	shek
驌	shek
濝	shem
驨	sheo
騄	shes
騝	shez
馯	shf
騞	shfc
湈	shfm
駈	shg
駏	shg
駿	shga
騪	shga
騜	shge
騩	shgg
駘	shgo
灆	shgq
騮	shgq
騡	shgs
驂	shgs
馻	shgw
騃	shgy
馵	shh
驊	shhf
驠	shhh
驩	shhi
騹	shhl
騏	shhv
騲	shhx
驧	shhx
駊	shja
颒	shjb
騈	shjf
騽	shjg
瀳	shjh
騵	shjm
馺	shjn
驕	shjo
馲	shjt
馸	shjt
駓	shjt
騼	shju
驄	shju
頮	shjv
騬	shjv
駪	shjw
騀	shjx
騱	shjy
駳	shjz
駯	shkm
驥	shkv
淽	shl
駞	shlc
驝	shlm
濭	shlq
驍	shlw
驖	shlx
馴	shm
浰	shn
滿	shnd
満	shne
騑	shne
滯	shni
溁	shnm
灡	shnm
騌	shnm
滿	shnn
駉	shno
駧	shno
騆	shno
駝	shnt
懘	shnu
懣	shnu
驞	shnv
濛	shnx
渶	shny
駚	shny
駽	shod
灘	shoi
馽	shoi
漌	shol
漢	shov
駛	shox
驒	shox
駬	shp
騢	shpa
馾	shpl
駅	shpn
駶	shpo
驟	shpx
驏	shpz
渵	shq
駟	shq
駔	shqf
騾	shqm
騧	shqo
騦	shqu
瀎	shqx
驛	shqx
駰	shqy
驛	shqy
涹	shr
駨	shsb
馰	shsd
騳	shsh
驫	shsh
騶	shsj
駒	shso
濍	shsu
騊	shsu
騘	shsu
駙	shtd
満	shte
澕	shtf
馷	shti
駍	shti
騅	shti
駤	shtl
駷	shtm
騋	shtm
渮	shto
驑	shtq
驪	shtu
駥	shtx
駴	shtx
駵	shtz
驦	shug
駜	shuj
驓	shvb
駖	shvd
駩	shve
駢	shvh
驣	shvh
衖	shvi
駼	shvm
騚	shvn
騟	shvn
匒	shvo
濸	shvo
騇	shvo
潻	shvs
駗	shvs
騐	shvu
鍙	shvv
駣	shvv
験	shvv
驗	shvv
駾	shvw
滯	shwi
驜	shwm
瀩	shwv
駫	shww
騨	shwx
馶	shxa
騣	shxa
驋	shxa
駀	shxd
駹	shxd
驎	shxi
渃	shxo
騋	shxv
駁	shxx
騤	shxy
馱	shy
駄	shyd
騎	shyo
驢	shyq
驉	shyt
騻	shyx
駲	shyy
遤	shz
駃	shzv
騛	shzv
鴻	sigh
氺	sii
澒	sijv
滸	silx
氻	sj
沠	sj
碆	sjac
錃	sjav
洦	sjb
湹	sjbl
瀍	sjbl
媭	sjbr
淨	sjei
滽	sjei
漮	sjes
漮	sjex
漘	sjfd
浱	sjfk
滣	sjfo
渓	sjfv
涐	sjfx
盨	sjgq
嬃	sjgr
澃	sjgs
頾	sjgt
湏	sjgv
須	sjgv
漞	sjgw
濿	sjhg
瀝	sjhl
瀇	sjhv
濦	sjiu
汳	sjja
溵	sjja
瀈	sjjc
泝	sjjd
峾	sjje
漝	sjjg
潙	sjjh
垽	sjjl
泒	sjjn
洉	sjjo
瀥	sjjo
漻	sjjs
瀷	sjjv
濢	sjjx
灚	sjkw
徃	sjl
泩	sjl
濳	sjlb
湑	sjld
滛	sjlu
灒	sjlv
鍌	sjlv
涏	sjlz
灖	sjme
涭	sjna
瀀	sjna
洏	sjnn
澚	sjns
渜	sjny
泇	sjo
渪	sjog
溮	sjpi
瀀	sjqa
灂	sjqd
漗	sjqu
潈	sjqx
潨	sjqx
浽	sjr
泲	sjsj
汈	sjt
汑	sjt
衝	sjti
涶	sjtl
泀	sjto
澸	sjtu
減	sjtx
滅	sjtx
泘	sjvi
鸂	sjwh
湚	sjwl
徯	sjwy
汘	sjx
浖	sjxd
涶	sjxf
沑	sjxt
洆	sjxt
溗	sjxv
灋	sjzg
溩	sjzh
瀌	sjzh
彶	sjzn
沜	sk
涱	sk
潷	skef
汼	ski
澨	skiv
淛	sknn
鼝	skta
淵	sktk
泆	skv
滊	skzx
坔	sl
汢	sl
沚	sl
辵	sl
復	slba
漡	slbs
瀞	sldi
濪	sldl
泤	sldv
瀐	slex
漬	slgv
滶	slha
潕	slhh
濤	sljd
淥	sljs
湪	sljx
濊	sljx
泎	slk
徍	sll
湗	slld
澁	slll
徺	sllw
澆	sllw
浾	slm
渉	slmj
溨	slmx
濲	slna
瀔	slna
瀫	slna
淸	slnl
潱	slnv
涜	slnw
瀐	slnx
溒	slok
渽	slox
塰	slql
瀿	slqm
瀆	slqv
瀻	slqx
泚	slt
衘	slti
禦	sltm
頿	sltv
淩	slva
淕	slvl
涬	slvx
澾	slvz
溸	slwm
汻	slx
渋	slx
洔	slxd
潅	slxi
衘	slxi
禦	slxm
匋	slxu
涬	sly
潪	slyb
汌	sm
術	smdi
渿	smfm
湐	smg
硰	smjc
渻	smjg
鯊	smjh
桬	smjm
乷	smjz
逤	smjz
溎	smll
灪	smls
澘	smmb
滼	smmd
漜	smml
濋	smml
潹	smmm
澿	smmm
涁	sms
泍	smt
澗	snb
渾	snc
涴	sndc
浵	snds
濵	sndv
潣	sndx
潤	sne
濅	snea
渄	snee
滱	snfa
瀽	snfl
徖	snfm
瀗	snfu
溕	snfx
瀉	sngh
灁	sngs
濶	snjo
瀋	snjq
浶	snki
漃	snla
徟	snlo
淍	snlo
浨	snm
澖	snm
泂	sno
灛	snox
洝	snr
洀	sns
瀊	snsq
浉	snti
衕	snti
瀾	sntm
濱	sntv
滵	snue
澝	snuf
澝	snui
淧	snuj
濘	snut
汭	snv
泬	snv
湥	snvd
浫	snvf
涳	snvi
漥	snvl
潌	snvl
溛	snvn
浻	snvo
灍	snvv
浤	snxg
涋	snyd
呇	so
敂	soa
涢	sob
雝	sodi
徎	soe
浧	soe
塣	soel
鴝	sogh
溳	sogv
沖	soi
斪	sojk
斪	sojt
澏	sooe
湂	soos
潬	soox
湒	sop
邭	sop
濈	sopx
欨	sorv
漊	sotr
洖	soty
況	sow
漋	spal
徦	spfa
溊	spfa
澱	spha
浘	spjl
浕	spnd
澼	spox
灄	sppp
濻	spqv
徲	spsi
漽	spsi
灟	spsq
埿	sptl
淈	spue
泦	spx
涺	spxo
潳	spyb
沺	sq
泴	sq
澠	sq
畓	sq
灗	sqdt
鶅	sqgh
潰	sqgv
瀢	sqgz
潶	sqh
潩	sqhv
渱	sqi
潀	sqjn
瀱	sqjn
潀	sqjv
澤	sqlx
澤	sqly
涃	sqm
渦	sqo
濄	sqoz
灅	sqql
濁	sqsq
渨	sqtk
疀	sqtl
漍	sqtx
溭	sqva
溫	sqvq
溿	sqvx
巤	sqxv
濖	sqyb
潿	sqzi
潒	srbx
澥	srdi
浄	srei
淊	srg
漁	srh
瀂	srhb
洈	srjc
沵	srm
汣	srn
渙	srny
瀺	srod
匔	sroo
潒	srox
澛	srtb
盜	srvq
匑	srzs
沝	ss
潃	ssad
曶	ssb
涾	ssb
漅	ssbm
彴	ssd
汋	ssd
甮	ssdi
怱	ssdu
瀓	ssea
洐	ssfi
溤	ssh
濷	sshd
渹	ssi
泲	ssij
衟	ssji
澓	ssla
漇	ssll
甮	ssnf
泃	sso
灉	ssoi
沕	sss
渁	sss
淴	sssu
湽	sstq
汮	ssv
漎	ssvl
淗	ssx
洶	ssxu
匂	st
驲	stb
漙	stbd
涷	stbm
潓	stbu
浭	stbx
澑	stcq
涖	std
煭	stdh
骍	stdx
骎	stea
骕	stei
洢	stej
徢	stel
骕	sten
淒	ster
洷	stgl
汧	sth
浟	stia
滫	stid
潐	stih
滌	stim
潗	stim
滺	stiu
準	stix
泟	stl
漹	stlh
徰	stll
沞	stni
洅	stnl
洓	stnm
骔	stnm
澑	stnq
灑	stnu
潄	stoa
灢	stok
湺	stom
溂	ston
湢	stoq
瀜	stoq
浢	stov
瀨	stov
瀬	stov
淢	stox
滆	stoy
徚	stqm
湅	stqm
骃	stqy
汅	sts
徑	stsi
涇	stsi
湽	stsq
骉	stst
沎	stt
汚	stts
骦	stug
溣	stvh
匉	stvi
泙	stvi
徠	stvm
淶	stvm
瀒	stvo
浹	stvv
濔	stvx
溍	stwb
溼	stwl
浌	stx
泭	stxd
漺	stxv
骙	stxy
洑	styd
洟	stzv
浀	su
泏	sue
澐	sufg
湝	sug
滍	suiq
皺	suja
鶵	sujh
雛	suji
芻	sujj
濃	sujk
鄒	sujp
滍	sulq
灀	sumg
瀮	summ
瀖	suti
灔	sutl
灎	sutq
淟	suv
澪	suvd
勽	sv
氼	sv
汃	sv
汄	sv
洕	svd
浳	svd
湌	svdk
滄	svdo
洤	sve
溔	sveh
瀁	svek
溓	svem
湵	sven
渼	svey
溬	svfg
溠	svfi
銜	svfi
涻	svfo
彸	svg
滃	svgj
洴	svh
渆	svhn
汵	svj
彾	svjd
渞	svjg
衑	svji
衜	svji
浛	svjo
匃	svl
従	svl
徶	svna
涗	svow
涚	svow
潧	svqb
澬	svrv
沴	svs
漵	svta
潊	svta
瀲	svta
徻	svtb
澮	svtb
淪	svth
渰	svth
塗	svtl
匌	svto
澰	svtv
湭	svu
澊	svud
從	svvl
聳	svvp
慫	svvu
瀸	svvx
熧	svvx
濨	svwu
澻	svxz
浂	svy
淃	svyc
潫	svym
渕	svyn
漛	svys
垼	swal
汎	swd
盕	swdq
濼	swgm
溑	swgv
泑	swj
渢	swjq
濰	swmi
灤	swmm
灣	swms
灙	swnh
漟	swnl
澢	swnq
灇	swta
洬	swtd
濧	swtd
澲	swtm
沨	swx
勼	sx
匁	sx
匊	sx
氿	sx
洣	sx
灳	sx
災	sx
汥	sxa
沷	sxad
濣	sxbx
漧	sxbz
潾	sxdi
漈	sxfm
汯	sxg
鵴	sxgh
憄	sxgu
泋	sxh
濆	sxhv
洊	sxiz
沋	sxld
浝	sxld
溹	sxnm
瀠	sxnm
湳	sxnx
湳	sxny
浡	sxnz
衚	sxoi
徝	sxqe
淔	sxqe
衠	sxqi
徳	sxqu
溇	sxr
溌	sxth
溌	sxtl
湀	sxty
胷	sxud
濇	sxvo
瀒	sxvo
徠	sxvv
淶	sxvv
洃	sxx
淺	sxx
浗	sxxd
瀅	sxxd
澇	sxxj
濚	sxxm
瀯	sxxo
濴	sxxs
灐	sxxv
濙	sxxx
瀦	sxyb
潑	sxza
徏	sy
汏	sy
匎	sybl
汱	syd
澯	sydx
洿	syfs
湞	sygv
瀕	syjv
浺	syoi
惉	syou
澞	syoy
滷	syqd
瀘	syqq
濾	syqu
洘	sys
渏	syto
浹	syvv
淲	syw
滮	syws
澽	syx
渀	syxh
漺	syxx
涍	syz
	syz
漖	syza
廵	sz
汓	sz
徫	szii
湋	szii
衛	szii
衞	szii
讆	szii
讏	szii
躗	szil
躛	szil
溋	szjq
漲	szsk
彿	szsn
渳	szsp
漒	szsq
瀰	szsx
決	szv
佭	taci
佫	tao
俻	taq
俢	tas
倃	tayo
專	tbgd
甎	tbgd
鴲	tbgh
鷒	tbgh
剸	tbgn
鄟	tbgp
儤	tbhs
敒	tbia
曺	tbib
専	tbid
叀	tbig
恵	tbiu
傝	tbjj
偒	tbjs
東	tbm
鶇	tbmh
僈	tbqa
偍	tbtl
刯	tbtn
偒	tbts
倱	tbu
儑	tbwh
甦	tbxl
郠	tbxp
伡	tc
佦	tc
価	tc
俥	tc
僌	tca
僲	tcdi
僄	tcfm
價	tcgv
畱	tciq
傴	tcoo
偠	tcr
怹	tcu
僊	tcye
仴	td
伷	td
偣	tdb
曺	tdb
殟	tdbq
億	tdbu
傹	tdbw
傽	tdbx
殙	tdcb
傑	tdcm
倗	tdd
傡	tdd
殧	tddd
儱	tdde
儕	tddh
袃	tddk
俷	tddl
殕	tddo
肂	tdef
殝	tdeh
俍	tdek
殔	tdes
俼	tdgd
殦	tdgh
歿	tdha
殢	tdhi
殣	tdhl
殜	tdhm
尃	tdid
旉	tdih
鵏	tdih
郙	tdip
盙	tdiq
喸	tdit
懯	tdiu
乶	tdiz
殠	tdjd
偽	tdjh
殅	tdjl
殈	tdjq
偐	tdjs
歽	tdjt
殀	tdjy
侫	tdlr
殤	tdls
殰	tdlv
殱	tdlx
儭	tdmw
仭	tdn
鮤	tdnh
鴷	tdnh
偙	tdni
劽	tdnj
姴	tdnr
	tdnt
殥	tdnv
殯	tdnv
銐	tdnv
烮	tdnx
佋	tdo
佲	tdo
儴	tdok
倞	tdom
傐	tdoo
殞	tdov
儫	tdox
殫	tdox
僱	tdpi
傓	tdpj
	tdqb
儃	tdqt
殨	tdqv
殬	tdqx
殬	tdqy
倿	tdr
歾	tdss
伃	tdt
殌	tdti
殐	tdtm
僪	tdto
殭	tdtt
殎	tdtv
恵	tdu
俲	tdvj
飱	tdvk
殮	tdvv
倅	tdvx
殲	tdvx
伭	tdw
傗	tdwq
颪	tdwq
伩	tdx
儍	tdxa
専	tdxd
殏	tdxd
殑	tdxw
殘	tdxx
殗	tdyl
侅	tdyv
殩	tdyx
乤	tdz
仼	te
傰	tedd
侓	tef
鶈	teih
郪	teip
儘	teiq
偳	tejn
侰	tejo
佷	tek
疌	tel
儘	telq
帯	teni
儶	teto
弎	tev
偆	tevb
侺	tevj
仠	tf
仹	tf
俌	tf
偰	tfdy
伝	tfg
貳	tfgv
倵	tflv
佅	tfm
颕	tfmb
頴	tfmv
傋	tfnl
弍	tfv
僣	tfvb
儧	tfvv
仏	tg
儌	tgda
偟	tge
晉	tggb
傪	tggs
戩	tggx
傁	tgia
儖	tgkq
鵄	tglh
鷆	tglh
臸	tgll
臵	tglo
眞	tglv
顚	tglv
臹	tglx
臶	tglz
佁	tgo
倶	tgtv
側	tgvn
儩	tgvs
俔	tgw
亙	thdt
僙	thdv
偡	thel
倛	thev
僛	thev
佄	thf
俬	thg
鳽	thgh
僷	thhm
備	thjf
儰	thjh
憊	thju
穎	thjv
伳	thl
偞	thlm
僀	thni
偀	thny
俰	tho
儺	thoi
僅	thol
傼	thov
傇	thp
儚	thqd
僃	thsf
雃	thti
僀	thwi
偢	thx
烎	thx
僽	thxu
仜	ti
隻	tia
脩	tiad
儵	tiah
翛	tiaj
跾	tial
條	tiam
絛	tiam
鞗	tiap
偹	tiaq
鋚	tiav
鎥	tiav
倐	tiax
焂	tiax
鷦	tihh
顦	tihv
丅	tii
犫	tiii
讎	tiii
亙	tijt
顀	tijv
雋	tim
燞	tirh
雙	tita
犨	titi
讐	titi
雔	titi
雥	titi
雦	titi
雧	titm
傠	tixd
鶽	tixh
儲	tiyb
進	tiz
佊	tja
伌	tjc
亙	tjdt
傭	tjei
傏	tjeo
傉	tjfd
倂	tjff
侲	tjfk
夒	tjga
傆	tjgm
頂	tjgv
儮	tjhl
儣	tjhv
仮	tjja
偱	tjjg
僞	tjjh
伒	tjjt
侂	tjjt
俽	tjjv
儨	tjjv
傂	tjjw
伒	tjk
偦	tjld
鵀	tjlh
栠	tjlm
俈	tjlo
傜	tjlu
儹	tjlv
賃	tjlv
侁	tjlw
傶	tjlx
侹	tjlz
倸	tjm
僾	tjna
優	tjna
僢	tjni
偁	tjnl
侕	tjnn
偄	tjny
偊	tjog
侐	tjq
優	tjqa
傯	tjqu
俀	tjr
仛	tjt
働	tjtj
倕	tjtl
偅	tjtl
係	tjwm
傒	tjwy
倕	tjxf
偛	tjxg
佸	tjxo
僠	tjxq
僁	tjxu
仸	tjy
伓	tjy
俖	tjyo
僑	tjyo
伾	tjyt
儦	tjzh
倀	tk
偝	tktd
仩	tl
傷	tlbs
傤	tlcx
儬	tldw
佉	tlg
鴊	tlgh
債	tlgv
儛	tlhi
丏	tlj
夒	tlja
儔	tljd
頃	tljv
頙	tljv
俵	tlk
靕	tlld
僥	tllw
俶	tlma
儓	tlol
儥	tlqv
匘	tlsx
佌	tlt
偨	tltm
俧	tlu
倰	tlva
倖	tlvx
傃	tlwm
倖	tly
倁	tlyo
觺	tlyr
欵	tlyv
瓪	tlza
瓸	tlzb
瓰	tlzd
瓱	tlzl
瓲	tlzl
瓼	tlzl
甅	tlzl
邷	tlzp
瓧	tlzx
瓩	tlzx
仦	tm
鵂	tmgh
烋	tmh
仯	tmj
偗	tmjg
儊	tmml
僸	tmmm
唜	tmot
恷	tmu
倯	tmvg
們	tn
僴	tnb
畱	tncq
倇	tndc
鸝	tndh
酈	tndp
婯	tndr
彨	tnds
彲	tnds
麗	tndu
邐	tndz
両	tne
僿	tnfl
倧	tnfm
俒	tnfw
巿	tni
帀	tni
兩	tnid
鳾	tnih
	tnit
迊	tniz
侘	tnjt
俕	tnm
朿	tnm
敇	tnma
棗	tnmm
僰	tnmv
侒	tnr
侜	tns
佇	tnt
儐	tntv
襾	tnu
儜	tnut
傛	tnvo
僒	tnvo
伔	tnw
伣	tnw
傢	tnx
佒	tny
俋	todl
侱	toe
剚	toen
戜	toex
傊	togv
叓	toia
栆	toid
嚢	toik
櫜	toim
蟗	toiq
侶	tojo
揧	tomf
鵣	tomh
鶒	tomh
鷘	tomh
諐	tomi
勅	tomj
慗	tomu
欶	tomv
賲	tomv
賴	tomv
頼	tomv
辢	tomx
遫	tomz
遬	tomz
鬷	tona
鬴	tond
鷊	tonh
鞷	tonp
鬸	tonq
鬺	tons
亜	tont
鹝	tont
悪	tonu
儼	tooa
僺	toom
偘	tooo
僤	toox
偮	top
畐	toq
鶝	toqh
疈	toqq
俁	tosy
僂	totr
戨	totx
伿	tov
毭	tovl
豏	tovm
剅	tovn
郖	tovp
頭	tovv
豍	tovx
戓	tox
戸	tp
邒	tp
傕	tpii
侷	tpjo
伬	tpn
侭	tpnd
倻	tpp
偓	tptl
偋	tpvh
佀	tpz
僝	tpzz
伵	tq
僶	tq
傦	tqd
伹	tqf
僓	tqgv
侽	tqj
鶫	tqmh
佪	tqo
儙	tqpz
儽	tqqm
畺	tqtt
偲	tqu
倛	tqv
僛	tqvv
儸	tqwi
傫	tqwm
個	tqxo
伮	tra
	tre
偩	trgv
佹	trjc
侞	tro
俛	trow
丂	ts
攷	tsa
侚	tsb
仢	tsd
佨	tse
傌	tsh
巠	tsi
鵛	tsih
勁	tsij
巰	tsim
剄	tsin
頸	tsiv
逕	tsiz
潁	tsjv
坙	tsl
偫	tsld
儠	tsqv
伆	tss
	tsuj
伨	tsv
傱	tsvl
傳	ttbd
倲	ttbm
僡	ttbu
俌	ttdd
倢	ttel
貨	ttgv
侀	tthn
倠	tti
儁	ttim
侙	ttiv
佂	ttl
傿	ttlh
儗	ttll
仾	ttlt
傾	ttlv
倆	ttnd
伂	ttni
侢	ttnl
儷	ttnu
倳	ttoi
儾	ttok
偪	ttoq
侸	ttov
俓	ttsi
伅	ttul
弌	ttv
伻	ttvi
俠	ttvv
儞	ttvx
俫	ttx
俹	ttxt
僫	ttxu
侇	ttzv
伈	tu
傮	tub
佖	tuj
儂	tujk
旾	tulb
頓	tulv
迍	tulz
僼	tutv
倎	tuv
仈	tv
偂	tvdn
傖	tvdo
佡	tve
亊	tvej
傔	tvem
儀	tvex
傞	tvfi
倽	tvfo
僐	tvfo
伀	tvg
傟	tvgj
倊	tvgu
貸	tvgv
併	tvh
仱	tvj
僋	tvjv
垈	tvl
伱	tvm
柋	tvm
璽	tvnd
鸍	tvnh
帒	tvni
壐	tvnl
蠒	tvnq
覼	tvnw
爾	tvnx
邇	tvnz
侻	tvow
佽	tvrv
儈	tvtb
倫	tvth
偸	tvtk
俆	tvtm
倹	tvtv
儉	tvtv
偤	tvu
僔	tvud
麥	tvva
麬	tvva
猌	tvvd
麱	tvvd
麭	tvve
麵	tvvf
麮	tvvg
麶	tvvg
鵊	tvvh
鶆	tvvh
麰	tvvi
勑	tvvj
麨	tvvj
麪	tvvj
侳	tvvl
來	tvvm
麳	tvvm
刾	tvvn
郟	tvvp
郲	tvvp
麫	tvvs
愸	tvvu
憖	tvvu
憗	tvvu
麯	tvvu
夾	tvvv
賚	tvvv
頬	tvvv
頰	tvvv
顂	tvvv
麩	tvvv
麳	tvvv
麷	tvvv
麲	tvvw
逨	tvvz
麧	tvvz
儯	tvyh
伇	twa
尫	twe
尶	twgq
偑	twjq
顈	twmv
僘	twna
儻	twnh
償	twnv
俉	two
卼	twrc
鄑	twtp
僕	twtv
侊	tww
僟	twwx
豗	twx
侎	tx
伖	txa
僯	txdi
姇	txdr
怤	txdu
鴇	txgh
値	txgl
僨	txhv
侟	txiz
颎	txjb
俇	txje
熲	txjv
佈	txni
侼	txnz
傎	txqv
駂	txsh
亞	txt
琧	txtd
鵶	txth
堊	txtl
蝁	txtq
惡	txtu
僜	txtv
倈	txvv
賚	txvv
伜	txx
俴	txx
倓	txx
倄	txxd
俙	txxi
僗	txxj
儝	txxm
慭	txyu
偖	tyb
昋	tyb
奣	tybd
偧	tydd
儏	tydx
偼	tyel
倷	tyfm
鴌	tygh
偵	tygv
佔	tyo
儢	tyqu
侤	tys
沗	tys
蝅	tytq
蠺	tytq
傄	tyvg
俠	tyvv
俿	tyw
倴	tyxh
傸	tyxx
侾	tyz
迗	tyz
辷	tz
偉	tzii
鄇	tzlp
鴺	tzsh
伄	tzsi
醊	uaaa
霷	ubbs
電	ubl
醖	ubq
雼	uc
醰	ucbx
醥	ucfm
醧	ucoo
雴	ud
醷	udbu
靇	udde
霽	uddh
酙	uddx
霡	uddx
酼	udgm
雱	udh
霢	udjk
醕	udob
釀	udok
霩	udop
霚	udta
霿	udtg
雺	udtj
霧	udtj
霱	udto
醸	udvk
醨	udxg
欪	uerv
醁	ues
糶	uexi
酑	uf
酺	uf
靊	uffv
雲	ufg
靉	ufga
霒	ufgj
霕	ufgl
霴	ufgs
靅	ufgv
霼	ufgx
靆	ufgz
鄠	ufsp
酜	ufv
酛	ufw
霊	ufwt
鶛	uggh
醦	uggs
醙	ugia
勓	ugj
醜	ugwg
雸	uhf
醼	uhkh
靀	uhnx
霙	uhny
醼	uhoh
霅	ui
靄	uibl
旹	uitb
妛	uitr
芔	uiui
農	ujfk
毞	ujfl
酕	ujfl
雮	ujfl
鴓	ujgh
覕	ujgw
靂	ujhl
霫	ujjg
櫱	ujjm
蠥	ujjq
糱	ujjx
辥	ujjx
孼	ujjz
釄	ujme
醿	ujmm
醾	ujmx
顬	ujnv
邲	ujp
釂	ujqd
雟	ujto
醎	ujtx
艸	ujui
茻	ujui
雽	ujvi
酻	ujz
雭	ujzn
坒	ul
旹	ulb
醘	ulgq
醻	uljd
妛	ulr
枈	um
雬	um
鸘	umgh
鹴	umgt
醂	umm
霦	umms
靌	unev
霥	unfx
霌	unlo
醡	unvk
酧	unxd
雵	uny
醠	unyq
吢	uo
霣	uogv
釅	uooa
龗	uooe
霝	uooo
孁	uoor
靈	uoov
霵	uopx
霳	upal
霨	upfd
靏	upih
酖	upl
醓	uplq
霬	uqhv
醳	uqlx
醳	uqly
靁	uqqq
靐	uquq
醞	uqvq
霔	usde
霶	usdh
霺	usea
霮	ushl
霟	ushv
靋	usjl
醄	uslu
霂	usm
霘	usno
霃	uspl
霗	usvd
霐	uszg
雫	utd
酺	utdd
霋	uter
醀	uti
靍	utih
鸖	utih
靃	utii
釃	utnu
酠	uto
豑	utoj
艶	utol
鄷	utop
豊	utov
醩	uub
醲	uujk
醹	uujn
醽	uuoo
霻	uutv
惢	uuu
橤	uuum
繠	uuum
敟	uva
雰	uvd
酫	uve
醝	uvfi
靎	uvgh
覥	uvgw
觍	uvnw
醶	uvtv
雿	uvwv
酘	uwa
酳	uwd
粊	ux
酭	uxd
醗	uxth
醗	uxtl
霯	uxtv
酔	uxx
醆	uxx
醈	uxx
醱	uxza
醏	uyb
醃	uybl
酟	uyo
逎	uz
霛	uzss
锠	vbb
鸧	vcgt
冴	vcij
	vcij
凐	vcl
凓	vcm
亽	vd
攽	vda
仒	vdd
飯	vdea
餕	vdea
餟	vdea
餿	vdea
饅	vdea
饊	vdea
餫	vdec
饝	vdec
餔	vded
餚	vded
餬	vded
餶	vded
餺	vded
饞	vded
飳	vdee
飽	vdee
飿	vdee
餭	vdee
飦	vdef
飷	vdef
餔	vdef
餠	vdef
饆	vdef
飠	vdeg
餡	vdeg
饀	vdeg
餅	vdeh
餝	vdeh
餴	vdeh
餻	vdeh
鶬	vdeh
飾	vdei
餙	vdei
餰	vdei
饠	vdei
飭	vdej
飶	vdej
飵	vdek
餏	vdek
餦	vdek
餵	vdek
饟	vdek
饢	vdek
飩	vdel
飪	vdel
餁	vdel
餣	vdel
饄	vdel
饉	vdel
餗	vdem
餘	vdem
餜	vdem
饓	vdem
創	vden
倉	vdeo
飴	vdeo
飼	vdeo
餂	vdeo
餄	vdeo
餇	vdeo
餉	vdeo
餎	vdeo
餢	vdeo
餹	vdeo
饇	vdeo
饍	vdeo
饎	vdeo
飹	vdep
餌	vdep
蝕	vdeq
餾	vdeq
饁	vdeq
饂	vdeq
饚	vdeq
餒	vder
餧	vder
飻	vdes
餳	vdes
飣	vdet
飥	vdet
餷	vdet
饈	vdet
饘	vdet
餛	vdeu
飤	vdev
飮	vdev
飲	vdev
餆	vdev
餖	vdev
餩	vdev
饋	vdev
饌	vdev
饐	vdev
饙	vdev
饡	vdev
飢	vdew
饒	vdew
戧	vdex
餀	vdex
餃	vdex
餓	vdex
餞	vdex
餤	vdex
餯	vdex
餼	vdex
饑	vdex
饖	vdex
饛	vdex
飫	vdey
飰	vdey
餪	vdey
餱	vdey
饃	vdey
餑	vdez
館	vdez
鳻	vdgh
貧	vdgv
弅	vdh
麄	vdju
頒	vdjv
兺	vdot
邠	vdp
	vdpj
蚠	vdq
凜	vdqm
瓫	vdtd
炃	vdx
仺	ve
	ve
羕	vedx
錱	vee
冿	vef
羮	vehv
義	vejx
甉	vemd
鶼	vemh
羑	vern
羨	vesv
凗	veti
凒	vetv
鯗	vevh
養	vevk
羙	vex
羛	vezn
	vf
羪	vfdk
羓	vfdl
羶	vfdt
鴹	vfgh
譱	vfii
齹	vfiu
劷	vfj
羻	vfja
羱	vfjm
羳	vfjq
羬	vfjx
佱	vfl
羗	vflg
羫	vfni
羜	vfnt
羦	vfnw
舖	vfod
鵨	vfoh
舘	vfoz
鮺	vfrh
鲝	vfrt
羏	vfs
羥	vfti
羠	vftv
羢	vftx
羺	vfun
敾	vfva
羒	vfvd
羴	vfvf
鯗	vfvh
養	vfvk
羭	vfvn
歚	vfvv
羷	vfvv
羖	vfwa
镈	vfxd
兿	vfxg
羵	vfxv
锽	vge
	vgga
鳶	vgh
鶲	vgjh
勜	vgjj
鹟	vgjt
頌	vgjv
枀	vgm
忩	vgu
貣	vgv
楽	vgvm
兊	vgw
毤	vgwl
剏	vhdd
铓	vhdl
剙	vhdv
凘	vhet
鵧	vhgh
頩	vhjv
锳	vhny
郱	vhp
艵	vhrl
	vhyb
冮	vi
丷	vii
釒	vii
鴒	vjdh
刢	vjdn
領	vjdv
凈	vjei
侌	vjfg
導	vjgd
凞	vjgh
鳹	vjgh
噵	vjgo
貪	vjgv
锧	vjjb
頷	vjov
欦	vjrv
雂	vjti
酓	vju
敜	vjua
韽	vjub
盦	vjuq
铦	vjxo
亾	vl
凊	vld
舎	vlo
舗	vlod
凟	vlqv
尒	vm
凚	vmmm
凕	vnbv
暼	vnmb
獘	vnmd
撆	vnmf
鱉	vnmh
鷩	vnmh
幣	vnmi
鄨	vnml
龞	vnml
蟞	vnmq
鼈	vnmq
龞	vnmq
嫳	vnmr
斃	vnmt
鐅	vnmv
龞	vnmx
兌	vow
敓	vowa
敚	vowa
兯	vp
冺	vptv
曽	vqb
鄫	vqbp
朆	vqbs
兾	vqhv
凙	vqlx
镮	vqtk
凅	vqxo
镵	vrod
凂	vrow
秶	vrvh
餈	vrvk
垐	vrvl
栥	vrvm
楶	vrvm
資	vrvv
乲	vrvz
淾	vs
馮	vsh
慿	vshu
憑	vshu
凴	vshw
镴	vsqv
亼	vt
凍	vtbm
镈	vtdd
兪	vtdk
鄃	vtdp
歈	vtdv
覦	vtdw
铚	vtgl
钘	vth
铏	vthn
隿	vti
凖	vtix
侴	vtjn
敍	vtma
敘	vtma
峹	vtme
嵞	vtme
雓	vtmi
厁	vtmp
畬	vtmq
悆	vtmu
侖	vtnh
敆	vtoa
斂	vtoa
剱	vtod
劎	vtod
劒	vtod
龕	vtoe
搻	vtof
龤	vtog
弇	vtoh
鴿	vtoh
鸙	vtoh
龢	vtoh
翖	vtoj
凁	vtom
剣	vton
劍	vton
劔	vton
畣	vtoq
盫	vtoq
龣	vtos
僉	vtov
欱	vtov
歛	vtov
頜	vtov
顩	vtov
龡	vtov
龥	vtov
會	vtqb
劊	vtqn
鄶	vtqp
朇	vtqx
铔	vtwt
屰	vuj
愬	vuju
欮	vujv
遡	vujz
蠤	vuqq
鷷	vuxh
鄭	vuyp
仌	vv
凎	vv
釡	vv
錣	vvaa
釵	vvad
鉖	vvad
鋒	vvaf
鎟	vvam
鉻	vvao
鏠	vvaz
鈤	vvb
鏝	vvba
錩	vvbb
鍀	vvbd
鏎	vvbf
鍝	vvbg
鉮	vvbi
鎉	vvbj
鋰	vvbl
鍉	vvbl
鍟	vvbl
鍻	vvbl
錁	vvbm
鐛	vvbm
鎾	vvbq
錫	vvbs
鍚	vvbs
鉭	vvbt
錕	vvbu
鎤	vvbw
釶	vvc
鉐	vvc
錉	vvcb
鐕	vvcb
鉔	vvci
釾	vvcj
錷	vvcl
鏢	vvcm
鉕	vvco
銽	vvco
鏂	vvco
鉚	vvcp
鋣	vvcp
鏩	vvct
鑎	vvcv
鉞	vvcx
鐔	vvcx
鏈	vvcz
釖	vvd
釸	vvd
鈅	vvd
鈾	vvd
鉝	vvd
鐓	vvda
鑁	vvda
鍦	vvdc
釰	vvdd
鉹	vvdd
錋	vvdd
錑	vvdd
錥	vvdd
鉒	vvde
鑨	vvde
銿	vvdf
鎇	vvdg
鈁	vvdh
鍽	vvdh
鎊	vvdh
鑇	vvdh
鈰	vvdi
鍗	vvdi
鏲	vvdi
	vvdj
銥	vvdk
鋃	vvdk
鎄	vvdk
鑲	vvdk
飡	vvdk
釯	vvdl
鈀	vvdl
鏇	vvdl
鏟	vvdl
鐘	vvdl
鋶	vvdm
鍄	vvdm
鍒	vvdm
釼	vvdn
凔	vvdo
鉊	vvdo
銘	vvdo
錇	vvdo
鎬	vvdo
鏑	vvdo
鐍	vvdo
鈩	vvdp
鎯	vvdp
鐿	vvdu
鈧	vvdw
鉉	vvdw
銃	vvdw
鏡	vvdw
鈄	vvdx
鈫	vvdx
鉸	vvdx
鋅	vvdx
錊	vvdx
鏱	vvdx
鏃	vvdy
錞	vvdz
釲	vve
鋟	vvea
鈺	vved
鏰	vved
鐞	vved
銉	vvef
錌	vvef
鎽	vvef
銟	vvei
鏙	vvei
銀	vvek
鏽	vvek
銇	vvem
鍴	vven
鑩	vveo
鑴	vveo
録	vves
鎧	vvev
鐉	vvev
銭	vvex
鍵	vvez
釪	vvf
釬	vvf
鋪	vvf
鐟	vvfb
鋳	vvfd
鎛	vvfd
鏏	vvfe
銒	vvff
	vvfo
釫	vvfs
銢	vvfs
鈇	vvfv
錻	vvfv
鑚	vvfv
鈨	vvfw
鍥	vvfy
鉅	vvg
鉑	vvg
鉬	vvg
鋑	vvga
鎪	vvga
钁	vvga
鍠	vvge
鵭	vvgh
鉾	vvgi
錦	vvgi
鑺	vvgi
鐤	vvgk
鏗	vvgl
鍘	vvgn
鈶	vvgo
鎦	vvgq
鑑	vvgq
鏒	vvgs
鋇	vvgv
鋲	vvgv
鑦	vvgv
鈗	vvgw
鋧	vvgw
鑬	vvgw
錍	vvgx
鉌	vvh
鏾	vvha
鑊	vvha
錯	vvhb
鐯	vvhb
鑙	vvhb
鏋	vvhd
鑮	vvhd
鉗	vvhf
鏵	vvhf
錺	vvhh
鑵	vvhi
銹	vvhj
鉪	vvhl
鋩	vvhl
鍖	vvhl
鍱	vvhm
鏫	vvhm
鐷	vvhm
钄	vvhm
鋓	vvhn
鍣	vvho
鍩	vvho
鎝	vvho
錨	vvhq
鑉	vvhq
錗	vvhr
鑗	vvhs
錵	vvht
鐁	vvht
鉷	vvhv
錤	vvhv
鐄	vvhv
鋵	vvhw
銰	vvhx
鍬	vvhx
鑖	vvhx
鑶	vvhx
鍈	vvhy
鏌	vvhy
鑝	vvhz
睂	vvig
釒	vvij
銾	vvis
釕	vvj
釛	vvj
釽	vvj
鈑	vvja
鈹	vvja
鍍	vvja
鍛	vvja
鍰	vvja
鎫	vvja
鑀	vvja
銆	vvjb
鋝	vvjd
鎒	vvjd
錘	vvjf
鎺	vvjf
鉱	vvjg
銩	vvjg
鍎	vvjg
鍤	vvjg
鎢	vvjh
鏣	vvjh
鑂	vvjh
鑣	vvjh
鏞	vvji
鑃	vvji
鋠	vvjk
鈓	vvjl
鉎	vvjl
錘	vvjl
鍾	vvjl
鎳	vvjm
鐮	vvjm
釞	vvjn
鈒	vvjn
鈲	vvjn
鉫	vvjo
鉰	vvjo
銄	vvjo
銗	vvjo
銛	vvjo
鋯	vvjo
鎕	vvjo
鐈	vvjo
鐇	vvjq
鋖	vvjr
鏐	vvjs
鏮	vvjs
釿	vvjt
鈕	vvjt
鉟	vvjt
懖	vvju
鎐	vvju
鎞	vvju
鎴	vvju
鏓	vvju
鏕	vvju
鏭	vvju
鍁	vvjv
鐝	vvjv
鑕	vvjv
鑛	vvjv
鑽	vvjv
顉	vvjv
銑	vvjw
釺	vvjx
銊	vvjx
銔	vvjx
鋨	vvjx
鋮	vvjx
鍼	vvjx
鏚	vvjx
鈈	vvjy
鐭	vvjy
鋋	vvjz
鋌	vvjz
鋢	vvjz
鎚	vvjz
鋹	vvk
鏘	vvkd
鈝	vvki
銖	vvkm
鏼	vvkm
鉳	vvkt
鉄	vvkv
鎎	vvkx
釓	vvl
釷	vvl
夎	vvla
錂	vvla
鍑	vvla
鉇	vvlc
錆	vvld
錹	vvld
鑄	vvld
鉣	vvlg
鉓	vvli
鈼	vvlk
錶	vvlk
鎱	vvlk
銈	vvll
錴	vvll
剉	vvln
銡	vvlo
鎑	vvlq
鋂	vvls
錄	vvls
鋕	vvlu
鑡	vvlu
鉯	vvlv
鑟	vvlv
鐃	vvlw
鐡	vvlx
鐬	vvlx
鐵	vvlx
﨨	vvlx
鉃	vvly
鉲	vvly
﨨	vvly
釳	vvlz
鐽	vvlz
釥	vvm
釧	vvm
鈢	vvm
鉥	vvmd
鑻	vvmf
錰	vvmh
鈔	vvmj
鉢	vvmt
釗	vvn
鍆	vvn
鏥	vvnb
鐧	vvnb
鋺	vvnc
鍕	vvnc
鐗	vvnd
鑧	vvnd
鋼	vvne
鋐	vvng
鐦	vvnh
錠	vvnl
鑳	vvnl
錝	vvnm
鑔	vvnm
鑭	vvnm
銅	vvno
錭	vvno
鎋	vvno
鎔	vvno
銨	vvnr
鉈	vvnt
銏	vvnt
鍹	vvnt
鑏	vvnt
鈉	vvnv
鏔	vvnv
鑌	vvnv
鑹	vvnv
鋎	vvnw
鎵	vvnx
鉠	vvny
錧	vvnz
釦	vvo
豃	vvoa
鋗	vvod
豅	vvoe
鋥	vvoe
谻	vvof
谹	vvog
鵒	vvoh
谾	vvoi
鈡	vvoi
銱	vvoi
鋛	vvoi
谺	vvoj
鋜	vvol
鐰	vvom
谽	vvoo
鋁	vvoo
鏴	vvoo
卻	vvop
郤	vvop
鍓	vvop
螸	vvoq
鏤	vvor
豂	vvos
鍔	vvos
慾	vvou
谼	vvov
豄	vvov
鉙	vvov
鉂	vvox
豀	vvoy
鋘	vvoy
逧	vvoz
鉺	vvp
鋷	vvpa
鍜	vvpa
鍲	vvpb
鈂	vvpl
銸	vvpl
鈬	vvpn
鋦	vvpo
鋸	vvpo
錒	vvpo
鎁	vvpp
鑷	vvpp
钃	vvpq
鐊	vvps
鈮	vvpt
鈱	vvpv
鐴	vvpx
鈻	vvpz
鈿	vvq
鉀	vvq
鉵	vvq
鉏	vvqf
鷁	vvqh
鑼	vvqi
鋤	vvqj
鍡	vvqk
鐶	vvqk
鎠	vvql
鑸	vvql
鏍	vvqm
錮	vvqo
鍋	vvqo
鐲	vvqq
鑘	vvqq
鉧	vvqs
鹢	vvqt
鍶	vvqu
鏆	vvqv
鐀	vvqv
鐸	vvqx
銦	vvqy
鐸	vvqy
鐹	vvqz
鑓	vvqz
釹	vvr
銵	vvr
鑥	vvrb
鑱	vvrd
錎	vvrg
錚	vvri
銫	vvrl
鉨	vvrm
銣	vvro
欽	vvrv
鋔	vvrw
鐌	vvrx
釤	vvs
銁	vvsb
錔	vvsb
釣	vvsd
鉋	vvse
鈎	vvsg
鍅	vvsg
鎷	vvsh
鍧	vvsi
鎃	vvsk
鏦	vvsl
鏁	vvsm
鉤	vvso
錙	vvsq
鐋	vvss
憌	vvsu
鋾	vvsu
鍃	vvsu
鍯	vvsu
鈞	vvsv
鎻	vvsv
鑞	vvsv
釘	vvt
鋄	vvta
錽	vvta
鉜	vvtd
鋪	vvtd
鎛	vvtd
鏄	vvtd
鏅	vvtd
鈃	vvth
鐎	vvth
鋞	vvti
錐	vvti
鎸	vvtj
鈍	vvtl
鉦	vvtl
銋	vvtl
銍	vvtl
凃	vvtm
銝	vvtm
鋉	vvtm
錬	vvtm
錸	vvtm
鍊	vvtm
鏶	vvtm
鐫	vvtm
鉶	vvtn
冾	vvto
鈳	vvto
鎶	vvto
鍢	vvtq
鍿	vvtq
鐂	vvtq
鈣	vvts
鎀	vvts
鈋	vvtt
錏	vvtt
鏸	vvtu
鐚	vvtu
鈵	vvtv
鉽	vvtv
銕	vvtv
鋀	vvtv
鋏	vvtv
鋱	vvtv
鎭	vvtv
鏉	vvtv
鎨	vvtx
鑈	vvtx
韱	vvtx
鍭	vvty
鎘	vvty
鈊	vvu
鈚	vvu
鏪	vvub
鈯	vvue
鍇	vvug
鉍	vvuj
鑐	vvun
鐳	vvuq
錪	vvuv
釟	vvv
釴	vvv
鍂	vvv
鏳	vvvb
鐠	vvvb
錈	vvvc
鈖	vvvd
鈴	vvvd
鎙	vvvd
鐏	vvvd
銓	vvve
鎿	vvvf
鈆	vvvg
錀	vvvh
鑰	vvvh
鎈	vvvi
鈐	vvvj
銻	vvvj
鎓	vvvj
銼	vvvl
錓	vvvl
鉩	vvvm
鎌	vvvm
鍮	vvvn
鎆	vvvn
鉿	vvvo
鋊	vvvo
鋡	vvvo
鐥	vvvo
鎰	vvvq
鉁	vvvs
錜	vvvu
銚	vvvv
鐱	vvvv
銳	vvvw
鋭	vvvw
鎡	vvvw
傘	vvvx
鉡	vvvx
鑯	vvvx
鎂	vvvy
鎹	vvvz
鐩	vvvz
釠	vvw
鈠	vvwa
釩	vvwd
銷	vvwd
鑆	vvwd
鐣	vvwf
钂	vvwh
鏛	vvwi
鏜	vvwl
銯	vvwm
鏿	vvwm
鑠	vvwm
鉛	vvwo
鋙	vvwo
鋿	vvwo
鐑	vvwo
鐺	vvwq
鎖	vvwv
鏷	vvwv
鑜	vvwv
镃	vvww
銧	vvww
鎲	vvww
鐖	vvwx
冸	vvx
釚	vvx
針	vvx
鈛	vvx
鈥	vvx
銤	vvx
鈘	vvxa
鍐	vvxa
鎩	vvxa
鏺	vvxa
釻	vvxd
鈸	vvxd
銪	vvxd
銶	vvxd
鍸	vvxd
鈜	vvxg
鈽	vvxi
鏻	vvxi
釮	vvxj
鐒	vvxj
鎍	vvxm
鑅	vvxm
鈷	vvxo
錸	vvxv
鎮	vvxv
鐙	vvxv
鐼	vvxv
鋴	vvxw
錟	vvxx
錢	vvxx
鍨	vvxy
銌	vvxz
鋍	vvxz
釙	vvy
釱	vvy
鈙	vvya
鍺	vvyb
鈦	vvyd
鏀	vvyd
钀	vvyd
鎼	vvyf
錛	vvyh
鏬	vvyi
鐪	vvyj
鍷	vvyl
錼	vvym
鐐	vvym
鉆	vvyo
錡	vvyo
銙	vvys
銬	vvys
銠	vvyt
鑢	vvyu
鍞	vvyv
錿	vvyw
鋽	vvyx
鏯	vvyx
鐻	vvyx
銂	vvyy
﨧	vvyz
釔	vvz
釨	vvz
鈏	vvzi
鈟	vvzi
鍏	vvzi
釢	vvzj
鉘	vvzn
錳	vvzq
鏹	vvzq
鈌	vvzv
鐨	vvzv
尣	vw
尩	vwe
镋	vwnw
铻	vwo
尦	vwsd
並	vwt
鴵	vwvh
頫	vwvv
甆	vwwd
鶿	vwwh
鷀	vwwh
仐	vx
冹	vxad
頖	vxjv
鵥	vxnh
爺	vxpp
	vy
	vyad
勌	vycj
飬	vydk
劵	vyj
牶	vyki
齤	vylu
奍	vyn
帣	vyni
觠	vyr
鮝	vyrh
駦	vysh
餋	vyvk
勬	vywj
絭	vywm
韏	vyzi
巻	vyzl
弮	vyzs
鵜	vzsh
弚	vzsi
巣	wbm
虩	wbmw
缊	wbq
単	wbx
戦	wbxx
	wd
揱	wdnf
缞	wdok
凨	wfg
鳯	wgh
缐	wgs
樂	wgwm
绬	whny
	wii
凮	wjb
響	wjdb
饗	wjdk
嚮	wjdo
鄉	wjdp
蠁	wjdq
郷	wjep
鴢	wjgh
鄕	wjgp
厳	wjja
纴	wjl
鄊	wjpp
蚃	wjq
風	wjq
颰	wjqa
颵	wjqd
颮	wjqe
颹	wjqi
颬	wjqj
颴	wjql
颲	wjqn
颭	wjqo
颱	wjqo
颳	wjqo
飍	wjqq
颩	wjqs
颺	wjqs
颸	wjqu
颫	wjqv
颶	wjqv
颷	wjqx
孧	wjz
乣	wl
凪	wl
盭	wlvq
盭	wlyq
凩	wm
糹	wm
綴	wmaa
紁	wmad
終	wmad
綘	wmaf
絳	wmai
経	wmal
縔	wmam
絡	wmao
綹	wmao
縫	wmaz
縵	wmba
繓	wmba
縪	wmbf
紳	wmbi
緹	wmbl
縄	wmbl
綶	wmbm
緼	wmbq
緆	wmbs
緄	wmbu
縨	wmbw
絏	wmbx
絤	wmc
緍	wmcb
緸	wmcl
縹	wmcm
轡	wmco
紙	wmcv
縺	wmcz
糿	wmd
紬	wmd
紉	wmdd
綟	wmdd
綳	wmdd
紸	wmde
縭	wmdg
紡	wmdh
緕	wmdh
編	wmdh
縍	wmdh
繎	wmdh
纃	wmdh
鶭	wmdh
締	wmdi
縴	wmdi
縗	wmdk
纕	wmdk
紦	wmdl
絕	wmdl
縼	wmdl
綡	wmdm
紹	wmdo
縞	wmdo
繘	wmdo
紓	wmdt
繵	wmdt
綛	wmdu
繶	wmdu
絯	wmdv
纐	wmdv
絃	wmdw
統	wmdw
綂	wmdw
紋	wmdx
紏	wmdx
絞	wmdx
綷	wmdx
繂	wmdx
織	wmdx
綧	wmdz
綅	wmea
繃	wmed
緋	wmee
縥	wmeh
繀	wmei
繡	wmek
繍	wmen
纗	wmeo
緑	wmes
繣	wmet
繏	wmev
縁	wmex
紆	wmf
縛	wmfd
紜	wmfg
綁	wmfp
纉	wmfv
絈	wmg
繳	wmga
綿	wmgi
緲	wmgj
紿	wmgo
繿	wmgq
纓	wmgr
線	wmgs
緿	wmgu
繉	wmgv
絸	wmgw
纜	wmgw
綼	wmgx
繖	wmha
紺	wmhf
綉	wmhj
紲	wmhl
緤	wmhm
緙	wmhp
縙	wmhp
緢	wmhq
緌	wmhr
繱	wmhu
綨	wmhv
緓	wmhy
縸	wmhy
纄	wmhz
紅	wmi
變	wmia
曫	wmib
巒	wmie
攣	wmif
矕	wmig
鸞	wmih
欒	wmim
	wmim
蠻	wmiq
孌	wmir
彎	wmis
灓	wmis
戀	wmiu
臠	wmiv
鑾	wmiv
卛	wmix
奱	wmiy
孿	wmiz
糼	wmj
絼	wmj
紴	wmja
綬	wmja
緞	wmja
緩	wmja
繌	wmja
纋	wmja
絔	wmjb
縃	wmjd
縟	wmjd
綞	wmjf
緬	wmjf
絋	wmjg
縚	wmjg
纁	wmjh
紝	wmjl
綞	wmjl
緟	wmjl
緾	wmjl
纏	wmjl
纒	wmjl
綵	wmjm
縓	wmjm
級	wmjn
絬	wmjo
綏	wmjr
繆	wmjs
紐	wmjt
紤	wmjt
總	wmju
纊	wmjv
纘	wmjv
絾	wmjx
緘	wmjx
縅	wmjx
縬	wmjx
紑	wmjy
緛	wmjy
縘	wmjy
綎	wmjz
綒	wmjz
綖	wmjz
縋	wmjz
絑	wmkm
紩	wmkv
糺	wml
綾	wmla
緮	wmla
絁	wmlc
綪	wmld
糾	wmli
絓	wmll
縤	wmlm
結	wmlo
繥	wmlo
綠	wmls
紪	wmlt
綕	wmlu
績	wmlv
纈	wmlv
續	wmlv
続	wmlw
繞	wmlw
緈	wmlx
緣	wmlx
繊	wmlx
纎	wmlx
緈	wmly
紇	wmlz
繨	wmlz
紃	wmm
絉	wmmd
緗	wmmg
紗	wmmj
綝	wmmm
絊	wmmt
縮	wmnb
綩	wmnc
緷	wmnc
繝	wmnd
綱	wmne
緋	wmne
綋	wmng
網	wmnl
綻	wmnl
綜	wmnm
絅	wmno
絧	wmno
綗	wmno
綢	wmno
縖	wmno
紵	wmnt
紽	wmnt
縇	wmnt
納	wmnv
繽	wmnv
綄	wmnw
縡	wmnx
紻	wmny
綰	wmnz
絹	wmod
繰	wmom
絽	wmoo
緝	wmop
縷	wmor
縜	wmov
繟	wmox
緅	wmpa
縀	wmpa
緡	wmpb
紞	wmpl
細	wmq
繩	wmq
緭	wmqd
縎	wmqd
組	wmqf
纙	wmqi
繯	wmqk
纆	wmql
綑	wmqm
縲	wmqm
纝	wmqm
綥	wmqn
絗	wmqo
緺	wmqo
縕	wmqq
緦	wmqu
繢	wmqv
繹	wmqx
絪	wmqy
繹	wmqy
繾	wmqz
纔	wmrd
繺	wmrh
繲	wmri
絶	wmrl
絻	wmrw
絢	wmsb
約	wmsd
絎	wmsi
縐	wmsj
縦	wmsl
縰	wmsl
縱	wmsl
繅	wmsm
絇	wmso
緇	wmsq
綯	wmsu
緫	wmsu
糽	wmt
緻	wmta
縉	wmtb
紨	wmtd
絥	wmtd
緉	wmtd
縛	wmtd
縳	wmtd
經	wmti
維	wmti
純	wmtl
絍	wmtl
絰	wmtl
緁	wmtl
綀	wmtm
緥	wmtm
練	wmtm
縧	wmtm
緀	wmtr
絙	wmtt
絚	wmtt
繮	wmtt
繐	wmtu
纚	wmtu
綊	wmtv
纀	wmtv
絨	wmtx
綆	wmtx
緎	wmtx
緶	wmtx
緱	wmty
紕	wmu
綇	wmu
絀	wmue
繧	wmug
繷	wmuk
繻	wmun
繒	wmvb
繪	wmvb
綣	wmvc
紛	wmvd
紷	wmvd
繜	wmvd
絟	wmve
絴	wmvf
絵	wmvg
絣	wmvh
綸	wmvh
縒	wmvi
紟	wmvj
綈	wmvj
緃	wmvl
縑	wmvm
紒	wmvn
緰	wmvn
給	wmvo
綌	wmvo
繕	wmvo
縊	wmvq
紾	wmvs
総	wmvu
緧	wmvu
縂	wmvu
絘	wmvv
絩	wmvv
綐	wmvw
絆	wmvx
纖	wmvx
縌	wmvz
繸	wmvz
綃	wmwd
鷥	wmwh
繼	wmwl
絲	wmwm
纅	wmwm
緔	wmwo
纞	wmwu
絖	wmww
緵	wmxa
紂	wmxd
紈	wmxd
紌	wmxd
紱	wmxd
絠	wmxd
絿	wmxd
紘	wmxg
絺	wmxi
繗	wmxi
継	wmxl
縩	wmxm
繬	wmxo
縝	wmxv
紣	wmxx
綫	wmxx
緂	wmxx
綍	wmxz
緒	wmyb
緖	wmyb
紎	wmyd
繚	wmym
綺	wmyo
纑	wmyq
絝	wmys
緪	wmyt
縆	wmyt
緽	wmyv
綽	wmyx
絒	wmyy
紭	wmzg
紖	wmzi
緯	wmzi
紀	wmzl
紼	wmzn
繈	wmzq
繦	wmzq
	wn
鴬	wngh
鸴	wngt
覚	wngw
凧	wni
労	wnj
坣	wnl
栄	wnm
彆	wnms
嘗	wnob
瓽	wnod
甞	wnof
黨	wnoh
幤	wnoi
牚	wnoj
劏	wnon
営	wnoo
當	wnoq
賞	wnov
蛍	wnq
纻	wnt
敩	wnza
郚	wop
逜	woz
畄	wq
獣	wqtd
绹	wslu
凬	wtb
鳳	wtgh
叢	wtva
對	wtvd
黺	wtvd
鸈	wtvh
業	wtvm
鄴	wtvp
懟	wtvu
菐	wtvv
鑿	wtvv
丵	wtvx
糳	wtvx
丵	wty
糳	wtyx
彂	wtzy
忢	wu
凲	wvem
挙	wvjf
绤	wvvo
尡	wwbu
鼡	wwf
黋	wwhv
兤	wwjv
輝	wwnc
斷	wwtk
斷	wwtt
幾	wwyx
韑	wwzi
飗	wxgq
飔	wxqu
飐	wxyo
纼	wzsi
炇	xa
犮	xad
炵	xadd
盋	xadq
糔	xadq
攳	xaed
熢	xafz
鳷	xagh
頍	xajv
焻	xbb
焨	xbd
燳	xbdh
燝	xbdm
亁	xbfz
熚	xbhf
爗	xbhf
焺	xbjh
煋	xbjl
煬	xbjs
糃	xbjs
粴	xbl
粿	xbm
熶	xbpa
煴	xbq
豱	xbq
焬	xbss
炟	xbt
煶	xbtl
糧	xbtl
煬	xbts
糃	xbts
熀	xbww
	xbx
幹	xbxf
鶾	xbxh
雗	xbxi
韓	xbxi
乹	xbxl
榦	xbxm
螒	xbxq
倝	xbxv
灺	xc
熛	xcfm
煙	xcl
熰	xcoo
焝	xctb
熸	xcwb
糣	xcwb
灱	xd
粙	xd
豖	xd
燑	xdbl
燱	xdbu
糡	xdbw
熾	xdbx
甐	xdcd
粦	xdci
翷	xdcj
斴	xdck
亃	xdcl
鄰	xdcp
斴	xdct
焩	xdd
籾	xdd
爖	xdde
龓	xdde
炓	xddx
熥	xddz
烺	xdek
焴	xdgd
煝	xdjg
豝	xdl
刌	xdn
剢	xdn
豴	xdno
熥	xdnz
燉	xdoa
爙	xdok
燺	xdom
熇	xdoo
煷	xdow
焞	xdoz
粐	xdp
糄	xdph
熩	xdpl
豟	xdpz
燣	xdqh
燷	xdqm
奿	xdr
煣	xdtm
焲	xdtn
燏	xdto
戫	xdtx
烄	xdvx
焠	xdvx
粇	xdw
糭	xdxa
炞	xdy
烗	xdyv
豥	xdyv
迶	xdz
熴	xebu
煡	xefz
燖	xeid
熽	xeik
燼	xeiq
煓	xejn
豤	xek
燼	xelq
粶	xes
熣	xeti
炐	xf
烳	xf
癷	xf
豧	xf
豣	xff
煹	xfnl
煿	xfxd
糐	xfxd
厷	xg
厹	xg
烥	xg
粔	xg
熞	xgal
燩	xgda
爠	xggi
糝	xggs
鳩	xgh
燬	xgia
焷	xgjx
粺	xgjx
爁	xgkq
糮	xgkq
爦	xgkw
炲	xgo
焌	xgva
粯	xgw
卋	xh
灷	xh
秌	xh
焟	xhb
燤	xhbg
爡	xhbq
糤	xhda
熪	xhdd
熿	xhdv
煁	xhel
糂	xhel
燍	xhet
粸	xhev
粓	xhf
翸	xhgj
歕	xhgv
賁	xhgv
焔	xhib
糒	xhjf
糒	xhji
糚	xhkl
鼖	xhla
煠	xhlm
枽	xhm
桒	xhm
爤	xhnm
糷	xhnm
焫	xhnv
煐	xhny
爟	xhoi
熯	xhov
煂	xhp
烵	xhsd
燪	xhsu
燁	xhtf
爑	xhth
糀	xhtt
烡	xhv
粠	xhv
尭	xhw
煍	xhx
灴	xi
訄	xi
詧	xi
毻	xidl
遀	xidz
熕	xigv
乂	xii
乑	xii
卍	xii
卐	xii
癶	xii
	xii
夑	xixa
爕	xixx
狢	xjao
粨	xjb
獌	xjba
猂	xjbf
猲	xjbl
糎	xjbl
狚	xjbt
猑	xjbu
獑	xjct
狘	xjcx
獤	xjda
猏	xjdd
猵	xjdh
獽	xjdk
獞	xjdl
獝	xjdo
犺	xjdw
犿	xjdy
猅	xjee
獉	xjeh
鵟	xjeh
獕	xjei
猯	xjen
煻	xjeo
焿	xjev
猼	xjfd
粍	xjfl
狋	xjfm
狾	xjft
猰	xjfy
熖	xjg
狛	xjg
獀	xjga
獥	xjga
玃	xjga
獡	xjgh
鼒	xjgk
豲	xjgm
煩	xjgv
狽	xjgv
頄	xjgv
頪	xjgv
猈	xjgx
獆	xjgx
獔	xjgx
獲	xjha
爄	xjhg
糲	xjhg
熫	xjhh
爏	xjhl
獦	xjhl
玂	xjht
爌	xjhv
猉	xjhv
獚	xjhv
獴	xjhx
獏	xjhy
獄	xjid
鸑	xjih
炍	xjja
狓	xjja
猨	xjja
獶	xjja
獿	xjja
粄	xjja
熁	xjjd
熤	xjjd
峱	xjje
猙	xjji
獅	xjji
協	xjjj
狅	xjjl
狌	xjjl
獂	xjjm
狧	xjjo
獢	xjjo
熮	xjjs
炘	xjjt
狉	xjjt
焮	xjjv
燲	xjjv
獷	xjjv
獋	xjjx
狿	xjjz
炘	xjk
猘	xjkn
甤	xjl
粧	xjl
獓	xjla
狏	xjlc
焅	xjlo
狤	xjlo
熎	xjlu
烍	xjlw
獟	xjlw
猭	xjlx
獩	xjlx
烶	xjlz
烻	xjlz
犵	xjlz
狇	xjm
燰	xjna
猅	xjne
猔	xjnm
狦	xjnn
粫	xjnn
糥	xjnn
狪	xjno
獰	xjnt
狖	xjnv
猽	xjnv
獱	xjnv
煗	xjny
玁	xjoa
狆	xjoi
猳	xjpa
狔	xjpt
烅	xjq
糆	xjqf
玀	xjqi
獧	xjqk
猧	xjqo
獨	xjqq
熜	xjqu
狝	xjrm
狥	xjsb
犳	xjsd
獁	xjsh
猀	xjsj
獵	xjsv
灹	xjt
籷	xjt
獿	xjta
猼	xjtd
燻	xjth
爋	xjth
犻	xjti
猚	xjti
煄	xjtl
猍	xjtm
狟	xjtt
狹	xjtv
獺	xjtv
煘	xjtx
獮	xjtx
獳	xjun
猠	xjuv
獙	xjva
獪	xjvb
狑	xjvd
獇	xjvg
猐	xjvl
燫	xjvm
獊	xjvo
獈	xjvq
猶	xjvu
狣	xjvv
獫	xjvv
猟	xjwf
狕	xjwj
猦	xjwq
獛	xjwv
豯	xjwy
粁	xjx
猣	xjxa
犱	xjxd
狵	xjxd
狶	xjxi
獜	xjxi
犲	xjxj
狜	xjxo
炄	xjxt
粈	xjxt
悐	xjxu
猍	xjxv
獖	xjxv
猤	xjxy
炋	xjy
犾	xjyd
燆	xjyo
獹	xjyq
狫	xjyt
猇	xjyw
烰	xjz
粰	xjz
熓	xjzh
爊	xjzh
犼	xjzl
猻	xjzm
熝	xjzu
麊	xjzu
獼	xjzx
粻	xk
熂	xkzx
炧	xlc
粚	xlc
尪	xle
尷	xlgq
熆	xlgq
燽	xljd
尰	xljl
烓	xll
燒	xllw
焃	xlm
爀	xlmm
豷	xlnv
熺	xloo
糦	xloo
尳	xlqd
烸	xlqs
尵	xlqv
尯	xlrc
尨	xlsd
尲	xlvm
燵	xlvz
籺	xlz
尮	xlzm
炑	xm
炢	xmd
剎	xmdn
弒	xmdv
粆	xmj
熦	xmji
爩	xmls
閷	xmnv
雑	xmti
殺	xmwa
烞	xmy
灲	xn
熐	xnbv
煇	xnc
炿	xnd
燗	xnd
焥	xndc
烿	xnds
燘	xndx
悳	xneu
烢	xnjt
粣	xnnt
熍	xnoo
疐	xnql
爓	xnrg
烐	xns
炨	xnt
爛	xntm
烔	xnto
粡	xnto
燜	xnu
熌	xnv
焵	xnve
焢	xnvi
焹	xnvl
烱	xnvo
焪	xnvs
遖	xnvz
糘	xnx
炴	xny
爎	xnym
遖	xnyz
鵓	xnzh
郣	xnzp
愂	xnzu
叴	xo
焆	xod
鶘	xodh
鶦	xodh
鴣	xogh
熉	xogv
焒	xoo
喪	xook
煰	xooo
賷	xoov
燀	xoox
瓳	xotd
熡	xotr
怘	xou
炾	xow
兡	xowb
兝	xowd
尅	xowd
勀	xowj
勊	xowj
兞	xowl
兣	xowl
剋	xown
兙	xowx
兛	xowx
邩	xp
粎	xpn
爥	xpsq
煀	xpue
糏	xpwd
炠	xq
畑	xq
畨	xq
煟	xqd
鷏	xqeh
嗭	xqet
惪	xqeu
顛	xqev
豠	xqf
爅	xqhl
熼	xqhv
糞	xqhv
燡	xqlx
燡	xqly
焑	xqm
煱	xqo
蟸	xqq
爞	xqqq
畞	xqrn
燭	xqsq
糰	xqtd
糫	xqtk
粸	xqv
熅	xqvq
糬	xqyb
煾	xqyu
籹	xr
煥	xrny
烆	xsfi
豞	xso
爉	xsqv
粅	xss
煼	xsuj
豵	xsvl
粷	xsx
烳	xtdd
煿	xtdd
糐	xtdd
豧	xtdd
詟	xtdi
	xtdy
発	xth
豜	xth
焳	xti
燋	xtih
烒	xtiv
炡	xtl
烌	xtm
粖	xtm
炣	xto
鄧	xtop
煏	xtoq
豋	xtov
覴	xtow
邆	xtoz
煉	xtqm
烴	xtsi
炛	xtt
豘	xtul
発	xtxl
鄈	xtyp
戣	xtyx
粃	xu
粬	xu
炪	xue
煯	xug
燶	xujk
爧	xuov
燯	xuvd
兇	xuw
鶺	xvdh
糋	xvdn
熗	xvdo
鹡	xvdt
烇	xve
熑	xvem
燨	xvex
爔	xvex
炂	xvg
焧	xvgu
炩	xvjd
焾	xvju
炌	xvn
燴	xvtb
糩	xvtb
爚	xvth
熻	xvtj
烚	xvto
粭	xvto
煪	xvu
燇	xvud
麥	xvva
麬	xvva
猌	xvvd
麱	xvvd
麭	xvve
麵	xvvf
麮	xvvg
麶	xvvg
鶆	xvvh
麰	xvvi
勑	xvvj
麨	xvvj
麪	xvvj
麳	xvvm
嗇	xvvo
焀	xvvo
郲	xvvp
麫	xvvs
愸	xvvu
憖	xvvu
憗	xvvu
麯	xvvu
來	xvvv
賫	xvvv
顂	xvvv
麩	xvvv
麳	xvvv
麷	xvvv
麲	xvvw
逨	xvvz
麧	xvvz
烑	xvwv
煫	xvx
烪	xvy
焍	xvzj
灮	xw
籶	xw
炈	xwa
癹	xwa
豛	xwa
朮	xwd
焇	xwd
怷	xwdu
爍	xwgm
煈	xwjq
颣	xwmb
纇	xwmv
爣	xwnh
糛	xwnl
爜	xwta
卆	xx
戔	xx
炏	xx
烼	xx
籵	xx
豩	xx
炦	xxad
烠	xxd
籿	xxd
殽	xxda
皳	xxda
郩	xxdp
盚	xxdq
慦	xxdu
顲	xxdv
鶑	xxgh
覢	xxgw
豮	xxhb
燌	xxhv
豶	xxhv
焼	xxhw
顃	xxjv
烾	xxl
剗	xxn
粀	xxn
	xxn
瑩	xxnd
瓻	xxnd
甇	xxnd
膋	xxnd
嵤	xxne
鵗	xxnh
鶯	xxnh
犖	xxni
謍	xxni
勞	xxnj
褮	xxnk
塋	xxnl
榮	xxnm
檾	xxnm
禜	xxnm
縈	xxnm
營	xxno
螢	xxnq
嫈	xxnr
滎	xxns
憥	xxnu
罃	xxnu
醟	xxnu
鎣	xxnv
焭	xxnw
覮	xxnw
煢	xxnx
煵	xxnx
熒	xxnx
煵	xxny
盞	xxq
爼	xxqf
欻	xxrv
燈	xxtv
糉	xxua
烣	xxx
粋	xxx
燊	xxxm
爃	xxxm
歘	xxxv
敥	xxya
煔	xxyo
虦	xxyw
敎	xxza
豬	xyb
櫫	xybm
粏	xyd
爘	xydk
類	xydv
燦	xydx
煃	xyll
炶	xyo
爐	xyqq
爈	xyqu
粩	xyt
虓	xyw
辻	xz
煒	xzii
發	xzsa
粌	xzsi
炥	xzsn
糑	xzsv
籸	xzx
惙	yaaa
慅	yadq
處	yaw
奛	ybd
覩	ybgw
懪	ybhs
斱	ybjk
愓	ybjs
斱	ybjt
鵪	yblh
剦	ybln
惈	ybm
惿	ybtl
愓	ybts
惃	ybu
殾	ybwa
愰	ybww
煑	ybx
鵫	ybxh
逴	ybxz
乽	ybz
忚	yc
恓	yc
愝	ycbr
憛	ycbx
恇	yce
慓	ycfm
慚	ycjt
慄	ycm
奩	ycoo
慪	ycoo
惛	yctb
奃	yctd
怟	yctd
忯	yctv
愜	yctv
憯	ycwb
怴	ycx
憟	ycx
慩	ycz
怞	yd
歺	yd
韰	ydat
愔	ydb
憶	ydbu
慞	ydbx
冭	ydd
奓	ydd
奟	ydd
恀	ydd
懠	yddh
悀	yddi
愑	yddj
悢	ydek
怺	ydjx
夿	ydl
悀	ydnf
愑	ydnj
憞	ydoa
憱	ydod
悙	ydoj
懹	ydok
悷	ydpd
惼	ydph
盇	ydq
懍	ydqh
懐	ydqk
懷	ydqk
憻	ydqt
忬	ydt
憰	ydto
恔	ydvx
忼	ydw
怰	ydw
慉	ydwq
忟	ydx
悋	ydxo
猋	ydyd
奒	ydyv
迏	ydz
迖	ydz
忹	ye
憳	yeid
帰	yeni
慛	yeti
愷	yetv
夳	yf
忓	yf
悑	yf
懳	yffu
夽	yfg
忶	yfg
怽	yfm
鴮	yfsh
綔	yfsm
郀	yfsp
忨	yfw
愽	yfxd
厺	yg
奆	yg
怇	yg
虗	yg
慳	ygal
憿	ygda
懰	ygdn
戄	ygga
懼	yggi
慘	yggs
鳪	ygh
恈	ygki
鼑	ygkk
懢	ygkq
貞	ygv
惻	ygvn
遉	ygvz
悓	ygw
愺	yhbx
慔	yhby
恾	yhdl
愖	yhel
怈	yhl
惵	yhlm
悧	yhn
慲	yhnd
慲	yhnn
懞	yhnx
愥	yhny
懽	yhoi
懄	yhoj
慬	yhol
愅	yhp
懜	yhqd
懱	yhqx
憽	yhsu
愩	yigv
耂	yii
羋	yiyf
忇	yj
怶	yja
懨	yjbd
愋	yjfa
慆	yjg
頻	yjgv
顰	yjgx
懭	yjhv
懚	yjiu
愶	yjjd
慴	yjjg
恊	yjjj
憀	yjjs
惞	yjjv
懫	yjjv
懙	yjkv
悎	yjlo
愮	yjlu
慽	yjlx
愱	yjly
慥	yjlz
戂	yjme
懡	yjmg
懓	yjna
懮	yjna
恦	yjno
愞	yjny
懮	yjqa
奤	yjqf
愐	yjqf
憁	yjqu
耉	yjso
慟	yjtj
虖	yjvi
歑	yjvv
慀	yjwy
憣	yjxq
憍	yjyo
怌	yjyt
忣	yjzn
悵	yk
憡	yktm
懻	yktv
怢	ykv
愾	ykzx
圶	yl
慯	ylbs
懴	ylex
慠	ylha
憮	ylhh
懤	yljd
奯	yljx
憢	yllw
懗	ylmm
懴	ylnx
恄	ylo
懛	ylol
憘	yloo
憉	ylos
忔	ylz
夵	ym
惏	ymm
虨	ymms
夰	yn
愘	ynao
慏	ynbv
惲	ync
憪	ynd
肻	ynd
憫	yndx
悰	ynfm
欳	ynhv
敹	ynja
奝	ynlo
悺	ynpz
叡	ynta
壡	yntl
愃	yntt
懧	ynut
悾	ynvi
愹	ynvo
夻	yo
梷	yoam
悁	yod
悜	yoe
愪	yogv
覘	yogw
頕	yojv
懆	yoom
憚	yoox
悞	yosy
鸆	yoth
慺	yotr
悮	yoty
怾	yov
怳	yow
奌	yoy
敁	yoya
迠	yoz
懾	yppp
惽	yptb
怋	yptv
憜	ypxd
怬	yq
憴	yq
盀	yq
愲	yqd
膚	yqd
鹵	yqdd
鹷	yqdd
鹺	yqdi
鹶	yqdj
鹻	yqdm
鹸	yqdv
鹼	yqdv
鹵	yqdx
鹹	yqdx
怚	yqf
虘	yqf
皻	yqfa
覰	yqfw
憒	yqgv
虜	yqj
懌	yqlx
懌	yqly
卨	yqo
恛	yqo
盧	yqq
鸕	yqqh
顱	yqqv
卥	yqsd
愄	yqtk
懁	yqtk
慖	yqtx
愢	yqu
慮	yqu
勴	yquj
慍	yqvq
禼	yqxg
慣	yqxv
逌	yqzz
怓	yra
	yre
惂	yrg
	yrha
恑	yrjc
憺	yrji
愌	yrny
悗	yrow
	yrta
忺	yrv
惸	ysbz
怉	yse
惱	ysjx
奫	yskk
怐	yso
耇	yso
愡	yssu
	ysuj
恟	ysxu
忊	yt
恉	ytb
慱	ytbd
憓	ytbu
悑	ytdd
愽	ytdd
悽	yter
恎	ytgl
耊	ytgl
愼	ytgv
恆	ytht
悈	ythx
奞	yti
雐	yti
愯	ytia
奪	ytid
懏	ytim
奮	ytiq
虧	ytis
恜	ytiv
懝	ytll
恘	ytm
怲	ytnv
攲	ytoa
敧	ytoa
獻	ytod
甗	ytod
鵸	ytoh
愊	ytoq
齾	ytou
懶	ytov
覻	ytow
惐	ytox
戲	ytox
鬳	ytoy
耈	ytso
忳	ytul
悏	ytvv
慡	ytxv
悿	ytyd
恞	ytzv
慒	yub
怭	yuj
虙	yuj
憹	yujk
悂	yul
惍	yv
昚	yvb
鷯	yvbh
尞	yvbm
遼	yvbz
愴	yvdo
恮	yve
懩	yvek
羍	yvf
眘	yvg
慃	yvgj
恱	yvgw
恲	yvh
忴	yvj
忦	yvn
悅	yvow
懀	yvtb
惀	yvth
悇	yvtm
憸	yvtv
夾	yvv
鵊	yvvh
郟	yvvp
頰	yvvv
懺	yvvx
恌	yvwv
怑	yvx
惓	yvyc
慻	yvyg
忛	ywd
覤	ywgw
甝	ywhf
怮	ywj
戃	ywnh
憆	ywnl
虝	ywss
虛	ywt
虪	ywth
虡	ywtv
覷	ywtw
戯	ywtx
戱	ywtx
悩	ywxu
虥	ywxx
贙	ywyv
虤	ywyw
夲	yx
豦	yx
憐	yxdi
憏	yxfm
憤	yxhv
逩	yxhz
墯	yxil
恠	yxil
勮	yxj
劇	yxn
懥	yxnl
憕	yxtv
忷	yxu
惾	yxua
懎	yxvo
忰	yxx
惔	yxx
恡	yxxg
鷞	yxxh
悕	yxxi
憦	yxxj
夶	yy
忕	yy
奲	yybx
忲	yyd
恗	yyfs
羐	yyln
怗	yyo
恅	yyt
愭	yytb
憭	yyvm
悏	yyvv
憈	yywt
懅	yyx
慡	yyxx
愇	yzii
忋	yzl
愵	yzsv
惤	yzsw
丮	zf
孡	zgo
孾	zgvr
叏	zia
乁	zii
	zii
韗	zioc
韌	ziod
韍	ziod
韒	ziod
韛	ziof
韠	ziof
韡	ziof
韜	ziog
韋	zioi
韔	ziok
韝	ziol
韎	ziom
韖	ziom
韘	ziom
韐	zioo
郼	ziop
韚	ziop
韞	zioq
韣	zioq
韢	ziou
韥	ziov
韟	ziox
韤	ziox
違	zioz
韕	zioz
舝	zisi
夃	zja
朶	zjm
刴	zjmn
盁	zjq
孫	zjwm
愻	zjwu
遜	zjwz
呄	zjxo
辸	zjz
邔	zlp
妀	zlr
鵋	zluh
孮	znfm
乪	zq
彃	zsbf
弤	zscd
彄	zsco
弸	zsdd
弝	zsdl
弨	zsdo
婱	zsdr
弴	zsdz
彇	zsek
弙	zsf
弡	zsg
弫	zsg
弬	zsg
彏	zsga
強	zsgq
弽	zshm
彉	zshv
弔	zsi
盄	zsiq
彍	zsjv
張	zsk
矤	zsly
刜	zsnn
鄪	zsnp
費	zsnv
弲	zsod
謽	zsoi
勥	zsoj
彈	zsox
彋	zsqk
弞	zsrv
弖	zst
弣	zstd
瓕	zstd
弳	zsti
彁	zsto
弻	zsts
彌	zstx
弢	zsua
彅	zsvd
弰	zswd
弾	zswx
弜	zszs
孲	ztxt
孞	zu
夬	zv
鴂	zvgh
飛	zvjv
飝	zvjv
刔	zvn
卂	zx
鳵	zxgh
蝨	zxqq
孨	zzz
孴	zzzb
