麽	jmmg
後	swa
後	swah
娅	rtwt
璇	edhl
於	dhvd
茜	hc
茜	hcbq
歆	dbrv
嗔	oxqv
觑	ywtw
佘	vfm
钰	ved
罡	qtl
哧	olm
绯	wene
踉	oldk
跄	olvc
镔	vngv
婕	rtel
猝	xjdx
玮	efji
嗖	ogia
芊	hjx
鹫	domt
獠	xjym
嵋	edjg
衲	jknv
珂	eto
珂	etok
祢	jyrm
铠	vezl
佟	tadd
芮	hnv
芮	hnvr
忡	yoi
鬟	ksqk
熠	xjjg
妲	rbt
唰	opnn
怦	ytvi
虬	ql
嚓	onxm
筱	ktia
忑	tdu
忐	lu
忐	lubt
滢	shnd
眈	gpl
皙	mjjg
璐	eolo
篝	kfnl
忒	tuv
烨	xttx
谑	iyct
焱	xxx
戬	twtx
呗	ob
呗	obub
昵	bpt
婧	rld
啐	odvx
崽	equ
劭	doj
劭	dojs
笈	kjzn
鲲	rtbu
诶	igly
浣	snfw
鑫	vvv
噔	oxtv
咔	oly
珏	eed
呦	owj
喏	ohxo
咣	oww
溟	snbv
囔	otok
吒	ojt
吒	ojtz
漉	sjzu
喵	ohq
淼	sss
颍	tsjb
馀	rlvm
伢	tcij
翊	djj
咂	ocni
佼	tdvx
诩	ijj
邬	sstp
炜	xfji
锺	vjtl
啷	odep
玎	et
眦	glt
晟	bjjx
呲	olt
鳌	lhat
铳	vdgw
嘭	olos
宓	nuj
隼	tix
魃	gwgd
噘	ojvv
呤	ovjd
汩	sb
汩	sbug
礴	chsd
纨	wxd
沣	sf
沣	sfuf
贽	fxdb
麴	tvvx
麴	xvvx
麴	xvvx
哒	oyz
哒	oyzd
噼	opox
琬	endc
睚	gjll
霈	usti
鸨	txgt
掰	jfvf
攥	fkgm
噌	ovqb
臊	doom
糗	xjgd
隗	pgwg
绔	wyfs
捱	fjll
殒	tdob
挲	smjf
桉	mnr
菡	hjxu
哐	oce
倜	tnlo
猊	xjgw
臌	dloa
獒	lhad
粼	xdck
揄	fvtn
恁	tjlu
殛	tdjt
邝	jp
邝	jpuk
螓	qevh
钛	vyd
钛	vydt
咝	owwt
嗵	oddz
嗵	odnz
颀	jjtb
螭	qdxg
犸	xjst
珈	ejo
珈	ejoz
忤	ylx
汜	se
琰	exx
琰	exxy
粲	ydax
飚	wxxx
齑	dxji
翦	vdnj
旃	dhld
趄	llqf
猬	xjqd
趔	lltn
囵	qvt
坳	lwj
骜	lhat
蘅	hsri
坂	ljja
魈	gwgd
袤	ddtk
锏	vnb
揶	fpp
蹩	vnml
愫	ylwm
嗬	ohto
嘣	oedd
堇	hol
骧	stdk
夥	bmdd
滟	sfrl
藜	hhss
潢	shdv
酆	ffep
孬	jyrz
徵	seta
峋	esb
蒯	hddn
鄢	tlsp
煊	xntt
蔻	hnfa
蓁	hevh
琮	enfm
琏	ecz
卟	oy
卟	oyub
嶙	exdi
摺	fjjg
珩	esfi
葳	hjtx
珉	eptv
踮	oljo
狒	xjzn
宕	nc
宕	ncbd
邙	dlp
绡	wwd
偻	txr
纾	wdt
荑	htzv
槿	mhol
绺	wayo
衾	vjdk
钺	vcx
荥	hns
丶	dii
箬	khxo
嫒	rjna
繇	jlxm
搡	faam
岈	ecij
幄	nipl
骅	sttx
昶	djxb
撸	frtb
狻	xjga
昴	bcjp
杈	mad
龛	vtod
蹇	nfnl
蜚	eneq
蜚	neeq
箐	kld
阚	njpa
嗄	ojga
佥	vtw
炷	xde
姝	rkm
佶	tlo
衩	jkad
恹	yjyd
姹	rnjt
浒	silx
跖	olc
钜	vg
钜	vguj
豸	jii
儆	thsa
仨	te
仨	teus
圜	qqtk
蜍	qvtm
舄	gsh
戗	vcx
莜	htia
椋	mdom
聃	pnl
町	qt
龅	lvue
龅	lwse
胫	dzi
祛	jylg
湫	shx
蒺	hjly
囡	qr
矍	ggta
煅	xjia
谡	iqva
坨	lnt
铤	vjlz
犟	zsoi
猕	xjzm
瘌	jton
栾	dmm
殄	tdvs
醐	uxod
嫱	rxvo
槊	vujm
醍	ubtl
逡	gvaz
鎏	sdgv
鸷	fxdt
骓	stti
哓	oxtw
馍	rlhy
鹗	ooft
瑗	ejfa
挹	fodl
獬	xjri
锃	voe
蝮	qlba
馗	xvjg
嶂	edbx
荟	hvfg
灏	sbdb
脶	donv
鹘	qdgt
嚯	outi
碇	cntl
碜	cgys
砣	cnt
谔	ioos
仝	vi
仝	vibt
泫	sdw
哞	ogki
诓	ice
桠	mtwt
糅	xdtm
镫	vxtv
貅	jtm
猱	xjdm
犴	xjf
蕲	hvbt
訇	si
郏	tvvp
葺	hop
铩	vxm
蚨	qfv
掾	fljx
螯	lhaq
恽	ync
鹜	dtjt
琚	epxo
蜮	qtox
抻	fbi
襁	jkzq
阈	ntox
呖	ojj
邳	jytp
窳	nvjn
貔	jjqu
炅	bx
炅	bxbg
糨	xzsq
抟	ffsd
腩	dxnx
腩	dxny
锴	vug
殚	tdvx
砀	czs
狴	xjul
猢	xjxd
囗	qii
撺	fnvi
缃	wmg
饽	rlxz
嶷	etll
蝾	qhnm
稹	hxqv
俅	txxd
狍	xjse
梏	mjlo
橐	toim
韪	btli
鳕	rtue
轸	cvs
黢	qhga
桎	mtgl
泷	sxtd
镏	vgdq
呙	onv
璺	jknd
辂	cao
辂	caol
崂	ehnj
炝	xvc
狲	xjzm
芩	hvj
阆	ndek
镛	vjei
诨	inc
璁	ejqu
骢	stju
纛	lqsm
楸	mhx
蟊	dtjq
爿	kii
聩	pqb
媸	ruiq
媸	rulq
掼	fqxb
怼	axdu
韫	fjiq
硭	chdl
蚋	qnv
絷	fxdm
歃	jxgv
嘬	obpa
茯	htyd
邴	tnvp
缛	wjfd
驺	stre
轱	cxo
甯	nudi
甯	nunf
遒	vuz
孢	zse
嵬	egwg
岬	eq
裾	jkpo
檑	muq
谥	ivvq
蚺	qnl
獾	xjhi
闫	ne
闫	necy
祧	jyvv
苻	htxd
阒	ngyd
椤	mqd
菀	hndc
嫫	rhby
荇	hsfi
喑	odb
茕	hnzx
觥	rww
晗	bvjo
磔	cdcm
畹	qndc
蓐	hjfd
徭	sjlu
巯	zidm
鲽	rthm
剡	xxn
猁	xjhn
逑	xxdz
捭	fgjx
脔	dmnv
鬈	ksvc
绻	wvyc
跹	oljz
铖	vjjx
炻	xc
裱	jklk
蕤	hxjl
悱	yene
猞	xjvo
恚	llu
貘	jhby
凼	su
凼	sucd
蜉	qjz
涞	stx
傩	tati
莳	hbxd
珙	ehv
筅	kjlw
荜	hux
怄	ycx
栎	mcm
讴	icx
觜	ltr
瘙	jadq
唿	ossu
缳	wqtk
锝	vbtd
拊	ftxd
螈	qjgm
郗	xxnp
仵	tlx
獍	xjdw
鹂	tndt
邰	gop
郜	jlop
纩	wj
纩	wjuk
堞	lhlm
鹬	dtjt
酃	uoop
冼	vjlw
锒	vdek
杌	mtw
硌	cao
硌	caog
骝	stgq
鏊	lhav
咴	oxx
荞	hjyn
暾	bdoa
窨	nvdb
鼐	zjgk
鲟	rted
竦	dtom
虢	jxdw
佤	ttld
狯	xjvg
癯	jggi
侔	tgki
腚	dntl
眙	ggo
尜	mym
蝰	qyll
囹	qvjd
洇	sqy
鼋	fwol
芫	hfw
赍	xvvb
樘	mwnl
墉	ljei
嘌	ocfm
恂	ysb
罅	keyi
罅	lxui
椴	mjia
彀	lnta
盱	gf
噻	onfl
旄	dhll
犍	jfez
庹	jhpn
欹	ytov
珥	ep
吡	ou
撄	fbbr
狃	xjjt
裢	jkcz
馐	rlvt
峄	eaf
峄	eafy
搠	fvud
鼍	ooql
襦	jkun
擀	fxbf
娈	dmr
昃	bjv
荛	hxtw
峤	ejyn
犰	xjx
蟥	qhdv
殳	wa
燹	xxx
缱	wqpz
狁	xjgw
帔	nija
樨	mpsi
畲	vfmq
瘐	jgv
腭	doos
瓴	vjdd
裣	jkvw
郓	ncp
砦	ltc
闼	nyz
鞒	hpjn
芨	hjzn
骐	sthv
瘿	jbbr
笳	kjo
黟	qhdd
憷	ymml
颏	dyvb
苡	hldv
勐	zqj
澍	slod
勖	bgj
诜	ijlw
濉	sgti
檫	mnxm
郇	sbp
骘	pyst
凫	gw
垭	ltwt
邗	fp
邗	fpuh
钯	vdl
搦	fzsv
喁	obng
煸	xdph
苕	hdo
謇	nfni
粑	xdl
瀣	sydt
迓	cijz
喈	oug
鄯	vfvp
鲵	rtgw
丨	iii
刭	zin
罴	qlgh
肜	ds
厶	gii
厶	giis
鲰	rtpa
笫	kjsj
笫	ksij
褰	nfnk
痼	jqxo
沭	smd
缗	wptb
菸	hdhd
衿	jkvj
艏	nsvg
裎	jkoe
旒	dhlm
栳	myt
茏	hxtd
艨	nshx
邛	ip
尻	px
尻	pxck
踽	oljg
艄	nswd
鲶	rtvu
眭	gll
榉	mwvf
笏	kss
廪	jdqm
蚍	qu
殍	tdjz
泶	wns
淝	sddl
菘	hmvg
蒹	hvem
忉	yd
忉	ydud
蝣	qdhz
萑	hti
逋	tdiz
唢	owb
矬	lyvl
艟	nsdl
蹰	oljd
荩	hpnd
縻	jmmm
亍	fi
佧	tly
趿	oljn
嘏	xopa
桫	msmj
翥	ybjj
鲠	rttx
雎	qfti
茑	hgt
觚	rjjn
阋	ngw
洄	sqo
焓	xvjo
跗	oltd
猗	xjyo
鹕	xodt
笤	kdo
钬	vx
钬	vxuh
镪	vzsq
鹈	vzst
踅	fjjl
棼	mmvd
漭	shyh
逄	aciz
锍	vdgm
哚	owm
砬	cd
砬	cdul
蝥	dtjq
钲	vtl
陟	py
塄	lqdh
痫	jnm
蚧	qvn
蚧	qvnz
潆	shnm
笄	kth
彖	ljx
萘	hyfm
郯	xxp
掮	fdpd
鲇	rtyo
舸	nsto
睃	ggva
蠃	dlod
蠃	dloq
岢	eto
矸	cf
矸	cfug
鸱	ctvt
狳	xjvm
祜	jyxo
囟	jqx
枥	mjj
蟛	qlos
擤	fjgn
莪	hjfx
觋	ivvw
醪	ujjs
倬	tybx
蚰	qd
蚰	qduy
轳	cyp
鬻	zsxy
栲	mys
嬗	rdqt
谘	ivro
鋈	sjyv
阍	nctb
柘	mc
馔	rlev
鳐	rtju
鳟	rtvd
耔	emz
槎	mvfi
锕	vpto
孥	raz
綦	hevm
洙	skm
薅	hrjd
蜞	qhev
茇	hxad
氪	kzxw
萁	hhev
芪	hctv
莰	hlrv
嵊	ejxv
蛩	iwdq
楂	mmbt
缒	wjpz
饣	rl
铧	vttx
鹚	vwwt
儋	trji
樾	mllx
滹	syji
茌	htl
骶	qdcd
嫜	rdbx
溏	sjeo
螽	addq
橛	mjvv
遄	ejnz
坭	lpt
熵	xdno
蔌	htov
鲂	rtdh
冱	vtlt
岙	jye
殂	tdqf
艉	nspl
蠼	qgga
鹾	yqxi
尕	zjm
攮	ftok
樗	mufs
皲	ncja
坻	lctd
椐	mpxo
彘	ljtt
隈	pqtk
朐	dso
橼	mwlx
暌	bxty
饧	rlzs
泔	shf
赜	glb
黧	hsjh
筚	kux
鸬	ypgt
醯	udgq
钪	vdw
鸹	jxot
哏	oek
甑	vqbd
膣	dnvl
螅	qjgu
锞	vbm
髫	ksdo
宄	nx
宄	nxbg
骟	stdj
棰	mjtl
棰	mjxf
缡	wdxg
苷	hhf
蹁	oldh
铗	vtvv
涑	stom
箜	knvi
芎	hzs
蔟	hdhy
觯	rvbx
鍪	dtjv
镟	vdhl
妫	rdjd
熘	xgdq
秫	hmd
阏	ndhd
飑	wxse
枳	mov
礅	cdoa
茭	hdvx
柁	mnt
柁	mntd
苴	hqf
铊	vnt
柽	mal
栌	myp
脘	dnfw
酎	uxd
浠	sxxi
蛳	qnti
楱	mevy
焐	xwo
秭	hjsj
秭	hsij
笥	kjto
茈	hlt
蒌	hxr
跏	oljo
镆	vhby
怙	yxo
枵	mots
圊	qld
圊	qldq
圮	lzl
堀	lpue
忄	yii
氚	kzm
绐	wgo
蟮	qvfo
邡	dhp
亻	tii
庑	jfl
廨	jrdi
钭	vddx
觳	lnta
闶	ndw
瓿	dotd
眚	jlg
芴	hss
鳓	rthj
俣	toty
徼	sgda
楗	mefz
莨	hdek
酰	ujlw
雠	tiii
喾	wnjo
笊	kj
黥	qhdm
芏	hl
芏	hlbd
菖	hbb
袢	jkvx
卺	jxtc
垆	lyp
旆	dhli
曛	bjth
汊	sad
穰	hdok
酾	utnd
鹣	vemt
塬	ljgm
蘖	hjpm
玢	evd
蕖	hsgm
坶	lqs
屣	psll
揎	fntt
榧	mcee
芑	hzl
蓥	hnv
蓥	hnvy
鼗	vwva
仂	tj
婺	dtjr
嫠	fmar
愦	yqb
癍	jede
癔	jdbu
蘧	hyxz
幞	niwv
痦	jwo
蛑	qgki
詈	qi
詈	qibl
钚	vjy
铴	vszs
锆	vjlo
丌	tn
柰	mfm
柰	mfmn
浜	sgv
蓼	hjjs
鄣	dbxp
偾	txhb
藿	huti
酢	ulk
铟	vqy
锛	vyxh
阊	nbb
骖	stgs
鲆	rtti
檩	mdqm
燔	xjxq
蘼	hjme
趵	olsd
酲	uoe
乇	jt
乇	jtbt
笸	kco
鄄	clp
黻	wtvd
伲	tpt
蜣	qvfl
谝	idph
伛	tcx
伛	tcxy
揠	fcbr
昝	ayb
溽	sjfd
胙	dlk
萏	hrg
麈	jzne
溱	sevh
碚	cdo
蕺	hopx
锊	vjxd
镧	vntm
坫	lyo
坫	lyod
崃	etx
糌	xayb
缬	wlob
瞢	hqng
堙	lcl
忭	ydy
筌	kve
艿	hzj
郅	tglp
鳎	rtbj
厍	jc
厍	jccs
哕	oed
廑	jhol
敫	gdha
栊	mxtd
癜	jpha
碹	cntt
磙	cdvk
笾	kjz
篪	kjjw
缌	wqu
荨	hexd
诹	ipa
诼	ixd
嗍	ovud
槠	miyb
欷	xxnv
甏	lovd
蓍	hytb
蛱	qtvv
裉	jkek
颞	paab
椹	mhel
诒	igo
铯	vrdl
鞫	hpsi
卣	yqz
尥	xlsd
槲	mrdx
氘	kzn
耩	emfl
馓	rlha
圪	llz
廴	zii
泺	scm
熳	xbqa
胗	dvs
苁	hvv
薹	hlol
锘	vhxo
阌	njna
鳊	rtdh
唑	ovvl
溻	sbjj
瘰	jqwm
砗	cc
砗	ccuc
砩	czsn
羝	vfcd
茺	hdgw
蓠	hdxg
刳	yfsn
唣	ogt
悝	ybl
慊	yvem
瘳	jjjs
茼	hnto
麇	jznh
黾	obl
嵛	evtn
杩	mst
狨	xjtx
狺	xji
痧	jsmj
砜	cwx
芡	hrv
蓣	hdtb
顸	fjb
溲	sgia
痤	jvvl
眄	gtlj
糍	xvww
葚	hhel
郐	vfgp
酹	ujxd
镢	vjvv
隳	pxid
鹋	hqgt
唛	ola
嬖	podr
怍	ylk
朊	dfw
涫	snpz
绲	wbu
腧	dvtn
葑	hlld
蠓	qhnx
鞲	hpfl
饫	rljy
垲	lezl
嵴	exvd
帻	nilb
旰	bf
旰	bfug
荭	hwi
蘩	hlqm
颃	dwjb
颟	htnb
鸲	sogt
龠	vtoh
呒	ofl
硖	ctvv
耧	emxr
蚴	qwj
蛸	qwd
裰	jkaa
謦	ldji
跣	oljw
踺	olez
逯	esz
逯	eszl
陔	pdyv
堋	ldd
峁	ecjp
廛	jbll
栝	mjxo
葸	hqu
薏	hdbu
踔	olyx
醢	uxoq
铒	vp
镲	vnxm
鲮	rtla
仉	tw
侉	tyfs
桄	mww
泮	svx
犭	xj
皤	gjxq
粝	xjth
蹀	olhm
颡	aaab
鲞	vyrt
唪	oevf
嗪	oevh
掭	ftyd
畈	qjja
簦	kxtv
绨	wvzj
胍	djjn
胲	ddyv
舻	nsyp
铘	vcip
锩	vvyc
鲋	rttd
崮	eqxo
庋	jxa
毳	jfll
箅	kqtn
菹	hsqf
虿	thq
贶	bow
陧	pbl
隰	pbwh
僬	ttih
匦	ccx
垧	ljno
疔	jt
疔	jtcd
肭	dnv
蝤	qvu
趑	llvv
酐	uf
醅	udo
醑	ujld
锬	vxx
垅	lxtd
悛	ygva
拶	fsd
簟	kcbx
莼	hwtl
蒴	hvud
藁	hdom
诖	ill
谳	ixnd
邾	kmp
鬏	kshx
龀	lvut
龀	lwt
剞	yton
埸	lbss
嵝	exr
搿	jfvf
桴	mjz
浯	swo
浯	swow
笱	kso
肽	dyd
舯	nsoi
芤	hzl
葙	hmg
鸸	jnnt
墁	lbqa
煳	xxod
硪	cjfx
礞	chnx
趱	lljb
躜	oljb
钼	vg
钼	vgum
匚	cii
呋	ofv
媵	dvyr
崦	eybl
潲	shwd
獯	xjjh
瘵	jxfm
绀	whf
莩	hjz
觫	rtom
镡	vcbx
髂	qdno
鬯	dxdt
鬯	xddt
鹨	jjvt
亓	fn
亓	fnbq
洚	saci
碲	cdni
磲	csgm
粜	uex
绱	wwno
芄	hxd
铪	vvto
髌	qdnv
鲥	rtbd
俜	tdts
刿	edn
吣	ou
垤	ltgl
枘	mnv
溷	sqx
胬	ranv
蒽	hqyu
銎	iwdv
锶	vqu
骱	qdvn
鹆	vvot
岣	eso
岵	exo
怿	yaf
掎	fyto
毹	vtdl
汆	jns
沲	slc
甙	thfv
菝	hfxd
讵	ig
诎	iue
赉	txb
郄	xxgp
鐾	podv
塍	dvyl
屺	ezl
屺	ezlq
庥	jtm
掊	fdo
掊	fdop
柃	mvjd
檎	mvdg
毵	gysl
渖	snbi
砘	ctul
窭	nvxr
肟	dfs
蔸	hcgw
蔸	hgcw
蛏	qal
躞	olxa
酯	utb
饩	rlkz
劢	thj
嘧	onue
嵫	evww
擐	fqtk
湓	svdq
蝻	qxnx
蝻	qxny
蠖	qhta
觖	rzv
跬	olll
阝	pii
仡	tlz
垌	lnto
氆	jflb
氇	jflb
汔	slz
篼	kgcw
缑	wtzy
舾	nsc
莸	hxjd
蠛	qhqx
蠲	vvqq
醣	ujeo
骀	stgo
倮	tbm
僦	tdod
凵	uii
崾	ecr
渫	shlm
瘗	jtvl
箦	klb
肼	dfn
腽	dbq
臁	djvm
舳	nsd
荽	hjr
蒉	hqb
蛴	qdxn
袼	jkao
跫	iwdl
儇	tqtk
埽	leni
庀	jt
庀	jtcp
扃	dpno
搛	fvem
浼	srow
滏	svxv
瓞	jjgv
疃	qdbl
硗	cxtw
禊	jyfy
篥	kcm
綮	dpam
苤	hjyt
踣	oldo
躐	olsv
钽	vbt
锸	vjxg
锼	vgia
阃	nqm
鞔	hprw
鹪	tiht
黪	qhgs
黼	wtvd
榀	mooo
榘	lygm
氵	sii
浍	svfg
炱	gox
煺	xekz
犋	jfqv
砻	xtdc
秕	hu
肀	ei
肷	drv
胂	dbi
莛	hjlz
裥	jknb
逭	npzz
钌	vj
钌	vjul
鳆	rtla
佴	tp
吲	ozsi
帱	nifd
搌	fphk
擗	fpox
桷	mr
氡	kzad
硐	cnto
糇	xtzy
腠	devy
葶	hdot
袷	jkvo
龆	lvuo
龆	lwdo
刂	nii
哜	odxn
埴	lxqe
岜	edl
徂	sqf
惝	ywno
扌	fii
烀	xjvi
眢	dcg
瞵	gxdi
筇	kip
簏	kjzu
芗	hwj
蝽	qevb
蟪	qtbu
郫	gjxp
钕	vr
钫	vdh
颥	ujnb
黹	wtvm
彳	sii
楦	mntt
氙	kze
澌	shet
畛	qvs
瘅	jvbx
砉	fc
砉	fcbh
砹	chx
碡	clqs
穸	nvd
缵	wjlb
羟	vfzi
膦	dxdi
菪	hnc
虼	qlz
蛘	qvf
螨	qhtv
裼	jkbs
讠	iii
迕	lxz
钅	vii
铈	vdni
锇	vjfx
锔	vpjo
锪	vssu
镓	vnx
镓	vnxj
镦	vdoa
镱	vdbu
骒	stbm
鹁	xnzt
冁	vbxk
冖	nii
哿	joto
埝	lvju
弪	zszi
攉	futi
浞	sol
潴	sxjb
籴	jnx
罱	qxnx
罱	qxny
羰	vfex
胨	dtm
胩	dly
舴	nslk
苊	hjc
茛	hek
蒇	hjbx
虮	qw
蠊	qjvm
轺	cdo
锿	vdok
髹	kstm
鸫	tmgt
哌	ojjk
垸	lnfw
埏	ljlz
墼	cuwl
帙	nikv
悃	yqm
揲	fhlm
晡	btdd
榍	mpwd
榱	mdok
殪	tdlv
漤	smmr
疬	jjj
砑	ccij
缲	woom
罘	qjy
苈	hjj
萆	hgjx
辶	zii
钔	vn
钔	vnum
铥	vjlg
镅	vdjg
髟	ks
鲡	rttd
鲦	rtam
鳇	rtge
鹇	nmgt
鹱	gtha
埒	ljxd
岽	etm
悫	lnwu
攵	aii
桊	vym
桕	mg
桕	mguj
槔	mgyx
溆	svta
漶	soou
牾	jfwo
疖	jp
疖	jpcj
矧	lyzi
稂	hdek
窀	nvtl
腈	dld
苄	hdy
薷	hujn
褙	jkkd
跽	olzu
钐	vs
钐	vsus
锖	vld
镎	vvtf
饔	dwjk
骣	stpz
鳙	rtji
丿	jii
坌	vdl
宀	nii
氍	ggtl
沩	sdjd
澉	sjpa
瀹	svth
珧	evwv
瘊	jtzy
瞍	ggia
硇	cjqx
筘	kfo
聍	pnt
聍	pntn
舁	gh
艚	nsub
蜱	qgjx
钍	vl
钍	vlut
铞	voni
铫	vvwv
骺	qdjo
鲼	rtxb
冂	nii
劐	htin
哳	ofjt
唼	odr
忮	yxa
恝	fdu
戋	fx
戋	fxaj
椠	cjjm
瘕	jpfa
瘛	jfdu
瘼	jhby
祓	jyxd
窆	nvjz
窬	nvvn
篚	kcee
粞	xc
羧	vfga
脬	djz
艽	hx
艽	hxbj
葜	hfdy
蓰	hsll
觌	xjdw
豇	tovi
轵	cov
醵	uyx
铌	vpt
镄	vzsb
阼	plk
鞴	hphf
鞴	hphi
鲅	rtxd
鲒	rtlo
埯	lybl
夂	aii
恧	jnnu
憝	dozu
搋	fjjw
氕	kzj
洳	sro
浈	syb
濞	sjgn
礤	chxm
艹	hii
蟓	qrbx
蟓	qrox
襻	jkmf
趼	olth
迮	lkz
钆	vl
钆	vlug
铷	vro
镨	vvwb
驵	stqf
鲣	rtnl
鳘	lqst
鸺	tmgt
嚆	ohdo
堍	lrod
巛	sii
廒	jlha
桤	mezl
橥	xjym
爝	xjqd
甾	sq
甾	sqbz
痄	jlk
癀	jhdv
筲	kwd
箨	kfaf
罾	qvqb
耵	pt
耵	ptud
舣	nsdx
荬	hjdy
诔	iem
赆	bpnd
蹯	oljq
钇	vz
钶	vto
钶	vtok
铕	vxd
镤	vwtv
鲚	rtdn
鲻	rtsq
鳢	rtuv
鹛	djgt
塥	ltoy
庳	jgjx
怊	ydo
捃	fejo
涠	sqfi
滠	spaa
猸	xjdg
甓	podd
瘃	jxd
瞀	dtjg
砼	cvi
礓	ctqt
绠	wtbx
耱	emjc
脎	dxm
脒	dx
脒	dxum
脞	dvvl
萜	hnio
蕻	hkhv
薤	htdt
衤	jk
跞	olcm
轹	ccm
锎	vnth
锓	vena
馇	rlmt
鲐	rtgo
鲩	rtnw
亠	dii
仫	tjg
卩	pii
垡	txl
垴	ldxu
岍	eth
崞	edoz
枨	mk
毪	jfli
牮	tvki
癃	jpal
眍	gcx
眵	gdd
稃	hjz
筢	kfdl
腙	dnfm
舭	nsu
菥	hmjt
蜾	qbm
螬	qub
螵	qcfm
衄	jqjt
谫	ivdd
躔	oljl
郛	jzp
酤	uxo
钷	vco
锫	vdo
镩	vnvi
阢	ptw
鼷	gldy
劁	tihn
埭	les
墚	lsdm
摅	fyu
泐	spj
牿	jfjo
犏	jfdh
猹	xjmt
疰	jde
痃	jdw
痖	jtwt
瘥	jvfi
磉	caam
礻	jy
箢	kndc
簖	kxlt
缋	wqb
缏	wttx
耥	emwo
脲	dps
膪	ddno
苠	hptv
茳	hsi
莶	hvtw
蒎	hsjk
蒡	hdnh
虍	yii
虍	yiih
螗	qjeo
贳	hlb
軎	co
軎	cobw
醌	ubu
醭	uwtv
铹	vhnj
铼	vtx
镥	vrtb
阽	pyo
馘	vjgx
鲺	rtzq
鹎	gjxt
鼽	jgqx
傺	txfm
勹	sii
喹	oyll
彡	sii
戤	zjax
攴	ya
瀵	sxqv
灬	hii
丂	ts
丄	lii
丅	tii
丆	jii
丏	tlj
丒	ddt
丠	ktt
両	tne
並	vwt
丮	zf
丱	hii
丳	oon
丷	vii
丼	fnd
乀	nii
乁	zii
乂	xii
乑	xii
乕	jjfi
乗	jthm
乚	lii
乛	jii
乢	el
乣	wl
乤	tdz
乥	jvz
乧	ddxz
乨	gol
乪	zq
乫	joz
乬	gz
乭	cz
乮	cjpz
乯	jviz
乲	vrvz
乴	fjjz
乵	dxl
乶	tdiz
乷	smjz
乹	xbxl
乺	jjzz
乻	dhvz
乼	sdez
乽	ybz
乿	jwml
亀	rbbl
亁	xbfz
亂	jdnl
亃	xdcl
亄	lntl
亅	iii
亇	rj
亊	tvej
亐	fs
亗	ef
亜	tont
亝	gggf
亞	txt
亣	dn
亪	dmz
亯	dob
亰	dbm
亱	dtbt
亴	donx
亶	dqot
亷	djem
亸	dozx
亹	djkf
亼	vt
亽	vd
亾	vl
仈	tv
仌	vv
仏	tg
仐	vx
仒	vdd
仛	tjt
仜	ti
仠	tf
仢	tsd
仦	tm
仧	lv
仩	tl
仭	tdn
仮	tjja
仯	tmj
仱	tvj
仴	td
仸	tjy
仹	tf
仺	ve
仼	te
仾	ttlt
伀	tvg
伂	ttni
伃	tdt
伄	tzsi
伅	ttul
伆	tss
伇	twa
伈	tu
伌	tjc
伒	tjjt
伓	tjy
伔	tnw
伖	txa
伜	txx
伝	tfg
伡	tc
伣	tnw
伨	tsv
伩	tdx
伬	tpn
伭	tdw
伮	tra
伱	tvm
伳	thl
伵	tq
伷	td
伹	tqf
伻	ttvi
伾	tjyt
伿	tov
佀	tpz
佁	tgo
佂	ttl
佄	thf
佅	tfm
佇	tnt
佈	txni
佉	tlg
佊	tja
佋	tdo
佌	tlt
佒	tny
佔	tyo
佖	tuj
佡	tve
佦	tc
佨	tse
佪	tqo
佫	tao
佭	taci
佱	vfl
佲	tdo
併	tvh
佷	tek
佸	tjxo
佹	trjc
佽	tvrv
侀	tthn
侁	tjlw
侂	tjjt
侅	tdyv
侇	ttzv
侊	tww
侌	vjfg
侎	tx
侐	tjq
侒	tnr
侓	tef
侕	tjnn
侖	vtnh
侘	tnjt
侙	ttiv
侚	tsb
侜	tns
侞	tro
侟	txiz
価	tc
侢	ttnl
侤	tys
侫	tdlr
侭	tpnd
侰	tejo
侱	toe
侲	tjfk
侳	tvvl
侴	vtjn
侶	tojo
侷	tpjo
侸	ttov
侹	tjlz
侺	tevj
侻	tvow
侼	txnz
侽	tqj
侾	tyz
俀	tjr
俁	tosy
係	tjwm
俆	tvtm
俇	txje
俈	tjlo
俉	two
俋	todl
俌	ttdd
俍	tdek
俒	tnfw
俓	ttsi
俔	tgw
俕	tnm
俖	tjyo
俙	txxi
俛	trow
俢	tas
俥	tc
俧	tlu
俫	ttx
俬	thg
俰	tho
俲	tdvj
俴	txx
俵	tlk
俶	tlma
俷	tddl
俹	ttxt
俻	taq
俼	tdgd
俽	tjjv
俿	tyw
倀	tk
倁	tlyo
倂	tjff
倃	tayo
倄	txxd
倅	tdvx
倆	ttnd
倇	tndc
倈	txvv
倉	vdeo
倊	tvgu
個	tqxo
倎	tuv
倐	tiax
們	tn
倓	txx
倗	tdd
倛	thev
倝	xbxv
倞	tdom
倠	tti
倢	ttel
値	txgl
倧	tnfm
倫	tvth
倯	tmvg
倰	tlva
倱	tbu
倲	ttbm
倳	ttoi
倴	tyxh
倵	tflv
倶	tgtv
倷	tyfm
倸	tjm
倹	tvtv
倻	tpp
倽	tvfo
倿	tdr
偀	thny
偁	tjnl
偂	tvdn
偄	tjny
偅	tjtl
偆	tevb
偉	tzii
偊	tjog
偋	tpvh
偍	tbtl
偐	tdjs
偑	twjq
偓	tptl
偖	tyb
偗	tmjg
偘	tooo
偙	tdni
偛	tjxg
偝	tktd
偞	thlm
偟	tge
偠	tcr
偡	thel
偢	thx
偣	tdb
偤	tvu
偦	tjld
偧	tydd
偨	tltm
偩	trgv
偪	ttoq
偫	tsld
偮	top
偰	tfdy
偱	tjjg
偲	tqu
偳	tejn
側	tgvn
偵	tygv
偸	tvtk
偹	tiaq
偼	tyel
偽	tdjh
傁	tgia
傂	tjjw
傃	tlwm
傄	tyvg
傆	tjgm
傇	thp
傉	tjfd
傊	togv
傋	tfnl
傌	tsh
傎	txqv
傏	tjeo
傐	tdoo
傑	tdcm
傒	tjwy
傓	tdpj
傔	tvem
傕	tpii
傖	tvdo
傗	tdwq
傘	vvvx
備	thjf
傛	tnvo
傜	tjlu
傝	tbjj
傞	tvfi
傟	tvgj
傠	tixd
傡	tdd
傢	tnx
傤	tlcx
傦	tqd
傪	tggs
傫	tqwm
傭	tjei
傮	tub
傯	tjqu
傰	tedd
傱	tsvl
傳	ttbd
傴	tcoo
債	tlgv
傶	tjlx
傷	tlbs
傸	tyxx
傹	tdbw
傼	thov
傽	tdbx
傾	ttlv
傿	ttlh
僁	tjxu
僂	totr
僃	thsf
僄	tcfm
僅	thol
僈	tbqa
僉	vtov
僊	tcye
僋	tvjv
僌	tca
働	tjtj
僐	tvfo
僑	tjyo
僒	tnvo
僓	tqgv
僔	tvud
僕	twtv
僗	txxj
僘	twna
僙	thdv
僛	thev
僜	txtv
僝	tpzz
僞	tjjh
僟	twwx
僠	tjxq
僡	ttbu
僢	tjni
僣	tfvb
僤	toox
僥	tllw
僨	txhv
僪	tdto
僫	ttxu
僯	txdi
僰	tnmv
僱	tdpi
僲	tcdi
僴	tnb
僶	tq
僷	thhm
僸	tmmm
價	tcgv
僺	toom
僼	tutv
僽	thxu
僾	tjna
僿	tnfl
儀	tvex
儁	ttim
儂	tujk
儃	tdqt
億	tdbu
儈	tvtb
儉	tvtv
儊	tmml
儌	tgda
儍	tdxa
儏	tydx
儐	tntv
儑	tbwh
儓	tlol
儔	tljd
儕	tddh
儖	tgkq
儗	ttll
儙	tqpz
儚	thqd
儛	tlhi
儜	tnut
儝	txxm
儞	ttvx
償	twnv
儠	tsqv
儢	tyqu
儣	tjhv
儤	tbhs
儥	tlqv
儦	tjzh
儧	tfvv
儨	tjjv
儩	tgvs
儫	tdox
儬	tldw
儭	tdmw
儮	tjhl
儯	tvyh
儰	thjh
儱	tdde
儲	tiyb
儴	tdok
儵	tiah
儶	teto
儷	ttnu
儸	tqwi
儹	tjlv
儺	thoi
儻	twnh
儼	tooa
儽	tqqm
儾	ttok
兂	cw
兇	xuw
兊	vgw
兌	vow
兎	jowd
兏	jlw
児	ibw
兒	gw
兓	cwcw
兗	dvow
兘	fwgo
兙	xowx
兛	xowx
兝	xowd
兞	xowl
兟	jlww
兠	kgtw
兡	xowb
兣	xowl
兤	wwjv
兦	jnl
內	njn
兩	tnid
兪	vtdl
兯	vp
兲	ev
兺	vdot
兾	vqhv
兿	vfxg
冃	nf
冄	nf
円	nit
冊	nh
冋	no
冎	qii
冏	nvo
冐	nfd
冑	dnf
冓	fntl
冔	bof
冘	pl
冝	nqf
冞	nx
冟	ngt
冡	nfx
冣	npa
冦	nfwa
冨	ntoq
冩	ngsh
冪	nhbi
冫	vii
冭	ydd
冮	vi
冴	vcij
冸	vvx
冹	vxad
冺	vptv
冾	vvto
冿	vef
凁	vtom
凂	vrow
凃	vvtm
凅	vqxo
凈	vjei
凊	vld
凍	vtbm
凎	vv
凐	vcl
凒	vetv
凓	vcm
凔	vvdo
凕	vnbv
凖	vtix
凗	veti
凘	vhet
凙	vqlx
凚	vmmm
凜	vdqm
凞	vjgh
凟	vlqv
凢	jw
凣	iw
凥	pw
処	aw
凧	wni
凨	wfg
凩	wm
凪	wl
凬	wtb
凮	wjb
凱	etow
凲	wvem
凴	vshw
凷	lu
凾	joau
刄	dn
刅	dv
刉	lzn
刋	jxn
刌	xdn
刏	kzn
刐	ndn
刓	fwn
刔	zvn
刕	ddd
刜	zsnn
刞	qfn
刟	don
刡	ptvn
刢	vjdn
刣	gon
別	ohn
刦	lgn
刧	lgd
刪	nhn
刬	fxn
刯	tbtn
刱	fndv
刲	lln
刴	zjmn
刵	pn
刼	lgdd
刾	tvvn
剄	tsin
剅	tovn
剆	degn
則	gvn
剈	odn
剉	vvln
剋	xown
剎	xmdn
剏	vhdd
剒	hbn
剓	hsjd
剕	enen
剗	xxn
剘	hevn
剙	vhdv
剚	toen
剛	nven
剝	ljtn
剟	aaan
剠	domn
剢	xdn
剣	vton
剤	dxhn
剦	ybln
剨	fcn
剫	jhan
剬	ejnn
剭	ptgn
剮	qon
剰	jxhn
剱	vtod
剳	hvtn
剴	eton
創	vden
剷	djjn
剸	tbgn
剹	jjvn
剺	fmad
剻	eddn
剼	gggn
剾	coon
劀	dtjn
劃	elqn
劄	kvtn
劅	qsqn
劆	jven
劇	yxn
劉	gdvn
劊	vtqn
劌	ljtn
劍	vton
劎	vtod
劏	wnon
劒	vtod
劔	vton
劕	jjtn
劖	roun
劗	jlwn
劘	jmmn
劚	psqn
劜	jl
劤	jjtj
劥	dwj
劦	jjj
劧	jfj
劮	kvj
劯	cj
劰	gj
労	wnj
劵	vyj
劶	jjtj
劷	vfj
劸	llj
効	dvxj
劺	gkij
劽	tdnj
勀	xowj
勁	tsij
勂	jloj
勄	lqsj
勅	tomj
勆	degj
勈	dnfj
勊	xowj
勌	vycj
勍	domj
勎	lvlj
勏	doj
勓	ugj
勔	jqnj
動	jtbj
務	dtjj
勚	hlbj
勛	ogvj
勜	vgjj
勝	dvyj
勞	xxnj
勠	jjvj
勡	cfmj
勢	lvlj
勣	lgvj
勥	zsoj
勧	lxij
勨	roxj
勩	hlgj
勪	jyoj
勫	jxqj
勬	vywj
勭	dblj
勮	yxj
勯	dqoj
勱	hbnj
勲	jtbh
勳	jtqj
勴	yquj
勵	jhbj
勶	sdgj
勷	dooj
勸	hooj
勻	sf
勼	sx
勽	sv
匁	sx
匂	st
匃	svl
匄	sdl
匇	sd
匉	stvi
匊	sx
匋	slxu
匌	svto
匎	sybl
匑	srzs
匒	shvo
匓	sega
匔	sroo
匘	tlsx
匛	crd
匜	cc
匞	ci
匟	cdw
匢	css
匤	ced
匥	cgh
匨	ckl
匩	cuie
匫	cssb
匬	cvtn
匭	ccx
匯	csti
匰	coox
匱	cqgv
匲	cyoo
匳	cvtv
匴	ckgh
匵	clqv
匶	chtg
匷	cggi
匸	cii
匼	cvto
匽	cbr
區	cooo
卂	zx
卄	hii
卆	xx
卋	xh
卍	xii
卐	xii
協	xjjj
単	wbx
卙	hevx
卛	wmix
卝	hii
卥	yqsd
卨	yqo
卪	pd
卬	cp
卭	ip
卲	dop
卶	ddp
卹	jqp
卻	vvop
卼	twrc
卽	gtp
卾	oofp
厀	mvsp
厁	vtmp
厃	rj
厇	jjt
厈	jf
厊	jcij
厎	jctd
厏	jlk
厐	jxtd
厑	jot
厒	jlxu
厓	jll
厔	jtgl
厖	jxld
厗	jdx
厙	jc
厛	jojt
厠	jgvn
厡	jgs
厤	jhh
厧	jxqv
厪	jhol
厫	jlha
厬	jbao
厭	jbdd
厯	jmmd
厰	jwna
厱	jvtv
厲	jhbg
厳	wjja
厴	jbdq
厵	jgmm
厷	xg
厸	gg
厹	xg
厺	yg
厼	gm
厽	ggg
叀	tbig
參	gggs
叄	ggge
叅	gggd
叆	fgja
叇	fgez
収	lia
叏	zia
叒	aaa
叓	toia
叕	aaaa
叚	pfza
叜	nxa
叝	lgpa
叞	pfma
叡	ynta
叢	wtva
叧	od
叴	xo
叺	ojn
叾	jo
叿	oi
吀	ojx
吂	dlo
吅	oo
吇	oz
吘	olx
吙	ox
吚	oej
吜	ojxt
吢	uo
吥	ojy
吪	ott
吰	oxg
吳	osy
吶	onjn
吷	ozv
吺	owa
吿	kio
呁	osv
呂	ojo
呄	zjxo
呅	odx
呇	so
呉	ostv
呌	oddx
呍	ofg
呏	ojh
呑	jyo
呚	oa
呝	odpz
呞	ojto
呟	odw
呠	omt
呡	optv
呣	oqs
呥	onl
呧	octd
呩	ofm
呪	oow
呫	oyo
呬	oq
呭	ohl
呮	oov
呯	otvi
呰	lto
呴	oso
呹	okv
呺	oots
呿	olg
咃	otc
咅	do
咉	ony
咊	oh
咍	ogo
咑	oft
咓	otld
咘	oxni
咜	ont
咞	oth
咟	ojb
咠	op
咡	op
咢	oofs
咮	okm
咰	osb
咲	ovy
咵	oyfs
咶	ojxo
咷	ovwv
咹	onr
咺	otbt
咼	qo
咾	oyt
哃	onto
哅	osxu
哊	oxd
哖	olci
哘	osfi
哛	otvd
哠	ojlo
員	ogv
哢	oeh
哤	oxld
哫	ool
哬	otto
哯	ogw
哰	onki
哱	oxnz
哵	oojn
哶	ohf
哷	ojxd
哸	ojr
哹	ojz
哻	obf
哾	ovow
唀	ohzj
唂	ovvo
唃	or
唄	ogv
唅	ovjo
唈	oodl
唋	ovtm
唌	ojlz
唍	onfw
唎	ohn
唒	ou
唕	ogx
唖	otot
唗	oll
唘	cao
唙	oxjx
唚	oena
唜	tmot
唝	oib
唟	lgot
唡	otnv
唦	osmj
唩	ohr
唫	ov
唭	ohev
唲	ogw
唴	ovfl
唵	oybl
唶	ohb
唸	ovju
唹	odhd
唺	ouv
唻	oxvv
唽	omjt
啀	ojll
啂	ojzl
啅	oybx
啇	dnxo
啌	onvi
啍	odoz
啎	lxwo
問	nno
啑	otel
啒	opue
啓	dpao
啔	dpxo
啘	ondc
啙	ltoo
啚	oxqo
啛	oter
啝	oho
啞	otxt
啟	dpoa
啠	jjto
啢	otnd
啨	old
啯	oqed
啳	ovyc
啴	ovbx
啽	ovth
啿	ohel
喅	obd
喆	lolo
喌	ooyy
喍	oltm
喒	oayb
喓	ocr
喕	ojqf
喖	omxo
喗	onc
喚	orny
喛	ojfa
喞	ogtp
喠	ojtl
喡	ozii
喢	ojxg
喣	osoh
喤	oge
喦	oooe
喨	odow
喩	ovtk
喪	xook
喫	ofdy
喬	jyoo
喭	odjs
單	oobx
喯	oyxh
喲	owmd
喴	ojtx
営	wnoo
喸	tdit
喿	ooom
嗀	lnta
嗁	ojjw
嗂	ojlu
嗃	odoo
嗆	ovdo
嗇	xvvo
嗈	osol
嗊	oigv
嗋	ojjd
嗎	osh
嗏	ohvm
嗐	onfo
嗕	ojfd
嗘	ojwy
嗙	odnh
嗚	ojzh
嗛	ovem
嗞	ovww
嗠	jzao
嗢	obq
嗧	jovh
嗩	owgv
嗭	xqet
嗴	ovfg
嗶	obhf
嗸	lhao
嗹	ocz
嗺	oeti
嗼	ohby
嗿	ovjv
嘂	oolo
嘃	ojei
嘄	ogm
嘆	ohov
嘇	oggs
嘊	oejl
嘋	oyza
嘍	ootr
嘑	oyji
嘒	offe
嘓	oqtx
嘔	ocoo
嘕	otlh
嘖	olgv
嘗	wnob
嘙	osjr
嘜	oxva
嘝	ordx
嘠	ojqx
嘡	ownl
嘦	ovcr
嘨	oeji
嘩	ohtf
嘪	oqgv
嘫	odyh
嘮	oxxj
嘯	oexk
嘰	owwx
嘳	oqgv
嘵	ollw
嘷	ojgx
嘸	olhh
嘺	ojyo
嘼	ooqo
嘽	ooox
嘾	ocbx
噀	oeev
噁	otxu
噂	ovud
噄	ofdm
噅	ojjh
噆	ocwb
噇	odbl
噈	odod
噊	odto
噋	odoa
噐	ooio
噑	ogxx
噓	oywt
噕	jjjo
噛	olxu
噝	owmm
噞	ovtv
噟	jtto
噠	olvz
噡	orji
噣	oqsq
噥	oujk
噦	oljx
噧	ohbg
噭	ogda
噮	oqtk
噯	ojna
噰	odwi
噲	ovtb
噳	oyoy
噴	oxhv
噵	vjgo
噷	odbv
噸	otuv
噹	ownq
噺	odmt
噽	lovt
噾	onvb
噿	ojjx
嚀	onut
嚁	ojji
嚂	ogkq
嚃	oqsz
嚇	olmm
嚈	ojbd
嚉	owtd
嚊	ojgn
嚋	oljd
嚌	oddh
嚐	ownb
嚑	ojth
嚒	ojmw
嚔	oxnl
嚕	orhb
嚖	offu
嚗	obhs
嚙	olvu
嚚	oogo
嚛	owgm
嚜	oqhl
嚝	ojhv
嚞	lolo
嚠	ogdn
嚡	ohpl
嚢	toik
嚦	ojhl
嚧	oyqq
嚨	odde
嚩	owmd
嚪	onrg
嚬	oyjv
嚭	lovo
嚮	wjdo
嚰	ojmc
嚱	oytx
嚲	dozx
嚳	jkxo
嚴	ooja
嚵	orod
嚶	ogvr
嚸	oqho
嚹	olxi
嚺	oqvz
嚻	oojo
嚽	olhv
嚾	ohoi
囀	octd
囁	oppp
囂	oojo
囃	odvi
囄	odxi
囅	oobk
囆	ohbq
囇	otnu
囈	ohlg
囉	oqwi
囋	ojlv
囌	ohrh
囎	ogvb
囏	hofo
囐	oytd
囑	opsq
囒	ohnm
囓	ofdu
囕	ogkw
囘	ne
囙	qz
囜	qg
団	qxd
囥	qdw
囦	qs
囧	qvn
囨	qjy
囩	qfg
囪	jqsd
囬	qnf
囮	qtt
囯	qe
囲	qfn
図	qddx
囶	qvl
囷	qh
囸	qtl
囻	qptv
囼	qgo
圀	qvdh
圁	qi
圂	qx
圅	dqvx
圇	qvth
國	qtox
圌	qejn
圍	qzii
圎	qggv
圏	qvyl
圐	qqdh
圑	qtdd
園	qlok
圓	qogv
圔	qlgq
圕	qelb
圖	qoxo
圗	qgxf
團	qtbd
圙	qvjf
圚	qqgv
圝	qwmm
圞	qwmm
圠	ll
圡	ld
圢	lt
圤	ly
圥	lw
圦	ljn
圧	jl
圫	ljt
圱	jxl
圲	ljx
圴	lsd
圵	ll
圶	yl
圷	ltd
圸	le
圼	bl
圽	lss
圿	lvn
坁	lctv
坃	lfw
坄	lwa
坅	lvj
坆	la
坈	lnw
坉	ltul
坋	lvd
坒	ul
坓	fnl
坔	sl
坕	jl
坖	fwl
坘	ltlt
坙	tsl
坢	lvx
坣	wnl
坥	lqf
坧	lc
坬	ljjn
坮	lgo
坰	lno
坱	lny
坲	lzsn
坴	lvl
坵	lg
坸	lso
坹	lnv
坽	lvjd
坾	lnt
坿	ltxd
垀	ljvi
垁	lly
垇	lu
垈	tvl
垉	lse
垊	lptv
垍	ljg
垎	lao
垏	lef
垐	vrvl
垑	ldd
垔	cl
垕	jjtl
垖	ljpz
垗	lvwv
垘	ltyd
垙	lww
垜	lzjm
垝	lrjc
垞	lnjt
垟	lvf
垥	lvto
垨	lnxd
垪	lvh
垬	lhv
垰	lltd
垱	lwe
垳	lsfi
垵	lnr
垶	ldx
垷	lgw
垹	lfp
垺	ljz
垻	lgv
垼	swal
垽	sjjl
垾	lbf
垿	ljdt
埀	jtkl
埁	levj
埄	laf
埅	pdhl
埆	lr
埈	lgva
埊	esl
埌	ldek
埍	lod
埐	lena
埑	fjjl
埓	ljxd
埖	lhtt
埛	lnvo
埜	mml
埡	ltxt
埢	lvyc
埣	ldvx
埥	lld
埦	lndc
埧	lqev
埨	lvth
埩	lrei
埪	lnvi
埫	lwno
埬	ltbm
埮	lxx
埰	ljm
埱	llma
埳	lrg
埶	lvld
埻	ldoz
埼	lyto
埾	pal
埿	sptl
堁	lbm
堃	dhdl
堄	lgw
堅	gal
堈	lnve
堊	txtl
堌	lqxo
堎	llva
堏	mdhl
堐	ljll
堒	lbu
堓	lejf
堔	lnvm
堖	lsjx
堗	lnvd
堘	lvyl
堚	lnc
堛	ltoq
堜	ltqm
堝	lqo
堟	lljx
堢	ltom
堣	lbng
堥	dtjl
堦	lug
堧	ljny
堨	lbsl
堩	lytt
堫	lxua
堬	lvtn
堭	lge
堮	loos
堯	lllw
堲	egpl
堳	ldjg
堶	lxid
堷	ldb
堸	lwjq
堹	ljtl
堺	lqvn
堻	sefl
堼	llxl
堽	lqtl
堾	levb
堿	ljtx
塀	lpvh
塁	qxl
塂	lhve
塃	lhdm
塇	lntt
塈	egcl
塉	lxvd
塊	lgwg
塋	xxnl
塎	lnvo
塏	letv
塐	llwm
塒	lbld
塓	lnbv
塕	lvgj
塖	ljxv
塗	svtl
塙	ldoo
塚	lnxd
塛	lcm
塜	lnfx
塝	ldnh
塟	htdl
塠	ljpz
塡	ltgv
塢	ljzh
塣	soel
塤	logv
塦	pcl
塧	lvvq
塨	lhvd
塩	lloq
塪	ljg
塮	lrxd
塯	lgdq
塰	slql
塱	degl
塲	llbs
塳	lafz
塴	ledd
塵	jznl
塶	ljzu
塷	lyqd
塸	lcoo
塹	ccjl
塺	jmml
塻	lhby
塼	ltbd
塿	lotr
墂	lcfm
墄	ljlx
墇	ldbx
墈	lhej
墋	lggs
墌	ljhh
墍	gtcl
墎	ldop
墏	kdxl
墐	lhol
墑	ldno
墔	leti
墕	ltlh
墖	lvtq
増	lvqb
墘	lxbz
墛	lpfd
墜	pvxl
墝	lllw
墠	loox
墡	lvfo
墢	lxza
墣	lwtv
墤	oqgv
墥	ldbl
墧	ljyo
墪	dozl
墫	lvud
墬	pljl
墭	ljjq
墮	pxil
墯	yxil
墰	lcbx
墱	lxtv
墲	llhh
墳	lxhv
墴	lhdv
墵	lufg
墶	llvz
墷	lhtf
墸	lhyb
墹	lnb
墺	ljny
墻	lxvo
墽	lgda
墾	jekl
壀	lpox
壂	phvl
壃	ltqt
壄	mdtl
壆	jkxl
壇	ldqt
壈	ldqh
壉	lyx
壊	lxqk
壋	lwnq
壌	ldvk
壍	scjl
壎	ljth
壏	lgkq
壐	tvnl
壒	lhlq
壓	jbdl
壔	lljd
壖	lujn
壘	qqql
壙	ljhv
壚	lyqq
壛	lnrg
壜	lbug
壝	lqgz
壞	ldqk
壠	ldde
壡	yntl
壢	ljhl
壣	lpwh
壥	ljql
壦	lhoi
壧	looa
壨	qqql
壩	luhd
壪	lwis
壭	lp
壯	kl
壱	lnt
売	lnw
壴	lov
壵	lll
壷	lnot
壸	lntt
壺	lnxt
壻	ljld
壼	lntt
壽	ljid
壾	lovg
壿	lvud
夀	fjod
夁	lqqo
夃	zja
夅	aci
夆	af
夈	ax
変	dma
夋	gva
夌	lva
夎	vvla
夐	rnva
夑	xixa
夓	ejga
夗	dc
夘	dp
夛	ed
夝	djl
夞	dyot
夠	ddso
夡	ddlo
夢	hqnd
夣	dgqd
夦	hevd
夨	ly
夬	zv
夰	yn
夲	yx
夳	yf
夵	ym
夶	yy
夻	yo
夼	ym
夽	yfg
夿	ydl
奃	yctd
奆	yg
奊	llly
奌	yoy
奍	vyn
奐	rnvy
奒	ydyv
奓	ydd
奙	gybl
奛	ybd
奝	ynlo
奞	yti
奟	ydd
奡	jgyn
奣	tybd
奤	yjqf
奦	dtjy
奧	jnjy
奨	kjxy
奩	ycoo
奪	ytid
奫	yskk
奬	kdxy
奮	ytiq
奯	yljx
奰	qqqy
奱	wmiy
奲	yybx
奵	rt
奷	rjx
奺	rrn
奻	rr
奼	rjt
奾	re
奿	xdr
妀	zlr
妅	ri
妉	rpl
妋	rfv
妌	rfn
妎	rvn
妏	rdx
妐	rvg
妑	rdl
妔	rdw
妕	roi
妘	rfg
妚	rjy
妜	rzv
妝	kr
妟	br
妠	rnv
妢	rvd
妦	rf
妧	rfw
妬	rc
妭	rxad
妰	rlk
妱	rdo
妴	dcr
妵	rde
妶	rdw
妷	rkv
妸	rto
妼	ruj
妽	rbi
妿	jor
姀	rh
姁	rso
姂	rjdz
姃	rtl
姄	rptv
姇	txdr
姈	rvjd
姉	rtni
姌	rnl
姍	rnh
姎	rny
姏	rhf
姕	ltr
姖	rg
姙	rtjl
姛	rnto
姞	rlo
姟	rdyv
姠	rjno
姡	rjxo
姢	rgd
姦	rrr
姧	rrf
姩	rlci
姫	rg
姭	jjjr
姮	rtbt
姯	rww
姰	rsb
姱	ryfs
姲	rnr
姳	rdo
姴	tdnr
姵	rwti
姶	rvto
姷	rxd
姸	rff
姺	rjlw
姼	rdd
姽	rrjc
姾	rve
娀	rtxx
娂	rhv
娊	rgw
娋	rwd
娍	rjjx
娎	fjjr
娏	rxld
娐	rjz
娔	rxow
娕	rtom
娖	rol
娗	rjlz
娙	rtsi
娚	rqj
娛	rosy
娝	rjyo
娞	rjr
娡	rlu
娢	rvjo
娤	klr
娦	rgv
娧	rvow
娨	rbf
娪	rwo
娫	rjlz
娬	rflv
娭	rgly
娮	ri
娯	rosv
娰	rtlv
娳	rhn
娵	rpa
娸	rhev
娹	rzsw
娺	raaa
娻	rtbm
娽	res
娾	rjll
娿	ptor
婁	otor
婂	rgni
婃	rnfm
婄	rdo
婅	rsx
婇	rjm
婈	rlva
婋	ryw
婌	rlma
婍	ryto
婎	rti
婏	rrod
婐	rbm
婑	rhr
婒	rxx
婖	rtyd
婗	rgw
婘	rvyc
婙	rrei
婛	rdom
婜	gar
婝	rntl
婟	rqxo
婠	rnpz
婣	rktk
婤	rnlo
婦	reni
婨	rvth
婩	rejf
婫	rbu
婬	rjjl
婭	rtxt
婮	rpxo
婯	tndr
婰	ruv
婱	zsdr
婲	rhtt
婳	rtqu
婹	rcr
婼	rhxo
婽	rpfa
婾	rvtk
媀	rbng
媁	rzii
媂	rdni
媃	rdtm
媄	rvey
媅	rhel
媆	rjny
媈	rnc
媉	rptl
媊	rvdn
媋	revb
媌	rhq
媍	rrgv
媎	ryb
媏	rejn
媐	ger
媑	rjtl
媓	rge
媔	rjqf
媕	rvth
媖	rhny
媗	rntt
媘	rug
媙	rjtx
媜	rygv
媝	hxr
媞	rbtl
媟	rhlm
媠	rxid
媡	rtqm
媣	rsxm
媤	rqu
媥	rdph
媦	rqd
媧	rqo
媨	rvu
媩	rxod
媫	ryel
媬	rtom
媭	sjbr
媮	rvtn
媯	rdjh
媰	rsuj
媱	rjlu
媴	rlok
媶	rhp
媷	rjfd
媹	rgdq
媺	reta
媻	nswr
媼	rqvq
媽	rsh
媿	rgwg
嫀	revh
嫃	rxqv
嫅	rvfi
嫆	rnvo
嫇	rnbv
嫈	xxnr
嫊	rlwm
嫋	rzsv
嫍	rjg
嫎	rdnh
嫏	rdep
嫑	jycr
嫓	rrnu
嫕	rclu
嫗	rcoo
嫙	rdhl
嫚	rbqa
嫛	clyr
嫝	rjes
嫞	rjei
嫟	rcho
嫢	fvgr
嫤	rhol
嫥	rtbd
嫧	rlgv
嫨	rhov
嫪	rjjs
嫬	rjhh
嫭	ryji
嫮	rufs
嫯	lhar
嫰	rtov
嫲	rjmm
嫳	vnmr
嫴	rxox
嫵	rlhh
嫶	rtih
嫷	rpxd
嫸	rvfo
嫹	rhdv
嫺	rnd
嫻	rnm
嫼	rqh
嫽	ryvm
嫾	rxdi
嫿	relt
嬀	rjjh
嬁	rxtv
嬂	rdbx
嬃	sjgr
嬄	rlnv
嬅	rhtf
嬆	rvtj
嬇	rqgv
嬈	rllw
嬋	roox
嬌	rjyo
嬍	reta
嬎	rrol
嬏	rjxq
嬐	rvtv
嬑	rdbu
嬒	rvtb
嬓	rgda
嬔	rrol
嬘	rvxz
嬙	rxvo
嬚	rjvm
嬛	rqtk
嬜	dbrr
嬞	rhjl
嬟	rvex
嬠	room
嬡	rjna
嬢	rdvk
嬣	rnut
嬤	rjmw
嬥	rjji
嬦	rljd
嬨	rvwu
嬩	rjkv
嬪	rntv
嬫	rxxm
嬬	rujn
嬭	rtvx
嬮	jbdr
嬯	rlol
嬰	gvgr
嬱	scjr
嬳	rhta
嬵	rwmi
嬶	rjgn
嬸	rnjq
嬹	rjkv
嬺	rchu
嬻	rlqv
嬼	rgdn
嬽	rqiy
嬾	rtov
孁	uoor
孂	rkeq
孃	rdok
孄	rntm
孅	rvvx
孆	rgvr
孇	rtia
孈	reto
孉	rhoi
孊	rjme
孋	rtnu
孌	wmir
孍	rooa
孎	rpsq
孏	rhnm
孒	jt
孞	zu
孠	jtoz
孡	zgo
孧	wjz
孨	zzz
孫	zjwm
孮	znfm
孯	gaz
孲	ztxt
孴	zzzb
孶	dwdz
孷	fmaz
學	jkxz
孹	podz
孼	ujjz
孾	zgvr
孿	wmiz
宂	nw
宆	nzs
宊	nyd
宍	ndv
宎	njy
宐	nhdt
宑	nfn
宒	njfl
宔	nde
宖	nzsg
実	nev
宧	ng
宨	nvwv
宩	nx
宬	njjx
宭	nejo
宮	nojo
宯	nyz
宱	ntlk
宲	nom
宷	njx
宺	notm
宻	nave
宼	nfwr
寀	njm
寁	ntel
寃	nrod
寈	nld
寉	nti
寊	nygv
寋	nfnc
寍	nuq
寎	nktv
寏	nrny
寑	ntea
寔	nbtl
寕	njqt
寖	nsea
寗	nujl
寘	nxqv
寙	njjn
寚	nelu
寛	nhgw
寜	nuqi
寠	notr
寢	nkea
寣	nki
實	nqxv
寧	nuqt
審	njxq
寪	njjh
寫	ngsh
寬	nhgd
寭	ntbu
寯	ntim
寱	nkjm
寲	ntll
寳	nerv
寴	ndmw
寵	ndde
寶	nelv
寷	nffv
寽	jxd
対	dxxd
尀	coxd
尃	tdid
尅	xowd
將	kdxd
專	tbgd
尋	eiod
尌	lovd
對	wtvd
導	vjgd
尒	vm
尓	lm
尗	lm
尙	mno
尞	yvbm
尟	btlj
尠	hevj
尡	wwbu
尣	vw
尦	vwsd
尨	xlsd
尩	vwe
尪	xle
尫	twe
尭	xhw
尮	xlzm
尯	xlrc
尰	xljl
尲	xlvm
尳	xlqd
尵	xlqv
尶	twgq
尷	xlgq
屃	pb
屄	pnv
屆	plu
屇	pq
屍	ptdt
屒	pjfk
屓	pgv
屔	gpt
屖	pdx
屗	pjfd
屚	pu
屛	pjff
屜	pshl
屟	phlm
屢	potr
層	pvqb
屧	pshm
屨	psor
屩	psjo
屪	pnym
屫	pkjo
屬	psqq
屭	pgvv
屮	ui
屰	vuj
屲	je
屳	jne
屴	ej
屵	ej
屶	ed
屷	ezj
屸	ei
屻	edd
屼	etw
屽	ef
屾	ee
岃	edd
岄	ed
岅	ejja
岆	ejy
岇	ecp
岉	ess
岊	dle
岋	ejzn
岎	evd
岏	efw
岒	evj
岓	ejjt
岕	evn
岝	elk
岞	elk
岟	eny
岠	eg
岡	nve
岤	env
岥	eja
岦	ed
岧	edo
岨	eqf
岪	ezsn
岮	ent
岯	ejyt
岰	ewj
岲	eow
岴	eg
岶	eg
岹	edo
岺	evjd
岻	ectd
岼	etvi
岾	eyo
峀	ed
峂	eadd
峅	egh
峆	evto
峇	evto
峈	eao
峉	eao
峊	jpze
峌	etgl
峍	eef
峎	eek
峏	ejnn
峐	edyv
峑	eve
峓	etzv
峔	eyt
峕	edb
峖	enr
峗	erjc
峘	etbt
峚	eyl
峛	etdn
峜	evl
峝	ento
峞	erjc
峟	exd
峠	eltd
峢	etdn
峣	extw
峧	edvx
峩	ejfx
峫	ecip
峬	etdd
峮	eejo
峯	eaf
峱	xjje
峲	ehn
峳	etia
峴	egw
峵	enxg
島	ge
峷	edx
峸	ejjx
峹	vtme
峺	etbx
峼	ejlo
峾	sjje
峿	ewo
崀	edek
崄	evtw
崅	er
崈	nfme
崉	esb
崊	emm
崋	ethf
崌	epxo
崏	ectb
崐	ebu
崑	ebu
崒	edvx
崓	eqxo
崕	ejll
崗	enve
崘	evth
崙	evth
崚	elva
崝	eld
崟	ev
崠	etbm
崡	ejxu
崢	ejei
崣	ehr
崥	egjx
崨	etel
崪	edvx
崫	epue
崬	etbm
崯	ev
崰	esq
崱	egvn
崲	ege
崳	evtn
崶	elld
崷	evu
崸	ejgv
崹	edni
崺	edhc
崻	esld
崼	ebtl
崿	eoos
嵀	emde
嵁	ehel
嵂	esef
嵃	edjs
嵄	evey
嵅	ejtx
嵆	hxle
嵈	ejfa
嵉	edot
嵍	dtje
嵎	ebng
嵏	exua
嵐	ewjq
嵑	ebsl
嵒	oooe
嵓	eooo
嵔	eqtk
嵕	exua
嵖	embt
嵗	ejtx
嵙	ehdx
嵞	vtme
嵟	ejti
嵠	ejwy
嵡	evgj
嵢	evdo
嵣	ejeo
嵤	xxne
嵥	edcm
嵦	eetv
嵧	egdq
嵨	ejzh
嵪	edoo
嵭	ednh
嵮	exqv
嵰	evem
嵱	envo
嵲	ejgm
嵳	evfi
嵵	ebld
嵶	ezsv
嵷	esvl
嵸	esvl
嵹	ezsq
嵺	ejjs
嵻	ejes
嵼	edjl
嵾	eggs
嵿	etjv
嶀	eufs
嶁	eotr
嶃	ecjt
嶄	ecjt
嶅	lhae
嶆	eub
嶇	ecoo
嶈	ekdd
嶉	eoti
嶊	efti
嶋	egh
嶌	egh
嶍	ejjg
嶎	epfd
嶏	ejul
嶐	epal
嶒	evqb
嶓	ejxq
嶔	evrv
嶕	etih
嶖	evtj
嶗	exxj
嶘	emxx
嶚	eyvm
嶛	eyvm
嶜	ecwb
嶞	pxie
嶟	evud
嶠	ejyo
嶡	ejvv
嶢	ellw
嶣	etih
嶤	ellw
嶥	ejvv
嶦	erji
嶨	jkxe
嶩	eujk
嶪	ewtm
嶫	ewtm
嶬	evex
嶭	ejpx
嶮	evtv
嶯	eopx
嶰	erdi
嶱	ehbl
嶲	etim
嶳	exll
嶴	jnxe
嶶	esea
嶸	exxm
嶹	eljd
嶺	evjv
嶻	eltx
嶼	ejkv
嶽	exjd
嶾	ejiu
嶿	eujn
巀	emjx
巁	ejhg
巂	etio
巃	edde
巄	edde
巆	exxo
巇	eytx
巈	ehpx
巊	egvr
巋	ejpi
巌	ewja
巏	ehoi
巐	edoh
巑	ejlv
巒	wmie
巓	etgv
巔	exqv
巕	evjr
巖	eooa
巗	eooa
巘	eytd
巚	eytd
巟	dlm
巠	tsi
巣	wbm
巤	sqxv
巪	gj
巬	iwfv
巭	ijfv
巰	tsim
巵	jjtl
巶	doe
巸	ge
巹	jxtl
巺	eetv
巻	vyzl
巼	dlot
巿	tni
帀	tni
帄	nit
帇	eni
帉	nivd
帊	nidl
帋	ctvi
帍	dpni
帎	nipl
帒	tvni
帓	nitm
帗	nixd
帞	nijb
帠	gni
帡	nivh
帢	nivo
帣	vyni
帤	roni
帥	jpzi
帨	nivw
帩	niwd
帪	nijk
師	jpzi
帬	ejoi
帲	nijf
帳	nik
帴	nixx
帵	ninc
帹	nidr
帺	nihv
帾	niyb
帿	nity
幀	niyv
幁	nijv
幃	nizi
幆	nibl
幇	llxi
幈	niph
幉	nihm
幊	niiv
幋	nswi
幍	nijg
幎	ninv
幏	ninx
幐	dvyi
幑	seja
幒	niju
幓	nigs
幖	nicm
幗	niqx
幘	nilv
幙	nihy
幚	fpgi
幜	nibm
幝	niox
幟	nidx
幠	nilh
幣	vnmi
幤	wnoi
幥	niwf
幦	podi
幧	niom
幨	niri
幩	nixv
幪	nihx
幫	llxi
幬	nild
幭	nihx
幮	nijd
幯	nikp
幰	ninu
幱	ninm
幷	jfjf
幹	xbxf
幾	wwyx
庁	jt
庂	jv
広	jg
庅	jjg
庈	jvj
庉	jtul
庌	jcij
庍	jjjt
庎	jvn
庒	jld
庘	jq
庛	jlt
庝	jadd
庡	jdk
庢	jtgl
庣	jvwv
庤	jlxd
庨	jyz
庩	jvtm
庪	jfxa
庫	jc
庬	jxld
庮	ju
庯	jtdd
庰	jvh
庱	jlva
庴	jhb
庺	jvgm
庻	jhvv
庼	jtlb
庽	jbng
庿	jhq
廀	jnxa
廁	jgvn
廂	jmg
廄	jega
廅	jlgq
廆	jgwg
廇	jgdq
廈	jjga
廋	jgia
廌	jznh
廍	jdop
廎	jtlv
廏	jgta
廐	jgtw
廔	jotr
廕	jpvg
廘	jjzu
廙	jqhv
廚	jlod
廜	jpyb
廝	jhet
廞	jvrv
廟	jxbd
廠	jwna
廡	jlhh
廢	jxza
廣	jhdv
廤	jcot
廥	jvtb
廦	jpox
廧	jxvo
廩	jdqh
廫	jdjs
廬	jyqq
廭	jhlv
廮	jgvr
廯	jrhf
廰	jpxu
廱	jsoi
廲	jtnu
廳	jpeu
廵	sz
廸	dz
廹	gz
廻	qoz
廼	cz
廽	qnfz
弅	vdh
弆	lgh
弇	vtoh
弉	klh
弌	ttv
弍	tfv
弎	tev
弐	ffv
弒	xmdv
弔	zsi
弖	zst
弙	zsf
弚	vzsi
弜	zszs
弝	zsdl
弞	zsrv
弡	zsg
弢	zsua
弣	zstd
弤	zscd
弨	zsdo
弫	zsg
弬	zsg
弮	vyzs
弰	zswd
弲	zsod
弳	zsti
弴	zsdz
張	zsk
強	zsgq
弸	zsdd
弻	zsts
弽	zshm
弾	zswx
弿	nfns
彁	zsto
彂	wtzy
彃	zsbf
彄	zsco
彅	zsvd
彆	wnms
彇	zsek
彈	zsox
彉	zshv
彋	zsqk
彌	zstx
彍	zsjv
彎	wmis
彏	zsga
彐	eii
彑	ljt
彔	ljts
彙	ljtm
彚	enbm
彛	exvh
彜	ljth
彞	exwh
彟	exda
彠	eioa
彣	dxs
彥	dxjs
彨	tnds
彫	nlos
彮	nvvs
彯	cfms
彲	tnds
彴	ssd
彵	sc
彶	sjzn
彸	svg
彺	se
彽	sctd
彾	svjd
彿	szsn
徃	sjl
徆	sc
徍	sll
徎	soe
徏	sy
徑	stsi
従	svl
徔	shdz
徖	snfm
徚	stqm
徝	sxqe
從	svvl
徟	snlo
徢	stel
徣	shb
徤	sefz
徥	sbtl
徦	spfa
徧	sdph
復	slba
徫	szii
徯	sjwy
徰	stll
徱	scfm
徲	spsi
徳	sxqu
徴	seea
徶	svna
徸	sdbl
徹	sdga
徺	sllw
徻	svtb
徾	seia
徿	sdde
忀	sdok
忁	sbus
忂	sggi
忇	yj
忈	fu
忊	yt
忋	yzl
忎	jxu
忓	yf
忔	ylz
忕	yy
忚	yc
忛	ywd
応	ju
忞	dxu
忟	ydx
忢	wu
忣	yjzn
忥	kzu
忦	yvn
忨	yfw
忩	vgu
忬	ydt
忯	yctv
忰	yxx
忲	yyd
忳	ytul
忴	yvj
忶	yfg
忷	yxu
忹	ye
忺	yrv
忼	ydw
怇	yg
怈	yhl
怉	yse
怋	yptv
怌	yjyt
怐	yso
怑	yvx
怓	yra
怗	yyo
怘	xou
怚	yqf
怞	yd
怟	yctd
怢	ykv
怣	kvu
怤	txdu
怬	yq
怭	yuj
怮	ywj
怰	ydw
怱	ssdu
怲	ytnv
怳	yow
怴	ycx
怶	yja
怷	xwdu
怸	mdu
怹	tcu
怺	ydjx
怽	yfm
怾	yov
恀	ydd
恄	ylo
恅	yyt
恆	ytht
恇	yce
恈	ygki
恉	ytb
恊	yjjj
恌	yvwv
恎	ytgl
恏	rzu
恑	yrjc
恓	yc
恔	ydvx
恖	jqxu
恗	yyfs
恘	ytm
恛	yqo
恜	ytiv
恞	ytzv
恟	ysxu
恠	yxil
恡	yxxg
恥	pu
恦	yjno
恮	yve
恱	yvgw
恲	yvh
恴	dbu
恷	tmu
恾	yhdl
悁	yod
悂	yul
悅	yvow
悆	vtmu
悇	yvtm
悈	ythx
悊	fjju
悋	ydxo
悎	yjlo
悐	xjxu
悑	ytdd
悓	ygw
悕	yxxi
悗	yrow
悘	clyu
悙	ydoj
悜	yoe
悞	yosy
悡	hnu
悢	ydek
悤	jqdu
悥	iu
悧	yhn
悪	tonu
悮	yoty
悰	ynfm
悳	xneu
悵	yk
悶	nnu
悷	ydpd
悹	npzu
悺	ynpz
悽	yter
悾	ynvi
悿	ytyd
惀	yvth
惁	mjju
惂	yrg
惃	ybu
惄	lmau
惈	ybm
惉	syou
惌	ndcu
惍	yv
惎	hevu
惏	ymm
惐	ytox
惒	hou
惓	yvyc
惔	yxx
惖	bssu
惙	yaaa
惛	yctb
惞	yjjv
惡	txtu
惢	uuu
惣	jfsu
惤	yzsw
惥	gvu
惪	xqeu
惱	ysjx
惲	ync
惵	yhlm
惷	evbu
惸	ysbz
惻	ygvn
惼	ydph
惽	yptb
惾	yxua
惿	ybtl
愂	xnzu
愃	yntt
愄	yqtk
愅	yhp
愇	yzii
愊	ytoq
愋	yjfa
愌	yrny
愐	yjqf
愔	ydb
愖	yhel
愗	dtju
愘	ynao
愙	naou
愛	jnua
愜	yctv
愝	ycbr
愞	yjny
愡	yssu
愢	yqu
愥	yhny
愨	lntu
愩	yigv
愪	yogv
愬	vuju
愭	yytb
愮	yjlu
愯	ytia
愰	ybww
愱	yjly
愲	yqd
愳	ggu
愴	yvdo
愵	yzsv
愶	yjjd
愷	yetv
愹	ynvo
愺	yhbx
愻	zjwu
愼	ytgv
愽	ytdd
愾	ykzx
慀	yjwy
慁	qxu
慃	yvgj
慄	ycm
慅	yadq
慆	yjg
慉	ydwq
態	gdtu
慍	yqvq
慏	ynbv
慐	igvu
慒	yub
慓	ycfm
慔	yhby
慖	yqtx
慗	tomu
慘	yggs
慙	ccju
慚	ycjt
慛	yeti
慜	lqsu
慞	ydbx
慟	yjtj
慠	ylha
慣	yqxv
慤	lnwu
慥	yjlz
慦	xxdu
慩	ycz
慪	ycoo
慫	svvu
慬	yhol
慭	txyu
慮	ytqu
慯	ylbs
慱	ytbd
慲	yhnd
慳	ygal
慴	yjjg
慶	jzna
慸	hnnu
慺	yotr
慻	yvyg
慼	jlmu
慽	yjlx
慾	vvou
慿	vshu
憀	yjjs
憁	yjqu
憃	evgu
憄	sxgu
憅	jtbu
憆	ywnl
憈	yywt
憉	ylos
憊	thju
憌	vvsu
憍	yjyo
憏	yxfm
憐	yxdi
憑	vshu
憒	yqgv
憓	ytbu
憕	yxtv
憘	yloo
憙	lovu
憚	yoox
憛	ycbx
憜	ypxd
憞	ydoa
憟	ycx
憠	jvuu
憡	yktm
憢	yllw
憣	yjxq
憤	yxhv
憥	xxnu
憦	yxxj
憪	ynd
憫	yndx
憭	yyvm
憮	ylhh
憯	ycwb
憰	ydto
憱	ydod
憲	nlqu
憳	yeid
憴	yq
憵	podu
憶	ydbu
憸	yvtv
憹	yujk
憺	yrji
憻	ydqt
憼	hsou
憽	yhsu
憿	ygda
懀	yvtb
懁	yqtk
懃	holu
懄	yhoj
懅	yyx
懆	yoom
懇	jeku
應	jttu
懍	ydqh
懎	yxvo
懏	ytim
懐	ydqk
懓	yjna
懕	jbdu
懖	vvju
懗	ylmm
懘	shnu
懙	yjkv
懚	yjiu
懛	ylol
懜	yhqd
懝	ytll
懞	yhnx
懟	wtvu
懠	yddh
懡	yjmg
懢	ygkq
懣	shnu
懤	yljd
懥	yxnl
懧	ynut
懨	yjbd
懩	yvek
懪	ybhs
懫	yjjv
懬	jhdu
懭	yjhv
懯	tdiu
懰	ygdn
懱	yhqx
懲	setu
懳	yffu
懶	ytov
懷	ydqk
懸	qemu
懹	ydok
懺	yvvx
懻	yktv
懼	yggi
懽	yhoi
懾	yppp
戀	wmiu
戁	hofu
戂	yjme
戃	ywnh
戄	ygga
戇	dbxu
戉	cx
戓	tox
戔	xx
戜	toex
戝	gvx
戠	dbx
戣	xtyx
戦	wbxx
戧	vdex
戨	totx
戩	tggx
戫	xdtx
戭	ntdx
戯	ywtx
戰	oobx
戱	ywtx
戲	ytox
戵	ggtx
戶	jjz
戸	tp
戹	dpz
戺	dpe
戻	dpy
戼	jctz
扂	dpyo
扄	dpjo
扅	dpdd
扆	dpdk
扊	dpxx
扏	fx
払	fg
扖	fjn
扗	fl
扙	fxn
扜	ff
扝	ffs
扞	ff
扟	fzx
扠	fad
扡	fc
扢	flz
扥	fjt
扨	fdd
扴	fvn
扵	fvdd
扷	fjy
扸	fk
扺	fctv
抁	fgw
抂	fe
抃	fdy
抅	fsg
抇	fb
抈	fd
抋	fu
抍	fjh
抎	ffg
抏	ffw
抐	fnv
抔	fjy
抙	fjf
抜	fxa
抝	fwj
択	fpn
抣	fsv
抧	fov
抩	fnl
抪	fxni
抭	fnw
抮	fvs
抯	fqf
抲	fto
抳	fpt
抴	fhl
抶	fkv
抷	fjyt
抸	fjdz
抺	ffm
抾	flg
拀	fow
拁	fjo
拋	fxlj
拏	rajf
拑	fhf
拕	fnt
拝	ff
拞	fg
拠	faw
拡	fjg
拤	fly
拪	fc
拰	ftjl
拲	hvjf
拵	fxiz
拸	fdd
拹	fjjj
拺	ftnm
拻	fxx
挀	fjjk
挃	ftgl
挄	fww
挅	fzjm
挆	fwm
挊	fltd
挋	fg
挌	fao
挍	fdvx
挏	fnto
挐	rojf
挒	ftdn
挓	fnjt
挔	fdk
挕	fp
挗	ftzv
挘	fmjj
挙	wvjf
挦	fexd
挧	fjj
挩	fvow
挬	fxnz
挭	ftbx
挮	fvzj
挰	foe
挱	fsmj
挳	ftsi
挴	flqs
挵	feh
挶	fpjo
挷	ffp
挸	fgw
挻	fjlz
挿	fjti
捁	fjlo
捄	fxxd
捇	flm
捈	fvtm
捊	fjz
捑	fbly
捒	ftom
捓	fcip
捔	fr
捖	fnfw
捗	fy
捘	fgva
捙	fc
捚	fbl
捛	foo
捜	fbia
捝	fvow
捠	fgv
捤	fpjl
捥	fndc
捦	fv
捨	fvfo
捪	fctb
捫	fn
捬	fjtd
捯	ftgn
捰	fbm
捲	fvyc
捳	fge
捴	fvgu
捵	fuv
捸	fes
捹	fyxh
捼	fhr
捾	fnpz
捿	fter
掁	fk
掃	feni
掄	fvth
掋	fjcd
掍	fbu
掑	fhev
掓	flma
掔	gajf
掗	ftxt
掙	fjei
掚	ftnd
掛	flly
掜	fgw
掝	ftox
掞	fxx
採	fjm
掤	fdd
掦	fbss
掫	fpa
掯	fld
掱	jfjf
掲	fbst
掵	fvtp
掶	fjev
掻	faq
掽	fvwt
掿	fhxo
揀	ftqm
揁	fygv
揂	fvu
揃	fvdn
揅	cthf
揈	fsi
揊	ftoq
揋	fqtk
揌	fqu
揑	fgi
揓	fdhc
揔	fssu
揕	fhel
揗	fjjg
揘	fge
揙	fdph
換	frny
揜	fvth
揝	fayb
揟	fjld
揢	fnao
揤	fegp
揥	fdni
揧	tomf
揨	fdot
揫	hxjf
揬	fnvd
揮	fnc
揯	fytt
揰	fjtl
揱	wdnf
揳	ffdy
揷	fjti
揺	fjfu
揻	fjtx
搃	fvou
搄	fytt
搇	fvjk
搈	fnvo
損	fogv
搎	fzjm
搑	fhp
搒	fdnh
搖	fdlu
搗	fge
搘	fytb
搙	fjfd
搚	fjjd
搝	fjgd
搟	fcf
搢	ftwb
搤	fvvq
搥	fjpz
搨	fbjj
搩	fdcm
搫	nswf
搮	fcm
搯	fjg
搰	fqd
搱	fpdx
搳	fnfo
搶	fvdo
搷	fxqv
搸	fevh
搹	ftoy
搻	vtof
搼	fvyf
摀	fjzh
摂	fpx
摃	figv
摉	fnvd
摋	fxma
摌	fdjl
摍	fntb
摎	fjjs
摏	fevg
摐	fsvl
摑	fqtx
摓	fafz
摖	fxfm
摗	ftov
摚	fwnl
摛	fdxg
摜	fqxv
摝	fjzu
摟	fotr
摠	fjqu
摡	fegw
摢	fyji
摣	fyqf
摥	flbs
摦	fyfn
摨	fpsi
摪	fkdd
摫	ffvw
摬	fdbw
摮	lhaf
摰	lvlf
摲	fcjt
摳	fcoo
摴	fufs
摵	fjlx
摶	ftbd
摻	fggs
摼	fgal
摽	fcfm
摾	fzsq
摿	fvdb
撀	ldjf
撁	fdyi
撃	ccwf
撆	vnmf
撈	fxxj
撉	dozf
撊	fnd
撋	fne
撌	fqgv
撎	flnv
撏	feid
撐	fwnj
撓	fllw
撔	fbdm
撗	fhdv
撘	fkvo
撛	fxdi
撜	fxtv
撝	fjjh
撟	fjyo
撠	fxbx
撡	fggd
撣	foox
撥	fxza
撦	fyyb
撧	fwml
撨	ftih
撪	fgyc
撫	flhh
撯	fvfg
撱	fpxd
撲	fwtv
撳	fvrv
撴	fdoa
撶	fhtf
撹	fwnw
撻	flvz
撽	fgda
撾	fqoz
撿	fvtv
擁	fdwi
擃	fujk
擄	fyqj
擆	fhyb
擈	fwtm
擉	fqsq
擊	cuwf
擋	fwnq
擌	fktv
擑	fopx
擓	fcsi
擔	frji
擕	ftim
擖	fhbl
擙	fjny
據	fyx
擛	fhhm
擜	fxnd
擝	fbdq
擟	ftvx
擠	fddh
擡	flol
擣	fljd
擥	gkqf
擧	jksf
擨	fjjv
擩	fujn
擫	fjbd
擬	ftll
擮	fltx
擯	fntv
擰	fnut
擱	fnao
擲	fvup
擴	fjhv
擵	fjmf
擶	fkvn
擷	flov
擹	fhov
擺	fqgt
擻	fota
擼	frhb
擽	fwgm
擿	fdnz
攁	fvek
攂	fqqq
攃	fhxm
攄	fyqu
攅	ffvv
攆	ffvc
攇	fnfu
攈	fjzh
攊	fjhl
攋	ftov
攌	fqqk
攍	fdld
攎	fyqq
攏	fdde
攐	fnfk
攑	fjkf
攓	fnfl
攔	fntm
攕	fvvx
攖	fgvr
攗	fjzx
攙	frod
攚	fxxo
攛	fnvv
攜	feto
攝	fppp
攟	fjzh
攠	fjme
攡	fdxi
攢	fjlv
攣	wmif
攤	fhoi
攦	ftnu
攧	fxqv
攨	fnvn
攩	fwnh
攪	fjkw
攬	fgkw
攭	fljq
攱	dxa
攲	ytoa
攳	xaed
攷	tsa
攺	ea
攼	fa
攽	vda
敀	ga
敁	yoya
敂	soa
敃	ptva
敄	dtja
敆	vtoa
敇	tnma
敊	lmya
敋	aoa
敍	vtma
敎	xxza
敐	jfka
敒	tbia
敓	vowa
敗	gva
敘	vtma
敚	vowa
敜	vjua
敟	uva
敠	aaaa
敡	bssa
敤	bmya
敥	xxya
敧	ytoa
敨	doa
敩	wnza
敪	aaaa
敭	bjja
敮	jxga
敯	ptva
敱	etoa
敳	etoa
敵	dnxa
敶	ptba
數	otoa
敹	ynja
敺	cooa
敻	rnva
敼	lova
敽	jyoa
敾	vfva
敿	jyoa
斀	qsqa
斂	vtoa
斃	vnmt
斅	jkxa
斆	jkxa
斈	dxz
斉	dxh
斊	dxp
斍	dxgw
斎	dxji
斏	dxdk
斒	dxdh
斔	dxqv
斕	dxnm
斖	dxjf
斘	dddx
斚	ggnx
斝	oonx
斞	gvdx
斠	fntx
斢	hdvx
斣	qsqx
斦	jjtt
斨	kjjt
斪	sojt
斬	ccjt
斮	hbjt
斱	ybjt
斳	holt
斴	xdct
斵	gdtt
斶	jjtq
斷	wwtt
斸	psqt
斺	dhvn
斻	dhlw
斾	dhli
斿	dhlz
旀	dhgm
旂	dhlt
旇	dhla
旈	dhdm
旉	tdih
旊	dhld
旍	dhld
旐	dhlv
旑	dhyo
旓	dhld
旔	dhez
旕	dhvt
旘	dhdx
旙	dhjq
旚	dhlm
旛	dhlq
旜	dhlt
旝	dhlb
旞	dhlz
旟	dhlv
旡	cw
旣	gtcw
旤	qocw
旪	bx
旫	bd
旲	by
旳	bsd
旴	bf
旵	be
旻	bdx
旼	bdx
旽	btul
旾	tulb
旿	blx
昁	btni
昄	bjja
昅	bjzn
昇	bjh
昈	bdp
昉	bdh
昋	tyb
昍	bb
昐	bvd
昑	bvj
昒	bss
昖	bvg
昗	bdv
昘	bdh
昚	yvb
昛	bg
昞	btnv
昡	bdw
昢	bue
昣	bvs
昦	byn
昩	btm
昪	bgh
昫	bso
昬	ptvb
昮	bij
昰	btl
昲	bzsn
昷	bq
昸	badd
昹	bdjx
昺	btnv
昻	bip
昽	bxtd
昿	bjg
晀	bvwv
時	blxd
晆	bll
晇	byfs
晈	bdvx
晉	tggb
晊	btgl
晍	bnto
晎	bhv
晐	bdyv
晑	bjno
晘	bbf
晙	bgva
晛	bgw
晜	bvzj
晝	elbt
晠	bjjx
晢	fjjb
晣	bfjt
晥	bnfw
晧	bjlo
晩	brbw
晪	buv
晫	bybx
晬	bdvx
晭	bnlo
晱	bxx
晲	bgw
晳	mjjb
晵	dpab
晸	btla
晹	bbss
晻	bybl
晼	bndc
晽	bmm
晿	bbb
暀	bsde
暁	bxhw
暅	bytt
暆	bdhc
暈	bnc
暉	bnc
暊	bjgv
暋	ptvb
暎	bhny
暏	byb
暐	bzii
暒	bbjl
暓	dtjb
暕	btqm
暙	bevb
暚	bjlu
暛	bvfi
暜	ddb
暞	bjgm
暟	betv
暠	bdoo
暡	bvgj
暢	bibs
暣	bkzx
暤	bgyx
暦	jmmb
暩	bxfm
暪	bhnd
暫	ccjb
暬	lvlb
暭	bgxx
暯	bhby
暰	bsvl
暲	bdbx
暳	bffe
暵	bhov
暶	bdhl
暷	btbd
暺	boox
暻	bbdm
暼	vnmb
暽	bxdi
暿	bloo
曀	blnv
曁	gtct
曂	bhdv
曃	besz
曄	bhtf
曅	bhtf
曆	jhhb
曇	bufg
曈	bdbl
曉	bllw
曊	bzsv
曋	bcbx
曍	bjgx
曏	bwjp
曐	bbbl
曑	bbbs
曒	bgda
曓	buex
曔	bhsa
曕	brji
曖	bjna
曗	bwtm
曘	bujn
曚	bhnx
曞	bjhg
曟	bbbk
曠	bjhv
曡	bbbf
曢	bnym
曤	buti
曥	byqq
曧	btoq
曨	bdde
曪	bqwi
曫	wmib
曬	btnu
曭	bwnh
曮	booa
曯	bpsq
曵	bxd
曶	ssb
書	elb
曻	bdci
曽	vqb
朁	cwcb
朂	gpj
會	vtqb
朄	bitm
朅	lgbl
朆	vqbs
朇	vtqx
朌	dvd
朎	dvjd
朏	due
朑	dhl
朒	dnvv
朓	dvwv
朖	ddek
朘	dgva
朙	qvnd
朚	dlbd
朜	ddoz
朞	hevd
朠	dhny
朡	dxua
朢	gde
朣	ddbl
朥	dxxj
朧	ddde
朩	mii
朮	xwd
朰	mz
朲	mv
朳	mv
朶	zjm
朷	md
朸	mj
朹	mx
朻	mli
朼	mt
朾	mt
朿	tnm
杁	mjn
杄	mjx
杅	mf
杇	mfs
杊	mm
杋	mwd
杍	mz
杒	mdd
杔	mjt
杕	my
杘	pm
杙	mv
杚	mlz
杛	mzs
杝	mc
杢	mi
杣	me
杤	mth
杦	mrn
杫	ml
杬	mfw
杮	mtni
東	tbm
杴	mrv
杶	mtul
杸	mwa
杹	mtt
杺	mu
杻	mjxt
杽	mjf
枀	vgm
枂	md
枃	msv
枅	mth
枆	mjfl
枈	um
枊	mcp
枌	mvd
枍	mvts
枎	mfv
枏	mnf
枑	mtlt
枔	mvj
枖	mjy
枙	mjc
枛	mj
枟	mfg
枠	mxx
枡	mjh
枤	myd
枦	mdp
枩	mvg
枮	myo
枱	mgo
枲	gom
枴	mod
枹	mse
枺	mtm
枻	mhl
枼	hlm
枽	xhm
枾	mxh
枿	mxh
柀	mja
柂	mlc
柅	mpt
柆	md
柇	mh
柈	mvx
柉	mjdz
柊	madd
柋	tvm
柌	mjto
柍	mny
柎	mtxd
柕	mdtj
柖	mdo
柗	mvo
柛	mbi
柟	mnl
柡	mfs
柣	mkv
柤	mqf
柦	mbt
柧	mjjn
柨	mxni
柪	mwj
柫	mzsn
柭	mxad
柮	mue
柲	muj
柵	mnh
柶	mq
柷	mow
柸	mjyt
柺	moj
査	mqf
柼	mnv
柾	mtl
栁	mdp
栂	mqs
栃	mjjh
栄	wnm
栆	toid
栍	mjl
栐	mdjx
栒	msb
栔	fdm
栕	mg
栙	maci
栚	mvy
栛	mjjj
栜	mtnm
栞	ffm
栟	mvh
栠	tjlm
栢	mjb
栣	mtjl
栤	mvs
栥	vrvm
栦	myyy
栧	mbx
栨	mvrv
栫	mxiz
栬	mrdl
栭	mjnn
栮	mp
栯	mxd
栰	mtx
栱	mhv
栴	mlnd
栵	mtdn
栶	mqy
栺	mtb
栻	mtiv
栿	mtyd
桇	rom
桋	mtzv
桍	myfs
桏	mip
桒	xhm
桖	mjq
桗	mzjm
桘	mjpz
桙	mgki
桚	msd
桛	mltd
桜	mwr
桝	mdci
桞	mdp
桟	mex
桪	mexd
桬	smjm
桭	mjfk
桮	mjyo
桯	moe
桰	mcto
桱	mtsi
桲	mxnz
桳	mgyx
桵	mjr
桸	mxxi
桹	mdek
桻	maf
桼	mvs
桽	mvvl
桾	mejo
桿	mbf
梀	mtom
梄	mu
梇	meh
梈	mdoj
梉	mkl
梊	fjjm
梋	mod
梌	mvtm
梍	mgt
梎	mgt
梐	mul
梑	mxjx
梒	mvjo
梔	mjjl
梕	mddu
梖	mgv
梘	mgw
梙	mooi
梚	mrow
梛	mdfp
條	tiam
梞	mzlu
梟	gm
梠	moo
梣	mevj
梤	mevd
梥	nvgm
梩	mbl
梪	mtov
梫	mena
梬	mdts
梮	mpjo
梲	mvow
梴	mjlz
梶	mpjl
梷	yoam
梸	mhn
梹	mgv
梺	mmtd
梻	mtzn
梽	mlu
梾	mtx
梿	mcz
棁	mvow
棃	hsjm
棄	dghm
棅	mjtm
棆	mvth
棇	mvgu
棈	mld
棊	hevm
棌	mjm
棎	mnvm
棏	mbtd
棓	mdo
棔	mctb
棖	mk
棗	tnmm
棙	mdpd
棛	mdgd
棜	mdhd
棝	mqxo
棞	mqh
棟	mtbm
棡	mnve
棢	mnvl
棤	mhb
棥	mxxm
棦	mrei
棧	mxx
棨	dpam
棩	mktk
棪	mxx
棫	mtox
棬	mvyc
棭	mdtn
棲	mter
棳	maaa
棴	mdpa
棷	mpa
棸	pam
棽	mmvj
棾	mmnw
棿	mgw
椀	mndc
椃	myw
椄	mdr
椆	mnlo
椈	msx
椉	ddcm
椊	mdvx
椌	mnvi
椏	mtxt
椑	mgjx
椓	mxd
椔	msq
椕	mvdm
椖	mdph
椘	mmdz
椙	mbb
椚	mn
椛	mhtt
検	mvtv
椝	fvnm
椞	mjjm
椡	mtgn
椢	mqed
椣	muv
椥	mlyo
椦	mvyj
椧	mvtp
椨	mjtd
椩	mjev
椫	mvbx
椬	mnqf
椮	mgys
椯	mejn
椱	mlba
椲	mzii
椳	mqtk
椵	mpfa
椶	mxua
椷	mjtx
椸	mdhc
椺	mtom
椻	mcbr
椼	mssi
椾	mvdn
楀	mjog
楁	mnao
楃	mptl
楄	mdph
楅	mtoq
楆	mcr
楇	mqo
楈	mjld
楉	mhxo
楌	mdjs
楍	mooo
楎	mnc
楏	myll
楐	mqvn
楑	mxty
楒	mqu
楓	mwjq
楕	mxid
楖	megp
楘	dtjm
楙	mdtm
楜	mxod
楟	mdot
楡	mvtk
楢	mvu
楤	mssu
楥	mjfa
楧	mhny
楨	mygv
楩	mttx
楪	mhlm
楬	mbsl
業	wtvm
楯	mjjg
楰	mgv
楲	mjtx
楳	mhfm
楴	mdni
極	mjot
楶	vrvm
楺	mdtm
楻	mge
楽	vgvm
楾	mgs
楿	mhb
榁	mntl
榃	mmq
榅	mbq
榊	mjyi
榋	meee
榌	mzvv
榎	mjga
榏	mvvq
榐	mphk
榑	mtdd
榒	mzsv
榓	mujq
榖	lnta
榗	mtwb
榙	mhvo
榚	mveh
榝	mxma
榞	mjgm
榟	mndx
榠	mnbv
榡	mlwm
榢	mnx
榤	mdcm
榥	mbww
榦	xbxm
榩	mydx
榪	msh
榬	mlok
榮	xxnm
榯	mbld
榰	mytb
榲	mqvq
榳	mjjz
榵	mhp
榶	mjeo
榸	mlbl
榹	mjjw
榺	dvym
榼	mlgq
榽	mjwy
榾	mqd
榿	metv
槀	donm
槂	mzjm
槄	mjg
槅	mtoy
槆	mhsb
槇	mtgv
槈	mjfd
槉	mjly
構	mfnl
槍	mvdo
槏	mvem
槑	omom
槒	mdwq
槓	migv
槕	mybm
槖	lncm
槗	mxoo
様	mves
槙	mxqv
槚	mcb
槜	mtij
槝	mge
槞	mdbl
槡	maam
槢	mjjg
槣	mnyo
槤	mcz
槥	mffe
槦	mjei
槧	ccjm
槨	mdop
槩	gtcm
槪	mgtw
槫	mtbd
槬	myfn
槮	mggs
槯	meti
槰	mafz
槱	muh
槳	kdxm
槴	mdpl
槵	moou
槶	mqtx
槷	lvlm
槸	mlvd
槹	mgxx
槺	mjes
槻	mfvw
槼	fvgm
槾	mbqa
樀	mdno
樁	mevg
樂	wgwm
樃	mded
樄	mptm
樅	msvl
樆	mdxg
樇	mtid
樈	mdbw
樌	mqxv
樍	mlgv
樎	mntb
樏	mqwm
樐	myqd
樑	msdm
樒	mnue
樓	motr
樔	msbm
樕	mtov
標	mcfm
樚	mjzu
樛	mjjs
樜	mjhh
樝	myqf
樞	mcoo
樠	mhnd
樢	mgh
樣	mvex
樤	mtim
樥	mhaf
樦	mkde
樧	mxma
権	mlxi
樫	mgal
樬	mjqu
樭	mhel
樮	mcx
樰	mue
樲	mtfv
樳	meid
樴	mdbx
樶	mbpa
樷	mmpa
樸	mwtv
樹	mlod
樺	mhtf
樻	mqgv
樼	mpzz
樿	moox
橀	mdgq
橁	mksb
橂	mvuy
橃	mxza
橅	mlhh
橆	lhmm
橈	mllw
橉	mxdi
橋	mjyo
橌	mnd
橍	mne
橎	mjxq
橏	mvfo
橑	myvm
橒	mufg
橓	mjni
橔	mdoa
橕	mwnj
橖	mwnm
橗	mhbd
橚	meik
橜	jvum
橝	mcbx
橞	mtbu
機	mwwx
橠	mddk
橢	mpxd
橤	uuum
橦	mdbl
橧	mvqb
橨	mxhv
橩	mxxx
橪	mdyh
橫	mhtv
橬	mcwb
橭	mxox
橮	mgdv
橯	mxxj
橰	mjgx
橲	mloo
橳	mdvj
橴	mltm
橵	mhda
橶	mxbx
橷	mkgw
橸	mbbb
橺	mnb
橻	mjxt
橽	mlvz
橿	mtqt
檁	mdqh
檂	mujk
檃	pjim
檅	mljx
檆	mxxo
檇	mtim
檈	mqtk
檉	mpoe
檊	mxbf
檋	mhvc
檍	mdbu
檏	mwtm
檒	mmwq
檓	mgea
檔	mwnq
檕	cuwm
檖	mvxz
檘	mpox
檙	mgkk
檚	mmml
檛	mqoz
檜	mvtb
檝	mopx
檞	mrdi
檟	mcgv
檢	mvtv
檣	mxvo
檤	mvjz
檥	mvex
檦	mcfn
檧	mhsu
檨	mvev
檪	mvgm
檭	mvek
檮	mljd
檯	mlol
檰	mwmi
檱	mkhv
檲	mqtd
檳	mntv
檴	mhta
檵	mwwl
檶	myco
檷	mtvx
檸	mnut
檹	mdho
檺	mdox
檻	mgkq
檼	mjiu
檽	mujn
檾	xxnm
檿	jbdm
櫀	mhem
櫁	mnuq
櫃	mcqv
櫄	mjth
櫅	mddh
櫆	mgwx
櫇	mjav
櫈	mxtw
櫉	mjld
櫊	mnao
櫋	mjgh
櫍	mjjv
櫎	mjhv
櫏	mcyz
櫐	qqqm
櫑	mqqq
櫒	mhxm
櫓	mrhb
櫔	mjhg
櫕	mfvv
櫖	myqu
櫗	mhqx
櫘	mffu
櫙	mhco
櫚	mnoo
櫛	mkep
櫜	toim
櫝	mlqv
櫞	mwmx
櫟	mwgm
櫠	mjxa
櫡	mkyb
櫢	mota
櫣	mhcz
櫤	mkvn
櫥	mjld
櫦	mjza
櫧	miyb
櫨	myqq
櫩	mnrg
櫪	mjhl
櫫	xybm
櫬	mdmw
櫭	megt
櫮	meoo
櫯	mrhh
櫰	mdqk
櫱	ujjm
櫲	mdtx
櫳	mdde
櫴	mtov
櫵	mhth
櫶	mnfu
櫸	mjkf
櫹	mhek
櫺	muoo
櫻	mgvr
櫼	mvvx
櫽	mjim
櫾	mjlm
櫿	mxxo
欀	mdok
欁	mujm
欂	mhsd
欃	mrod
欄	mntm
欅	mjkf
欆	mtia
欇	mppp
欈	meto
欉	mwta
權	mhoi
欋	mggi
欌	mhkx
欍	mhtg
欎	mxxd
欏	mqwi
欐	mtnu
欑	mjlv
欒	wmim
欓	mwnh
欔	mgga
欕	mooa
欖	mgkw
欗	mhnm
欘	mpsq
欙	mqqm
欚	mljq
欛	muhd
欜	mtok
欝	mxxd
欞	muov
欟	mhow
欥	brv
欦	vjrv
欨	sorv
欩	dorv
欪	uerv
欬	dyvv
欭	qyrv
欮	vujv
欯	lorv
欰	jqrv
欱	vtov
欳	ynhv
欴	degv
欵	tlyv
欶	tomv
欸	glyv
欻	xxrv
欼	aaav
欽	vvrv
欿	rgrv
歀	mfmv
歁	hevv
歂	ejnv
歄	qorv
歅	clrv
歈	vtdv
歊	donv
歋	jjyv
歍	jztv
歎	hofv
歏	holv
歐	coov
歑	yjvv
歒	dnxv
歓	lxiv
歕	xhgv
歖	lovv
歗	eikv
歘	xxxv
歚	vfvv
歛	vtov
歞	bwwv
歟	jksv
歠	aaav
歡	hoov
歨	ll
歩	lmj
歫	lg
歬	lns
歭	llxd
歮	lll
歯	lxu
歰	dddl
歱	ljtl
歲	ljtx
歳	ljtx
歴	jmml
歵	llgv
歶	ltbg
歷	jhhl
歸	jpzi
歺	yd
歽	tdjt
歾	tdss
歿	tdha
殀	tdjy
殅	tdjl
殈	tdjq
殌	tdti
殎	tdtv
殏	tdxd
殐	tdtm
殑	tdxw
殔	tdes
殕	tddo
殗	tdyl
殘	tdxx
殙	tdcb
殜	tdhm
殝	tdeh
殞	tdov
殟	tdbq
殠	tdjd
殢	tdhi
殣	tdhl
殤	tdls
殥	tdnv
殦	tdgh
殧	tddd
殨	tdqv
殩	tdyx
殫	tdox
殭	tdtt
殮	tdvv
殯	tdnv
殰	tdlv
殱	tdlx
殲	tdvx
殶	dewa
殸	ldja
殹	clya
殺	xmwa
殻	lnwa
殼	lnta
殽	xxda
殾	ybwa
毀	glwa
毃	dona
毄	cowa
毇	gxwa
毈	cypa
毉	clyv
毊	ldjo
毌	qx
毎	lqx
毐	lqx
毑	qsc
毘	qu
毜	jflm
毝	jfls
毞	ujfl
毟	mjjl
毠	jojl
毢	jflc
毣	jjjl
毤	vgwl
毥	jflb
毦	pjfl
毧	jflx
毨	jflw
毩	jflx
毭	tovl
毮	fmjl
毰	jflo
毱	jflx
毲	aaal
毴	jfle
毶	jfls
毷	bgjl
毸	jflu
毺	jfln
毻	xidl
毼	bsvl
毾	bjjl
毿	gggl
氀	otol
氁	jfly
氂	fmal
氃	dbll
氄	dtjl
氈	dqol
氉	oool
氊	jflt
氋	hnfl
氌	jflb
氎	qqql
氒	ctvx
気	kzx
氜	kzb
氝	kznv
氞	kztv
氠	kzbi
氣	kzx
氥	kzc
氫	kzti
氬	kztt
氭	kztm
氱	kzbs
氳	kzqq
氶	jx
氷	ds
氺	sii
氻	sj
氼	sv
氾	sc
氿	sx
汃	sv
汄	sv
汅	sts
汈	sjt
汋	ssd
汌	sm
汎	swd
汏	sy
汑	sjt
汒	sdl
汓	sz
汖	es
汘	sjx
汙	sf
汚	stts
汢	sl
汣	srn
汥	sxa
汦	sctv
汧	sth
汫	sfn
汬	fns
汭	snv
汮	ssv
汯	sxg
汱	syd
汳	sjja
汵	svj
汷	sa
汸	sdh
決	szv
汻	slx
汼	ski
汿	sdt
沀	sdt
沄	sfg
沇	sgw
沋	sxld
沎	stt
沑	sjxt
沒	sha
沕	sss
沖	soi
沗	tys
沚	sl
沜	sk
沝	ss
沞	stni
沠	sj
沨	swx
沯	sc
沰	sc
沴	svs
沵	srm
沶	sfm
沷	sxad
沺	sq
泀	sjto
況	sow
泂	sno
泃	sso
泆	skv
泇	sjo
泈	sadd
泋	sxh
泍	smt
泎	slk
泏	sue
泑	swj
泒	sjjn
泘	sjvi
泙	stvi
泚	slt
泝	sjjd
泟	stl
泤	sldv
泦	spx
泧	scx
泩	sjl
泬	snv
泭	stxd
泴	sq
泹	sbt
泿	sek
洀	sns
洂	sdm
洃	sxx
洅	stnl
洆	sjxt
洈	srjc
洉	sjjo
洊	sxiz
洍	sg
洏	sjnn
洐	ssfi
洑	styd
洓	stnm
洔	slxd
洕	svd
洖	soty
洘	sys
洜	aos
洝	snr
洟	stzv
洠	sgki
洡	sem
洢	stej
洣	sx
洤	sve
洦	sjb
洨	sdvx
洩	sbx
洬	swtd
洭	sce
洯	fds
洰	sg
洴	svh
洶	ssxu
洷	stgl
洺	sdo
洿	syfs
浀	su
浂	svy
浄	srei
浉	snti
浌	stx
浐	sdj
浕	spnd
浖	sjxd
浗	sxxd
浘	spjl
浛	svjo
浝	sxld
浟	stia
浡	sxnz
浢	stov
浤	snxg
浧	soe
浨	snm
浫	snvf
浭	stbx
浰	shn
浱	sjfk
浲	saf
浳	svd
浵	snds
浶	snki
浺	syoi
浻	snvo
浽	sjr
浾	slm
浿	sgv
涀	sgw
涁	sms
涃	sqm
涄	sdts
涆	sbf
涇	stsi
涋	snyd
涍	syz
涏	sjlz
涐	sjfx
涒	sejo
涖	std
涗	svow
涘	sgly
涙	sdpy
涚	svow
涜	slnw
涢	sob
涥	sdoj
涭	sjna
涰	saaa
涱	sk
涳	snvi
涴	sndc
涷	stbm
涹	shr
涺	spxo
涻	svfo
涼	sdom
涽	sctb
涾	ssb
淁	sdr
淂	sbtd
淃	svyc
淈	spue
淉	sbm
淊	srg
淍	snlo
淎	sevf
淏	sbty
淐	sbb
淒	ster
淓	shdh
淔	sxqe
淕	slvl
淗	ssx
淚	sdpd
淛	sknn
淜	sdd
淟	suv
淢	stox
淣	sgw
淥	sljs
淧	snuj
淨	sjei
淩	slva
淪	svth
淭	sdpm
淯	sdgd
淲	syw
淴	sssu
淵	sktk
淸	slnl
淺	sxx
淽	shl
淾	vs
淿	sgni
渀	syxh
渁	sss
渂	sbdx
渃	shxo
渆	svhn
渇	sbst
済	sdxh
渉	slmj
渋	slx
渏	syto
渒	sgjx
渓	sjfv
渕	svyn
渘	sdtm
渙	srny
減	sjtx
渜	sjny
渞	svjg
渟	sdot
渢	swjq
渦	sqo
渨	sqtk
渪	sjog
測	sgvn
渮	shto
渰	svth
渱	sqi
渳	szsp
渵	shq
渶	shny
渷	sdvw
渹	ssi
渻	smjg
渼	svey
渽	slox
渾	snc
渿	smfm
湀	sxty
湁	sfvo
湂	soos
湅	stqm
湆	sdb
湇	sdd
湈	shfm
湊	sevy
湋	szii
湌	svdk
湏	sjgv
湐	smg
湑	sjld
湒	sop
湕	sefz
湗	slld
湙	sdmy
湚	sjwl
湜	sbtl
湝	sug
湞	sygv
湠	sexx
湡	sbng
湢	stoq
湤	sdhc
湥	snvd
湦	sbjl
湨	sgyd
湪	sljx
湬	hxs
湭	svu
湰	satl
湱	sfc
湵	sven
湶	sgs
湷	sevb
湸	sdow
湹	sjbl
湺	stom
湻	sdob
湼	sgi
溁	shnm
溂	ston
溄	seaf
溇	sxr
溈	sdjh
溊	spfa
溋	szjq
溍	stwb
溎	smll
溑	swgv
溒	slok
溓	svem
溔	sveh
溕	snfx
準	stix
溗	sjxv
溙	sevs
溛	snvn
溝	sfnl
溞	sadq
溠	svfi
溡	sbld
溣	stvh
溤	ssh
溨	slmx
溩	sjzh
溫	sqvq
溬	svfg
溭	sqva
溮	sjpi
溰	setv
溳	sogv
溵	sjja
溸	slwm
溹	sxnm
溼	stwl
溾	sgwg
溿	sqvx
滀	sdwq
滃	svgj
滄	svdo
滅	sjtx
滆	stoy
滈	sdoo
滉	sbww
滊	skzx
滌	stim
滎	xxns
滐	sdcm
滖	sdok
滙	scti
滛	sjlu
滜	sgyx
滝	sdbl
滣	sjfo
滧	sdva
滫	stid
滬	sdpl
滭	sbhf
滮	syws
滰	sdbw
滱	snfa
滲	sggs
滳	sdno
滵	snue
滶	slha
滷	syqd
滸	silx
滺	stiu
滻	sdjl
滼	smmd
滽	sjei
滾	sdvk
滿	shnd
漀	ldjs
漁	srh
漃	snla
漄	sejl
漅	ssbm
漇	ssll
漈	sxfm
漊	sotr
漋	spal
漌	shol
漍	sqtx
漎	ssvl
漑	sgtw
漒	szsq
漖	syza
漗	sjqu
漘	sjfd
漙	stbd
漚	scoo
漛	svys
漜	smml
漝	sjjg
漞	sjgw
漟	swnl
漡	slbs
漢	shov
漣	scz
漥	snvl
漦	fmas
漧	sxbz
漨	safz
漬	slgv
漮	sjes
漰	sedd
漲	szsk
漴	senm
漵	svta
漷	sdop
漸	scjt
漹	stlh
漻	sjjs
漼	seti
漽	spsi
漿	kdxs
潁	tsjv
潂	sevt
潃	ssad
潄	stoa
潅	slxi
潈	sjqx
潉	sebu
潊	svta
潌	snvl
潏	sdto
潐	stih
潑	sxza
潓	stbu
潔	sfdm
潕	slhh
潖	seel
潗	stim
潙	sjjh
潚	seik
潛	scwb
潡	sdoa
潣	sndx
潤	sne
潥	scx
潧	svqb
潨	sjqx
潩	sqhv
潪	slyb
潫	svym
潬	soox
潯	seid
潰	sqgv
潱	slnv
潳	spyb
潵	shda
潶	sqh
潷	skef
潹	smmm
潻	shvs
潾	sxdi
潿	sqzi
澀	sddl
澁	slll
澂	seta
澃	sjgs
澅	selt
澆	sllw
澇	sxxj
澊	svud
澋	sbdm
澏	sooe
澐	sufg
澒	sijv
澓	ssla
澔	sgjo
澕	shtf
澖	snm
澗	snb
澘	smmb
澙	sgsh
澚	sjns
澛	srtb
澞	syoy
澟	sdqh
澠	sq
澢	swnq
澥	srdi
澦	sdtv
澨	skiv
澩	jkxs
澪	suvd
澫	shbg
澬	svrv
澭	sdwi
澮	svtb
澯	sydx
澰	svtv
澱	spha
澲	swtm
澵	sdmt
澷	sbqh
澸	sjtu
澺	sdbu
澻	svxz
澼	spox
澽	syx
澾	slvz
澿	smmm
濁	sqsq
濃	sujk
濄	sqoz
濅	snea
濆	sxhv
濇	sxvo
濈	sopx
濊	sljx
濋	smml
濌	jtbb
濍	shsu
濎	sgkk
濏	seej
濐	sbyb
濓	sdjm
濔	stvx
濕	sbwh
濖	sqyb
濗	shbi
濘	snut
濙	sxxx
濚	sxxm
濛	shnx
濝	shem
濟	sddh
濢	sjjx
濣	sxbx
濤	sljd
濥	sdnv
濦	sjiu
濧	swtd
濨	svwu
濪	sldl
濫	sgkq
濭	shlq
濰	swmi
濱	sntv
濲	slna
濳	sjlb
濴	sxxs
濵	sndv
濶	snjo
濷	sshd
濸	shvo
濹	sbll
濺	sgvx
濻	spqv
濼	swgm
濽	sfvv
濾	syqu
濿	sjhg
瀁	svek
瀂	srhb
瀃	sgvs
瀅	sxxd
瀆	slqv
瀇	sjhv
瀈	sjjc
瀉	sngh
瀊	snsq
瀋	snjq
瀌	sjzh
瀍	sjbl
瀎	shqx
瀏	sgdn
瀓	ssea
瀔	slna
瀕	syjv
瀖	suti
瀗	snfu
瀘	syqq
瀙	sdmw
瀜	stoq
瀝	sjhl
瀞	sldi
瀟	shek
瀠	sxnm
瀢	sqgz
瀤	sdqk
瀥	sjjo
瀦	sxyb
瀧	sdde
瀨	stov
瀩	shwv
瀪	lqss
瀫	slna
瀬	stov
瀭	scvn
瀮	summ
瀯	sxxo
瀰	szsx
瀱	sqjn
瀲	svta
瀳	shjh
瀴	sgvr
瀶	sglo
瀷	sjjv
瀸	svvx
瀺	srod
瀻	slqx
瀼	sdok
瀽	snfl
瀾	sntm
瀿	slqm
灀	sumg
灁	sngs
灂	sjqd
灃	sffv
灄	sppp
灅	sqql
灆	shgq
灇	swta
灈	sggi
灉	ssoi
灊	scwy
灋	sjzg
灍	snvv
灎	sutq
灐	sxxv
灑	stnu
灒	sjlv
灓	wmis
灔	sutl
灕	sdxi
灖	sjme
灗	sqdt
灘	shoi
灙	swnh
灚	sjkw
灛	snox
灜	sdld
灝	sbdv
灟	spsq
灠	sgkw
灡	shnm
灢	stok
灣	swms
灤	swmm
灥	gsgs
灦	sbwv
灧	sffl
灨	sdbv
灩	sffq
灪	smls
灮	xw
灱	xd
灲	xn
灳	sx
灴	xi
灷	xh
灹	xjt
灺	xc
灻	lx
災	sx
炁	cwh
炂	xvg
炃	vdx
炄	xjxt
炇	xa
炈	xwa
炋	xjy
炌	xvn
炍	xjja
炏	xx
炐	xf
炑	xm
炓	xddx
炗	hx
炘	xjjt
炚	bx
炛	xtt
炞	xdy
炟	xbt
炠	xq
炡	xtl
炢	xmd
炣	xto
炥	xzsn
炦	xxad
炧	xlc
炨	xnt
炩	xvjd
炪	xue
炰	seh
炲	xgo
炴	xny
炵	xadd
炶	xyo
為	djjh
炾	xow
炿	xnd
烄	xdvx
烅	xjq
烆	xsfi
烇	xve
烉	rnvx
烋	tmh
烌	xtm
烍	xjlw
烎	thx
烏	jzth
烐	xns
烑	xvwv
烒	xtiv
烓	xll
烔	xnto
烕	jtxx
烖	lxx
烗	xdyv
烚	xvto
烝	jxth
烞	xmy
烠	xxd
烡	xhv
烢	xnjt
烣	xxx
烥	xg
烪	xvy
烮	tdnx
烰	xjz
烱	xnvo
烲	fjjx
烳	xtdd
烴	xtsi
烵	xhsd
烶	xjlz
烸	xlqs
烺	xdek
烻	xjlz
烼	xx
烾	xxl
烿	xnds
焀	xvvo
焁	orvx
焂	tiax
焃	xlm
焄	ejoh
焅	xjlo
焆	xod
焇	xwd
焈	dpex
焋	klx
焌	xgva
焍	xvzj
焎	fjjh
焏	joah
焑	xqm
焒	xoo
焔	xhib
焛	nnx
焝	xctb
焞	xdoz
焟	xhb
焠	xdvx
無	lhh
焢	xnvi
焣	pah
焤	jtxx
焥	xndc
焧	xvgu
焨	xbd
焩	xdd
焪	xnvs
焫	xhnv
焬	xbss
焭	xxnw
焮	xjjv
焲	xdtn
焳	xti
焴	xdgd
焵	xnve
焷	xgjx
焸	bbx
焹	xnvl
焺	xbjh
焻	xbb
焼	xxhw
焽	bdx
焾	xvju
焿	xjev
煀	xpue
煁	xhel
煂	xhp
煃	xyll
煄	xjtl
煇	xnc
煈	xwjq
煉	xtqm
煋	xbjl
煍	xhx
煏	xtoq
煐	xhny
煑	ybx
煒	xzii
煓	xejn
煔	xxyo
煗	xjny
煘	xjtx
煙	xcl
煚	bgx
煛	ggx
煝	xdjg
煟	xqd
煠	xhlm
煡	xefz
煢	xxnx
煣	xdtm
煥	xrny
煩	xjgv
煪	xvu
煫	xvx
煭	stdh
煯	xug
煰	xooo
煱	xqo
煴	xbq
煶	xbtl
煷	xdow
煹	xfnl
煻	xjeo
煼	xsuj
煾	xqyu
煿	xtdd
熀	xbww
熁	xjjd
熂	xkzx
熃	dtjx
熅	xqvq
熆	xlgq
熇	xdoo
熈	jgeh
熉	xogv
熋	gdtx
熌	xnv
熍	xnoo
熎	xjlu
熐	xnbv
熑	xvem
熒	xxnx
熓	xjzh
熕	xigv
熖	xjg
熗	xvdo
熚	xbhf
熛	xcfm
熜	xjqu
熝	xjzu
熞	xgal
熡	xotr
熢	xafz
熣	xeti
熤	xjjd
熦	xmji
熧	svvx
熩	xdpl
熪	xhdd
熫	xjhh
熭	ffex
熮	xjjs
熯	xhov
熰	xcoo
熱	lvlh
熲	txjv
熴	xebu
熶	xbpa
熸	xcwb
熺	xloo
熻	xvtj
熼	xqhv
熽	xeik
熾	xdbx
熿	xhdv
燀	xoox
燁	xhtf
燅	lvlx
燆	xjyo
燇	xvud
燈	xxtv
燉	xdoa
燊	xxxm
燋	xtih
燌	xxhv
燍	xhet
燏	xdto
燑	xdbl
燒	xllw
燓	mxxx
燖	xeid
燗	xnd
燘	xndx
燛	ggx
燜	xnu
燝	xbdm
燞	tirh
營	xxno
燢	jkxx
燣	xdqh
燤	xhbg
燦	xydx
燨	xvex
燩	xgda
燪	xhsu
燫	xjvm
燬	xgia
燭	xqsq
燯	xuvd
燰	xjna
燱	xdbu
燲	xjjv
燳	xbdh
燴	xvtb
燵	xlvz
燶	xujk
燷	xdqm
燺	xdom
燻	xjth
燽	xljd
燾	ljih
爀	xlmm
爁	xgkq
爂	jknx
爃	xxxm
爄	xjhg
爅	xqhl
爇	hlvh
爈	xyqu
爉	xsqv
爊	xjzh
爋	xjth
爌	xjhv
爍	xwgm
爎	xnym
爏	xjhl
爐	xyqq
爑	xhth
爒	dxym
爓	xnrg
爔	xvex
爕	xixx
爖	xdde
爗	xbhf
爘	xydk
爙	xdok
爚	xvth
爛	xntm
爜	xwta
爞	xqqq
爟	xhoi
爠	xggi
爡	xhbq
爢	jmmh
爣	xwnh
爤	xhnm
爥	xpsq
爦	xgkw
爧	xuov
爩	xmls
爫	jii
爭	jei
爮	jse
爯	jnl
爲	jjjh
爳	jjjj
爴	qtoj
爺	vxpp
爼	xxqf
爾	tvnx
牀	km
牂	kvf
牃	khlm
牄	kvdo
牅	kjei
牆	kxvo
牉	kvx
牊	kdo
牋	kxx
牎	kssu
牏	kvtn
牐	kjxg
牑	kdph
牓	kdnh
牔	ktdd
牕	kjqu
牘	klqv
牚	wnoj
牜	jf
牞	jfj
牣	jfdd
牤	jfdl
牥	jfdh
牨	jfdw
牪	jfki
牫	jfx
牭	jfq
牰	jfd
牱	jfto
牳	jfqs
牶	vyki
牷	jfve
牸	jfnz
牻	jfxd
牼	jfti
牽	dyni
犂	hsji
犃	jfdo
犅	jfne
犆	jfxe
犈	jfvc
犉	jfdz
犌	jfpa
犎	llxi
犐	jfhx
犑	jfgd
犓	jfsj
犔	jfkx
犖	xxni
犗	jfno
犘	jmmi
犙	jfgs
犚	pfmi
犛	fmai
犜	jfda
犝	jfdl
犞	jfjo
犠	jfvx
犡	jfjg
犢	jflv
犣	jfsv
犤	jfqt
犥	jfjh
犦	jfbs
犧	jfvx
犨	titi
犩	hrgi
犪	jfva
犫	tiii
犮	xad
犱	xjxd
犲	xjxj
犳	xjsd
犵	xjlz
犺	xjdw
犻	xjti
犼	xjzl
犾	xjyd
犿	xjdy
狀	kyd
狅	xjjl
狆	xjoi
狇	xjm
狉	xjjt
狊	gyd
狋	xjfm
狌	xjjl
狏	xjlc
狑	xjvd
狓	xjja
狔	xjpt
狕	xjwj
狖	xjnv
狘	xjcx
狚	xjbt
狛	xjg
狜	xjxo
狝	xjrm
狟	xjtt
狢	xjao
狣	xjvv
狤	xjlo
狥	xjsb
狦	xjnn
狧	xjjo
狪	xjno
狫	xjyt
狵	xjxd
狶	xjxi
狹	xjtv
狽	xjgv
狾	xjft
狿	xjjz
猀	xjsj
猂	xjbf
猃	xjvw
猇	xjyw
猈	xjgx
猉	xjhv
猋	ydyd
猏	xjdd
猐	xjvl
猑	xjbu
猒	bdyd
猔	xjnm
猘	xjkn
猙	xjji
猚	xjti
猟	xjwf
猠	xjuv
猣	xjxa
猤	xjxy
猦	xjwq
猧	xjqo
猨	xjja
猭	xjlx
猯	xjen
猰	xjfy
猲	xjbl
猳	xjpa
猵	xjdh
猶	xjvu
猻	xjzm
猼	xjtd
猽	xjnv
獀	xjga
獁	xjsh
獂	xjjm
獃	etod
獄	xjid
獅	xjji
獆	xjgx
獇	xjvg
獈	xjvq
獉	xjeh
獊	xjvo
獋	xjjx
獌	xjba
獎	kdxd
獏	xjhy
獑	xjct
獓	xjla
獔	xjgx
獕	xjei
獖	xjxv
獘	vnmd
獙	xjva
獚	xjhv
獛	xjwv
獜	xjxi
獝	xjdo
獞	xjdl
獟	xjlw
獡	xjgh
獢	xjjo
獣	wqtd
獤	xjda
獥	xjga
獦	xjhl
獧	xjqk
獨	xjqq
獩	xjlx
獪	xjvb
獫	xjvv
獮	xjtx
獰	xjnt
獱	xjnv
獲	xjha
獳	xjun
獴	xjhx
獵	xjsv
獶	xjja
獷	xjjv
獸	ooqd
獹	xjyq
獺	xjtv
獻	ytod
獼	xjzx
獽	xjdk
玀	xjqi
玁	xjoa
玂	xjht
玃	xjga
玅	dwmj
玈	dwlk
玊	ed
玌	el
玍	ll
玏	ej
玐	ev
玒	ei
玓	esd
玔	em
玕	ef
玗	ef
玙	es
玚	ezs
玜	evg
玝	elx
玞	efv
玠	evn
玣	edy
玤	ef
玦	ezv
玧	egw
玪	evj
玬	end
玭	eu
玱	evc
玴	ehl
玵	ehf
玶	etvi
玸	ese
玹	edw
玼	elt
玽	eso
玾	eq
玿	edo
珁	etld
珃	enl
珄	ejl
珅	ebi
珆	ego
珇	eqf
珋	ecjp
珌	euj
珎	erm
珒	eef
珓	edvx
珔	exiz
珕	ejjj
珖	eww
珗	ejlw
珘	ens
珚	eqy
珛	exd
珜	evf
珝	ejj
珟	ewtd
珡	eev
珢	eek
珣	esb
珤	elxu
珦	ejno
珨	evto
珫	edgw
珬	ejtx
珯	eyt
珰	ewe
珱	ewr
珳	edxs
珴	ejfx
珵	eoe
珶	evzj
珷	eflv
珸	ewo
珹	ejjx
珺	eejo
珻	elqs
珼	egv
珽	ejlz
現	egw
珿	eol
琀	evjo
琁	eljl
琂	ei
琄	eod
琇	ehzj
琈	ejz
琋	exxi
琌	eevj
琎	efnz
琑	ewd
琒	eaf
琓	enfw
琔	entl
琕	egjx
琖	exx
琗	edvx
琘	ectb
琙	etox
琝	ebdx
琞	bded
琟	eti
琠	euv
琡	elma
琣	edo
琤	erei
琧	txtd
琩	ebb
琫	eevf
琭	ees
琱	enlo
琷	evfl
琸	eybx
琹	eem
琺	eslg
琻	ev
琽	eyb
琾	eqvn
琿	enc
瑀	ejog
瑂	edjg
瑃	eevb
瑄	entt
瑅	ebtl
瑆	ebjl
瑇	elqs
瑈	edtm
瑉	eptb
瑊	ejtx
瑋	ezii
瑌	ejny
瑍	erny
瑎	eug
瑏	envj
瑐	evdn
瑑	eljx
瑓	etqm
瑔	egs
瑖	ejia
瑘	epp
瑝	ege
瑠	egdq
瑡	ejpi
瑢	envo
瑣	ewgv
瑤	edlu
瑥	ebq
瑦	ejzh
瑧	eevh
瑩	xxnd
瑪	esh
瑫	ejg
瑬	sdgd
瑮	ecm
瑲	evdo
瑳	evfi
瑴	lnta
瑵	eadq
瑸	engv
瑹	ehvm
瑺	ewni
瑻	eqxv
瑼	etbd
瑽	esvl
瑿	clyd
璂	ehel
璄	edbw
璅	esbm
璆	ejjs
璈	elha
璉	ecz
璊	ehnd
璌	entv
璍	ehtf
璏	eljt
璑	elhh
璒	extv
璓	ehhj
璔	evqb
璕	eeid
璖	esgm
璙	eyvm
璚	edto
璛	eeik
璝	eqgv
璠	ejxq
璡	etiz
璣	ewwx
璤	etbu
璥	ehsa
璦	ejna
璪	eoom
璫	ewnq
璬	egda
璭	encz
璮	edqt
璯	evtb
環	eqtk
璱	eeej
璲	evxz
璳	ekmv
璴	emml
璵	ejkv
璷	etda
璸	entv
璹	eljd
璻	ejjx
璼	egkq
璽	tvnd
璾	eddh
瓀	eujn
瓁	ehta
瓂	ehlq
瓃	eqqq
瓄	elqv
瓅	ewgm
瓆	ejjv
瓈	ehss
瓉	efvv
瓊	erna
瓋	ednz
瓌	edqk
瓍	epxz
瓎	etov
瓏	edde
瓐	eyqq
瓑	ejhl
瓓	entm
瓔	egvr
瓕	zstd
瓗	eeto
瓘	ehoi
瓙	eljh
瓚	ejlv
瓛	eytd
瓝	jjgd
瓟	jjge
瓥	jjgq
瓧	tlzx
瓨	itld
瓩	tlzx
瓪	tlza
瓫	vdtd
瓬	dhtd
瓭	pltd
瓰	tlzd
瓱	tlzl
瓲	tlzl
瓳	xotd
瓵	gotd
瓸	tlzb
瓹	odtd
瓺	ktld
瓻	xxnd
瓼	tlzl
瓽	wnod
瓾	hrtd
甁	jfjd
甃	hxtd
甅	tlzl
甆	vwwd
甇	xxnd
甈	jgmd
甉	vemd
甊	otod
甋	dnxd
甌	cood
甎	tbgd
甐	xdcd
甒	lhhd
甔	rjvd
甕	dwjd
甖	gvgd
甗	ytod
甛	hfjo
甝	ywhf
甞	wnof
甠	bjl
甡	jljl
產	dxjl
産	djjl
甤	xjl
甦	tbxl
甧	jljd
甶	jq
甹	dts
甼	qt
甿	qdl
畁	dtn
畂	qrn
畃	bisd
畄	wq
畆	dqg
畇	qsv
畉	qfv
畊	qfn
畍	qvn
畐	toq
畑	xq
畒	dqv
畓	sq
畕	qq
畖	qjjn
畗	doq
畘	qnl
畝	dqrn
畞	xqrn
畟	qva
畠	gq
畡	qdyv
畢	bhf
畣	vtoq
畤	qlxd
畧	qao
畨	xq
畩	qdk
畫	elqt
畬	vtmq
畭	qvtm
畮	qlqs
畯	qgva
異	qhv
畳	qnqf
畵	elqu
當	wnoq
畷	qaaa
畺	tqtt
畻	qvyl
畽	qjtl
畾	qqq
疀	sqtl
疁	qjjs
疂	qxnf
疄	qxdi
疅	qtqt
疇	qljd
疈	toqq
疉	qqqt
疊	qqqf
疌	tel
疍	jlbt
疎	jltm
疐	xnql
疒	jii
疓	jzj
疕	jt
疘	ji
疛	jxd
疜	jtd
疞	jfs
疦	jzv
疧	jctv
疨	jcij
疩	jxx
疪	ju
疭	jvv
疶	jhl
疷	jctd
疺	jjdz
疻	jov
疿	jzsn
痀	jso
痁	jyo
痆	jpt
痋	jq
痌	jnto
痎	jdyv
痏	jxd
痐	jqo
痑	jdd
痓	jtgl
痗	jlqs
痙	jtsi
痚	jyz
痜	jhw
痝	jxld
痟	jwd
痠	jgva
痡	jtdd
痥	jvow
痩	jbia
痬	jbss
痭	jdd
痮	jk
痯	jnpz
痵	jhz
痶	juv
痷	jybl
痸	jknn
痺	jgjx
痻	jctb
痽	jti
痾	jpto
瘂	jtxt
瘄	jhb
瘆	jgys
瘇	jjtl
瘋	jwjq
瘎	jhel
瘏	jyb
瘑	jqo
瘒	jnc
瘓	jrny
瘔	jhxo
瘚	jvuv
瘜	jjgu
瘞	jtvl
瘡	jvdo
瘣	jgwg
瘧	jyct
瘨	jxqv
瘬	jzsk
瘭	jcfm
瘮	jggs
瘯	jdhy
瘱	jtvu
瘲	jsvl
瘶	jtov
瘷	jtoa
瘹	jvsd
瘺	jpu
瘻	jotr
瘽	jhol
癁	jsla
療	jyvm
癄	jtih
癆	jxxj
癇	jnd
癈	jxza
癉	joox
癊	jpvg
癋	jtxu
癎	jnb
癏	jqtk
癑	jujk
癒	jvtu
癓	jsea
癕	jdwi
癗	juq
癘	jhbg
癙	jglv
癚	jrji
癛	jdqh
癝	jdqm
癟	jjgh
癠	jddh
癡	jtll
癢	jvek
癤	jkep
癥	jsea
癦	jqhl
癧	jjhl
癨	juti
癩	jtov
癬	jrhf
癭	jgvr
癮	jpju
癰	jsoi
癱	jhoi
癲	jxqv
癳	jqqm
癴	jwmf
癵	jwmv
癶	xii
癷	xf
癹	xwa
發	xzsa
癿	gl
皀	gt
皁	gx
皃	gw
皅	gdl
皉	glt
皌	gtm
皍	gtlp
皏	gvh
皐	gxx
皒	gjfx
皔	gbf
皕	jbjb
皗	gnlo
皘	gld
皚	getv
皛	ggg
皜	gdoo
皞	ggyx
皟	glgv
皠	geti
皢	gllw
皣	ghtf
皥	gjgx
皦	ggda
皧	gjna
皨	gggl
皩	gebw
皪	gwgm
皫	gjzh
皬	guti
皭	gjqd
皯	jaf
皰	jase
皳	xxda
皵	hbja
皶	mbta
皷	lova
皸	ncja
皹	janc
皺	suja
皻	yqfa
皼	lnta
皽	dqoa
皾	lqga
盀	yq
盁	zjq
盃	jyq
盄	zsiq
盇	ydq
盉	hq
盋	xadq
盌	dcq
盓	sfq
盕	swdq
盙	tdiq
盚	xxdq
盜	srvq
盝	esq
盞	xxq
盠	ljtq
盢	qydq
監	gkq
盤	nswq
盦	vjuq
盧	yqq
盨	sjgq
盫	vtoq
盬	glxq
盰	gf
盳	gdl
盶	gfw
盷	gsv
盺	gjjt
盻	gvts
盽	gf
盿	gdx
眀	gd
眂	gctv
眃	gfg
眅	gjja
眆	gdh
県	glm
眎	gfm
眏	gny
眐	gtl
眑	gwj
眒	gbi
眓	gcx
眕	gvs
眖	gow
眗	gso
眘	yvg
眛	gfm
眜	gtm
眝	gnt
眞	tglv
眡	gctd
眣	gkv
眤	gpt
眥	ltg
眧	gdo
眪	gtnv
眫	gvx
眮	gnto
眰	gtgl
眱	gtzv
眲	gp
眳	gdo
眴	gsb
眹	gvy
眻	gvf
眽	gjjk
眿	gdjx
睂	vvig
睅	gbf
睆	gnfw
睈	goe
睉	gvvl
睊	god
睋	gjfx
睌	grow
睍	ggw
睎	gxxi
睏	gqm
睒	gxx
睓	guv
睔	gvth
睕	gndc
睖	glva
睗	gbss
睘	qtok
睙	gdpd
睜	gjei
睝	hsjg
睟	gdvx
睠	gvyc
睤	gqtn
睧	gctb
睭	gnlo
睮	gvtn
睯	ptvg
睰	ghxo
睱	gpfa
睲	gbjl
睳	gyll
睴	gnc
睵	glox
睶	gevb
睷	gefz
睸	gdjg
睻	gntt
睼	gbtl
瞁	ggyd
瞂	jjxd
瞃	gjjg
瞈	gvgj
瞉	lnta
瞊	gjeo
瞏	qlok
瞐	ggg
瞔	glgv
瞕	gdbx
瞖	clyg
瞗	ggh
瞘	gcoo
瞙	ghby
瞚	gntv
瞛	gsvl
瞜	gotr
瞝	gdxg
瞞	ghnd
瞡	gfvw
瞣	goou
瞤	gne
瞦	gloo
瞨	gwtv
瞫	gcbx
瞮	gdga
瞯	gnd
瞱	ghtf
瞲	gdto
瞴	glhh
瞶	gqgv
瞷	gnb
瞸	ghhm
瞹	gjna
瞺	gvtb
瞼	gvtv
瞾	ggni
矀	gsea
矁	ghxu
矂	goom
矃	gnut
矄	gjth
矅	gjji
矆	ghta
矇	ghnx
矈	ggnh
矉	gntv
矊	gwmi
矋	gjhg
矌	gjhv
矎	grna
矏	gjgh
矐	guti
矑	gyqq
矒	ghqg
矓	gdde
矔	ghoi
矕	wmig
矖	gtnu
矘	gwnh
矙	gnja
矚	gpsq
矝	dtjd
矞	dtjo
矟	dtjd
矠	dtjb
矡	dtja
矤	zsly
矦	rjly
矨	lyjy
矪	lyns
矯	lyjo
矰	lyvb
矱	lyha
矲	lyqt
矴	ct
矵	cn
矷	cz
矹	ctw
矺	cjt
矻	clz
矼	ci
砃	cnd
砄	czv
砅	cs
砆	cfv
砇	cdx
砈	cjc
砊	cdw
砋	cl
砎	cvn
砏	cvd
砐	cjzn
砓	cwa
砕	cxx
砙	ctld
砛	cvj
砞	ctm
砡	ced
砢	cto
砤	clc
砨	cdpz
砪	cqs
砫	cde
砮	rac
砯	cds
砱	cvjd
砳	cc
砵	cmt
砶	cg
砿	cjg
硁	czi
硂	cve
硃	ckm
硄	cww
硆	cvto
硈	clo
硉	cef
硊	crjc
硋	cdyv
硍	cek
硏	cff
硑	cvh
硓	cyt
硔	chv
硘	cqo
硙	cezl
硚	cjyn
硛	cdm
硜	ctsi
硞	cjlo
硟	cjlz
硠	cdek
硡	cnxg
硢	cvtm
硣	cyz
硥	cxld
硦	ceh
硨	cc
硩	fjjc
硯	cgw
硰	smjc
硱	cqm
硲	cvvo
硳	clm
硴	chtt
硵	cyqx
硶	cevj
硸	cejf
硹	cmvg
硺	cxd
硻	gac
硽	cybl
碀	crei
碂	cnfm
碃	cld
碄	cmm
碅	cqh
碆	sjac
碈	cctb
碊	cxx
碋	ceto
碏	chb
碐	clva
碒	cv
碔	cflv
碕	cyto
碖	cvth
碙	cnve
碝	cjny
碞	oooc
碠	cdot
碢	cqo
碤	chny
碥	cdph
碦	cnao
碨	cqtk
碩	cjgv
碪	chel
碫	cjia
碬	cpfa
碮	cbtl
碯	csjx
碵	cygv
碶	cfdy
碷	cjjg
碸	cwjq
確	cpii
碻	cdoo
碼	csh
碽	cigv
碿	cpwd
磀	cvuz
磂	cgdq
磃	cjjw
磄	cjeo
磆	cqd
磇	cjqu
磈	cgwg
磌	cxqv
磍	cnfo
磎	cjwy
磏	cvem
磑	cetv
磒	cogv
磓	cjpz
磖	cjjg
磗	ctdd
磘	cjlu
磚	ctbd
磛	ccjc
磜	cxfm
磝	clha
磞	cedd
磟	cjjs
磠	cyqd
磡	chej
磣	cggs
磥	cqwm
磦	ccfm
磧	clgv
磩	cjlx
磪	ceti
磫	csvl
磭	cjfd
磮	cevh
磯	cwwx
磰	cvfo
磱	cxxj
磳	cvqb
磵	cnb
磶	cgsh
磸	cvuy
磹	ccbx
磻	cjxq
磼	ctim
磽	cllw
磾	coox
磿	jhhc
礀	cnd
礂	cloo
礃	cwnf
礄	cjyo
礆	cvtv
礇	cjny
礈	cvxz
礉	cgda
礊	cuwc
礌	cuq
礍	chbl
礎	cmml
礏	cwtm
礐	jkxc
礑	cwnq
礒	cvex
礔	cpox
礕	podc
礖	cjkv
礗	cntv
礘	cbwh
礙	ctll
礚	chlq
礛	cgkq
礜	jksc
礝	cujn
礟	cshx
礠	cvwu
礡	chtd
礢	cvek
礣	chqx
礥	cgav
礦	cjhv
礧	cqqq
礨	qqqc
礩	cjjv
礪	cjhg
礫	cwgm
礬	mxxc
礭	cuti
礮	cshx
礯	cxxm
礰	cjhl
礲	cdde
礳	cjmc
礵	cumg
礶	choi
礷	chgq
礸	cjlv
礹	cooa
礽	jyzj
礿	jysd
祂	jyc
祃	jyst
祄	jyvn
祅	jyjy
祊	jydh
祋	jywa
祌	jyoi
祍	jyjl
祎	jyfi
祏	jyc
祑	jykv
祒	jydo
祔	jytd
祕	jyuj
祘	fmfm
祙	jyfm
祡	ltfm
祣	jylk
祤	jyjj
祦	jyoy
祩	jykm
祪	jyrc
祫	jyvo
祬	jytl
祮	jylo
祰	jyjo
祱	jyvw
祲	jyea
祳	jyjk
祴	jytx
祵	jyqm
祶	jyvj
祹	jysu
祻	jyqo
祼	jybm
祽	jydx
祾	jyla
祿	jylx
禂	jyno
禃	jyxe
禆	jygx
禈	jync
禉	jyvu
禋	jycl
禌	jyvw
禍	jyqo
禎	jyyv
禐	jyja
禑	jybg
禒	jylx
禓	jybs
禔	jybl
禕	jyzi
禖	jyhm
禗	jyqu
禘	jydi
禙	jykd
禚	jyvh
禜	xxnm
禝	jyqa
禞	jydo
禟	jyjo
禠	jyjw
禡	jysh
禢	jybj
禣	jytd
禥	jyhl
禨	jywx
禩	jyqv
禪	jyox
禫	jycx
禬	jyvb
禭	jyvz
禮	jyuv
禯	jyuk
禰	jytx
禱	jyld
禲	jyjg
禴	jyvh
禵	jybv
禶	jyjv
禷	jyxv
禸	ng
禼	yqxg
禿	hw
秂	hv
秄	hz
秅	hjt
秇	hxd
秈	he
秊	hjx
秌	xh
秎	hvd
秏	hjfl
秐	hfg
秓	hxa
秔	hdw
秖	hctv
秗	hjy
秙	hxo
秚	hvx
秛	hja
秜	hpt
秝	hh
秞	hd
秠	hjyt
秡	hxad
秢	hvjd
秥	hyo
秨	hlk
秪	hctd
秬	hg
秮	hgo
秱	hnto
秲	hlxd
秳	hjxo
秴	hvto
秵	hqy
秶	vrvh
秷	htgl
秹	htjl
秺	hnjt
秼	hkm
秿	htdd
稁	donh
稄	hgva
稅	hvow
稆	hoo
稇	hqm
稈	hbf
稉	htbx
稊	hvzj
稌	hvtm
稏	htxt
稐	hvth
稑	hlvl
稒	hqxo
稓	hhb
稕	hdoz
稖	hdo
稘	hhev
稙	hxqe
稛	hqh
稜	hlva
稝	hdd
稟	dqoh
稡	hdvx
稢	htox
稤	hdom
稥	hhb
稦	hzii
稧	hfdy
稨	hdph
稩	hqd
稪	hlba
稫	htoq
稬	hjny
稭	hug
種	hjtl
稯	hxua
稰	hjld
稱	hjnl
稲	hjib
稴	hvem
稵	hvww
稶	htod
稸	hdwq
稺	hpdx
稾	donh
穀	lnta
穁	hhp
穃	hnvo
穄	hxfm
穅	hjes
穇	hggs
穈	jmmh
穉	hpsi
穊	hegw
穌	rhh
積	hlgv
穎	thjv
穏	hjeu
穐	hrbl
穒	hgh
穓	hqhv
穔	hhdv
穕	htim
穖	hwwx
穘	hllw
穙	hwtv
穚	hjyo
穛	htih
穜	hdbl
穝	hbpa
穞	hrtb
穟	hvxz
穠	hujk
穡	hxvo
穢	hljx
穣	hdvk
穤	hujn
穥	hjkv
穦	hntv
穧	hddh
穨	hwqv
穩	hjiu
穪	htvx
穫	hhta
穬	hjhv
穭	hrhb
穮	hjzh
穯	hxoo
穱	hjqd
穲	htnu
穳	hjlv
穵	nvz
穻	nvf
穼	nvm
穽	nvfn
穾	nvjy
窂	nvki
窅	nvg
窇	nvse
窉	nvtv
窊	nvjn
窋	nvue
窌	nvcp
窎	nvgt
窏	nvsf
窐	nvll
窓	nvgu
窔	nvdx
窙	nvyz
窚	nvjx
窛	nvfr
窞	nvrg
窡	nvaa
窢	nvtx
窣	nvdx
窤	nvbu
窧	nvyx
窩	nvqo
窪	nvsl
窫	nvfy
窮	nvrs
窯	nvvh
窰	nvju
窱	nvtm
窲	nvxx
窴	nvxv
窵	nvgh
窶	nvor
窷	nvpp
窹	nvko
窺	nvfw
窻	nvju
窼	nvsm
窽	nvtv
窾	nvlv
竀	nvtw
竁	nvjl
竂	nvym
竃	nvll
竄	nvgv
竅	nvga
竆	nvro
竇	nvlv
竈	nvlq
竊	nvjg
竌	dw
竍	dx
竎	dh
竏	djx
竐	dwa
竒	doi
竓	djfl
竔	djh
竕	dvd
竗	dmj
竘	dso
竚	dnt
竛	dvjd
竜	dbl
竝	dd
竡	djb
竢	dgly
竤	dnxg
竧	dr
竨	dybx
竩	dnqf
竪	gad
竫	drei
竬	djog
竮	dpvh
竰	djbl
竱	dtbd
竲	dvqb
竳	dxtv
竴	dvud
竵	dtoy
競	doww
竷	dbxa
竸	dbww
竻	kj
竼	kwd
竾	kc
笀	kdl
笁	ki
笂	kxd
笅	kxx
笇	kdy
笉	ksv
笌	kcij
笍	knv
笎	kfw
笐	kdw
笒	kvj
笓	ku
笖	kldv
笗	kadd
笘	kyo
笚	kq
笜	kue
笝	kqa
笟	kjjn
笡	kqf
笢	kptv
笣	kse
笧	knnt
笩	ktv
笭	kvjd
笯	kra
笰	kzsn
笲	kgh
笴	kto
笵	ksc
笶	kly
笷	kcjp
笹	khl
笻	kip
笽	kq
笿	kao
筀	kll
筁	ku
筂	ksc
筃	kqy
筄	kvwv
筆	kef
筈	kjxo
筊	kdvx
筍	ksb
筎	kro
筓	kff
筕	ksfi
筗	ktoi
筙	kem
筜	kwe
筞	knm
筟	kjz
筡	kvtm
筣	khn
筤	kdek
筥	koo
筦	knfw
筧	kgw
筨	kvjo
筪	kcq
筫	kgv
筬	kjjx
筭	keh
筯	kqfj
筰	ktlk
筳	kjlz
筶	kjlo
筸	kbf
筺	kced
筻	ktbx
筼	kob
筽	koty
筿	kam
箁	kdo
箃	kpa
箆	knvu
箇	kqxo
箈	ksgo
箉	kfoj
箊	kdhd
箋	kxx
箌	ktgn
箎	kyw
箏	kjei
箑	ktel
箒	keni
箖	kmm
箘	kqh
箙	kdpa
箚	kvtn
箛	kzjn
箞	kvyc
箟	kbu
箣	ktnn
箤	kdvx
箥	ksja
箮	kntt
箯	kttx
箰	ksbz
箲	ksjw
箳	kpvh
箵	kmjg
箶	kxod
箷	kdhc
箹	kwmd
箺	kevb
箻	ksef
箼	kptl
箽	kjtl
箾	kwdn
箿	kop
節	kegp
篂	kbjl
篃	kdjg
範	kcc
篅	kejn
篈	klld
築	kiwm
篊	kshv
篋	kctv
篍	khx
篎	kgmj
篏	khfv
篐	kmci
篒	kvdk
篔	kogv
篕	klgq
篖	kjeo
篗	ktia
篘	ksuj
篜	kjxh
篞	ksbl
篟	ktld
篢	kigv
篣	kdnh
篤	ksh
篧	kpii
篨	kpvm
篩	kjpi
篫	kiwf
篬	kvdo
篭	kdbl
篯	kvfx
篰	kdop
篲	kffe
篳	kbhf
篴	kxz
篵	ksvl
篶	ktlh
篹	kgyc
篺	kfgx
篻	kcfm
篽	kslp
篿	ktbd
簀	klgv
簁	ksll
簂	kqtx
簃	khdd
簄	kdpl
簅	kdjl
簆	knfa
簈	kpjf
簉	kjlz
簊	khel
簍	kotr
簎	kfhb
簐	kcrv
簑	kdok
簒	kgyg
簓	knls
簔	kdtk
簗	ksdm
簘	kexn
簙	kxtd
簚	kqtx
簛	khet
簜	ksbs
簝	kyvm
簞	koox
簠	ktdq
簡	knb
簢	kndx
簣	kqgv
簤	kqgv
簥	kjyo
簨	keev
簩	kxxj
簫	keik
簬	kolo
簭	kivo
簮	kfvb
簯	kmhv
簰	kkgx
簱	kdhv
簲	kdgx
簳	kxbf
簴	kywv
簵	kcao
簶	kjys
簹	kwnq
簺	knfl
簻	kqoz
簼	kffl
簽	kvtv
簾	kjvm
籂	kvdi
籃	kgkq
籄	kcqv
籅	kjkv
籆	khta
籇	kdox
籈	kcld
籉	klol
籊	kjji
籋	ktvx
籌	kljd
籎	ktll
籏	kdhv
籑	kgyk
籒	kftq
籓	ksjq
籔	kota
籕	kmgq
籗	kuti
籘	kdvm
籙	kves
籚	kyqq
籛	kvxx
籝	kdld
籞	kslm
籟	ktov
籠	kdde
籡	kfvv
籢	kvta
籤	kvvx
籦	kvjl
籧	kyxz
籨	kvtv
籩	kjgz
籪	kwwt
籫	kjlv
籬	kdxi
籭	ktnu
籮	kqwi
籯	kdld
籰	kgga
籱	kuti
籲	kvtv
籵	xx
籶	xw
籷	xjt
籸	xzx
籹	xr
籺	xlz
籾	xdd
籿	xxd
粀	xxn
粁	xjx
粂	rdx
粃	xu
粄	xjja
粅	xss
粆	xmj
粇	xdw
粈	xjxt
粊	ux
粋	xxx
粌	xzsi
粍	xjfl
粎	xpn
粏	xyd
粐	xdp
粓	xhf
粔	xg
粖	xtm
粙	xd
粚	xlc
粛	exn
粠	xhv
粡	xnto
粣	xnnt
粦	xdci
粧	xjl
粨	xjb
粩	xyt
粫	xjnn
粬	xu
粭	xvto
粯	xgw
粰	xjz
粴	xbl
粵	jnjs
粶	xes
粷	xsx
粸	xhev
粺	xgjx
粻	xk
粿	xbm
糀	xhtt
糂	xhel
糄	xdph
糆	xjqf
糈	xjld
糉	xxua
糋	xvdn
糎	xjbl
糏	xpwd
糐	xtdd
糑	xzsv
糓	lnta
糔	xadq
糘	xnx
糚	xhkl
糛	xwnl
糝	xggs
糞	xqhv
糡	xdbw
糣	xcwb
糤	xhda
糥	xjnn
糦	xloo
糧	xbtl
糩	xvtb
糫	xqtk
糬	xqyb
糭	xdxa
糮	xgkq
糰	xqtd
糱	ujjx
糲	xjhg
糵	hjpx
糶	uexi
糷	xhnm
糹	wm
糺	wml
糼	wmj
糽	wmt
糾	wmli
糿	wmd
紀	wmzl
紁	wmad
紂	wmxd
紃	wmm
約	wmsd
紅	wmi
紆	wmf
紇	wmlz
紈	wmxd
紉	wmdd
紋	wmdx
紌	wmxd
納	wmnv
紎	wmyd
紏	wmdx
紐	wmjt
紑	wmjy
紒	wmvn
紓	wmdt
純	wmtl
紕	wmu
紖	wmzi
紗	wmmj
紘	wmxg
紙	wmcv
級	wmjn
紛	wmvd
紜	wmfg
紝	wmjl
紞	wmpl
紟	wmvj
紡	wmdh
紣	wmxx
紤	wmjt
紥	flwm
紦	wmdl
紨	wmtd
紩	wmkv
紪	wmlt
紬	wmd
紭	wmzg
紮	mlwm
細	wmq
紱	wmxd
紲	wmhl
紳	wmbi
紴	wmja
紵	wmnt
紷	wmvd
紸	wmde
紹	wmdo
紺	wmhf
紻	wmny
紼	wmzn
紽	wmnt
紾	wmvs
紿	wmgo
絀	wmue
絁	wmlc
終	wmad
絃	wmdw
組	wmqf
絅	wmno
絆	wmvx
絇	wmso
絈	wmg
絉	wmmd
絊	wmmt
絋	wmjg
経	wmal
絍	wmtl
絎	wmsi
絏	wmbx
結	wmlo
絑	wmkm
絒	wmyy
絓	wmll
絔	wmjb
絕	wmdl
絖	wmww
絗	wmqo
絘	wmvv
絙	wmtt
絚	wmtt
絛	tiam
絜	fdwm
絝	wmys
絞	wmdx
絟	wmve
絠	wmxd
絡	wmao
絢	wmsb
絣	wmvh
絤	wmc
絥	wmtd
給	wmvo
絧	wmno
絨	wmtx
絩	wmvv
絪	wmqy
絫	gggm
絬	wmjo
絭	vywm
絯	wmdv
絰	wmtl
統	wmdw
絲	wmwm
絳	wmai
絴	wmvf
絵	wmvg
絶	wmrl
絸	wmgw
絹	wmod
絺	wmxi
絻	wmrw
絼	wmj
絽	wmoo
絾	wmjx
絿	wmxd
綀	wmtm
綁	wmfp
綂	wmdw
綃	wmwd
綄	wmnw
綅	wmea
綆	wmtx
綇	wmu
綈	wmvj
綉	wmhj
綊	wmtv
綋	wmng
綌	wmvo
綍	wmxz
綎	wmjz
綏	wmjr
綐	wmvw
綑	wmqm
綒	wmjz
經	wmti
綔	yfsm
綕	wmlu
綖	wmjz
綗	wmno
綘	wmaf
継	wmxl
続	wmlw
綛	wmdu
綜	wmnm
綝	wmmm
綟	wmdd
綠	wmls
綡	wmdm
綢	wmno
綣	wmvc
綤	dopm
綥	wmqn
綧	wmdz
綨	wmhv
綩	wmnc
綪	wmld
綫	wmxx
綬	wmja
維	wmti
綯	wmsu
綰	wmnz
綱	wmne
網	wmnl
綳	wmdd
綴	wmaa
綵	wmjm
綶	wmbm
綷	wmdx
綸	wmvh
綹	wmao
綺	wmyo
綻	wmnl
綼	wmgx
綽	wmyx
綾	wmla
綿	wmgi
緀	wmtr
緁	wmtl
緂	wmxx
緃	wmvl
緄	wmbu
緅	wmpa
緆	wmbs
緇	wmsq
緉	wmtd
緊	gawm
緌	wmhr
緍	wmcb
緎	wmtx
総	wmvu
緐	lqsm
緑	wmes
緒	wmyb
緓	wmhy
緔	wmwo
緕	wmdh
緖	wmyb
緗	wmmg
緘	wmjx
緙	wmhp
線	wmgs
緛	wmjy
緜	gnim
緝	wmop
緞	wmja
緟	wmjl
締	wmdi
緡	wmpb
緢	wmhq
緣	wmlx
緤	wmhm
緥	wmtm
緦	wmqu
緧	wmvu
編	wmdh
緩	wmja
緪	wmyt
緫	wmsu
緬	wmjf
緭	wmqd
緮	wmla
緯	wmzi
緰	wmvn
緱	wmty
緲	wmgj
緳	jfdm
練	wmtm
緵	wmxa
緶	wmtx
緷	wmnc
緸	wmcl
緹	wmbl
緺	wmqo
緻	wmta
緼	wmbq
緽	wmyv
緾	wmjl
緿	wmgu
縀	wmpa
縁	wmex
縂	wmvu
縃	wmjd
縄	wmbl
縅	wmjx
縆	wmyt
縇	wmnt
縈	xxnm
縉	wmtb
縊	wmvq
縋	wmjz
縌	wmvz
縍	wmdh
縎	wmqd
縏	nswm
縐	wmsj
縑	wmvm
縒	wmvi
縓	wmjm
縔	wmam
縕	wmqq
縖	wmno
縗	wmdk
縘	wmjy
縙	wmhp
縚	wmjg
縛	wmtd
縜	wmov
縝	wmxv
縞	wmdo
縟	wmjd
縠	lnta
縡	wmnx
縢	dvym
縣	qemm
縤	wmlm
縥	wmeh
縦	wmsl
縧	wmtm
縨	wmbw
縩	wmxm
縪	wmbf
縫	wmaz
縬	wmjx
縭	wmdg
縮	wmnb
縰	wmsl
縱	wmsl
縲	wmqm
縳	wmtd
縴	wmdi
縵	wmba
縷	wmor
縸	wmhy
縹	wmcm
縺	wmcz
縼	wmdl
總	wmju
績	wmlv
繀	wmei
繂	wmdx
繃	wmed
繄	clym
繅	wmsm
繆	wmjs
繈	wmzq
繉	wmgv
繊	wmlx
繋	ccwm
繌	wmja
繍	wmen
繎	wmdh
繏	wmev
繐	wmtu
繒	wmvb
繓	wmba
織	wmdx
繕	wmvo
繖	wmha
繗	wmxi
繘	wmdo
繚	wmym
繛	lwmx
繜	wmvd
繝	wmnd
繞	wmlw
繟	wmox
繠	uuum
繡	wmek
繢	wmqv
繣	wmet
繤	hgym
繥	wmlo
繦	wmzq
繧	wmug
繨	wmlz
繩	wmq
繪	wmvb
繫	cuwm
繬	wmxo
繭	hmwq
繮	wmtt
繯	wmqk
繰	wmom
繱	wmhu
繲	wmri
繳	wmga
繴	podm
繵	wmdt
繶	wmdu
繷	wmuk
繸	wmvz
繺	wmrh
繻	wmun
繼	wmwl
繽	wmnv
繾	wmqz
繿	wmgq
纀	wmtv
纁	wmjh
纃	wmdh
纄	wmhz
纅	wmwm
纆	wmql
纇	xwmv
纈	wmlv
纉	wmfv
纊	wmjv
纋	wmja
續	wmlv
纍	qqqm
纎	wmlx
纏	wmjl
纐	wmdv
纑	wmyq
纒	wmjl
纓	wmgr
纔	wmrd
纕	wmdk
纖	wmvx
纗	wmeo
纘	wmjv
纙	wmqi
纚	wmtu
纜	wmgw
纝	wmqm
纞	wmwu
纟	wii
纴	wjl
纻	wnt
纼	wzsi
绗	wsfi
绤	wvvo
绬	whny
绹	wslu
缊	wbq
缐	wgs
缞	wdok
缷	lxup
缹	lxuh
缻	lxud
缼	lxuv
缽	lxut
缾	lxuh
缿	lxuo
罀	lxuv
罁	lxue
罃	xxnu
罆	lxuv
罇	lxud
罈	lxux
罊	cuwu
罋	dwju
罌	gvgu
罍	qqqu
罎	lxug
罏	lxuq
罒	qii
罖	qvd
罙	nvm
罛	qjjn
罜	qde
罝	qqf
罞	qdtj
罠	qptv
罣	qll
罤	qvzj
罥	qod
罦	qjz
罧	qmm
罫	qlly
罬	qaaa
罭	qtox
罰	qin
罳	qqu
罵	qsh
罶	qgdq
罷	qgdt
罸	qixd
罺	qsbm
罻	qpfd
罼	qbhf
罽	qjxn
罿	qdbl
羀	nxxq
羂	qwmd
羃	qhbi
羄	qwmx
羅	qwmi
羆	qgdh
羇	qhpo
羈	qhph
羉	qwmm
羋	yiyf
羍	yvf
羏	vfs
羐	yyln
羑	vern
羒	vfvd
羓	vfdl
羕	vedx
羖	vfwa
羗	vflg
羘	dvf
羙	vex
羛	vezn
羜	vfnt
羠	vftv
羢	vftx
羣	ejof
羥	vfti
羦	vfnw
羨	vesv
義	vejx
羪	vfdk
羫	vfni
羬	vfjx
羭	vfvn
羮	vehv
羱	vfjm
羳	vfjq
羴	vfvf
羵	vfxv
羶	vfdt
羷	vfvv
羺	vfun
羻	vfja
羾	jji
翂	jjvd
翄	jjxa
翆	jjxx
翇	jjxd
翈	qjj
翉	mtjj
翋	jjd
翍	jjja
翏	jjvs
翐	jjkv
翑	jjso
習	jjg
翓	lojj
翖	vtoj
翗	ddjj
翙	edjj
翚	jjnc
翛	tiaj
翜	jjtv
翝	nxgj
翞	jjdm
翢	nljj
翣	jjdr
翤	onhj
翧	ntbj
翨	jjbl
翪	jjxa
翫	jjgw
翬	jjnc
翭	jjty
翯	jjdo
翲	cfmj
翴	jjcz
翵	jjgh
翶	gxxj
翷	xdcj
翸	xhgj
翹	lllj
翺	jgxj
翽	ljtj
翾	qtoj
翿	ljij
耂	yii
耇	yso
耈	ytso
耉	yjso
耊	ytgl
耎	jnny
耏	jnns
耓	emt
耚	emja
耛	emgo
耝	emqf
耞	emjo
耟	emg
耠	emvo
耡	emqj
耢	emhj
耣	emvh
耤	emhb
耫	emlv
耬	emor
耭	emwx
耮	emxj
耯	emha
耰	emja
耲	emdk
耴	pl
耹	pvj
耺	pfg
耼	pnf
耾	pxg
聀	px
聁	pvd
聄	pvs
聅	ply
聇	ptl
聈	pwj
聉	pue
聎	pvwv
聏	pjnn
聐	plo
聑	pp
聓	iwdp
聕	pjlo
聖	poe
聙	pld
聛	pgjx
聜	pnvi
聝	ptox
聞	nnp
聟	lyop
聠	pvh
聡	pvgu
聢	pntl
聣	pgw
聤	pdot
聥	pjog
聦	pssu
聧	pxty
聨	pwwh
聫	pwwy
聬	pvgj
聭	pgwg
聮	pwwh
聯	pwwh
聰	pjqu
聲	ldjp
聳	svvp
聴	pxqu
聵	pqgv
聶	ppp
職	pdbx
聸	prji
聹	pnut
聺	pnxm
聻	scjp
聼	jpxu
聽	pexu
肁	dpef
肂	tdef
肅	eikk
肈	dpxf
肊	dz
肍	dx
肎	nd
肏	jnnv
肐	dlz
肑	dsd
肒	dxd
肔	dc
肕	ddd
肗	dr
肙	od
肞	dad
肣	dvj
肦	dvd
肧	djy
肨	df
肬	dxld
肰	dyd
肳	dss
肵	djjt
肸	dvx
肹	dvts
肻	ynd
胅	dkv
胇	dzsn
胈	dxad
胉	dg
胊	dso
胋	dyo
胐	due
胑	dov
胒	dpt
胓	dtvi
胔	ltnv
胕	dtxd
胘	ddw
胟	dqs
胠	dlg
胢	dto
胣	dlc
胦	dny
胮	daci
胵	dtgl
胷	sxud
胹	djnn
胻	dsfi
胾	lnvx
胿	dll
脀	jxtd
脁	dvwv
脃	drdl
脄	dxx
脅	jjjd
脇	djjj
脈	djjk
脋	dddd
脌	dlci
脕	drow
脗	dsso
脙	dxxd
脛	dtsi
脜	djg
脝	ddoj
脟	djxd
脠	djlz
脡	djlz
脣	jfkd
脦	dtuv
脧	dgva
脨	dtom
脩	tiad
脪	dxxi
脫	dvow
脭	doe
脮	djr
脳	dwxu
脴	djyo
脵	doty
脹	dk
脺	ddvx
脻	dtel
脼	dtnd
脽	dti
脿	dlk
腀	dvth
腁	djff
腂	dbm
腃	dvyc
腅	dxx
腇	dhr
腉	dgw
腎	gad
腏	daaa
腒	dpxo
腖	dtbm
腗	ddtn
腘	dqed
腛	dptl
腜	dhfm
腝	djny
腞	dljx
腟	dntl
腡	dqo
腢	dbng
腣	ddni
腤	ddb
腦	dsjx
腨	dejn
腪	dnc
腫	djtl
腬	ddtm
腲	dqtk
腳	dvvp
腵	dpfa
腶	djia
腷	dtoq
膁	dvem
膃	dqvq
膄	dgia
膅	djeo
膆	dlwm
膇	djpz
膋	xxnd
膌	dxvd
膍	djqu
膎	djwy
膐	dhlv
膒	dcoo
膓	dlbs
膔	djzu
膕	dqtx
膖	dafz
膗	deti
膙	dzsq
膚	yqd
膞	dtbd
膠	djjs
膡	dvyg
膢	dotr
膤	due
膧	ddbl
膩	dtfv
膫	dyvm
膬	djfl
膭	dqgv
膮	dllw
膯	dxtv
膰	djxq
膱	ddbx
膲	dtih
膴	dlhh
膵	dhdx
膷	dwjp
膸	dxiz
膹	dxhv
膽	drji
膾	dvtb
膿	dujk
臅	dqsq
臇	dtim
臈	dhbl
臉	dvtv
臋	phvv
臍	dddh
臎	djjx
臏	dntv
臐	djth
臒	dhta
臔	dgav
臕	djzh
臖	jknd
臗	dnhd
臘	dsqv
臚	dyqq
臛	duti
臞	dggi
臟	dhkx
臠	wmiv
臡	hofv
臢	djlv
臤	ga
臥	gv
臦	gg
臨	gloo
臩	ggyn
臫	jgl
臮	jgjv
臯	jgxx
臰	jgtt
臱	jgnh
臲	jgmc
臵	tglo
臶	tglz
臷	ltgx
臸	tgll
臹	tglx
臺	lonl
臽	rg
臿	jxg
舃	gsh
與	jksv
興	jknv
舉	jksf
舊	htig
舋	jknf
舎	vlo
舏	jxoi
舑	jxol
舓	jxos
舕	jxox
舖	vfod
舗	vlod
舘	vfoz
舙	jxoo
舚	jxoi
舝	zisi
舠	nsd
舡	nsi
舤	nswd
舥	nsdl
舦	nsyd
舧	nsjd
舩	nsvg
舮	nsdp
舲	nsvd
舺	nsq
舼	nshv
舽	nsai
舿	nsys
艀	nsjz
艁	nsjo
艂	nsaf
艃	nsbl
艅	nsvm
艆	nsdk
艈	nsdm
艊	nsgi
艌	nsvu
艍	nspo
艎	nsge
艐	nsxa
艑	nsdh
艓	nshm
艔	nsja
艕	nsdh
艖	nsvi
艗	nsvq
艙	nsvo
艛	nsor
艜	nshi
艝	nsue
艞	nskv
艠	nsxv
艡	nswq
艢	nsxo
艣	nsyj
艤	nsvx
艥	nsox
艦	nsgq
艧	nsha
艩	nsdh
艪	nsrb
艫	nsyq
艬	nsrd
艭	nsta
艱	hofk
艴	zsnl
艵	vhrl
艶	utol
艷	ffel
艻	hj
艼	ht
芀	hd
芁	hw
芃	hwd
芅	hv
芆	had
芇	hni
芉	hf
芌	hfs
芐	htd
芓	hz
芔	uiui
芕	hd
芖	hy
芚	htul
芛	hej
芞	hkz
芠	hdx
芢	htf
芧	hdt
芲	hvt
芵	hzv
芶	hsg
芺	hjy
芻	sujj
芼	hjfl
芿	htzj
苀	hdw
苂	hx
苃	hxa
苅	hxn
苆	htd
苉	hcw
苐	hzsj
苖	hd
苘	hno
苙	hd
苝	hkt
苢	hpz
苧	hnt
苨	hpt
苩	hg
苪	htnv
苬	hqv
苭	hwj
苮	hte
苰	hzsg
苲	hlk
苳	hadd
苵	hkv
苶	hvm
苸	hjvi
苺	hqs
苼	hjl
苽	hjjn
苾	huj
苿	hfm
茀	hzsn
茊	hg
茋	hctd
茍	hso
茐	hssd
茒	hdp
茓	hnv
茖	hao
茘	hddd
茙	htxx
茝	hg
茞	hg
茟	hef
茠	htm
茡	hnz
茢	htdn
茣	hoty
茤	hdd
茥	hll
茦	htnm
茩	hjjo
茪	hww
茮	hlm
茰	hbx
茲	hww
茷	htx
茻	ujui
茽	htoi
茾	hth
茿	hiwd
荁	htbt
荂	hyfs
荅	hvto
荈	hdci
荊	hthn
荋	hjnn
荌	hnr
荍	hlia
荎	htgl
荓	hvh
荕	hdj
荖	hyt
荗	hjdx
荘	hkl
荙	hyz
荝	hbn
荢	hnf
荮	hwxd
荰	hml
荱	hpjl
荲	hbl
荳	htov
荴	hffv
荵	hddu
荶	hovj
荹	hy
荺	hlsv
荾	hgva
荿	hjjx
莀	hjfk
莁	hivv
莂	hojn
莃	hxxi
莄	htbx
莇	hqfj
莈	hswa
莊	hkl
莋	htlk
莌	hvow
莍	hxxd
莏	hfmj
莐	hspl
莑	haf
莔	hqvn
莕	hmo
莖	htsi
莗	hc
莙	hejo
莚	hjlz
莝	hvvl
莟	hvjo
莡	hol
莣	hdlu
莤	hu
莥	hxjt
莦	hwd
莧	hgw
莬	hrow
莭	hegp
莮	hqj
莯	hsm
莵	hjod
莻	hzjt
莾	hyxh
莿	htnn
菂	hgsd
菃	hsg
菄	htbm
菆	hpa
菈	hfd
菉	hes
菋	hofm
菍	hvju
菎	hbu
菐	wtvv
菑	hsq
菒	hbm
菓	hbm
菕	hvth
菗	hfd
菚	hxx
菛	hn
菞	hhsj
菣	hga
菤	hvyc
菦	hjjz
菧	hjcd
菨	hdr
菫	htol
菬	hsdo
菭	hsgo
菮	hjev
華	hthf
菳	hv
菴	hybl
菵	hnvl
菶	hevf
菷	heni
菺	hdpd
菻	hmm
菼	hxx
菾	htyd
菿	htgn
萀	hyw
萂	hho
萅	htub
萇	hk
萈	hgwd
萉	hddl
萐	htel
萒	hdvw
萓	hnqf
萔	hfdo
萕	hdxh
萖	hgw
萗	hnfm
萙	hmpl
萚	hfaf
萛	hgh
萞	hnvu
萟	hhxd
萠	hdd
萡	hsg
萢	hsse
萩	hhx
萪	hhdx
萫	hhb
萬	hbng
萭	hjog
萮	hvtn
萯	hrgv
萰	htqm
萲	hjfa
萴	hgvn
萵	hqo
萶	hevb
萷	hwdn
萻	hdb
萾	hzjq
萿	hsjo
葀	hfjo
葁	hver
葂	hroj
葃	hblk
葄	hdlk
葅	hvvf
葇	hdtm
葈	hgom
葉	hhlm
葊	hvth
葋	hdso
葌	hrrr
葍	htoq
葎	hsef
葏	hsef
葐	hvdq
葒	hwmi
葓	hshv
葔	htzy
葕	hssi
葖	hnvd
葘	htsq
葝	htsj
葞	hzsp
葟	hge
葠	htea
葢	hydq
葤	hwmd
葥	hvdn
葦	hzii
葨	hqtk
葪	hrn
葮	hjia
葯	hwmd
葰	htga
葲	hgs
葴	hjtx
葷	hnc
葹	hdhc
葻	hwjq
葼	hxua
葽	hcr
葿	hdjg
蒀	hbq
蒁	hmdz
蒃	hljx
蒄	hnfd
蒅	hsxm
蒆	hiwr
蒈	hug
蒊	httt
蒍	hdjh
蒏	hnu
蒐	hgwg
蒑	hjja
蒒	hjpi
蒓	hwml
蒔	hbld
蒕	hqvq
蒖	hxqv
蒗	hsdk
蒘	hrof
蒚	htoy
蒛	hlxv
蒝	hjgm
蒞	hstd
蒟	hdso
蒠	hjgu
蒢	hpvm
蒣	hsvm
蒤	hsvm
蒥	hgdq
蒦	htia
蒧	hjyx
蒨	htld
蒩	hhqf
蒪	htdd
蒫	hvfi
蒬	hnrd
蒭	hsuj
蒮	hpii
蒰	hnsa
蒱	hftd
蒳	hwmv
蒵	hjwy
蒶	hwmd
蒷	hogv
蒻	hzsv
蒼	hvdo
蒾	hxz
蓀	hzjm
蓂	hnbv
蓃	hgia
蓅	hsdm
蓆	hjhi
蓇	hqd
蓈	hdep
蓋	hlgq
蓌	hvva
蓎	hjeo
蓏	hjjn
蓒	hcf
蓔	hveh
蓕	hmll
蓗	hsll
蓘	hdvk
蓙	hjvl
蓚	htis
蓛	htna
蓜	huzl
蓞	hjg
蓡	hsea
蓢	hded
蓤	hvla
蓧	htim
蓨	htid
蓩	hdtj
蓫	hxz
蓭	hjyl
蓮	hcz
蓯	hsvl
蓱	hsvh
蓲	hcoo
蓳	hhol
蓴	htbd
蓵	hftl
蓶	hoti
蓷	hfti
蓸	hub
蓹	hslp
蓺	hlvd
蓽	hbhf
蓾	hyqd
蔀	hdop
蔁	hdbx
蔂	hqwm
蔄	hno
蔅	hnr
蔇	hegw
蔈	hcfm
蔉	hdvk
蔊	hxbf
蔋	hsla
蔍	hjzu
蔎	hiwa
蔏	hdno
蔐	hdno
蔒	hejh
蔔	hstq
蔖	hyqf
蔘	hggs
蔙	hdhl
蔛	hrdx
蔜	hlha
蔝	hgx
蔞	hotr
蔠	hwmd
蔢	hsjr
蔣	hkdd
蔤	hnue
蔥	hjqu
蔦	hgh
蔧	hffe
蔨	hqvc
蔩	hntv
蔪	hcjt
蔭	hpvg
蔮	hqtx
蔯	hptm
蔰	hdpl
蔱	hxma
蔲	hnfa
蔳	hsld
蔴	hjmm
蔵	hjgx
蔶	hlgv
蔹	hvta
蔾	hhsm
蔿	hjjh
蕀	htnm
蕁	heid
蕂	hdvj
蕄	hnu
蕅	hsbg
蕆	hjgx
蕇	hoox
蕋	hlll
蕌	hbbb
蕍	hsvn
蕎	hjyo
蕏	hxjb
蕐	htvf
蕑	hnd
蕒	hqgv
蕓	hufg
蕕	hxju
蕗	holo
蕘	hllw
蕚	hoos
蕛	hhvj
蕝	hwml
蕟	hxza
蕠	hrom
蕡	hxhv
蕢	hqgv
蕣	hjni
蕥	hcii
蕦	hsjv
蕧	hsla
蕩	hsbs
蕪	hlhh
蕫	hdbl
蕬	hwmm
蕭	heik
蕮	hgsh
蕯	hpal
蕰	hsbq
蕱	hhwd
蕳	hnb
蕵	hdvk
蕶	huvd
蕷	hdtv
蕸	hpfz
蕼	hkef
蕽	hujk
蕿	hxja
薀	hsqq
薁	hjny
薂	hgda
薃	hsdo
薆	hjna
薈	hvtb
薉	hljx
薊	hrhn
薋	hvrv
薌	hwjp
薍	hjdl
薎	hqnx
薐	hhla
薑	htqt
薒	hydx
薓	hsea
薔	hxvo
薕	hjvm
薖	hqoz
薗	hqlk
薘	hlvz
薚	htds
薝	hrji
薞	htdk
薟	hvtv
薠	hxjv
薡	hgkk
薣	hloa
薥	hqsq
薦	hjzh
薧	hdot
薩	hpdl
薫	hjth
薭	hhgx
薱	hwtd
薲	hntv
薳	hloz
薴	hnut
薵	hljd
薶	hjbl
薸	hscm
薺	hddh
薻	hssm
薼	hjzl
薽	hcld
薾	htvx
薿	htll
藀	hxxx
藂	hpax
藃	hdov
藄	hhem
藅	hqin
藆	hnff
藇	hjkv
藈	hgxy
藊	hhdh
藋	hjji
藌	hnuq
藍	hgkq
藑	hrna
藒	hhbl
藔	hnym
藖	hgav
藗	htoz
藘	hyqu
藙	hdxa
藚	hlqv
藛	hngh
藝	hlvg
藞	hccc
藟	hqqq
藠	hggg
藡	hdnz
藢	hsea
藣	hqgt
藦	hjmf
藧	hwma
藨	hjzh
藪	hota
藫	hscx
藬	hpqv
藭	hnvs
藮	hmth
藯	hpfu
藰	hgdn
藱	hjgg
藲	hmco
藳	hdoh
藴	hwmq
藵	htok
藶	hjhl
藷	hiyb
藹	hibl
藺	hnti
藼	hnlu
藽	hdmw
藾	htov
蘁	heoo
蘂	huum
蘃	hllm
蘄	hoot
蘆	hyqq
蘇	hrhh
蘈	hhwv
蘉	hqna
蘊	hwmq
蘋	hyjv
蘌	hslm
蘍	hjtj
蘎	hudl
蘏	htfv
蘐	hija
蘒	hhrl
蘓	hhrh
蘔	hthv
蘕	hwmz
蘘	hdok
蘙	hclj
蘚	hrhf
蘛	hhed
蘜	hhpx
蘝	hvtv
蘞	hvta
蘟	hpju
蘠	hkxo
蘡	hgvr
蘢	hdde
蘣	hhde
蘤	hgjh
蘥	hvth
蘦	huoo
蘨	hjlm
蘪	hjzx
蘫	hsgq
蘬	hjpi
蘭	hntm
蘮	hqjn
蘯	hsbq
蘰	hwma
蘱	hxyv
蘲	hqql
蘳	hhdl
蘴	hffv
蘵	hpdx
蘶	hhrg
蘷	hjba
蘹	hydk
蘺	hdxi
蘻	hcum
蘽	hqqm
蘾	hldk
蘿	hqwi
虀	hddt
虁	hvja
虂	huoo
虃	hsvx
虄	hqal
虅	hdvh
虆	hqqm
虇	hzsi
虉	htoh
虋	hjkd
虌	hvnq
虒	jjyw
虓	xyw
處	yaw
虖	yjvi
虗	yg
虘	yqf
虙	yuj
虛	ywt
虜	yqj
虝	ywss
號	otsw
虠	dvxw
虡	ywtv
虣	flvw
虤	ywyw
虥	ywxx
虦	xxyw
虧	ytis
虨	ymms
虩	wbmw
虪	ywth
虭	qd
虯	qli
虰	qt
虲	qy
虳	qsd
虴	qjt
虵	qc
虶	qf
虷	qf
虸	qz
蚃	wjq
蚄	qdh
蚅	qjc
蚆	qdl
蚇	qpn
蚈	qth
蚉	dxq
蚎	qb
蚏	qd
蚐	qsv
蚑	qxa
蚒	qnd
蚔	qctv
蚖	qfw
蚗	qzv
蚘	qxld
蚙	qvj
蚚	qjjt
蚛	qoi
蚞	qm
蚟	qe
蚠	vdq
蚡	qvd
蚢	qdw
蚥	qvx
蚦	qnf
蚫	qse
蚭	qpt
蚮	qtv
蚲	qtvi
蚳	qctd
蚷	qg
蚸	qjjd
蚹	qtxd
蚻	mlq
蚼	qso
蚽	qjyt
蚾	qja
蚿	qdw
蛁	qdo
蛂	qxad
蛃	qtnv
蛅	qyo
蛈	qkv
蛌	qjjn
蛍	wnq
蛒	qao
蛓	lqx
蛕	qxd
蛖	qxld
蛗	jpzq
蛚	qtdn
蛜	qtej
蛝	qek
蛠	qjjj
蛡	qjj
蛢	qvh
蛣	qlo
蛥	qdd
蛦	qtzv
蛧	qnxx
蛨	qjb
蛪	fdq
蛫	qrjc
蛬	hvq
蛯	qyt
蛵	qtsi
蛶	qjxd
蛷	qxxd
蛻	qvow
蛼	qc
蛽	qgv
蛿	qvjo
蜁	qljl
蜄	qjfk
蜅	qtdd
蜆	qgw
蜋	qdek
蜌	qul
蜎	qod
蜏	qhzj
蜐	qlgj
蜑	jlzq
蜔	qsq
蜖	qqnf
蜙	qmvg
蜛	qpxo
蜝	hevq
蜟	qdgd
蜠	qqh
蜤	mjjq
蜦	qvth
蜧	qdpd
蜨	qtel
蜪	qslu
蜫	qbu
蜬	qjxu
蜭	qrg
蜯	qevf
蜰	ddlq
蜲	qhr
蜳	qdoz
蜵	qktk
蜶	qdvx
蜸	gaq
蜹	qhnv
蜺	qgw
蜼	qti
蜽	qtnd
蝀	qtbm
蝁	txtq
蝂	qkja
蝃	qaaa
蝄	qnvl
蝅	tytq
蝆	qyif
蝊	qntl
蝋	qwwf
蝍	qegp
蝏	qdot
蝐	qbg
蝑	qjld
蝒	qjqf
蝔	qug
蝕	vdeq
蝖	qntt
蝘	qcbr
蝚	qdtm
蝛	qjtx
蝜	qrgv
蝝	qljx
蝞	qdjg
蝟	qqd
蝡	qjny
蝢	qjgv
蝦	qpfa
蝧	qhny
蝨	zxqq
蝩	qjtl
蝫	qyb
蝬	qxua
蝭	qbtl
蝯	qjfa
蝱	dlqq
蝳	qlqs
蝵	hxq
蝷	qjvj
蝸	qqo
蝹	qbq
蝺	qjog
蝿	qbbl
螀	kdxq
螁	qekz
螄	qjpi
螇	qjwy
螉	qvgj
螊	qvem
螋	qgia
螌	nswq
螎	qtoy
螏	qjly
螐	qjzh
螑	qjgd
螒	xbxq
螔	qjjw
螕	qjqu
螖	qqd
螘	qetv
螙	mqq
螚	gdtq
螛	qnfo
螜	lntq
螝	qgwg
螞	qsh
螠	qvvq
螡	dxqq
螢	xxnq
螣	dvyq
螤	dxqv
螥	qvdo
螦	qlwm
螧	qytb
螩	qtim
螪	qdno
螰	qjzu
螱	pfmq
螴	ptbq
螶	gqq
螷	jgjq
螸	vvoq
螹	qcjt
螻	qotr
螼	qhol
螾	qntv
螿	kdxq
蟁	ptvq
蟂	qgm
蟃	qbqa
蟇	hbyq
蟈	qqtx
蟉	qjjs
蟌	qjqu
蟍	qhnm
蟎	qhnd
蟐	qwni
蟔	qqh
蟕	qltr
蟖	qhet
蟗	toiq
蟘	qtvv
蟙	qdbx
蟚	lovq
蟜	qjyo
蟝	qsgm
蟞	vnmq
蟟	qyvm
蟡	qjjh
蟢	qloo
蟣	qwwx
蟤	qeev
蟦	qxhv
蟧	qxxj
蟨	jvuq
蟩	qjvv
蟫	qcbx
蟬	qoox
蟭	qtih
蟯	qllw
蟰	qeik
蟱	qlhh
蟲	qqq
蟳	qeid
蟴	hevq
蟵	qjtd
蟶	qpoe
蟷	qwnq
蟸	xqq
蟺	qdqt
蟻	qvex
蟼	hsoq
蟽	qlvz
蟿	cuwq
蠀	qvrv
蠁	wjdq
蠂	qhhm
蠄	qvdg
蠅	qq
蠆	hbnq
蠇	qhbg
蠈	gvtq
蠉	qqtk
蠋	qqsq
蠍	qbsv
蠎	qhyh
蠏	qrdi
蠐	qddh
蠑	qxxm
蠒	tvnq
蠔	qdox
蠗	qjji
蠘	qltx
蠙	qntv
蠚	hxoq
蠜	mxxq
蠝	qqqq
蠞	kegq
蠟	qsqv
蠠	jqnq
蠣	qjhg
蠤	vuqq
蠥	ujjq
蠦	qyqq
蠧	lncq
蠨	qhek
蠩	qiyb
蠫	jnqq
蠬	qdde
蠭	afzq
蠮	qclj
蠯	jgjq
蠰	qdok
蠱	qqqq
蠳	qgvr
蠴	qhqb
蠵	qeto
蠶	cwcq
蠷	qggi
蠸	qhoi
蠺	tytq
蠻	wmiq
蠽	mjiq
蠾	qpsq
衁	dljq
衂	jqdd
衃	jqjy
衇	jqjk
衈	jqp
衉	jqao
衊	jqhx
衋	efjq
衎	sffi
衏	sfwi
衐	sgfi
衑	svji
術	smdi
衕	snti
衖	shvi
衚	sxoi
衛	szii
衜	svji
衝	sjti
衞	szii
衟	ssji
衠	sxqi
衦	jkf
衧	jkf
衪	jkc
衭	jkfv
衯	jkvd
衱	jkjn
衳	jkvg
衴	jkpl
衵	jkb
衶	jkoi
衸	jkvn
衺	dcik
衻	jknf
衼	jkxa
袀	jksv
袃	tddk
袇	jknd
袉	jknt
袊	jkvd
袌	dsek
袎	jkwj
袏	jkxi
袐	jkuj
袑	jkdo
袓	jkqf
袔	jkto
袕	jknv
袗	jkvs
袘	jklc
袙	jkg
袚	jkxd
袛	jkcd
袝	jktd
袞	dvok
袟	jkkv
袠	dkvk
袡	jknl
袣	jkhl
袥	jkc
袦	jkue
袧	jkso
袨	jkdw
袩	jkyo
袪	jklg
袬	dgok
袮	jklm
袯	jkyd
袰	qsdk
袲	dddk
袳	jkdd
袴	jkys
袵	jktl
袶	jkai
袸	jkxz
袹	jkjb
袺	jklo
袻	jkjn
袽	jkro
袾	jkkm
袿	jkll
裀	jkqy
裃	jkld
裄	jksi
裇	jkjq
裈	jknc
裊	gdk
裋	jktv
裌	jktv
裍	jkqm
裏	dblk
裐	jkod
裑	jkr
裓	jktx
裖	jkjk
裗	jkdm
裚	fjjk
裛	dodk
補	jktd
裝	kldk
裞	jkvw
裠	ejok
裡	jkbl
裦	dedk
裧	jkxx
裩	jkbu
裪	jksu
裫	jkkk
裬	jkla
裭	jkyw
裮	jkbb
裲	jktd
裷	jkvc
裺	jkyl
裻	lmak
製	knik
裿	jkyo
褀	jkhv
褁	bmk
褃	jkld
褄	jktr
褅	jkdi
褆	jkbl
複	jkla
褈	jkjl
褉	jkfy
褋	jkhm
褌	jknc
褍	jken
褎	dehk
褏	dedk
褑	jkja
褔	jktq
褖	jklx
褗	jkcr
褘	jkzi
褜	dsek
褝	jkwx
褞	jkbq
褟	jkbj
褠	jkfl
褢	dgwk
褣	jkno
褤	jklk
褦	jkgt
褧	pxdk
褨	jkvi
褩	nswk
褬	jkam
褭	dshk
褮	xxnk
褯	jkji
褱	dqsk
褲	jkjc
褳	jkcz
褵	jkdg
褷	jksl
褸	jkor
褹	jkld
褻	dlvk
褼	jkce
褾	jkcm
褿	jkub
襀	jklv
襂	jkgs
襃	deok
襅	jkbf
襆	jkwv
襇	jknb
襈	jkev
襉	jknd
襊	jkba
襋	jktm
襌	jkox
襍	jktm
襎	jkjq
襏	jkxa
襐	jkrx
襑	jked
襒	jkva
襓	jklw
襔	jkhd
襕	jknm
襖	jkjy
襘	jkvb
襙	jkom
襚	jkvz
襛	jkuk
襜	jkri
襝	jkvv
襠	jkwq
襡	jkqq
襢	jkdt
襣	jkjn
襤	jkgq
襥	jktv
襧	jktx
襨	jkwd
襩	jklv
襪	jkhx
襫	jktv
襬	jkqt
襭	jklv
襮	jkbs
襯	jkdw
襰	jktv
襱	jkde
襳	jkvx
襴	jknm
襵	jkpp
襶	jklx
襷	jkjf
襸	jkjv
襹	jktu
襺	jkhq
襼	jkhg
襽	jkhm
襾	tnu
覀	cii
覂	cjdz
覄	ctyd
覅	crss
覇	chpd
覈	cgda
覉	chpo
覊	chph
見	gw
覌	agw
覍	mgw
覎	gwz
規	fvgw
覐	gwxx
覑	kgw
覒	jflw
覓	jgw
覔	jygw
覕	ujgw
視	jygw
覗	jtow
覘	yogw
覙	rmgw
覚	wngw
覛	jjkw
覝	fxgw
覞	gwgw
覟	lugw
覠	ejow
覡	ivvw
覢	xxgw
覣	hrgw
覤	ywgw
覥	uvgw
覦	vtdw
覧	gkgw
覨	oofw
覩	ybgw
親	dmgw
覫	dndw
覬	etow
覭	nbdw
覮	xxnw
覯	fntw
覰	yqfw
覱	ccjw
覲	holw
観	lxiw
覴	xtow
覵	ndgw
覶	jdnw
覷	ywtw
覸	nbgw
覹	gwsa
覺	jkxw
覻	ytow
覼	tvnw
覽	gkqw
覾	njxw
覿	lqgw
觀	hoow
觃	nwz
觍	uvnw
觏	fntw
觓	rli
觕	jfr
觗	rctv
觙	rjzn
觛	rbt
觝	rctd
觟	rll
觠	vyr
觡	rao
觢	fdr
觤	rrjc
觧	rvf
觨	ris
觩	rxxd
觪	rdx
觬	rgw
觭	ryto
觮	res
觰	ryb
觱	jtor
觲	rvei
觴	rlbs
觵	rhdv
觶	roox
觷	jkxr
觸	rqsq
觹	rtim
觺	tlyr
觻	rwgm
觽	retm
觿	reto
訁	iii
訂	iit
訃	iiy
訄	xi
訅	iix
訆	iili
計	iix
訉	iiwd
訊	iizx
訋	iisd
訌	iii
訍	iiad
討	iixd
訐	iif
訑	iic
訒	iidd
訓	iim
訔	ei
訕	iie
訖	iilz
託	iijt
記	iizl
訙	iixd
訚	ni
訛	iitt
訜	iivd
訝	iicj
訞	iijy
訟	iivg
訠	iizi
訡	iivj
訢	iijt
訣	iizv
訤	iixx
訥	iinv
訦	iipl
訧	iixd
訨	iil
訩	iixu
訪	iidh
訫	iiu
訬	iimj
設	iiwa
訮	iith
訯	iijn
訰	iitl
許	iilx
訲	iioi
訳	iipn
訴	iijd
訵	iiq
訶	iito
訷	iibi
訸	iih
訹	iimd
診	iivs
註	iide
証	iitl
訽	iiso
訿	iilt
詀	iiyo
詁	iixo
詂	iitd
詃	iidw
詄	iikv
詅	iivd
詆	iicd
詇	iiny
詉	iira
詊	iivx
詋	iiow
詌	iihf
詍	iihl
詎	iig
詐	iilk
詑	iint
詒	iigo
詓	iilg
詔	iido
評	iiti
詖	iija
詗	iino
詘	iiue
詙	iixd
詚	iibt
詛	iiqf
詜	iiua
詝	iint
詞	iijo
詟	xtdi
詠	iidx
詡	iijj
詢	iisb
詣	iitb
詤	iivm
詥	iivo
試	iitv
詧	xi
詩	iild
詪	iiek
詫	iint
詬	iijo
詭	iirc
詮	iive
詯	iijg
詰	iilo
話	iijo
該	iidv
詳	iivf
詴	iixd
詵	iijw
詶	iiyy
詷	iino
詸	iix
詺	iido
詼	iixx
詽	iiff
詾	iisu
詿	iill
誀	iip
誁	iivh
誂	iivv
誃	iidd
誄	iiem
誅	iikm
誆	iice
誇	iiys
誈	iitl
誋	iizu
誌	iilu
認	iidu
誎	iitm
誏	iidk
誐	iijx
誑	iixe
誒	iigy
誔	iijz
誕	iijz
誖	iixz
誗	iihn
誘	iihj
誙	iiti
誚	iiwd
誛	iiea
誜	iiga
誝	iivo
語	iiwo
誟	iiyz
誠	iijx
誡	iitx
誢	iigw
誣	iiiv
誤	iioy
誥	iijo
誦	iidf
誨	iils
誩	iii
說	iivw
誫	iijk
説	iivw
読	iilw
誮	iiht
誯	iibb
誰	iiti
誱	iitl
課	iibm
誳	iipe
誴	iinm
誵	iixd
誶	iidx
誷	iinl
誸	iizw
誻	iisb
誼	iinf
誽	iigw
誾	nni
調	iino
諀	iigx
諁	iiaa
諂	iirg
諃	iimm
諄	iidz
諅	hevi
諆	iihv
談	iixx
諉	iihr
諊	iisx
請	iild
諌	iitm
諍	iiri
諎	iihb
諏	iipa
諐	tomi
諑	iixd
諒	iidm
諓	iixx
諔	iila
諕	iiyw
論	iivh
諗	iivu
諘	iilk
諙	iicb
諚	iinl
諛	iigv
諜	iihm
諝	iijd
諞	iidh
諟	iibl
諠	iint
諡	iivq
諢	iinc
諣	iiqo
諤	iios
諥	iijl
諦	iidi
諧	iiug
諨	iitq
諩	iivt
諪	iidt
諫	iitm
諬	hxli
諭	iivn
諮	iivo
諯	iien
諰	iiqu
諱	iizi
諲	iicl
諳	iidb
諴	iijx
諶	iihl
諷	iiwq
諸	iiyb
諹	iibs
諺	iids
諻	iige
諼	iija
諽	iihp
諾	iiho
諿	iiop
謀	iihm
謁	iibl
謂	iiqd
謃	iibl
謄	dvyi
謅	iisj
謆	iidj
謈	bhvi
謉	iigg
謊	iihm
謋	iidm
謌	iito
謍	xxni
謎	iixz
謏	iiga
謐	iiuq
謑	iijy
謒	iivo
謓	iixv
謔	iiyt
謕	iijw
謖	iiqa
謗	iidh
謘	iipx
謙	iivm
謚	iivq
講	iifl
謜	iijm
謝	iird
謞	iido
謟	iijg
謠	iidu
謡	iiju
謢	iita
謣	iius
謤	iicm
謥	iiju
謧	iidg
謨	iihy
謩	hbyi
謪	iido
謫	iido
謬	iijs
謭	iivd
謮	iilv
謯	iiyf
謰	iicz
謱	iior
謲	iigs
謳	iico
謴	iiqv
謵	iijg
謶	iijh
謷	lhai
謸	iila
謹	iihl
謻	iihd
謼	iiyi
謽	zsoi
謾	iiba
謿	iixd
譀	iija
譁	iihf
譂	iiox
譃	iiyt
譄	iivb
譅	iidl
譆	iilo
譇	iiyb
譈	iida
證	iixv
譊	iilw
譋	iind
譌	iijh
譍	jtti
譎	iido
譏	iiwx
譐	iivd
譑	iijo
譒	iijq
譓	iitu
譔	iiev
譕	iilh
譖	iicb
譗	iiko
識	iidx
譙	iith
譚	iicx
譛	iifb
譜	iivb
譝	iiq
譞	iiqk
譟	iiom
譠	iidt
譡	iiwq
譢	iivz
譣	iivv
譤	iiga
譥	gdhi
譧	iijm
譨	iiuk
譩	iidu
譪	iihl
譫	iiri
譭	iiga
譮	iivb
議	iivx
譱	vfii
譲	iidk
譳	iiun
譴	iiqz
譵	iiwd
譶	iii
護	iiha
譸	iild
譹	iidx
譺	iitl
譻	gvgi
譼	gkqi
譽	jksi
譾	iivj
譿	iifu
讀	iilv
讁	iidz
讂	iira
讃	iifv
讄	iiqq
讅	iinq
讆	szii
讇	iing
讈	iijl
讉	iiqz
變	wmia
讌	iihh
讍	iieo
讎	tiii
讏	szii
讐	titi
讑	iivh
讒	iird
讓	iidk
讔	iipu
讕	iinm
讖	iivx
讗	iieo
讘	iipp
讙	iihi
讚	iijv
讛	iihg
讜	iiwh
讝	iioa
讞	iiyd
讟	iili
讬	ijt
讱	idd
讻	ixu
诇	ino
诪	ifxd
谉	inbi
谞	ijld
谸	jxvo
谹	vvog
谺	vvoj
谻	vvof
谼	vvov
谽	vvoo
谾	vvoi
豀	vvoy
豂	vvos
豃	vvoa
豄	vvov
豅	vvoe
豈	etov
豊	utov
豋	xtov
豍	tovx
豎	gatv
豏	tovm
豐	ffev
豑	utoj
豒	ffej
豓	ffeq
豔	ffeq
豖	xd
豗	twx
豘	xtul
豙	dx
豛	xwa
豜	xth
豝	xdl
豞	xso
豟	xdpz
豠	xqf
豣	xff
豤	xek
豥	xdyv
豦	yx
豧	xtdd
豩	xx
豬	xyb
豮	xxhb
豯	xjwy
豰	lnfa
豱	xbq
豲	xjgm
豴	xdno
豵	xsvl
豶	xxhv
豷	xlnv
豻	jf
豼	ju
豽	jnv
豾	jjyt
豿	jso
貀	jue
貁	jnv
貃	jg
貄	jef
貆	jtbt
貇	jek
貈	jns
貋	jbf
貎	jgw
貏	jgjx
貐	jvtn
貑	jpfa
貒	jejn
貓	jhq
貕	jjwy
貖	jvvq
貗	jotr
貙	jcoo
貚	joox
貛	jhoi
貜	jgga
貝	gv
貞	ygv
貟	ggv
負	rgv
財	gvxj
貢	igv
貣	vgv
貤	gvc
貥	gvdw
貦	gvfw
貧	vdgv
貨	ttgv
販	gvja
貪	vjgv
貫	qxgv
責	lgv
貭	jjxv
貮	fgvv
貯	gvnt
貰	hlgv
貱	gvja
貲	ltgv
貳	tfgv
貴	qgv
貵	gygv
貶	gvjz
買	qgv
貸	tvgv
貹	gvjl
貺	gvow
費	zsnv
貼	gvyo
貽	gvgo
貾	gvcd
貿	gdgv
賀	jogv
賁	xhgv
賂	gvao
賃	tjlv
賄	gvxd
賅	gvdv
賆	gvvh
資	vrvv
賈	cgv
賉	gvjq
賊	gvtx
賋	gvdx
賌	dyvv
賍	gvjl
賎	gvex
賏	gvgv
賐	gvga
賑	gvjk
賒	gvvm
賔	ndjv
賕	gvxd
賖	gvvm
賗	gvoi
賘	gvjd
賙	gvno
賛	fvfv
賜	gvbs
賝	gvnm
賞	wnov
賟	gvuv
賠	gvdo
賡	jevv
賢	gagv
賣	lqgv
賤	gvxx
賥	gvdx
賦	gvfv
賧	gvxx
賨	nfmv
賩	gvnm
質	jjtv
賫	xvvv
賬	gvk
賭	gvyb
賯	gvsz
賰	gveb
賱	gvnc
賲	tomv
賳	gvlx
賴	tomv
賶	gvvo
賷	xoov
賹	gvvq
賺	gvvm
賻	gvtd
購	gvfl
賽	nfnv
賾	glgv
賿	gvjs
贀	clyv
贁	gvga
贂	gvgs
贅	lhav
贆	gvyd
贇	dxfv
贈	gvvb
贉	gvcx
贊	jlwv
贋	jttv
贌	gvwv
贍	gvri
贎	gvhg
贐	gveq
贑	dbxv
贒	goiv
贓	gvkx
贔	gvgv
贕	cypv
贖	gvlv
贗	jtgv
贘	gvwv
贙	ywyv
贚	gvde
贛	dbxv
贜	gvhx
贠	gb
赇	bxxd
赑	bbb
赒	bnlo
赕	bxx
赥	lmrv
赨	lmq
赩	lmrl
赪	lmyb
赬	lmyv
赮	lmpa
赱	lvz
赲	llj
赸	lle
赹	llsv
赺	llvj
赻	llmj
赼	llrv
赽	llzv
赾	lljt
赿	llcv
趀	llsj
趂	llrm
趃	llkv
趆	llcd
趇	lld
趈	llyo
趉	llue
趍	lldd
趎	llkm
趏	lljo
趐	lljj
趒	llvv
趓	llwm
趕	llbf
趖	llvl
趗	llol
趘	llpl
趙	llwd
趚	lltm
趛	llv
趜	llsx
趝	llvu
趞	llhb
趠	llyx
趡	llti
趢	lles
趤	llnc
趥	llvu
趦	llvo
趧	llbl
趨	llsj
趩	llqv
趪	llhv
趫	lljo
趬	lllw
趭	llth
趮	llom
趰	lltx
趲	lljv
趶	olf
趹	olzv
趻	olvj
趽	oldh
跀	old
跁	oldl
跂	olxa
跅	oljd
跇	olhl
跈	olvs
跉	olvd
跊	olfm
跍	olxo
跐	ollt
跒	olto
跓	olde
跔	olso
跕	olyo
跘	olvx
跙	olqf
跜	olpt
跠	oltv
跡	oldm
跢	oldd
跥	olzm
跧	olve
跩	olbx
跭	olai
跮	oltl
跰	olvh
跱	olld
跲	olvo
跴	olc
跾	tial
跿	olll
踀	olol
踁	olti
踂	olpl
踃	olwd
踄	oly
踆	olga
踇	olls
踈	oltm
踋	ollp
踍	olyz
踐	olxx
踑	olhv
踒	olhr
踓	olti
踕	oltl
踖	olhb
踗	olvu
踘	olsx
踙	olpa
踚	olvh
踛	olll
踜	olla
踠	olnc
踤	oldx
踥	oldr
踦	olyo
踧	olla
踨	olvl
踰	olvn
踲	oljg
踳	oleb
踴	oldj
踶	olbl
踷	olyb
踸	olhl
踻	olqo
踼	olbs
踾	oltq
踿	olhx
蹃	olho
蹅	olmt
蹆	olez
蹌	olvo
蹍	olpk
蹎	olxv
蹏	oljw
蹐	olxd
蹔	ccjl
蹕	olbf
蹖	oleg
蹗	olju
蹚	olwl
蹛	olhi
蹜	olnb
蹝	olsl
蹞	oltv
蹟	ollv
蹠	oljh
蹡	olkd
蹢	oldo
蹣	olhd
蹤	olsl
蹥	olcz
蹧	olub
蹨	oldh
蹪	olqv
蹫	oldo
蹮	olce
蹱	oldl
蹳	olxa
蹵	doml
蹷	jvul
蹸	olxi
蹹	olvj
蹺	ollw
蹻	oljo
蹽	olym
蹾	olda
躂	ollz
躃	olpx
躄	podl
躆	olyx
躈	olga
躉	hbnl
躊	olld
躋	oldh
躌	olli
躍	olji
躎	oltx
躑	olvp
躒	olwm
躓	oljv
躕	oljd
躗	szil
躘	olde
躙	olni
躚	olcz
躛	szil
躟	oldk
躠	hjpl
躡	olpp
躢	olnj
躣	olgi
躤	olhb
躥	olnv
躦	oljv
躧	oltu
躨	olva
躩	olga
躪	olhi
躭	rpl
躮	rvd
躰	rmt
躱	rzjm
躳	roo
躴	rdek
躵	rddu
躶	rbm
躷	rhr
躸	ryto
躹	rsx
躻	rnvi
躼	rk
躾	rvey
躿	rjes
軀	rcoo
軁	rotr
軂	rxxj
軃	roox
軄	rdbx
軅	rjti
軆	rutv
軇	rljd
軈	rjtu
軉	rnev
車	cii
軋	ccl
軌	ccx
軍	nc
軏	cctw
軐	cczx
軑	ccy
軒	ccf
軓	ccwd
軔	ccdd
軕	cce
軖	cce
軗	ccwa
軘	cctl
軙	ccya
軛	ccjc
軜	ccnv
軝	cccv
軞	ccjl
軟	ccrv
軠	ccjl
軡	ccvj
転	ccfg
軣	cx
軤	ccji
軥	ccso
軦	ccow
軧	cccd
軨	ccvd
軩	ccgo
軪	ccwj
軫	ccvs
軬	gyc
軭	ccce
軮	ccny
軯	ccti
軰	ktc
軱	ccjn
軲	ccxo
軳	ccse
軴	ccde
軵	cctd
軶	ccdz
軷	ccxd
軸	ccd
軹	ccov
軺	ccdo
軻	ccto
軼	cckv
軽	ccal
軾	cctv
軿	ccvh
輀	ccjn
輁	cchv
輂	hvc
較	ccdx
輄	ccww
輅	ccao
輆	ccdv
輇	ccve
輈	ccns
載	lcx
輊	cctl
輋	eyc
輌	ccte
輍	ccvo
輎	ccwd
輏	ccu
輐	ccnw
輑	cceo
輒	ccpl
輓	ccrw
輔	cctd
輕	ccti
輖	ccno
輗	ccgw
輘	ccla
輙	ccpa
輚	ccxx
輛	cctd
輜	ccsq
輝	wwnc
輞	ccnl
輟	ccaa
輠	ccbm
輡	ccrg
輢	ccyo
輣	ccdd
輤	ccld
輥	ccbu
輦	fvfc
輧	ccjf
輨	ccnz
輪	ccvh
輬	ccdm
輭	ccjy
輮	ccdm
輯	ccop
輰	ccbs
輱	ccjx
輲	ccen
輳	ccey
輴	ccjg
輵	ccbl
輶	ccvu
輷	ccsi
輸	ccvn
輹	ccla
輻	cctq
輼	ccbq
輽	ccgq
輾	ccpk
輿	jkcv
轀	ccqq
轁	ccjg
轂	lnta
轃	cceh
轄	ccno
轅	cclk
轆	ccju
轇	ccjs
轈	ccsm
轉	cctd
轊	ccfe
轋	cccz
轌	ccue
轍	ccda
轎	ccjo
轏	ccpz
轐	ccwv
轑	ccym
轒	ccxv
轓	ccjq
轔	ccxi
轕	cchl
轖	ccxo
轗	ccju
轘	ccqk
轙	ccvx
轚	cuwc
轛	ccwd
轜	ccun
轝	jksc
轞	ccgq
轟	ccc
轠	ccqq
轡	wmco
轢	ccwm
轣	ccjl
轤	ccyq
轥	cchi
轪	cy
辀	cns
辁	cve
辌	cdom
辒	cbq
辝	godx
辠	jgdx
辡	dxdx
辢	tomx
辤	jnax
辥	ujjx
辦	dxjx
辧	dxdx
辪	ljpx
辬	dxdx
辭	jdnx
辮	dxwx
辯	dxix
農	ujfk
辳	mmjk
辴	oobk
辵	sl
辷	tz
辸	zjz
辺	dz
辻	xz
込	jnz
辿	ez
迀	fz
迃	fsz
迊	tniz
迋	ez
迌	dz
迍	tulz
迏	ydz
迒	dwz
迖	ydz
迗	tyz
迚	oiz
迠	yoz
迡	ptz
迣	hlz
迧	biz
迬	dez
迯	dyz
迱	ntz
迲	lgz
迴	qoz
迵	ntoz
迶	xdz
迻	ddz
迼	loz
迿	sbz
逇	lcz
逈	jnoz
逌	yqzz
逎	uz
逓	jjfz
逕	tsiz
逘	glyz
這	iz
逜	woz
連	cz
逤	smjz
逥	qnfz
逧	vvoz
逩	yxhz
逪	hbz
逫	aaaz
逬	jfjz
逰	flzz
週	nloz
進	tiz
逳	dgdz
逴	ybxz
逷	bssz
逺	lykz
逽	hxoz
遀	xidz
遃	djsz
遅	pvfz
遆	dnnz
遈	btlz
遉	ygvz
遊	dhlz
運	ncz
遌	oofz
過	qoz
達	lvfz
違	zioz
遙	dlxz
遚	giaz
遜	zjwz
遞	jjyz
遟	pdxz
遠	lokz
遡	vujz
遤	shz
遦	qxgz
遧	dbxz
適	dnxz
遪	gggz
遫	tomz
遬	tomz
遱	otoz
遲	pskz
遳	hvvz
遶	lllz
遷	cyez
選	eehz
遹	dtjz
遺	qgvz
遻	oovz
遼	yvbz
遾	kivz
邁	hbnz
還	qtoz
邅	dqoz
邆	xtoz
邇	tvnz
邉	jgnz
邊	jgnz
邌	hsjz
邍	aqez
邎	dijz
邏	qwmz
邐	tndz
邒	tp
邔	zlp
邖	ep
邘	fp
邚	rp
邜	dp
邞	fvp
邟	dwp
邠	vdp
邤	jjtp
邥	plp
邧	fwp
邩	xp
邫	fodl
邭	sop
邲	ujp
邷	tlzp
邼	cep
邽	llp
邿	lxdp
郀	yfsp
郂	dyvp
郆	lop
郈	jjtp
郉	ffp
郋	jgp
郌	llol
郍	nsp
郒	degl
郔	jlzp
郕	jjxp
郖	tovp
郘	oop
郙	tdip
郚	wop
郞	dekp
郠	tbxp
郣	xnzp
郤	vvop
郥	gvp
郩	xxdp
郪	teip
郬	ldp
郮	nlop
郰	pap
郱	vhp
郳	gwp
郶	dool
郷	wjep
郹	gydp
郺	ddsl
郻	glsp
郼	ziop
郿	djgp
鄀	hxop
鄁	ktdp
鄃	vtdp
鄅	jonp
鄆	ncp
鄇	tzlp
鄈	xtyp
鄉	wjdp
鄊	wjpp
鄋	giap
鄌	jeip
鄍	nbdp
鄎	jgup
鄏	jfkp
鄐	dwqp
鄑	twtp
鄒	sujp
鄓	jgyp
鄔	jztp
鄕	wjgp
鄖	ogvp
鄚	hbyp
鄛	sbmp
鄜	jznp
鄝	jjvp
鄟	tbgp
鄠	ufsp
鄡	gmp
鄤	bqap
鄥	ghp
鄦	lhhp
鄧	xtop
鄨	vnml
鄩	eiop
鄪	zsnp
鄫	vqbp
鄬	jjjp
鄭	vuyp
鄮	gdgp
鄰	xdcp
鄲	oobp
鄳	qp
鄴	wtvp
鄵	ooop
鄶	vtqp
鄷	utop
鄸	hqnp
鄺	jhdp
鄻	fvfp
鄼	fvfp
鄽	jblp
鄿	hoop
酁	roup
酂	jlwp
酄	hoop
酅	etip
酇	jlwp
酈	tndp
酏	uc
酑	uf
酓	vju
酔	uxx
酕	ujfl
酖	upl
酘	uwa
酙	uddx
酛	ufw
酜	ufv
酟	uyo
酠	uto
酧	unxd
酨	lux
酫	uve
酭	uxd
酳	uwd
酺	utdd
酻	ujz
酼	udgm
醀	uti
醁	ues
醂	umm
醃	uybl
醄	uslu
醆	uxx
醈	uxx
醊	uaaa
醎	ujtx
醏	uyb
醓	uplq
醔	hxu
醕	udob
醖	ubq
醘	ulgq
醙	ugia
醜	ugwg
醝	uvfi
醞	uqvq
醟	xxnu
醠	unyq
醡	unvk
醤	kjxu
醥	ucfm
醦	uggs
醧	ucoo
醨	udxg
醩	uub
醫	clyu
醬	kdxu
醰	ucbx
醱	uxza
醲	uujk
醶	uvtv
醷	udbu
醸	udvk
醹	uujn
醻	uljd
醽	uuoo
醾	ujmx
醿	ujmm
釀	udok
釁	jknd
釂	ujqd
釃	utnu
釄	ujme
釅	uooa
釈	jxpn
釐	fmal
釒	vii
釓	vvl
釔	vvz
釕	vvj
釖	vvd
釗	vvn
釘	vvt
釙	vvy
釚	vvx
釛	vvj
針	vvx
釞	vvjn
釟	vvv
釠	vvw
釡	vv
釢	vvzj
釣	vvsd
釤	vvs
釥	vvm
釦	vvo
釧	vvm
釨	vvz
釩	vvwd
釪	vvf
釫	vvfs
釬	vvf
釮	vvxj
釯	vvdl
釰	vvdd
釱	vvy
釲	vve
釳	vvlz
釴	vvv
釵	vvad
釶	vvc
釷	vvl
釸	vvd
釹	vvr
釺	vvjx
釻	vvxd
釼	vvdn
釽	vvj
釾	vvcj
釿	vvjt
鈀	vvdl
鈁	vvdh
鈂	vvpl
鈃	vvth
鈄	vvdx
鈅	vvd
鈆	vvvg
鈇	vvfv
鈈	vvjy
鈉	vvnv
鈊	vvu
鈋	vvtt
鈌	vvzv
鈍	vvtl
鈎	vvsg
鈏	vvzi
鈐	vvvj
鈑	vvja
鈒	vvjn
鈓	vvjl
鈔	vvmj
鈕	vvjt
鈖	vvvd
鈗	vvgw
鈘	vvxa
鈙	vvya
鈚	vvu
鈛	vvx
鈜	vvxg
鈝	vvki
鈞	vvsv
鈟	vvzi
鈠	vvwa
鈡	vvoi
鈢	vvm
鈣	vvts
鈤	vvb
鈥	vvx
鈦	vvyd
鈧	vvdw
鈨	vvfw
鈩	vvdp
鈫	vvdx
鈬	vvpn
鈭	ltv
鈮	vvpt
鈯	vvue
鈰	vvdi
鈱	vvpv
鈲	vvjn
鈳	vvto
鈴	vvvd
鈵	vvtv
鈶	vvgo
鈷	vvxo
鈸	vvxd
鈹	vvja
鈺	vved
鈻	vvpz
鈼	vvlk
鈽	vvxi
鈾	vvd
鈿	vvq
鉀	vvq
鉁	vvvs
鉂	vvox
鉃	vvly
鉄	vvkv
鉅	vvg
鉆	vvyo
鉇	vvlc
鉈	vvnt
鉉	vvdw
鉊	vvdo
鉋	vvse
鉌	vvh
鉍	vvuj
鉎	vvjl
鉏	vvqf
鉐	vvc
鉑	vvg
鉒	vvde
鉓	vvli
鉔	vvci
鉕	vvco
鉖	vvad
鉗	vvhf
鉘	vvzn
鉙	vvov
鉚	vvcp
鉛	vvwo
鉜	vvtd
鉝	vvd
鉞	vvcx
鉟	vvjt
鉠	vvny
鉡	vvvx
鉢	vvmt
鉣	vvlg
鉤	vvso
鉥	vvmd
鉦	vvtl
鉧	vvqs
鉨	vvrm
鉩	vvvm
鉪	vvhl
鉫	vvjo
鉬	vvg
鉭	vvbt
鉮	vvbi
鉯	vvlv
鉰	vvjo
鉱	vvjg
鉲	vvly
鉳	vvkt
鉵	vvq
鉶	vvtn
鉷	vvhv
鉸	vvdx
鉹	vvdd
鉺	vvp
鉻	vvao
鉽	vvtv
鉾	vvgi
鉿	vvvo
銀	vvek
銁	vvsb
銂	vvyy
銃	vvdw
銄	vvjo
銅	vvno
銆	vvjb
銇	vvem
銈	vvll
銉	vvef
銊	vvjx
銋	vvtl
銌	vvxz
銍	vvtl
銏	vvnt
銐	tdnv
銑	vvjw
銒	vvff
銓	vvve
銔	vvjx
銕	vvtv
銖	vvkm
銗	vvjo
銘	vvdo
銙	vvys
銚	vvvv
銛	vvjo
銜	svfi
銝	vvtm
銞	sbv
銟	vvei
銠	vvyt
銡	vvlo
銢	vvfs
銣	vvro
銤	vvx
銥	vvdk
銦	vvqy
銧	vvww
銨	vvnr
銩	vvjg
銪	vvxd
銫	vvrl
銬	vvys
銭	vvex
銯	vvwm
銰	vvhx
銱	vvoi
銳	vvvw
銴	fjjv
銵	vvr
銶	vvxd
銷	vvwd
銸	vvpl
銹	vvhj
銺	klv
銻	vvvj
銼	vvvl
銽	vvco
銾	vvis
銿	vvdf
鋀	vvtv
鋁	vvoo
鋂	vvls
鋃	vvdk
鋄	vvta
鋅	vvdx
鋆	lsvv
鋇	vvgv
鋉	vvtm
鋊	vvvo
鋋	vvjz
鋌	vvjz
鋍	vvxz
鋎	vvnw
鋏	vvtv
鋐	vvng
鋑	vvga
鋒	vvaf
鋓	vvhn
鋔	vvrw
鋕	vvlu
鋖	vvjr
鋗	vvod
鋘	vvoy
鋙	vvwo
鋚	tiav
鋛	vvoi
鋜	vvol
鋝	vvjd
鋞	vvti
鋟	vvea
鋠	vvjk
鋡	vvvo
鋢	vvjz
鋣	vvcp
鋤	vvqj
鋥	vvoe
鋦	vvpo
鋧	vvgw
鋨	vvjx
鋩	vvhl
鋪	vvtd
鋫	hnv
鋬	fjjv
鋭	vvvw
鋮	vvjx
鋯	vvjo
鋰	vvbl
鋱	vvtv
鋲	vvgv
鋳	vvfd
鋴	vvxw
鋵	vvhw
鋶	vvdm
鋷	vvpa
鋸	vvpo
鋹	vvk
鋺	vvnc
鋻	gav
鋼	vvne
鋽	vvyx
鋾	vvsu
鋿	vvwo
錀	vvvh
錁	vvbm
錂	vvla
錃	sjav
錄	vvls
錅	hsjv
錆	vvld
錇	vvdo
錈	vvvc
錉	vvcb
錊	vvdx
錋	vvdd
錌	vvef
錍	vvgx
錎	vvrg
錏	vvtt
錐	vvti
錑	vvdd
錒	vvpo
錓	vvvl
錔	vvsb
錕	vvbu
錖	lmav
錗	vvhr
錙	vvsq
錚	vvri
錛	vvyh
錜	vvvu
錝	vvnm
錞	vvdz
錟	vvxx
錠	vvnl
錡	vvyo
錢	vvxx
錣	vvaa
錤	vvhv
錥	vvdd
錦	vvgi
錧	vvnz
錨	vvhq
錩	vvbb
錪	vvuv
錫	vvbs
錬	vvtm
錭	vvno
錮	vvqo
錯	vvhb
錰	vvmh
錱	vee
録	vves
錳	vvzq
錴	vvll
錵	vvht
錶	vvlk
錷	vvcl
錹	vvld
錺	vvhh
錻	vvfv
錼	vvym
錽	vvta
錿	vvyw
鍀	vvbd
鍁	vvjv
鍂	vvv
鍃	vvsu
鍄	vvdm
鍅	vvsg
鍆	vvn
鍇	vvug
鍈	vvhy
鍉	vvbl
鍊	vvtm
鍋	vvqo
鍌	sjlv
鍍	vvja
鍎	vvjg
鍏	vvzi
鍐	vvxa
鍑	vvla
鍒	vvdm
鍓	vvop
鍔	vvos
鍕	vvnc
鍖	vvhl
鍗	vvdi
鍘	vvgn
鍙	shvv
鍚	vvbs
鍛	vvja
鍜	vvpa
鍝	vvbg
鍞	vvyv
鍟	vvbl
鍠	vvge
鍡	vvqk
鍢	vvtq
鍣	vvho
鍤	vvjg
鍥	vvfy
鍦	vvdc
鍧	vvsi
鍨	vvxy
鍩	vvho
鍫	hxv
鍬	vvhx
鍭	vvty
鍮	vvvn
鍯	vvsu
鍰	vvja
鍱	vvhm
鍲	vvpb
鍳	gkv
鍴	vven
鍵	vvez
鍶	vvqu
鍷	vvyl
鍸	vvxd
鍹	vvnt
鍺	vvyb
鍻	vvbl
鍼	vvjx
鍽	vvdh
鍾	vvjl
鍿	vvtq
鎀	vvts
鎁	vvpp
鎂	vvvy
鎃	vvsk
鎄	vvdk
鎆	vvvn
鎇	vvdg
鎈	vvvi
鎉	vvbj
鎊	vvdh
鎋	vvno
鎌	vvvm
鎍	vvxm
鎎	vvkx
鎐	vvju
鎑	vvlq
鎒	vvjd
鎓	vvvj
鎔	vvno
鎕	vvjo
鎖	vvwv
鎘	vvty
鎙	vvvd
鎚	vvjz
鎛	vvtd
鎜	nswv
鎝	vvho
鎞	vvju
鎟	vvam
鎠	vvql
鎡	vvvw
鎢	vvjh
鎣	xxnv
鎤	vvbw
鎥	tiav
鎦	vvgq
鎧	vvev
鎨	vvtx
鎩	vvxa
鎪	vvga
鎫	vvja
鎬	vvdo
鎭	vvtv
鎮	vvxv
鎯	vvdp
鎰	vvvq
鎱	vvlk
鎲	vvww
鎳	vvjm
鎴	vvju
鎵	vvnx
鎶	vvto
鎷	vvsh
鎸	vvtj
鎹	vvvz
鎺	vvjf
鎻	vvsv
鎼	vvyf
鎽	vvef
鎾	vvbq
鎿	vvvf
鏀	vvyd
鏁	vvsm
鏂	vvco
鏃	vvdy
鏄	vvtd
鏅	vvtd
鏆	vvqv
鏇	vvdl
鏈	vvcz
鏉	vvtv
鏋	vvhd
鏌	vvhy
鏍	vvqm
鏎	vvbf
鏏	vvfe
鏐	vvjs
鏑	vvdo
鏒	vvgs
鏓	vvju
鏔	vvnv
鏕	vvju
鏗	vvgl
鏘	vvkd
鏙	vvei
鏚	vvjx
鏛	vvwi
鏜	vvwl
鏝	vvba
鏞	vvji
鏟	vvdl
鏠	vvaz
鏡	vvdw
鏢	vvcm
鏣	vvjh
鏤	vvor
鏥	vvnb
鏦	vvsl
鏧	ldjv
鏨	ccjv
鏩	vvct
鏪	vvub
鏫	vvhm
鏬	vvyi
鏭	vvju
鏮	vvjs
鏯	vvyx
鏰	vved
鏱	vvdx
鏲	vvdi
鏳	vvvb
鏴	vvoo
鏵	vvhf
鏶	vvtm
鏷	vvwv
鏸	vvtu
鏹	vvzq
鏺	vvxa
鏻	vvxi
鏼	vvkm
鏽	vvek
鏾	vvha
鏿	vvwm
鐀	vvqv
鐁	vvht
鐂	vvtq
鐃	vvlw
鐄	vvhv
鐅	vnmv
鐆	pvxv
鐇	vvjq
鐈	vvjo
鐉	vvev
鐊	vvps
鐋	vvss
鐌	vvrx
鐍	vvdo
鐎	vvth
鐏	vvvd
鐐	vvym
鐑	vvwo
鐒	vvxj
鐓	vvda
鐔	vvcx
鐕	vvcb
鐖	vvwx
鐗	vvnd
鐘	vvdl
鐙	vvxv
鐚	vvtu
鐛	vvbm
鐜	dozv
鐝	vvjv
鐞	vved
鐟	vvfb
鐠	vvvb
鐡	vvlx
鐢	mxxv
鐣	vvwf
鐤	vvgk
鐥	vvvo
鐦	vvnh
鐧	vvnb
鐨	vvzv
鐩	vvvz
鐪	vvyj
鐫	vvtm
鐬	vvlx
鐭	vvjy
鐮	vvjm
鐯	vvhb
鐰	vvom
鐱	vvvv
鐲	vvqq
鐳	vvuq
鐴	vvpx
鐵	vvlx
鐶	vvqk
鐷	vvhm
鐹	vvqz
鐺	vvwq
鐻	vvyx
鐼	vvxv
鐽	vvlz
鐿	vvdu
鑀	vvja
鑁	vvda
鑂	vvjh
鑃	vvji
鑄	vvld
鑅	vvxm
鑆	vvwd
鑇	vvdh
鑈	vvtx
鑉	vvhq
鑊	vvha
鑋	cctv
鑌	vvnv
鑍	gvgv
鑎	vvcv
鑏	vvnt
鑐	vvun
鑑	vvgq
鑒	gkqv
鑓	vvqz
鑔	vvnm
鑕	vvjv
鑖	vvhx
鑗	vvhs
鑘	vvqq
鑙	vvhb
鑚	vvfv
鑛	vvjv
鑜	vvwv
鑝	vvhz
鑞	vvsv
鑟	vvlv
鑠	vvwm
鑡	vvlu
鑢	vvyu
鑣	vvjh
鑥	vvrb
鑦	vvgv
鑧	vvnd
鑨	vvde
鑩	vveo
鑬	vvgw
鑭	vvnm
鑮	vvhd
鑯	vvvx
鑰	vvvh
鑱	vvrd
鑲	vvdk
鑳	vvnl
鑴	vveo
鑵	vvhi
鑶	vvhx
鑷	vvpp
鑸	vvql
鑹	vvnv
鑺	vvgi
鑻	vvmf
鑼	vvqi
鑽	vvjv
鑾	wmiv
鑿	wtvv
钀	vvyd
钁	vvga
钂	vvwh
钃	vvpq
钄	vvhm
钘	vth
铏	vthn
铑	vyt
铓	vhdl
铔	vtwt
铚	vtgl
铦	vjxo
铻	vwo
铽	vtuv
锠	vbb
锧	vjjb
锳	vhny
锽	vge
镃	vvww
镈	vtdd
镋	vwnw
镮	vqtk
镴	vsqv
镵	vrod
長	kii
镸	kii
镹	krn
镺	kjy
镻	kkv
镼	kpue
镽	kyvm
镾	ktvx
門	nii
閁	nnj
閂	nnt
閃	nnv
閄	nnv
閅	nnt
閆	nne
閇	nntd
閈	nnf
閉	nnxj
閊	nne
開	nnth
閌	nndw
閍	nndh
閎	nnxg
閏	nne
閐	nnjl
閑	nnm
閒	nnd
間	nnb
閔	nndx
閕	nncj
閖	nns
閗	nndx
閘	nnq
閙	nndi
閚	nnd
閛	nnti
閜	nnto
閝	nnvd
閞	nngh
閟	nnuj
閠	nned
閡	nndv
関	nnvy
閣	nnao
閤	nnvo
閥	nntx
閦	nnvv
閧	nnhv
閨	nnll
閩	nnq
閫	nnqm
閬	nndk
閭	nnoo
閮	nnjz
閯	nnsj
閰	nng
閱	nnvw
閲	nnvw
閳	nnc
閴	nngv
閵	nnti
閶	nnbb
閷	xmnv
閸	nntt
閹	nnyl
閺	nnbx
閻	nnrg
閼	nndd
閽	nncb
閾	nntx
閿	nnja
闀	nnhe
闁	nnn
闂	nnvc
闃	nngd
闄	nncr
闅	nnga
闆	nnoo
闇	nndb
闈	nnzi
闉	nncl
闊	nnso
闋	nnxy
闌	nntm
闍	nnyb
闎	nngs
闏	nnwq
闐	nnxv
闑	nnjm
闒	nnbj
闓	nnev
闔	nnlq
闕	nnvv
闖	nnsh
闗	nnwh
闘	nntd
闚	nnfw
闛	nnwl
關	nnwh
闝	nnga
闞	nnja
闟	nnvj
闠	nnqv
闡	nnox
闢	nnpx
闣	nnwq
闤	nnqk
闥	nnlz
闦	nnuv
闧	nnlz
闬	nf
闿	nezl
阇	nyb
阓	nqb
阘	nbjj
阛	nqtk
阞	pj
阠	pzx
阣	plz
阤	pc
阥	ps
阦	px
阧	pddx
阨	pjc
阩	pjh
阫	pjy
阭	pgw
阯	pl
阰	pu
阷	ptl
阸	pdpz
阹	plg
阺	pctd
阾	pvjd
陁	plc
陃	ptnv
陊	pdd
陎	pkm
陏	pxd
陑	pjnn
陒	prjc
陓	pyfs
陖	pgva
陗	pwd
陘	ptsi
陙	pjfk
陚	pflv
陝	ptjv
陞	pjhl
陠	ptdd
陣	pc
陥	prib
陦	pfxd
陭	pyto
陮	pti
陯	pvth
陰	pvjg
陱	psx
陳	ptbm
陸	plvl
陹	pjhb
険	pvtv
陻	pcl
陼	pyb
陾	pjny
陿	pctv
隀	pjtl
隁	pcbr
隂	pvk
隃	pvtn
隇	pjtx
隉	pgi
隊	pvx
隌	pdb
階	pug
隑	petv
隒	pvem
隓	pxii
隕	pogv
隖	pjzh
隚	pwnl
際	pxfm
隝	pgh
隞	plha
隟	psbm
隠	pjeu
隡	pdjl
隢	pllw
隣	pxdi
隤	pqgv
隥	pxtv
隦	ppox
隨	pxiz
隩	pjny
險	pvtv
隫	pxhv
隬	ptvx
隭	pujn
隮	pddh
隯	pljd
隱	pjiu
隲	pmjh
隴	pdde
隵	pytx
隷	lfms
隸	mfms
隺	pii
隻	tia
隿	vti
雂	vjti
雃	thti
雈	hti
雋	tim
雐	yti
雑	xmti
雓	vtmi
雔	titi
雖	oqti
雗	xbxi
雘	ndha
雙	tita
雚	hooi
雛	suji
雜	dvvi
雝	sodi
雞	jwyi
雟	ujto
雡	jjvi
離	dxui
難	hofi
雤	jkxi
雥	titi
雦	titi
雧	titm
雫	utd
雬	um
雭	ujzn
雮	ujfl
雰	uvd
雱	udh
雲	ufg
雴	ud
雵	uny
雸	uhf
雺	udtj
電	ubl
雼	uc
雽	ujvi
雿	uvwv
霂	usm
霃	uspl
霅	ui
霊	ufwt
霋	uter
霌	unlo
霐	uszg
霒	ufgj
霔	usde
霕	ufgl
霗	usvd
霘	usno
霙	uhny
霚	udta
霛	uzss
霝	uooo
霟	ushv
霡	uddx
霢	udjk
霣	uogv
霥	unfx
霦	umms
霧	udtj
霨	upfd
霩	udop
霫	ujjg
霬	uqhv
霮	ushl
霯	uxtv
霱	udto
霳	upal
霴	ufgs
霵	uopx
霶	usdh
霷	ubbs
霺	usea
霻	uutv
霼	ufgx
霽	uddh
霿	udtg
靀	uhnx
靁	uqqq
靂	ujhl
靃	utii
靄	uibl
靅	ufgv
靆	ufgz
靇	udde
靈	uoov
靉	ufga
靊	uffv
靋	usjl
靌	unev
靍	utih
靎	uvgh
靏	upih
靐	uquq
靔	ldkz
靕	tlld
靗	ldww
靘	ldrl
靚	ldgw
靜	ldji
靝	ldkx
靣	jqo
靤	jqne
靦	jqnw
靧	jqnv
靨	jbdf
靪	hpt
靫	hpad
靬	hpf
靭	hpdd
靮	hpsd
靯	hpl
靰	hptw
靱	hpdn
靲	hpvj
靵	hpjt
靷	hpzi
靹	hpnv
靺	hptm
靻	hpqf
靽	hpvx
靾	hphl
靿	hpwj
鞀	hpdo
鞁	hpja
鞂	hph
鞃	hpzg
鞄	hpse
鞆	hptv
鞇	hpqy
鞈	hpvo
鞉	hpvv
鞊	hplo
鞌	nrhp
鞎	hpek
鞏	iwdp
鞐	hpld
鞓	hpoe
鞕	hptx
鞖	hpjr
鞗	tiap
鞙	hpod
鞚	hpni
鞛	hpdo
鞜	hpsb
鞝	hpwo
鞞	hpgx
鞟	hpdz
鞡	hpfd
鞢	hphm
鞤	llxp
鞥	hpvh
鞦	hphx
鞧	hpvu
鞨	hpbl
鞩	hpwn
鞪	dtjp
鞬	hpez
鞮	hpbl
鞰	hpbq
鞱	hpjg
鞳	hpho
鞵	hpjy
鞶	nswp
鞷	tonp
鞸	hpbf
鞹	hpdp
鞺	hpwl
鞻	hpor
鞼	hpqv
鞽	hpjo
鞾	hphf
鞿	hpwx
韀	hpjh
韁	hptt
韂	hpri
韃	hplz
韄	hpha
韅	hpbh
韆	hpcz
韇	hplv
韈	hphx
韉	hphh
韊	hphm
韋	zioi
韌	ziod
韍	ziod
韎	ziom
韏	vyzi
韐	zioo
韑	wwzi
韒	ziod
韓	xbxi
韔	ziok
韕	zioz
韖	ziom
韗	zioc
韘	ziom
韙	btli
韚	ziop
韛	ziof
韜	ziog
韝	ziol
韞	zioq
韟	ziox
韠	ziof
韡	ziof
韢	ziou
韣	zioq
韤	ziox
韥	ziov
韨	fjia
韰	ydat
韱	vvtx
韲	ddyt
韴	dbti
韷	dbue
韸	dbaf
韺	dbhy
韻	dbov
韼	dbaz
韽	vjub
韾	ldjb
響	wjdb
頀	dbha
頁	jgv
頂	tjgv
頃	tljv
頄	xjgv
項	ijgv
順	mjgv
頇	fjgv
須	sjgv
頉	ljgv
頊	ejgv
頋	jcjv
頌	vgjv
頍	xajv
頎	jjtv
頏	dwjv
預	dtjv
頑	fwjv
頒	vdjv
頓	tulv
頔	djgv
頕	yojv
頖	vxjv
頗	jajv
領	vjdv
頙	tljv
頚	aljv
頛	emjv
頜	vtov
頝	dvxv
頞	nrjv
頟	aojv
頠	rjcv
頡	lojv
頢	jxov
頣	gjgv
頤	gjgv
頥	igjv
頦	dyvv
頧	jpzv
頨	jjjv
頩	vhjv
頪	xjgv
頫	vwvv
頬	tvvv
頭	tovv
頮	shjv
頯	dhjv
頱	jxdv
頲	jlzv
頳	lmjv
頴	tfmv
頵	ejov
頶	jlov
頷	vjov
頸	tsiv
頹	hwjv
頺	hzjv
頻	yjgv
頼	tomv
頽	hwjv
頾	sjgt
頿	sltv
顀	tijv
顁	ntlv
顃	xxjv
顄	jxuv
顅	dpdv
顆	bmjv
顇	dvvv
顈	twmv
顉	vvjv
顊	jpzv
顋	qujv
題	btlv
額	naov
顎	oofv
顏	dxjv
顐	ncjv
顑	jtov
顒	bngv
顓	ejnv
顔	djsv
顕	bwtv
顖	jqxv
顗	etov
願	jgmv
顙	aaav
顚	tglv
顛	xqev
顜	fntv
顝	qdjv
類	xydv
顟	jjvv
顠	cfmv
顡	dxjv
顢	hniv
顣	jlmv
顤	lllv
顥	bdov
顦	tihv
顧	dptv
顨	jgvn
顩	vtov
顪	ljtv
顫	dqov
顬	ujnv
顭	hqnv
顯	bwwv
顰	yjgx
顱	yqqv
顲	xxdv
顳	pppv
顴	hoov
颎	txjb
颒	shjb
颕	tfmb
颙	bngb
颣	xwmb
風	wjq
颩	wjqs
颪	tdwq
颫	wjqv
颬	wjqj
颭	wjqo
颮	wjqe
颯	dwjq
颰	wjqa
颱	wjqo
颲	wjqn
颳	wjqo
颴	wjql
颵	wjqd
颶	wjqv
颷	wjqx
颸	wjqu
颹	wjqi
颺	wjqs
颻	jlxq
飌	hooq
飍	wjqq
飐	wxyo
飔	wxqu
飖	jlxx
飗	wxgq
飛	zvjv
飜	jxqv
飝	zvjv
飠	vdeg
飡	vvdk
飢	vdew
飣	vdet
飤	vdev
飥	vdet
飦	vdef
飩	vdel
飪	vdel
飫	vdey
飬	vydk
飭	vdej
飮	vdev
飯	vdea
飰	vdey
飱	tdvk
飲	vdev
飳	vdee
飴	vdeo
飵	vdek
飶	vdej
飷	vdef
飸	otsk
飹	vdep
飺	ltvk
飻	vdes
飼	vdeo
飽	vdee
飾	vdei
飿	vdee
餀	vdex
餁	vdel
餂	vdeo
餃	vdex
餄	vdeo
餅	vdeh
餆	vdev
餇	vdeo
餈	vrvk
餉	vdeo
餋	vyvk
餌	vdep
餎	vdeo
餏	vdek
餑	vdez
餒	vder
餓	vdex
餔	vded
餕	vdea
餖	vdev
餗	vdem
餘	vdem
餙	vdei
餚	vded
餛	vdeu
餜	vdem
餝	vdeh
餞	vdex
餟	vdea
餠	vdef
餡	vdeg
餢	vdeo
餣	vdel
餤	vdex
餦	vdek
餧	vder
館	vdez
餩	vdev
餪	vdey
餫	vdec
餬	vded
餭	vdee
餯	vdex
餰	vdei
餱	vdey
餳	vdes
餴	vdeh
餵	vdek
餶	vded
餷	vdet
餹	vdeo
餺	vded
餻	vdeh
餼	vdex
餾	vdeq
餿	vdea
饀	vdeg
饁	vdeq
饂	vdeq
饃	vdey
饄	vdel
饅	vdea
饆	vdef
饇	vdeo
饈	vdet
饉	vdel
饊	vdea
饋	vdev
饌	vdev
饍	vdeo
饎	vdeo
饏	jpak
饐	vdev
饑	vdex
饒	vdew
饓	vdem
饖	vdex
饗	wjdk
饘	vdet
饙	vdev
饚	vdeq
饛	vdex
饜	jbdk
饝	vdec
饞	vded
饟	vdek
饠	vdei
饡	vdev
饢	vdek
饤	rlt
饦	rljt
饳	rlue
饸	rlvo
饹	rlao
饻	rldk
饾	rltv
馂	rlga
馃	rlbm
馉	rlqd
馌	rllq
馎	rltd
馚	hbvd
馛	hbxa
馜	hbpt
馝	hbuj
馞	hbxz
馟	hbjz
馠	hbvo
馢	hbxx
馣	hbyl
馤	hbbl
馦	hbvm
馧	hbbq
馩	hbxv
馪	hbnv
馫	hbhb
馬	sh
馭	sha
馮	vsh
馯	shf
馰	shsd
馱	shy
馲	shjt
馳	shc
馴	shm
馵	shh
馶	shxa
馷	shti
馸	shjt
馹	shb
馺	shjn
馻	shgw
馼	shdx
馽	shoi
馾	shpl
馿	shdp
駀	shxd
駁	shxx
駂	txsh
駃	shzv
駄	shyd
駅	shpn
駆	shcx
駇	sha
駈	shg
駉	shno
駊	shja
駋	shdo
駌	dcsh
駍	shti
駎	shd
駏	shg
駐	shde
駑	rash
駒	shso
駓	shjt
駔	shqf
駕	josh
駖	shvd
駗	shvs
駘	shgo
駙	shtd
駚	shny
駛	shox
駜	shuj
駝	shnt
駞	shlc
駟	shq
駠	shcp
駡	oosh
駢	shvh
駣	shvv
駤	shtl
駥	shtx
駦	vysh
駧	shno
駨	shsb
駩	shve
駪	shjw
駫	shww
駬	shp
駭	shdv
駮	shdx
駯	shkm
駰	shqy
駱	shao
駲	shyy
駳	shjz
駴	shtx
駵	shtz
駶	shpo
駷	shtm
駸	shea
駹	shxd
駺	shdk
駻	shbf
駼	shvm
駽	shod
駾	shvw
駿	shga
騀	shjx
騁	shds
騂	shdx
騃	shgy
騄	shes
騅	shti
騆	shno
騇	shvo
騈	shjf
騉	shbu
騊	shsu
騌	shnm
騍	shbm
騎	shyo
騏	shhv
騐	shvu
騒	shaq
験	shvv
騔	shbl
騕	shcr
騖	dtjh
騗	dpnh
騘	shsu
騙	shdh
騚	shvn
騛	shzv
騜	shge
騝	shez
騞	shfc
騟	shvn
騠	shbl
騡	shgs
騢	shpa
騣	shxa
騤	shxy
騥	shdm
騦	shqu
騧	shqo
騨	shwx
騩	shgg
騪	shga
騫	nfnh
騬	shjv
騭	pysh
騮	shgq
騯	shdh
騰	dvyh
騱	shjy
騲	shhx
騳	shsh
騴	shbr
騵	shjm
騶	shsj
騷	shaq
騸	shdj
騹	shhl
騻	shyx
騼	shju
騽	shjg
騾	shqm
騿	shdx
驀	hbyh
驁	lhah
驂	shgs
驃	shcm
驄	shju
驅	shco
驆	shbf
驇	lvlh
驈	shdo
驉	shyt
驊	shhf
驋	shxa
驌	shek
驍	shlw
驎	shxi
驏	shpz
驐	shda
驑	shtq
驒	shox
驓	shvb
驔	shcx
驕	shjo
驖	shlx
驗	shvv
驙	shdt
驚	hsoh
驜	shwm
驝	shlm
驞	shnv
驟	shpx
驠	shhh
驢	shyq
驣	shvh
驤	shdk
驥	shkv
驦	shug
驧	shhx
驨	sheo
驩	shhi
驪	shtu
驫	shsh
驲	stb
骃	stqy
骉	stst
骍	stdx
骎	stea
骔	stnm
骙	stxy
骦	stug
骩	qdx
骪	qdwd
骫	qdxd
骬	qdf
骭	qdf
骮	qdv
骯	qddw
骲	qdse
骳	qdja
骴	qdlt
骵	qdmt
骻	qdys
骽	qdjr
骾	qdtx
骿	qdvh
髄	qdxz
髆	qdtd
髇	qddo
髈	qddh
髉	qdpi
髊	qdvi
髍	qdjm
髏	qdor
髐	qdlw
髒	qdhh
體	qduv
髕	qdnv
髖	qdnd
髗	qdyq
髙	dnfo
髚	donw
髛	donx
髜	donh
髝	donj
髞	donm
髠	ksw
髢	ksc
髣	ksdh
髤	ksm
髥	ksnf
髨	ksfw
髩	kstj
髪	ksxa
髬	ksjt
髮	ksxd
髰	kshl
髱	ksse
髲	ksja
髳	ksdj
髴	kszn
髵	ksjn
髶	ksp
髷	ksu
髸	kshv
髺	ksjo
髼	ksaf
髽	ksvl
髾	kswd
髿	kssj
鬀	ksvj
鬁	kshn
鬂	ksgv
鬄	ksbs
鬅	ksdd
鬆	ksmg
鬉	ksxa
鬊	kseb
鬋	ksvn
鬌	ksxd
鬍	ksxd
鬎	kstn
鬐	ksyb
鬑	ksvm
鬒	ksxv
鬔	ksaz
鬕	kshy
鬖	ksgs
鬗	kshd
鬘	ksba
鬙	ksvb
鬚	kssv
鬛	ksqv
鬜	ksnd
鬝	ksnb
鬞	ksuk
鬠	ksvb
鬡	ksnt
鬢	ksnv
鬤	ksdk
鬦	eiex
鬧	eiei
鬨	eiev
鬩	eiew
鬪	eied
鬫	eiea
鬬	eiet
鬭	eiet
鬰	mxxs
鬱	mlxs
鬳	ytoy
鬴	tond
鬵	cwcy
鬶	fvny
鬷	tona
鬸	tonq
鬹	fvgy
鬺	tons
鬽	gwgs
鬾	gwga
鬿	gwgt
魀	gwgn
魊	gwgx
魋	gwgi
魌	gwgv
魎	gwgd
魐	gwgm
魒	gwgm
魓	gwgf
魕	gwgx
魖	gwgt
魗	ljig
魘	jbdg
魙	scjg
魚	rh
魛	rhd
魜	rhv
魝	rhn
魞	rhjn
魟	rhi
魠	rhjt
魡	rhsd
魢	rhzl
魣	rhdt
魤	rhtt
魥	rhjn
魦	rhmj
魧	rhdw
魨	rhtl
魩	rhss
魪	rhvn
魫	rhpl
魬	rhja
魭	rhfw
魮	rhu
魯	rhb
魰	rhdx
魱	rhtt
魲	rhdp
魳	rhti
魴	rhdh
魵	rhvd
魶	rhnv
魷	rhxd
魸	rhk
魹	rhjl
魺	rhto
魻	rhq
魼	rhlg
魽	rhhf
魾	rhjt
魿	rhvd
鮀	rhnt
鮁	rhxd
鮂	rhqv
鮃	rhti
鮄	rhzn
鮅	rhuj
鮆	ltrh
鮇	rhfm
鮈	rhso
鮉	rhdo
鮊	rhg
鮋	rhd
鮌	rhdw
鮍	rhja
鮎	rhyo
鮏	rhjl
鮐	rhgo
鮑	rhse
鮒	rhtd
鮓	rhlk
鮔	rhg
鮕	rhxo
鮖	rhc
鮗	rhad
鮘	rhtv
鮙	rhjj
鮚	rhlo
鮛	rhlm
鮜	rhjo
鮝	vyrh
鮞	rhjn
鮟	rhnr
鮠	rhrc
鮡	rhvv
鮢	rhkm
鮣	rhep
鮤	tdnh
鮥	rhao
鮦	rhno
鮧	rhtv
鮨	rhtb
鮩	rhvh
鮪	rhxd
鮫	rhdx
鮬	rhys
鮭	rhll
鮮	rhvf
鮯	rhvo
鮰	rhqo
鮱	rhyt
鮲	rhtd
鮳	rhys
鮴	rhtm
鮵	rhvw
鮶	rheo
鮷	rhvj
鮸	rhrw
鮹	rhwd
鮺	vfrh
鮻	rhga
鮼	rhea
鮽	rhvm
鮾	rhjr
鮿	rhpl
鯀	rhjm
鯁	rhtx
鯂	rhu
鯃	rhwo
鯄	rhxd
鯅	rhjz
鯆	rhtd
鯇	rhnw
鯉	rhbl
鯊	smjh
鯋	rhsj
鯌	rhjo
鯍	rhdm
鯎	rhjx
鯏	rhhn
鯐	rhll
鯑	rhxi
鯓	rhr
鯔	rhsq
鯕	rhhv
鯖	rhld
鯘	rhhr
鯙	rhdz
鯚	rhhz
鯛	rhno
鯜	rhdr
鯝	rhqo
鯞	rhei
鯟	rhtm
鯢	rhgw
鯣	rhbs
鯤	rhbu
鯥	rhll
鯦	rhao
鯧	rhbb
鯨	rhdm
鯩	rhvh
鯪	rhla
鯫	rhpa
鯬	hsjh
鯭	rhzq
鯮	rhnm
鯯	rhkn
鯰	rhvu
鯱	rhyw
鯲	rhdd
鯳	rhjd
鯴	rhzq
鯵	rhgs
鯶	rhnc
鯷	rhbl
鯸	rhty
鯹	rhbl
鯺	rhyb
鯻	rhtn
鯼	rhxa
鯽	rhep
鯾	rhtx
鯿	rhdh
鰀	rhja
鰁	rhgs
鰂	rhgn
鰃	rhqk
鰄	rhjx
鰅	rhbg
鰆	rheb
鰇	rhdm
鰈	rhhm
鰉	rhge
鰊	rhtm
鰋	rhcr
鰌	rhvu
鰍	rhhx
鰎	rhez
鰏	rhtq
鰐	rhos
鰑	rhbs
鰒	rhla
鰓	rhqu
鰔	rhjx
鰕	rhpa
鰖	rhxd
鰗	rhxd
鰘	rhnl
鰙	rhho
鰚	rhnt
鰛	rhbq
鰜	rhvm
鰝	rhdo
鰞	rhjh
鰟	rhdh
鰠	rhaq
鰡	rhgq
鰢	rhsh
鰣	rhbd
鰤	rhji
鰥	rhqs
鰦	rhvw
鰧	dvyh
鰨	rhbj
鰩	rhju
鰪	rhlq
鰫	rhno
鰬	rhyx
鰭	rhyb
鰮	rhqq
鰯	rhzv
鰰	rhji
鰱	rhcz
鰲	lhah
鰳	rhhj
鰴	rhea
鰵	lqsh
鰶	rhxm
鰷	rhtm
鰸	rhco
鰹	rhgl
鰺	rhgs
鰻	rhba
鰼	rhjg
鰽	rhub
鰾	rhcm
鰿	rhlv
鱀	egch
鱁	rhxz
鱂	rhkd
鱃	rhvt
鱄	rhtd
鱅	rhji
鱆	rhdx
鱇	rhjs
鱈	rhue
鱉	vnmh
鱊	rhdo
鱋	rhyt
鱌	rhrx
鱍	rhxa
鱎	rhjo
鱏	rhcx
鱐	rhek
鱑	rhhv
鱒	rhvd
鱓	rhox
鱔	rhvo
鱕	rhjq
鱖	rhjv
鱗	rhxi
鱘	rhed
鱙	rhlw
鱚	rhlo
鱛	rhvb
鱜	rhwp
鱝	rhxv
鱞	rhqk
鱟	jkxh
鱠	rhvb
鱡	rhgx
鱢	rhom
鱣	rhdt
鱤	rhju
鱥	rhlx
鱦	rhq
鱧	rhuv
鱨	rhwb
鱩	rhuq
鱪	rhbb
鱫	rhja
鱬	rhun
鱭	rhdh
鱮	rhjv
鱯	rhha
鱰	rhqb
鱱	rhjg
鱳	rhwm
鱴	rhhx
鱵	rhkx
鱶	rhvk
鱷	rheo
鱸	rhyq
鱹	rhhi
鱺	rhtu
鱻	rhrh
鱽	rtd
鱾	rtzl
鲀	rttl
鲃	rtdl
鲄	rtto
鲉	rtd
鲊	rtlk
鲌	rtg
鲏	rtja
鲓	rtys
鲕	rtjn
鲖	rtno
鲘	rtjo
鲙	rtvg
鲝	vfrt
鲪	rteo
鲯	rthv
鲴	rtqo
鲹	rtgs
鲾	rttq
鲿	rtwg
鳀	rtbl
鳁	rtbq
鳂	rtqk
鳈	rtgs
鳉	rtkd
鳋	rtaq
鳑	rtdh
鳒	rtvm
鳚	rtpd
鳛	rtjg
鳠	rtha
鳡	rtju
鳣	rtdt
鳤	rtkz
鳥	gh
鳦	ghz
鳧	ghw
鳨	ghj
鳩	xgh
鳪	ygh
鳫	jgh
鳬	gw
鳭	dgh
鳮	agh
鳯	wgh
鳰	jdgh
鳱	fgh
鳲	pgh
鳳	wtgh
鳴	ogh
鳵	zxgh
鳶	vgh
鳷	xagh
鳸	dpgh
鳹	vjgh
鳺	fvgh
鳻	vdgh
鳼	dxgh
鳽	thgh
鳾	tnih
鳿	egh
鴀	jygh
鴁	jygh
鴂	zvgh
鴃	ghzv
鴄	cwgh
鴅	ndgh
鴆	plgh
鴇	txgh
鴈	jtgh
鴉	cijh
鴊	tlgh
鴋	dhgh
鴌	tygh
鴍	dxgh
鴎	cxgh
鴏	ghtv
鴐	jogh
鴑	ragh
鴒	vjdh
鴓	ujgh
鴔	jdzh
鴕	ghnt
鴖	ptvh
鴗	dgh
鴘	ghgh
鴙	lygh
鴚	ghto
鴛	dcgh
鴜	ltgh
鴝	sogh
鴞	otsh
鴟	ctvh
鴠	btgh
鴡	qfgh
鴢	wjgh
鴣	xogh
鴤	ghad
鴥	ghnv
鴦	nygh
鴧	nwgh
鴨	qgh
鴩	kvgh
鴪	nvgh
鴫	qgh
鴬	wngh
鴭	jpzh
鴮	yfsh
鴯	jnnh
鴰	jxoh
鴱	hxgh
鴲	tbgh
鴳	nrgh
鴴	sfih
鴵	vwvh
鴶	logh
鴷	tdnh
鴸	kmgh
鴹	vfgh
鴺	tzsh
鴻	sigh
鴼	ghao
鴽	rogh
鴾	gkih
鴿	vtoh
鵀	tjlh
鵁	dvxh
鵂	tmgh
鵃	nsgh
鵄	tglh
鵅	aogh
鵆	sghi
鵇	lcih
鵈	pgh
鵉	dmgh
鵋	zluh
鵌	ghvm
鵍	nfwh
鵎	jrgh
鵏	tdih
鵐	ivvh
鵑	odgh
鵒	vvoh
鵓	xnzh
鵔	ghga
鵕	gvah
鵖	eggh
鵗	xxnh
鵘	ejoh
鵙	gvgh
鵚	hwgh
鵛	tsih
鵜	vzsh
鵝	jfxh
鵞	jfxh
鵟	xjeh
鵠	jloh
鵡	flvh
鵢	rgh
鵣	tomh
鵤	rgh
鵥	vxnh
鵦	ghes
鵧	vhgh
鵨	vfoh
鵩	dpah
鵪	yblh
鵫	ybxh
鵬	ddgh
鵭	vvgh
鵮	rggh
鵯	gjxh
鵰	nloh
鵱	lvlh
鵲	hbgh
鵳	dpdh
鵴	sxgh
鵵	rowh
鵶	txth
鵷	ndch
鵸	ytoh
鵹	hsjh
鵺	dtdh
鵼	nvih
鵽	aaah
鵾	bugh
鵿	ghbh
鶀	ghhv
鶁	domh
鶂	gwgh
鶃	ghgw
鶄	ldgh
鶅	sqgh
鶇	tbmh
鶈	teih
鶉	dozh
鶊	jevh
鶋	pxoh
鶌	pueh
鶍	bssh
鶎	nfmh
鶏	jfvh
鶐	mdzh
鶑	xxgh
鶒	tomh
鶓	hqgh
鶔	dtjh
鶕	dbgh
鶖	hxgh
鶗	btlh
鶘	xodh
鶙	dnnh
鶚	oofh
鶛	uggh
鶜	hdth
鶝	toqh
鶞	jjxh
鶟	nvyh
鶠	cbrh
鶡	bsvh
鶢	jfah
鶣	dpnh
鶤	ncgh
鶥	djgh
鶦	xodh
鶧	hnyh
鶨	ljxh
鶩	dtjh
鶪	gydh
鶫	tqmh
鶬	vdeh
鶭	wmdh
鶮	donh
鶯	xxnh
鶰	ogvh
鶱	nfnh
鶲	vgjh
鶳	ghji
鶴	piih
鶵	sujh
鶶	jeih
鶷	nfoh
鶹	gdqh
鶺	xvdh
鶻	qdgh
鶼	vemh
鶽	tixh
鶾	xbxh
鶿	vwwh
鷀	vwwh
鷁	vvqh
鷂	jlxh
鷄	jwyh
鷅	cmgh
鷆	tglh
鷇	lnta
鷈	ghjw
鷉	jjyh
鷊	tonh
鷋	hvth
鷌	ghsh
鷍	jgmh
鷎	gyxh
鷏	xqeh
鷐	bjfh
鷑	kdgh
鷒	tbgh
鷓	jhhh
鷔	lhah
鷕	otih
鷖	clyh
鷗	cooh
鷘	tomh
鷚	jjvh
鷛	jedh
鷜	otoh
鷝	bhfh
鷞	yxxh
鷟	dhlh
鷠	rhgh
鷡	lhhh
鷢	jvuh
鷣	cbxh
鷤	oobh
鷥	wmwh
鷦	tihh
鷧	lnth
鷨	hthh
鷩	vnmh
鷪	ggnh
鷫	eikh
鷬	hdvh
鷭	jxqh
鷮	jyoh
鷯	yvbh
鷱	jgxh
鷲	domh
鷳	ndgh
鷴	nmgh
鷵	pybh
鷶	qgvh
鷷	vuxh
鷸	dtjh
鷹	jtth
鷺	olah
鷻	ghda
鷼	nbgh
鷽	jkxh
鷾	dbuh
鷿	podh
鸀	qsqh
鸂	sjwh
鸃	ghvx
鸄	gdhh
鸆	yoth
鸇	dqoh
鸈	wtvh
鸊	podh
鸋	nuqh
鸌	ghha
鸍	tvnh
鸎	gvgh
鸏	hnfh
鸐	jjth
鸑	xjih
鸒	jksh
鸓	qqqh
鸔	ghbs
鸕	yqqh
鸖	utih
鸘	umgh
鸙	vtoh
鸚	gvgh
鸛	hooh
鸜	ggth
鸝	tndh
鸞	wmih
鸤	pgt
鸧	vcgt
鸴	wngt
鸻	sfit
鸼	nsgt
鹀	ivvt
鹍	bugt
鹐	rggt
鹒	jevt
鹓	ndct
鹖	bsvt
鹙	hxgt
鹝	tont
鹟	vgjt
鹠	gdqt
鹡	xvdt
鹢	vvqt
鹥	clyt
鹯	dqot
鹲	hnft
鹴	umgt
鹶	yqdj
鹷	yqdd
鹸	yqdv
鹹	yqdx
鹺	yqdi
鹻	yqdm
鹼	yqdv
鹽	glyq
麀	jznt
麁	rjzu
麃	jznh
麄	vdju
麅	jzne
麆	jznf
麉	ffju
麊	xjzu
麌	jzny
麍	jznm
麎	jznk
麏	jzno
麐	jzno
麑	jznw
麔	jzno
麕	jznh
麖	jznm
麗	tndu
麘	jznb
麙	jznx
麚	jzna
麛	jznp
麜	jznm
麞	jznx
麠	jznt
麡	jznh
麢	jzno
麣	jzna
麤	jznu
麹	lasx
麺	lajf
麼	jmmw
麿	jmmo
黀	jmma
黁	jmmb
黂	jmmv
黃	htdv
黅	hdvj
黆	hdvl
黇	hdvo
黈	hdve
黊	hdvl
黋	wwhv
黌	jkxv
黒	blh
黓	qhv
黕	qhpl
黖	qhcw
黗	qhtl
黙	blyh
點	qhyo
黣	qhls
黤	qhyl
黦	qhnc
黨	wnoh
黫	qhcl
黬	qhjx
黭	qhvh
黮	qhhl
黰	qhxv
黱	dvyh
黲	qhgs
黳	clyh
黴	seta
黵	qhri
黶	jbdh
黷	qhlv
黺	wtvd
黽	qii
黿	fwq
鼀	lvq
鼁	lgq
鼂	btq
鼃	llq
鼄	kmq
鼅	lyoq
鼆	nbdq
鼈	vnmq
鼉	ooqq
鼊	podq
鼌	btol
鼏	ngkk
鼑	ygkk
鼒	xjgk
鼔	lova
鼕	lovd
鼖	xhla
鼘	lovk
鼚	lovk
鼛	lovo
鼜	lovq
鼝	skta
鼞	lovl
鼟	lovv
鼡	wwf
鼢	gldd
鼣	gldd
鼤	gldx
鼥	gldd
鼦	gldo
鼧	gldt
鼨	gldd
鼩	gldo
鼪	gldl
鼫	gldc
鼭	gldd
鼮	gldz
鼰	gldv
鼱	gldd
鼲	gldc
鼳	gldd
鼴	gldr
鼵	gldd
鼶	gldw
鼸	gldm
鼺	gldq
鼼	jgqi
鼿	jgqw
齀	jgqd
齁	jgqo
齂	jgqs
齃	jgql
齄	jgqt
齅	jgqd
齆	jgql
齇	jgqf
齈	jgqk
齉	jgqk
齊	ddyh
齋	ddym
齌	ddyx
齍	ddyq
齎	ddyv
齏	ddyt
齒	lvvu
齓	lvvl
齔	lvvt
齕	lvvz
齖	lvvj
齗	lvvt
齘	lvvn
齙	lvve
齚	lvvk
齛	lvvl
齜	lvvt
齝	lvvo
齞	lvvv
齟	lvvf
齠	lvvo
齡	lvvd
齢	lxud
齣	lvvo
齤	vylu
齥	lvvx
齦	lvvk
齧	fdlu
齨	lvvg
齩	lvvx
齪	lvvl
齫	lvvm
齬	lvvo
齭	lvvt
齮	lvvo
齯	lvvw
齰	lvvb
齱	lvva
齲	lvvg
齳	lvvc
齴	lvvs
齵	lvvg
齶	lvvs
齷	lvvl
齸	lvvq
齹	vfiu
齺	lvvj
齻	lvvv
齼	lvvl
齽	lvvm
齾	ytou
龎	jdde
龐	jdde
龓	xdde
龕	vtoe
龗	uooe
龡	vtov
龢	vtoh
龣	vtos
龤	vtog
龥	vtov
	jj
	xii
	lii
	jii
	zii
	tsuj
	tre
	rii
	cii
	dii
	oonv
	onja
	onja
	wii
	md
	ysuj
	yre
	jf
	fnx
	fsc
	ftia
	faa
	lii
	hii
	mnx
	tdqb
	syz
	jl
	ev
	wn
	jl
	gxr
	hgys
	kii
	wd
	nw
	vf
	ve
	lx
	emqt
	emqg
	dfsd
	hnvj
	jkqv
	jkqb
	vy
	ijjt
	gvld
	bld
	ol
	vvdj
	vcij
	vyad
	vdpj
	vhyb
	vvfo
	vgga
	nnvl
	nnri
	nvvl
	nrei
	xbx
	xxn
	yrta
	rtep
	rteb
	rtvu
	yrha
	dvyt
	tnit
	dvxt
	tdnt
	ldgt
	gydt
	jjyt
	podt
	xtdy
	wmim
郎	dekp
﨎	dxta
﨏	lvvo
﨑	edto
﨓	mhtd
﨔	mwvf
礼	fml
﨟	hdbl
蘒	hhjx
﨡	qjl
﨣	lldx
﨤	jznz
﨧	vvyz
﨩	pge
丵	wtvx
亙	tjdt
來	tvvm
來	xvvv
俠	ttvv
俠	tyvv
倕	tjtl
倕	tjxf
倖	tlvx
倖	tly
偒	tbts
僀	thni
儘	teiq
優	tjqa
叐	fa
叐	jxa
剶	ljxn
劑	dydn
劙	ljxn
勑	tvvj
匧	ctvv
厜	jjtl
厜	jjxf
厞	jene
厞	jnee
唊	otvv
唊	oyvv
啈	olvx
啈	oly
啺	objs
啺	obts
嚍	oeiq
嚍	oelq
嚘	ojna
嚘	ojqa
嚥	ohkh
嚥	ohoh
圛	qqlx
圛	qqly
埇	lddi
埇	ldnf
埉	ltvv
埉	lyvv
埵	ljtl
埵	ljxf
執	lvxd
執	lyxd
報	lvxa
報	lypa
場	lbjs
場	lbts
墆	lhni
墆	lhwi
墊	lvxl
墊	lyxl
墿	lqlx
墿	lqly
壗	leiq
壗	lelq
壟	ddsl
壟	ddtl
夒	jgla
夒	tjga
夒	tlja
夾	tvvv
夾	yvv
奜	eney
奜	neey
妛	uitr
妛	ulr
娷	rjtl
娷	rjxf
婓	ener
婓	neer
婔	rene
婔	rnee
婞	rlvx
婞	rly
婡	rtvm
婡	rxvv
婸	rbjs
婸	rbts
婻	rxnx
婻	rxny
媢	rbg
媢	rnfg
嬊	hkor
嬊	hokr
嬕	rqlx
嬕	rqly
嬧	reiq
嬧	relq
嬿	rhkh
嬿	rhoh
専	tbid
専	tdxd
峽	etvv
峽	eyvv
崍	etvm
崍	exvv
崜	ejtl
崜	ejxf
崵	ebjs
崵	ebts
嵜	edoi
嵜	edto
嵽	ehni
嵽	ehwi
嶑	erbx
嶑	erox
嶧	eqlx
嶧	eqly
嶵	eqee
嶵	eqne
巎	ejga
巎	etja
巙	evja
巙	evla
帯	hnni
帯	teni
帰	neni
帰	yeni
帶	hnni
帶	hwni
庲	jtvm
庲	jxvv
廃	jxth
廃	jxtl
廗	jhni
廗	jhwi
徠	stvm
徠	sxvv
恵	tbiu
恵	tdu
悀	yddi
悀	ydnf
悏	ytvv
悏	yyvv
悩	ywxu
悩	ywxu
愑	yddj
愑	ydnj
愓	ybjs
愓	ybts
愸	tvvu
愸	xvvu
慂	sddu
慂	sdnu
慡	ytxv
慡	yyxx
慹	lvxu
慹	lyxu
憂	jnfa
憂	jqfa
憖	tvvu
憖	xvvu
憗	tvvu
憗	xvvu
懌	yqlx
懌	yqly
懮	yjna
懮	yjqa
懴	ylex
懴	ylnx
戞	jnfx
戞	jqfx
挾	ftvv
挾	fyvv
揚	fbjs
揚	fbts
摕	fhni
摕	fhwi
摤	ftxv
摤	fyxx
摯	lvxf
摯	lyxf
擇	fqlx
擇	fqly
擾	fjna
擾	fjqa
斁	qlva
斁	qlya
斄	fmam
斄	fmav
斲	ftjt
斲	ljit
斲	ljst
斲	lzst
旹	uitb
旹	ulb
昜	bjjs
昜	btss
暃	bene
暃	bnee
暔	bxnx
暔	bxny
暘	bbjs
暘	bbts
曎	bqlx
曎	bqly
曣	bhkh
曣	bhoh
曺	tbib
曺	tdb
柹	mjsj
柹	msij
桺	mtcz
桺	mtjz
梜	mtvv
梜	myvv
棐	enem
棐	neem
棑	mene
棑	mnee
棶	mtvm
棶	mxvv
椂	mes
椂	mesl
楊	mbjs
楊	mbts
樉	mtxv
樉	myxx
樋	mddz
樋	mdnz
橊	mtcq
橊	mtnq
橣	mnuf
橣	mnui
檌	mqee
檌	mqne
檡	mqlx
檡	mqly
櫌	mjna
櫌	mjqa
櫷	mjll
櫷	mjlt
櫷	mjq
欫	klrv
欫	ltlv
欫	lxtv
歝	qlvv
歝	qlyv
殬	tdqx
殬	tdqy
毆	cooa
毆	cooa
泲	sjsj
泲	ssij
浹	stvv
浹	syvv
涬	slvx
涬	sly
涶	sjtl
涶	sjxf
淶	stvm
淶	sxvv
渄	sene
渄	snee
湧	sddj
湧	sdnj
湯	sbjs
湯	sbts
湳	sxnx
湳	sxny
湽	sstq
湽	stsq
満	shne
満	shte
溌	sxth
溌	sxtl
滍	suiq
滍	sulq
滯	shni
滯	shwi
漐	lvxs
漐	lyxs
漺	stxv
漺	syxx
潀	sqjn
潀	sqjv
潒	srbx
潒	srox
澑	stcq
澑	stnq
澝	snuf
澝	snui
澤	sqlx
澤	sqly
濜	seiq
濜	selq
瀀	sjna
瀀	sjqa
瀐	slex
瀐	slnx
瀒	stvo
瀒	sxvo
煬	xbjs
煬	xbts
煵	xxnx
煵	xxny
熥	xddz
熥	xdnz
燙	sbjx
燙	sbtx
燡	xqlx
燡	xqly
燼	xeiq
燼	xelq
牬	jfjj
牬	jfsj
犇	kiji
犇	kiki
犕	jfhf
犕	jfhi
猅	xjee
猅	xjne
猆	ened
猆	need
猌	tvvd
猌	xvvd
猍	xjtm
猍	xjxv
獿	xjja
獿	xjta
琜	etvm
琜	exvv
琲	eene
琲	enee
瑒	ebjs
瑒	ebts
璗	sbjd
璗	sbtd
璢	etcq
璢	etnq
璶	eeiq
璶	eelq
瓇	ejna
瓇	ejqa
瓡	lvxn
瓡	lyjn
甀	jthd
甀	jxhd
甪	jdi
甪	jnf
甮	ssdi
甮	ssnf
畱	tciq
畱	tncq
畼	qbjs
畼	qbts
瘍	jbjs
瘍	jbts
瘝	jqid
瘝	jqiv
瘝	jqs
癅	jtcq
癅	jtnq
発	xth
発	xtxl
盡	eitq
盡	elhq
盩	lvxq
盩	lyaq
盪	sbjq
盪	sbtq
盭	wlvq
盭	wlyq
眔	qivv
眔	qs
眾	qjin
眾	qjiv
眾	qtvv
睞	gtvm
睞	gxvv
睪	qlvx
睪	qly
砽	cdi
砽	cnf
硤	ctvv
硤	cyvv
硧	cddi
硧	cdnf
硾	cjtl
硾	cjxf
碭	cbjs
碭	cbts
磢	ctxv
磢	cyxx
磤	cjea
磤	cjja
礋	cqlx
礋	cqly
礱	ddsc
礱	ddtc
禦	sltm
禦	slxm
穂	htbu
穂	htdu
筩	kddi
筩	kdnf
筴	ktvv
筴	kyvv
箂	ktvm
箂	kxvv
籖	klex
籖	klnx
籜	kfqx
籜	kfqy
糃	xbjs
糃	xbts
糒	xhjf
糒	xhji
糳	wtvx
糳	wtyx
糴	jdxi
糴	jnxi
綞	wmjf
綞	wmjl
緈	wmlx
緈	wmly
緋	wmee
緋	wmne
縶	lvxm
縶	lyxm
繹	wmqx
繹	wmqy
聗	ptvv
聗	pyvv
聾	ddsp
聾	ddtp
胏	djsj
胏	dsij
脥	dtvv
脥	dyvv
腄	djtl
腄	djxf
腸	dbjs
腸	dbts
膟	ddvx
膟	ddwx
臙	dhkh
臙	dhoh
臝	dlod
臝	dlom
艒	nsbg
艒	nsng
艸	hii
艸	ujui
苚	hdi
苚	hnf
茚	hctp
茚	hep
莢	htvv
莢	hyvv
菙	hjtl
菙	hjxf
萊	htvm
萊	hxvv
萳	hxnx
萳	hxny
萺	hbg
萺	hnfg
蓪	hddz
蓪	hdnz
蓻	hlvd
蓻	hlyd
蔕	hhni
蔕	hhwi
蕔	hlva
蕔	hlya
蕜	henu
蕜	hneu
薬	hgxm
薬	hvgm
藎	heiq
藎	helq
藥	hgwm
藥	hwgm
蘀	hfqx
蘀	hfqy
虈	hjgo
虈	hooo
虊	hiwm
虊	hwmm
蛺	qtvv
蛺	qyvv
蝪	qbjs
蝪	qbts
螮	qhni
螮	qhwi
蟄	lvxq
蟄	lyxq
蟏	qhei
蟏	qhen
蠌	qqlx
蠌	qqly
蠪	ddsq
蠪	ddtq
蠿	ewwq
蠿	jwwq
衆	jqjv
衆	jqtv
衆	jqx
衘	slti
衘	slxi
裵	denk
裵	dnek
裶	jkee
裶	jkne
褺	lvxk
褺	lyxk
襗	jkqx
襗	jkqy
襲	ddsk
襲	ddtk
觾	rhkh
觾	rhoh
誹	iiee
誹	iine
誺	iitm
誺	iixv
諈	iijf
諈	iijl
諵	iixx
諵	iixy
謺	lvxi
謺	lyxi
譯	iiqx
譯	iiqy
讋	ddsi
讋	ddti
賓	ntiv
賓	ntjv
賚	tvvv
賚	txvv
賮	eitv
賮	elhv
賵	gvbg
賵	gvng
贄	lvxv
贄	lyxv
贏	dlod
贏	dlov
赗	bbg
赗	bnfg
躖	olwi
躖	olwt
輩	enec
輩	neec
輫	ccee
輫	ccne
輺	ccsq
輺	cctq
逨	tvvz
逨	xvvz
逹	lvxz
逹	lyz
逿	bjjz
逿	btsz
遖	xnvz
遖	xnyz
遰	hnnz
遰	hwnz
郟	tvvp
郟	yvvp
郲	tvvp
郲	xvvp
郵	jtlp
郵	jxhp
鄾	jnfp
鄾	jqfp
酀	hkop
酀	hokp
醗	uxth
醗	uxtl
醳	uqlx
醳	uqly
醼	uhkh
醼	uhoh
釋	jxqx
釋	jxqy
錘	vvjf
錘	vvjl
錸	vvtm
錸	vvxv
鐸	vvqx
鐸	vvqy
陜	ptvv
陜	pyvv
陫	pene
陫	pnee
陽	pbjs
陽	pbts
靑	lnit
靑	lnl
靟	enel
靟	neel
韮	hent
韮	hnet
韯	lenx
韯	lnex
頰	tvvv
頰	yvvv
顂	tvvv
顂	xvvv
顮	ntiv
顮	ntjv
養	vevk
養	vfvk
餥	enek
餥	neek
馡	hbee
馡	hbne
騋	shtm
騋	shxv
騑	shee
騑	shne
騺	lvxh
騺	lyxh
驘	dlod
驘	dloh
驛	shqx
驛	shqy
驡	ddsh
驡	ddth
骕	stei
骕	sten
鬥	eiei
鬥	ieei
鬮	eiel
鬮	eieq
鬮	eiex
鯒	rhdf
鯒	rhdi
鯗	vevh
鯗	vfvh
鯠	rhtm
鯠	rhxv
鯡	rhee
鯡	rhne
鲬	rtdf
鲬	rtdi
鵊	tvvh
鵊	yvvh
鶆	tvvh
鶆	xvvh
鷙	lvxh
鷙	lyxh
鷰	hkoh
鷰	hokh
鸁	dlod
鸁	dloh
鸅	qlvh
鸅	qlyh
鸉	mbjh
鸉	mbth
鸗	ddsh
鸗	ddth
鹔	eijt
鹔	emnt
鹵	yqdd
鹵	yqdx
麥	tvva
麥	xvva
麧	tvvz
麧	xvvz
麨	tvvj
麨	xvvj
麩	tvvv
麩	xvvv
麪	tvvj
麪	xvvj
麫	tvvs
麫	xvvs
麬	tvva
麬	xvva
麭	tvve
麭	xvve
麮	tvvg
麮	xvvg
麯	tvvu
麯	xvvu
麰	tvvi
麰	xvvi
麱	tvvd
麱	xvvd
麲	tvvw
麲	xvvw
麳	tvvm
麳	tvvv
麳	xvvm
麳	xvvv
麵	tvvf
麵	xvvf
麶	tvvg
麶	xvvg
麷	tvvv
麷	xvvv
龁	lvuz
龁	lwlz
龂	lvut
龂	lwjt
龍	ddse
龍	ddte
龏	ddsh
龏	ddth
龑	ddsy
龑	ddty
龒	ddsm
龒	ddtm
龔	ddsv
龔	ddtv
龖	ddse
龖	ddte
龘	ddse
龘	ddte
龜	jlzl
龜	jlzx
龜	jq
龝	hjll
龝	hjlx
龝	hjq
龞	vnml
龞	vnmq
龞	vnmx
	eit
	el
	ihkh
	ihoh
﨨	vvlx
﨨	vvly
