的	d
一	y
了	l
是	u
不	b
我	w
人	r
在	z
这	ve
他	t
有	yz
来	ld
道	dcz
你	n
个	g
大	da
到	dc
上	uh
说	uo
们	mf
着	v
出	i
中	vs
地	di
那	na
就	j
也	ye
下	x
要	yc
么	me
子	zi
时	uio
为	wwd
为	wwl
然	rj
可	k
她	ta
过	goz
之	vid
以	yi
看	kj
会	hv
会	kkrs
得	de
天	tm
去	q
自	zip
好	hc
心	xb
和	h
没	m
能	ng
对	dv
后	hz
还	hd
里	l
里	lio
小	xn
手	uz
而	er
起	qiz
只	vi
身	ufp
想	xlx
都	dz
头	tz
如	ru
无	wu
面	mm
多	do
已	yiv
发	f
事	ui
生	ug
知	vik
家	jx
前	qm
声	ugu
开	kd
方	fh
经	jk
现	xmw
笑	xnv
什	ufru
力	liv
点	dm
两	ll
法	fa
国	go
样	yh
所	so
成	ig
意	yix
见	jm
但	dj
老	lc
用	ys
又	yzv
情	qkx
于	yua
于	yva
当	dh
动	dsl
己	jiv
些	xp
行	hh
行	xks
此	ci
眼	yjo
气	qip
把	ba
回	hvk
话	hxy
将	jl
真	vf
长	ih
长	vhpd
长	zhp
三	s
间	jmm
进	jb
年	nm
神	ufu
明	mk
十	uia
女	nv
向	xl
定	dk
正	vg
实	uib
本	bf
很	hf
同	ts
从	cs
高	gc
问	wf
才	cd
全	qr
被	bw
主	vu
再	zd
走	zz
却	qt
儿	erp
分	ff
口	kz
其	qib
作	zo
种	vsh
几	jipv
外	wd
打	daf
最	zv
门	mfd
与	yu
与	yv
给	gw
光	gl
白	bd
等	dg
听	tk
因	yb
重	isl
重	isp
重	vsl
重	vsp
少	uc
风	fg
相	xlm
住	vur
次	c
何	her
让	rh
色	se
二	e
公	gs
日	ri
怎	zf
名	mkkx
名	mkx
死	sid
便	bmr
位	ww
位	wwra
部	bu
果	goa
果	gom
果	goo
应	yk
体	ti
感	gjx
太	td
内	nw
觉	jnj
觉	jtjb
水	uv
先	xm
难	nj
王	wh
比	bi
别	bp
入	rup
边	bm
第	div
直	viu
机	ji
理	liwt
快	kk
更	gg
做	zor
处	iu
者	vel
者	veo
并	bk
接	jpf
西	xi
马	ma
轻	qki
四	si
关	gr
山	uj
月	yt
放	fhw
连	lm
加	jxl
目	mu
脸	lmo
飞	fwv
使	uir
龙	ls
强	ql
张	vh
由	yza
金	jbra
金	jbrq
立	lid
叫	jn
安	a
师	uiaj
师	uija
吧	bak
剑	jml
信	xbr
学	xt
军	jy
望	whw
算	sr
原	yr
美	mw
像	xlr
平	p
东	ds
场	iht
吗	mak
战	vjg
特	te
万	wj
数	uu
云	yy
清	qkd
今	jbr
变	bmyb
任	rf
空	ks
表	bn
完	wjb
合	he
带	ddj
常	ihj
量	llo
海	hdd
受	uzy
解	jpj
文	wfd
命	mkr
转	vr
斯	sij
通	tsz
冷	lg
思	sit
思	six
黑	hw
世	uiav
世	uic
该	gd
双	ul
利	lil
至	viat
至	vit
非	fw
林	lb
呢	ne
新	xbj
步	buv
五	wua
李	limz
度	du
虽	sv
路	lu
惊	jkx
微	wws
跟	gf
似	sir
物	wun
许	xu
化	hx
制	vil
火	hod
性	xk
反	fj
武	wug
总	zs
指	vifo
系	xip
系	xisp
结	jp
花	hxc
亲	qb
教	jnw
功	gsg
刚	gh
提	tif
杀	ua
竟	jkl
士	uiaa
士	uiua
远	yrz
百	bda
红	hs
它	tab
离	liw
满	mj
找	vc
落	lo
容	rs
必	bid
深	uf
城	igt
拉	la
奇	jidk
奇	qi
若	ro
各	ge
失	uip
尔	erd
言	yj
传	ir
且	qp
形	xkp
青	qkf
石	dja
石	uiak
干	gj
半	bjb
近	jbz
认	rfy
怕	pa
队	dve
电	dma
电	dmo
夫	fua
往	whs
突	tux
吃	ii
啊	aa
倒	dcr
活	ho
件	jmr
随	sve
绝	jts
刻	kel
息	xixo
息	xiz
即	jie
工	gsa
早	zc
极	jim
乎	hup
界	jpt
记	jiy
紧	jbs
怪	gk
流	lqd
报	bc
车	ie
管	grv
音	ybl
衣	yidn
衣	yiwn
保	bcr
暗	an
弟	dib
及	jip
交	jnl
交	jnwi
交	jnwx
影	ykp
华	hxu
爱	ai
精	jkm
伤	uhr
势	uil
民	mb
令	lkr
计	jiyu
决	jt
玉	yuw
玉	yvw
服	fuo
条	tn
众	vsr
领	lk
哥	gek
南	nju
般	bjv
元	yre
罗	los
收	uzj
收	uzw
未	wwa
始	uin
办	bj
题	tiu
题	tiy
星	xko
克	ke
根	gfm
谁	uw
阵	vfe
则	ze
象	xld
象	xlu
男	njt
达	daz
告	gck
展	vj
击	jieu
击	jik
击	jiuu
坐	zot
灵	lkx
血	xtp
整	vgv
整	vgwv
员	yyk
员	yrbk
员	yrk
兵	bkb
兵	bkq
急	jix
千	qmp
切	qpd
越	ytz
喜	xika
喜	xiu
语	yuy
语	yvy
站	vjl
请	qk
德	des
帮	bh
敢	gjw
消	xnd
业	yea
姐	jpn
周	vz
视	uij
字	zib
八	bap
每	mwr
苦	ku
房	fhh
忙	mh
雷	lwy
团	tr
片	pm
哪	nak
尽	jbi
书	uuv
备	bww
求	qq
司	siv
北	bwb
静	jkf
错	co
断	drj
准	vy
江	jldg
刀	dcv
建	jmz
兄	xs
终	vss
足	zuk
兴	xkb
冲	isd
阳	yhe
代	dd
或	hog
楚	iup
底	deg
底	dig
夜	yew
术	uum
格	gem
识	uiy
持	iif
答	dav
哈	ha
留	lqt
确	qtu
易	yio
七	qia
论	ly
父	fup
拿	naf
程	igh
阿	aae
害	hdb
族	zuf
破	pe
破	po
孩	hdz
魔	mog
魔	moms
官	grb
沉	ifd
显	xmo
够	gz
宝	bcb
取	que
取	quy
单	djb
掌	vhf
务	wul
务	wuw
低	dir
雪	xty
响	xlk
布	buj
布	buu
市	uijw
市	uiw
摇	ycf
依	yir
依	yirn
久	jqp
级	jis
首	uzbo
运	yyz
朝	ic
待	dds
娘	nl
客	keb
统	tss
忽	hux
速	suz
复	fuw
修	xq
欢	hr
异	yis
式	uig
护	hu
爷	yef
况	kl
脚	jno
招	vcf
九	jq
集	jivm
区	qu
区	quk
晚	wjo
铁	tp
黄	hl
友	yzu
亚	yaa
除	iue
钱	qmj
送	ss
兰	lj
联	lme
政	vgw
义	yid
丝	sia
古	gu
六	lq
器	qik
甚	ufq
照	vch
基	jit
闪	ujm
院	yree
装	vl
居	jvuk
产	ij
呼	huk
杨	yhm
露	lzy
露	luyk
句	jvg
乱	lr
举	jvx
敌	diw
斗	dzd
香	xlh
停	tkr
台	tdk
台	tds
群	qy
嘴	zvk
希	xij
希	xixj
酒	jqd
巴	bav
怀	hkx
议	yiy
类	lw
支	viuy
慢	mjx
陈	if
仙	xmr
段	dr
调	dn
顿	dy
派	pd
英	ykc
喝	hekv
期	jiq
期	qio
威	wwn
威	www
另	lkk
府	fug
改	gdw
旁	ph
资	zibr
续	xus
造	zcz
乐	le
攻	gsw
左	zogu
左	zou
愿	yri
围	wwk
疑	yibr
念	nmx
引	ybg
热	re
怒	nu
退	tvz
缓	hrs
线	xms
注	vud
细	xis
图	tu
背	bwo
需	xuya
痛	tsb
观	grj
组	zu
雨	yuad
雨	yvad
曾	cg
约	yts
包	bcg
木	mua
技	jif
示	uie
皇	hlb
据	jv
差	iag
设	ue
设	uey
密	mi
谢	xpy
鬼	gvp
鬼	gvs
穿	irx
脑	nc
赶	gjz
莫	moc
丽	lia
品	pbk
叶	xpk
叶	yek
既	jig
存	cyu
存	cyz
睛	jkoo
宫	gsbk
烈	lph
诉	su
追	vv
推	tv
您	nb
右	yzk
右	yzuk
商	uhk
商	uhl
商	uhw
争	vgd
角	jnd
角	jtd
淡	djd
止	via
谈	tj
严	yja
恶	eex
狂	klq
挥	hvf
亮	llj
亮	llw
卫	wwe
闻	wfe
闻	wfm
忍	rfx
态	tdx
汉	hjd
继	jisv
继	jvs
模	mo
模	mumd
银	ybj
仍	rg
跑	pc
否	fz
君	jyk
妹	mwn
隐	ybex
母	muv
科	keh
凌	lkd
选	xr
梦	mg
刘	lql
寒	hjb
局	jvu
冰	bkd
禁	jbu
境	jkt
掉	dnf
究	jqx
余	yur
余	yvr
查	ia
激	jidw
号	hckv
防	fhe
费	fwb
恐	ksx
楼	lz
导	dcc
肯	kf
故	guw
游	yzd
球	qqw
树	uumc
叹	tjk
救	jqw
施	uif
帝	dij
佛	fo
简	jmvo
料	ln
际	jiex
顾	guy
齐	qiw
抓	vx
玩	wjw
猛	mgq
份	ffr
米	mid
仅	jbry
具	jvb
胜	ugot
治	vidk
章	vhl
巨	jva
巨	jvk
险	xme
守	uzb
散	sj
须	xup
须	xuy
眉	mwu
抱	bcf
权	qrm
试	uiyg
独	duq
震	vfy
索	sos
证	vgy
礼	liu
助	vul
圣	ugt
圣	ugy
股	guo
跳	tnz
波	bo
负	fudr
虎	huh
练	lms
姑	gun
唐	thg
室	uibt
伙	hor
沙	uad
妈	man
阴	ybeo
称	ighx
投	tzf
柔	rz
扬	yhf
规	gv
毫	hcm
温	wfdm
较	jni
毒	duf
毒	dum
耳	era
座	zog
射	uec
厉	lii
层	cgu
副	fud
副	ful
担	djf
参	cj
置	vis
历	li
初	iuy
卡	ka
承	igv
质	vibp
质	vip
属	uuu
渐	jmd
蓝	ljc
船	irv
逃	tcz
皮	pi
药	ycc
呀	ya
靠	kcf
充	is
标	bnm
坚	jmt
贵	gvb
共	gsb
赵	vcz
维	wwst
陆	lqe
陆	lue
块	kkt
吸	xik
刺	cil
堂	th
醒	xky
考	kc
松	ssm
排	pdf
划	hxl
换	hrf
河	hed
环	hrw
土	tua
志	vix
责	zeb
致	viw
压	yai
素	suf
素	sus
湖	hudo
睡	uvo
苏	suc
京	jkw
效	xnw
朋	pg
宇	yub
宇	yvb
顺	uy
紫	zis
伸	ufr
赛	sd
超	icz
忘	whx
幸	xktu
遇	yuz
遇	yvz
孙	sy
顶	dkd
顶	dky
拍	pdfo
警	jky
按	anf
察	iab
广	and
藏	ch
胡	huo
秘	bih
秘	mih
凡	fjj
型	xkt
尚	uhx
恩	en
脱	to
营	ykck
营	ykk
增	zg
价	jxr
史	uik
节	jpc
秋	qqh
翻	fjy
迷	miz
州	vzd
付	fu
项	xlg
萧	xnc
状	vlq
尼	ni
雅	yav
凤	fgjy
秦	qbh
草	cc
败	bdb
著	vuc
咱	zj
朱	vumr
朱	vup
呆	ddk
封	fgc
普	pu
景	jkox
专	vra
味	wwkw
舞	wura
舞	wux
弄	nsw
虚	xuh
毕	bib
讲	jly
福	fuu
纪	jisj
握	wo
习	xiv
社	ueu
永	ysdn
寻	xy
默	moh
洞	dsd
控	ksf
骑	qim
钟	vsj
徐	xusm
辈	bwi
假	jxry
病	bkbn
胸	xso
欲	yuq
欲	yvq
伯	bdr
峰	fgu
肉	rzk
岁	svu
医	yikd
野	yel
值	vir
职	vie
尊	zy
恨	hfx
狠	hfq
田	tma
魂	hyg
毛	mc
免	mmd
短	dru
秀	xqh
麻	mag
坏	hk
印	ybe
良	lld
迎	ykz
枪	qlm
弹	djg
骨	gug
骨	guob
探	tjf
啦	lak
研	yju
妖	ycnd
劲	jbl
临	lba
宁	nk
屋	wuu
案	anb
杰	jph
欧	o
饭	fju
村	cy
升	ugp
抬	tdf
蒙	mgcu
蒙	mgu
略	lt
丹	djp
源	yrd
纷	ffs
雄	xsv
烟	yjh
危	wwdv
优	yzr
写	xpb
床	ilg
罪	zvs
网	whk
食	sirg
食	uirg
板	bjm
校	xnm
某	mz
妙	mnn
休	xqr
珠	vuw
列	lp
盘	pj
透	tzz
春	iy
委	wwh
移	yih
呵	hek
偷	tzr
奥	ao
吴	wukd
验	yjm
牙	yaap
泪	lwd
宗	zsb
摆	bdfs
善	ujk
浪	lh
羽	yuxd
羽	yvxd
肩	jmh
智	vio
拥	ysf
弱	rog
柳	lqme
硬	yku
纳	nas
洛	lod
范	fjc
混	hy
玄	xrw
买	md
济	jid
徒	tus
烦	fjh
配	pw
适	uiz
端	drl
娜	nan
哭	kuk
凝	nkd
镇	vfj
率	lv
避	biz
拳	qrf
创	il
采	cdv
晓	xno
托	tof
森	sf
哼	hgk
惜	xix
束	uua
束	uumk
熟	uzh
归	gva
归	gvx
抗	khf
邪	xpe
邪	yeey
庄	vlg
喊	hjk
梅	mwm
韩	hjw
罢	bas
仇	izr
奔	bfd
亡	whdv
亡	whwv
富	fub
限	xmeg
吓	xxk
养	yhy
厅	tki
贝	bwk
娇	jnn
省	ugo
占	vja
横	hg
飘	pn
戏	xiy
画	hxa
暴	bco
灭	mp
域	yut
域	yvt
瞧	qno
软	rr
摸	mof
席	xig
稳	wfh
绿	lus
伊	yiry
讨	tcy
释	uipu
获	hoc
店	dmg
敬	jkwk
谷	gub
谷	gukr
仿	fhr
借	jpro
丈	vha
姓	xkn
挑	tnf
祖	zuu
套	tc
困	ky
墙	qlt
冒	mco
夏	xx
叔	uuyx
架	jxm
鱼	yud
鱼	yvd
织	visb
尖	jmx
丁	dka
牛	nq
旧	jqo
扑	puf
彩	cdp
降	jle
降	xle
燕	yjc
燕	yjhb
卷	jr
臂	bio
桌	vo
卖	mdu
嘿	hwk
骂	mam
鲜	xmy
幽	yzus
训	xyy
演	yjdb
闭	bim
巧	qng
奋	ffd
杂	za
亦	yiw
预	yuya
预	yvya
尤	yzw
尤	yzyd
偏	pmr
替	tio
箭	jmvl
残	cjd
拜	bdf
腿	tvo
婆	pen
婆	pon
唯	wwkt
迹	jiz
班	bjd
班	bjw
诸	vuy
吉	jika
吉	jiuk
诺	noy
狼	lhq
洋	yhd
虑	lvh
杯	bwm
袋	ddy
策	ce
腰	yco
殿	dmuy
番	fjt
测	ced
输	uui
杜	dumt
惨	cjx
盟	mgm
鲁	luo
鲁	luyo
豪	hcu
积	jih
趣	quz
圆	yrkr
午	wupu
午	wur
午	wuur
户	hud
执	vif
妇	fun
沈	ufd
登	dgd
懂	dsx
含	hj
犹	yzq
互	hua
律	lvs
锋	fgj
抢	qlf
厚	hzi
聚	jve
尸	uiv
闹	ncm
纵	zssr
凭	pkj
迅	xyz
财	cdb
搞	gcf
嘛	makm
侧	cer
农	ns
稍	uch
介	jpr
宣	xrb
抽	iz
颜	yjy
躲	dou
舒	uur
舒	uuua
舒	uuy
供	gsr
傲	aor
勇	ysl
阶	jpe
犯	fjq
益	yim
尘	ift
甲	jxa
甲	jxo
皱	vzp
街	jpx
孤	guz
协	xpu
兽	uzka
碰	pgu
伟	wwr
塔	tat
批	pif
盖	gemt
盖	gdm
盖	gdy
监	jmmd
劳	lcc
碎	svuu
撞	vlf
阻	zue
操	ccf
概	gdme
曲	qua
胆	djo
轮	lyi
婚	hyn
迟	iiz
凶	xsk
凶	xsx
党	dhe
爸	baf
剧	jvl
弃	qic
奈	ndd
逐	vuz
疯	fgb
距	jvz
附	fue
谓	wwy
歌	geq
哦	eek
构	gzm
咬	yck
误	wuy
塞	set
塞	sdt
慕	mux
笔	biv
孔	ksz
牌	pdp
陪	pwe
折	vef
窗	ilx
逼	bizt
材	cdm
挡	dhf
岛	dcn
择	vdf
择	zef
袭	xil
袭	xiyl
挂	gx
伦	lyr
遍	bmz
芒	mhc
征	vgs
触	iuj
瞪	dgo
荡	dhc
抵	dif
郎	lhe
滚	gy
怜	lmx
乃	nd
幻	hrv
幻	hry
臣	ifa
臣	ifk
判	pjl
烧	uche
翼	yiyb
腾	tg
欣	xbq
灯	dgh
库	kug
妻	qin
私	sih
荣	rsc
夺	doc
园	yrke
壁	bit
贼	zw
颗	keym
累	lws
宋	ssb
狗	gzq
悄	qnxo
颤	ijy
吟	ybk
伏	furq
瞬	uyo
舍	uer
补	buy
扫	sc
跃	ytzd
艺	yic
挺	tkf
岳	ytq
岳	ytu
悲	bwx
圈	jrk
旋	xrf
瑞	rv
惑	hox
竹	vupd
竹	vurd
蛋	dji
艾	aic
扎	va
莉	lic
损	syf
迫	pel
迫	pol
盛	ugm
企	qir
缘	yrs
纯	iys
俊	jyr
努	nul
逸	yizd
逸	yizt
菲	fwc
抖	dzf
乌	wup
油	yzdy
炼	lmh
唇	iyk
幕	muj
康	kh
吐	tuk
汗	hjdu
馆	gru
昨	zoo
赞	zjb
茶	iac
苍	chc
恢	hvxh
裂	lpy
育	yuo
育	yvo
央	yha
央	yhdk
闲	xmm
吼	hzkv
爆	bch
鼓	guv
乡	xlv
陷	xmej
曼	mjo
泰	tdd
踪	zsz
灰	hvu
赤	iit
萨	sac
缺	qtf
宽	kr
岂	qiu
伴	bjr
猜	cdq
额	ee
遗	yiz
谋	mzy
浮	fudz
昏	hyo
融	rsi
妮	nin
菜	cdc
例	lir
盯	dko
涌	ysd
遭	zczo
洲	vzdv
潜	qmdo
拼	pb
勒	leg
博	bou
蛇	uei
港	ghd
貌	mcv
绍	ucs
拔	bafy
洗	xid
彻	ies
针	vfju
纸	visq
莱	ldc
县	xmsq
剩	ugl
扶	fuf
愤	ffx
镜	jkj
爵	jtv
晶	jko
佩	pwr
讯	xyyu
忧	yzx
鼻	bizj
御	yuse
御	yvse
均	jyt
枫	fgm
泽	zed
凯	kdj
浩	hcd
奶	ndn
怨	yrx
毁	hvj
毁	hvug
壮	vlu
诚	igy
忠	vsx
洪	hsd
雾	wuyl
糊	hum
固	guk
轰	hsi
坦	tjta
睁	vgo
佳	jxrt
爹	dpf
蒂	dic
丢	dq
庆	qkg
亿	yirv
词	ciy
辛	xbd
辛	xbl
丰	fga
缩	soso
吹	iv
仰	yhr
迪	dizy
晃	hlo
庭	tkg
莲	lmc
梁	llm
仔	zir
侠	xxr
阁	gemk
检	jmma
暂	zjo
读	dzy
读	duy
郭	goe
绕	rc
插	iaf
凉	lldx
净	jkd
召	vck
减	jmdg
侍	uirc
慌	hlx
敏	mbw
伍	wurw
鹰	ykg
朗	lho
讶	yay
诗	uiyc
货	hob
掩	yjfd
码	mau
浑	hyd
隔	gee
傅	furc
疾	jib
鸟	nn
赏	uhb
摩	mamf
摩	momf
池	iid
氏	uipq
振	vff
途	tuz
闷	mfm
童	tsl
朵	doj
傻	uar
粗	cum
旦	djoa
悉	xixm
鸣	mkk
径	jks
旅	lvf
赫	hei
穴	xtb
延	yjz
惯	grx
唤	hrk
皆	jpb
盗	dcm
琴	qbw
帐	vhj
戴	ddg
忆	yixv
仁	rfr
宜	yib
甘	gja
炸	vah
戒	jpgc
琳	lbw
浓	nsd
吻	wfk
季	jihz
疼	tgb
桑	sh
堡	bct
珍	vfw
贴	tpb
符	fuv
芳	fhc
嗯	ngk
羞	xqi
羞	xqy
典	dmb
劫	jpls
骗	pmm
旗	qif
啸	xnkb
堆	dvt
霸	bay
廷	tkz
促	cu
惧	jvxb
耐	ndc
庞	phg
荒	hlc
序	xug
躺	thu
粉	ffm
慧	hvx
餐	cju
喃	njk
踏	tazo
吕	lvk
孟	mgz
抚	fufe
抚	fufy
匆	csg
漫	mjd
乘	ighb
乘	igp
启	qih
脉	mdo
仪	yiri
络	losk
拒	jvf
洁	jpd
郑	vge
奉	fgf
漂	pnd
愈	yuxl
愈	yvxl
倍	bwr
拖	tofy
怔	vgx
映	yko
访	fhy
奴	nun
乔	qnpa
颇	pey
颇	poy
愣	lgx
献	xmq
编	bms
健	jmrz
扭	nqf
缠	ijs
核	hem
评	pk
享	xlw
尾	wwuq
碧	biu
瓦	wa
尺	iis
尺	iiu
票	pnu
玛	maw
川	irp
彼	bis
焰	yjhj
醉	zvy
述	uuz
痕	hfb
晨	ifo
薄	bcc
胖	pho
恭	gsx
辉	hvg
绪	xuso
倾	qkr
亏	kv
躯	quu
磨	mom
隆	lset
岸	anu
括	gxf
废	fwg
狐	huq
吞	ty
丫	yab
丫	yada
锁	soj
忌	jixj
悟	wuxk
滑	hxd
椅	yimk
赌	dub
垂	ivp
粮	llmg
厂	iha
辰	ifi
曹	ccc
曹	cco
霍	hoy
遥	yczk
痴	iib
款	krq
贫	pbb
扩	ko
督	duoy
乖	gkp
欺	qiq
聊	lne
悠	yzxw
艳	yjf
奖	jld
帅	uk
估	gur
爬	pav
匹	pike
录	lux
截	jpg
截	jpv
牢	lcb
锐	rvj
递	diz
唱	ihk
唉	aik
嘻	xikk
董	dsc
刹	ial
刹	ual
钢	ghj
惹	rec
惹	rex
焦	jnh
穷	qs
援	yrf
慰	wwx
措	cof
悔	hvxm
革	gen
陵	lke
姿	zin
扯	iefv
泉	qrd
予	yus
予	yvs
筑	vuv
勾	gzg
授	uzf
罩	vcs
埋	mdt
熊	xsh
潮	icd
漠	modd
轩	xri
殊	uud
哀	aikd
哀	aiw
哀	aiyk
鸡	jin
掠	ltf
肚	duo
聪	cse
斩	vji
狱	yuqq
狱	yvqq
俩	lx
炮	pch
俱	jvr
挣	vgf
邦	bhe
袖	xqyy
泛	fjd
沿	yjdk
辞	ciu
卓	voa
卓	vou
恼	ncx
航	hhv
零	lky
盈	ykm
载	zdg
载	zdgi
载	zdi
扰	rcf
末	moa
恋	lmxb
肃	sux
鹏	pgn
姆	munm
屈	quui
屈	quuk
屈	quuu
眸	mzo
冥	mkb
辆	lli
劝	qrl
刃	rfd
炎	yjhh
姬	jini
拦	ljf
堪	kjt
劈	pid
墨	mot
培	pwt
霜	uly
斜	xpd
审	ufb
甜	tmu
撒	sa
驾	jxmk
耀	ycg
脆	cvo
袍	pcy
驻	vum
霞	xxy
厌	yji
尝	ihx
弯	wjg
宏	hsb
滴	did
牧	mun
键	jmj
耶	yee
销	xnj
膀	bho
寂	jiby
媚	mwno
枝	vim
牵	qmn
丧	sha
丧	sht
丧	shu
祝	vuu
趁	ifz
舌	ueq
课	key
麦	mdf
抹	maf
抹	mef
抹	mofm
玲	lkw
喷	pfk
染	rjm
跪	gvz
擦	ca
翔	xlyd
币	bip
埃	ait
钻	zr
贯	grbd
贯	grbm
盾	dyp
灾	zdb
溜	lqdt
询	xyyo
腹	fuow
渡	dud
燃	rjh
眨	vao
撤	ief
敲	qngy
敲	qnp
侵	qbr
喘	irk
柄	bkm
悦	ytx
嫁	jxn
岩	yjuk
赖	ldu
烂	ljh
嘉	jxk
嘉	jxu
拾	uifk
泥	nid
夹	gaa
夹	jxad
版	bjp
搜	sz
汇	hvd
冬	dsw
俗	sur
僧	sg
竞	jkle
喂	wwkd
骇	hdm
搭	dafk
暖	nr
茫	mhcw
茫	mhov
返	fjz
莎	uac
挤	jifa
宾	bb
冠	grbc
析	xim
郁	yue
郁	yve
允	yye
允	yys
疗	lnb
繁	fjs
桥	qn
葛	gec
祥	xluy
瘦	uzby
仲	vsrv
耸	sse
仗	vhr
弓	gsv
违	wwz
豫	yuyu
豫	yvyu
幅	fuj
胁	xpo
瓶	pkw
愧	kvx
晕	yyo
柱	vumt
饰	uiuj
翠	cv
翠	cvy
勉	mml
勉	mmml
矮	aiu
宿	sub
偶	our
汤	thdp
刑	xkl
涛	tcd
黎	lidp
煞	uah
贤	xmb
姊	zinp
衫	ujy
锦	jbj
抛	pcf
虫	isa
虫	isk
昂	ago
恰	qx
咐	fuk
铺	puj
琪	qiwb
衡	hgx
饮	ybu
捉	vof
纤	qms
纤	xmsu
袁	yrt
袁	yryk
猎	lpq
赢	ykb
购	gzb
卢	lua
础	iuu
亭	tkw
娃	wan
慈	cix
晴	qko
咒	vzjk
咒	vzk
羊	yhda
羊	yhq
签	qmv
猫	mcq
薇	wwc
覆	fux
祸	hou
罚	fas
舰	jmv
魏	wwg
耗	hcl
寸	cya
跌	dp
俄	eer
蝶	dpi
详	xly
撑	igf
闯	ilm
箱	xlvo
弗	fuga
扮	bjfd
诱	yzy
障	vhe
怖	bux
屁	piu
弥	mig
歉	qmq
砍	kju
齿	iiv
踢	tiz
寺	sic
爪	vcp
爪	vxp
贸	mcb
脏	zh
棋	qimb
贺	heb
迈	mdz
捕	buf
笼	lsv
浅	qmdj
扣	kzf
拨	bofy
扇	ujh
臭	izz
篇	pmz
猪	vuq
邓	dge
泄	xpdu
辱	ruc
辱	rui
肤	fuod
懒	ljx
裁	cdg
裁	cdy
仆	pur
穆	muh
昆	kyo
丑	izv
愁	izx
渊	yrda
勤	qbl
悬	xrx
铃	lkj
韦	wwaa
崇	isu
井	jka
帕	paj
昌	iho
鞭	bmg
叛	pjf
僵	jlr
纹	wfs
鸿	hsn
瑶	ycw
雕	dnvv
洒	sad
冯	fgd
蛮	mji
爽	uld
跨	kxz
饶	rcu
矛	mcs
缝	fgs
湾	wjd
税	uvh
涉	ued
铜	tsj
屠	tuu
麽	mem
乾	gjq
莹	ykyb
涂	tud
奸	jmn
梯	tim
邀	ycz
誉	yuyb
誉	yvyb
诡	gvy
慎	ufx
夕	xipd
婉	wjn
吩	ffk
镖	bnj
摔	ukf
魄	peb
魄	pob
卧	wob
酷	kuy
丛	csa
巡	xyzi
巡	xyzv
祭	jiun
崖	yau
誓	uiyj
描	mnf
奏	zzf
肖	xnox
肖	xnx
碍	aiuc
曰	yta
霄	xny
糟	zcm
麟	lbl
枚	mwmw
肌	jio
欠	qmd
稀	xih
阔	kom
液	yed
笨	bfv
勃	bol
毅	yiu
矿	klu
湿	uid
桃	tcm
疲	pib
荷	hec
汽	qidv
姜	jln
摄	uef
哎	aiki
植	vimq
艰	jmy
脖	boo
催	cvr
虹	hsig
巫	wugr
屏	pku
咽	yjk
驰	iim
蓉	rsck
凑	cz
愕	eexk
肥	fwo
绩	jisr
坛	tjt
凄	qidn
搬	bjf
扔	rgf
瑟	seb
瑟	sew
杖	vhm
芙	fuc
畏	wwt
频	pby
润	ry
酸	sry
割	gel
绵	mms
披	pify
滋	zid
秒	mnh
戈	gea
贪	tjb
贪	tjr
捷	jpfr
瞒	mjor
播	bof
逆	niz
咳	kek
申	ufa
卑	bwp
卑	bwu
搂	lzf
寇	kzb
魅	mwg
惠	hvxd
惠	hvxs
宛	wjbv
喉	hzk
幼	yzl
卿	qke
龄	lki
赐	cib
驶	uim
瓜	gxp
氛	ffq
腕	wjov
污	wud
谅	lly
筹	izvc
宠	isb
碗	wju
妃	fwn
筋	jbv
甩	uko
甩	ukp
甩	uky
驱	qum
寨	vdm
蕾	lwc
兼	jmbb
婷	tkn
捏	np
妥	tonz
妥	tov
拓	tofk
斥	iij
斥	iip
吵	icku
订	dkyd
纠	jqs
璃	liws
届	jpu
饿	eeu
夸	kx
倩	qmro
薛	xtc
窜	cr
崔	cvu
尉	wwcx
恒	hgxa
後	hzs
宴	yjb
晌	uho
艘	szv
辣	lax
哇	wak
柜	gvmj
斤	jbp
储	iur
挨	aif
豹	bcv
雁	yjit
吾	wuk
吾	wuwk
挖	waf
饱	bcu
彭	pgp
役	yisy
琼	qsw
遮	vez
舟	vzpd
佣	ysr
狮	uiq
寿	uzc
陶	tce
患	hrx
砸	zau
颊	jxy
励	lilw
愚	yuxs
愚	yvxs
腐	fugr
牲	ugn
哑	yak
恍	hlxe
裤	kuyi
俏	qnro
鼠	uuj
岚	lju
狄	diq
妄	whn
丘	qqj
抑	yif
呈	igk
蓦	momd
尹	ybv
尹	ybxp
坡	pet
坡	pot
契	qid
嫌	xmnb
津	jbd
售	uzk
棒	bhm
郡	jye
撕	sif
骤	vzm
疆	jlg
颈	jkyg
贾	guxb
咕	gukk
歇	xpq
漏	lzd
脾	pio
窝	wox
嫣	yjnh
盼	pjo
耻	iie
蜜	mib
蜜	mii
姨	yin
厨	iui
珊	ujw
链	lmjz
裹	gow
裹	goy
汪	whd
靖	jklo
殷	yjuv
殷	ybuv
拟	nif
淫	ybd
呜	wukw
韵	yyy
柯	kemk
巾	jba
庙	mng
纱	uas
娶	qun
矩	jvuj
棍	gym
晋	jbo
伐	far
绳	ugs
涨	vhd
添	tmd
陛	biet
嘲	ick
捧	pgf
宅	vdb
鼎	dkov
谨	jby
乏	fap
黛	ddhg
仓	chr
岗	ghu
掏	tcf
削	xndo
削	xnl
削	xtl
诧	iayq
灌	grd
旨	vib
旨	viob
刷	ux
页	year
泡	pcd
辩	bmy
俞	yurl
俞	yvrl
婴	ykn
盒	hemk
嚷	rhk
沾	vjd
漆	qidd
蠢	iyi
甫	fuad
膝	xiod
墓	muc
逢	fgz
嫩	nf
坠	vvt
雀	qnv
雀	qtv
枯	kum
偿	ihr
陌	moe
屑	xpuo
畅	ihu
陡	dze
挽	wjf
鹤	hen
涵	hjdk
署	uus
沃	wod
叉	iay
搏	bofc
逝	uizj
趟	thz
鞋	xpg
赴	fuz
谦	qmy
砰	pguu
骄	jnm
遂	svz
泣	qida
档	dhm
摊	tjft
慨	kdx
籍	jivo
擒	qbf
苗	mn
浴	yudk
浴	yvdk
鉴	jmjd
尴	gjwm
尴	gjy
迁	qmz
疏	uup
疏	uuvv
尬	gaw
尬	gay
赚	vrb
逗	dzz
豆	dza
孝	xnz
芬	ffc
湘	xldo
诀	jty
晰	xio
廉	lmg
馨	xbx
辽	lnz
械	xpm
吊	dnk
炉	luh
串	ira
裸	loy
哲	vek
凛	lbdx
渴	ked
柏	bdm
芸	yyc
拱	gsf
妨	fhn
揉	rzf
樱	ykmn
寄	jibk
宙	vzb
宰	zdbu
媒	mwnm
眯	mio
贡	gsbg
崩	bg
绑	bhs
斧	fujj
惶	hlxt
嘶	sikj
沟	gzd
禅	ijuu
禅	uju
骚	scm
荆	jklc
歪	wdb
涯	yad
耍	uxn
遵	zyz
伪	wwrw
冤	yrb
悍	hjxu
耿	gge
翅	iivd
翅	iiy
循	xys
聂	npe
猴	hzq
拂	fuff
裙	qyy
蓬	pgc
芝	vic
昭	vco
倏	uurq
舱	chv
肆	siy
帽	mcj
岭	lku
叮	dkk
拐	gkf
儒	rur
嫂	scn
瞥	ppo
廊	lhg
赔	pwb
辨	bmd
鄙	bie
哩	lik
逊	xyzx
愉	yux
愉	yvx
摘	vd
淋	lbd
牺	xink
俯	fur
谭	tjy
蒋	jlc
劣	lpl
玫	mww
吁	xuky
肠	ihop
押	yaf
昔	xic
昔	xioa
昔	xioc
攀	pjfm
乳	ruv
鹿	lugb
潘	pjd
娅	yana
藤	tgc
躬	gsu
蔡	cdcx
涩	sed
揭	jpfv
嗓	shk
啪	pak
翎	lkys
撼	hjf
竖	uul
遣	qmzk
囊	nh
眠	mmo
掀	xmf
旺	who
弘	hsg
戚	qiwx
烁	uoh
逍	xnzo
坤	kyt
憾	hjxx
仑	lyrb
租	zuh
咯	gekk
卜	boa
凰	hlj
哄	hsk
匪	fwk
膛	tho
淑	uudy
忖	cyx
堵	dut
夷	yidg
柴	idm
撇	pp
歹	dda
辜	gux
沐	mud
绽	vjs
辅	fuif
萍	pkcu
敖	aow
拆	id
磊	lwu
罕	hjx
冻	dsdd
赋	fubg
趋	quzx
瞳	tso
杆	gjm
灿	cjh
葬	zhc
篮	ljv
胞	bcos
颠	dmy
黯	anh
峡	xxu
顽	wjy
朕	vfod
兆	vce
擅	ujf
陀	toe
龟	gvd
蜂	fgi
贞	vfa
贞	vfb
阎	yjmj
咦	yik
惟	wwxt
竭	jpl
厢	xli
惩	igx
谎	hly
腔	qlo
裴	pwy
玻	bow
璇	xrwr
溪	xidd
铭	mkj
邻	lbe
朴	pnm
衷	vsw
衷	vsy
帘	lmj
帘	lmxj
拢	lsf
魁	kvg
哗	hxk
侄	virt
茵	ybc
盆	pf
阅	ytm
弦	xmg
兮	xib
翁	wg
贱	jmb
债	vdr
斌	bbw
坑	kg
逻	loz
踩	cdz
瞎	xxo
躁	zczm
讽	fgy
钉	dkj
蓄	xuc
丸	wjj
丸	wjp
丐	gda
矣	yisd
册	cek
册	cep
兔	tudd
溃	kvd
隙	xie
叠	dpq
叠	dpyq
瞄	mno
倚	yirk
轿	jnia
舅	jqj
舅	jqn
钦	qbj
祈	qiuj
烛	vuh
怡	yixk
兹	cibs
兹	zibs
肢	vioy
综	zss
禀	bku
禀	bkw
於	yuf
於	yvf
壶	huu
雯	wfy
栏	ljm
览	ljj
斑	bjww
蹲	dyz
纽	nqs
践	jmzj
棠	thmk
棠	thmx
汹	xsd
胎	tdo
妾	qpl
妾	qpn
篷	pgv
腥	xkot
厮	sii
锅	goj
楞	lgm
澳	aod
窃	qpx
霆	tky
桂	gvm
艇	tkv
轨	gvi
哨	uck
寡	gxbd
挪	no
翰	hjyd
尧	ycge
咧	lpk
怯	qpxs
瑰	gvw
沧	chd
寞	mob
叙	xuyy
彷	phs
佐	zorg
呐	nakn
卒	zuur
卒	zuw
栽	zdgm
栽	zdm
焕	hrh
塌	tatd
绣	xqs
骆	lomk
敛	lmw
携	xpf
蹄	tizj
颖	ykhr
颖	yky
棵	kem
廖	lng
呻	ufk
痒	yhb
驳	bom
裳	uhy
睹	duoo
泼	ped
泼	pod
溢	yidm
狡	jnq
倘	thr
胳	geok
羡	xmyr
婢	bin
枕	vfm
妒	dun
绮	qis
噬	uika
呃	eekv
喔	oo
狸	liq
缕	lvsn
译	yiyu
泊	bod
芷	vicv
咪	mik
刮	gxl
咖	kakk
恕	uux
煌	hlh
嘱	vuk
蚩	iii
栋	dsm
锤	ivu
逛	glz
暇	xxoy
栈	vjmj
溅	jmdj
巷	hhg
巷	hhs
巷	xls
填	tmt
膊	booc
诈	vay
昧	mwo
乞	qirv
叱	iik
姚	ycn
渔	yuda
渔	yvda
摧	cvf
遁	dyzo
焚	ffh
糕	gcm
衬	ify
倦	jrr
辕	yrin
啡	fwke
啥	uak
乙	yivv
彦	yjp
郝	hce
履	lvuw
匕	bipv
潇	xndb
茜	xick
嘟	duk
汝	rud
耽	dje
旭	xuj
浸	jbdy
畜	iut
硕	uou
蕴	yycm
侦	vfr
佑	yzrk
灼	voh
嗤	iiki
峻	jyu
菊	jvc
彤	tsp
焉	yjhv
焉	yjv
敦	dyw
哟	yo
筒	tsv
棉	mmm
霉	mwy
衰	ukw
衰	ukyx
烤	kch
麒	qilb
钩	gzj
犬	qra
庸	ysg
滩	tjdt
姥	lcn
桶	tsm
榜	bhmw
茅	mccp
狭	xxq
剥	bcd
剥	bcl
剥	bold
症	vgb
诞	djy
乍	vap
翩	pmy
辑	jii
棺	grm
潭	tjd
歆	xbqo
滞	vidj
抄	icf
谱	puy
枉	whm
趴	paz
狞	nkq
隶	lix
嗔	ifkb
毙	bisb
谊	yiyq
淮	hkd
笛	divy
缚	fus
剪	jmdl
囚	qqk
蔽	bicw
辟	pix
碌	luu
塑	sot
刊	kjl
澜	ljdb
捂	wuf
秃	tuh
掷	vife
桐	tsmt
霎	uay
搁	gef
帆	fjjf
矢	uird
腻	nio
函	hjkd
函	hjl
址	vitv
弩	nug
邱	qqe
孽	npc
孽	npz
藉	jic
胀	vho
兀	wuae
嚣	xnyk
雍	ysv
雍	ysw
巍	wwu
匠	jlj
冉	rja
冉	rjk
窥	kvxe
蛛	vui
狈	bwq
瑜	yuwl
瑜	yvwl
妍	yjnc
衍	yjs
邵	uce
朽	xqm
噗	pukd
苟	gzc
鲍	bcy
胃	wwo
壳	keu
暮	muo
萝	loc
恳	kfx
渠	qumj
挟	xpfd
琉	lqw
熙	xihs
噢	ook
雇	guh
碑	bwuu
驼	tomb
俺	anr
绘	hvs
喀	kak
斐	fww
阮	rre
嘎	ga
吱	zik
炽	iih
钥	ycjo
钥	ytj
妆	vln
杏	xkk
杏	xkm
桓	hrm
昊	hco
擎	qkfw
贷	ddb
磁	cius
宪	xmbe
沸	fwd
衙	yas
匙	iibr
匙	iiub
鞘	qngo
剂	jil
搅	jnf
猿	yrq
赠	zgb
徽	hvsw
裕	yuyk
裕	yvyk
祷	dcu
株	vumw
蜀	uusi
桩	vlm
账	vhb
巢	ici
堕	dot
梭	som
兜	dzek
敞	ihw
肿	vso
骷	kugk
髅	lzg
娟	jrn
茂	mcc
窄	vdx
菱	lkc
吨	dyk
絮	xusk
坎	kjtr
琦	qiwk
芦	luc
渗	ufdp
拘	gzf
梵	fjf
脊	jiod
澡	zcd
窟	kux
姻	ybn
捐	jrf
盏	vjm
孕	yyzn
滔	tcdj
挫	coft
伺	cir
贩	fjb
扁	bmh
墅	uut
寝	qbb
侮	wurm
垃	lat
郊	jne
眶	klok
莽	mhcc
俘	furz
蝉	iji
卦	gxb
喧	xrk
圾	jitj
诛	vuyw
澄	igd
妞	nqn
彪	bnh
淳	iyd
唔	ngkk
揽	ljfe
厦	uai
厦	xxiw
嗡	wgk
勋	xyl
歧	qiv
鸦	yan
聘	pbe
珑	lsw
哮	xnk
嗦	sokx
虞	yuh
虞	yvh
惭	cjxj
熬	aoh
迭	dpz
盐	yjmb
啧	zek
捣	dcf
梳	uumv
浆	jldx
烫	thh
虐	nt
钧	jyj
掘	jtfi
掘	jtfk
掘	jtfu
忿	ffxd
畔	pjt
樊	fjdm
倪	nir
亩	muw
咙	lsk
邮	yze
襄	xlwn
襄	xlya
禽	qbrs
鳞	lby
勿	wugp
炀	yhhp
嫉	jind
杭	hhm
嚎	hck
衔	xmx
菁	jkco
眩	xro
栗	limx
蹦	bgzo
喻	yuk
喻	yvk
盲	mho
虏	luhl
茹	ruck
觑	quj
佘	uerx
蔓	mjc
陋	lze
苹	pkc
娱	yun
娱	yvn
堤	dit
彬	bbm
绷	bgs
铸	vuj
酬	izy
绞	jnsi
渺	mnd
淘	tcdk
卸	xpev
蛟	jnii
朦	mgo
帖	tpj
菩	puck
坊	fht
旷	klo
襟	jbyx
汁	vidu
僻	pir
翘	qny
盔	kvm
嘘	xuk
峨	eeug
疚	jqb
慑	uex
粹	cvm
醋	cuy
饥	jiu
秩	vih
沫	mod
肺	fwoj
咆	pck
砖	vru
嘀	dik
弧	hug
锡	xijw
顷	qkb
顷	qky
迦	jxz
拚	pbf
胧	lso
妓	jiny
捞	lcf
蹈	dczj
坟	fft
幢	ilj
幢	vlj
湛	vjdu
湛	zjd
亨	hgl
亨	hgw
媳	xinx
荐	jmc
奕	yidb
吏	liau
磕	keum
皓	hcb
婿	xun
跋	baz
钰	yujy
钰	yvjy
罡	ghsv
扳	bjfy
屡	lvu
犀	xiun
稿	gch
蚁	yii
咚	dsk
耕	ggl
锻	drjy
奢	uedo
诊	vfyp
祺	qiub
泳	ysdy
拭	uifg
蚀	uiu
垒	lwt
冈	ghk
窍	qnxv
龚	gsl
戟	jigu
萱	xrc
绰	ics
脂	vioo
宵	xnb
钓	dnj
蔑	mpc
嵌	qmu
戮	lugp
叩	kzk
迸	bgz
淹	yjd
丞	iga
丞	igl
喇	lakl
哧	iikb
叨	dck
瓷	ciw
炯	jsh
蝎	xpi
揪	jqfh
沛	pwd
斋	vdw
侣	lvr
挠	ncf
蝠	fuit
逞	igz
疫	yiby
眷	jro
姗	ujn
懈	xpx
瘫	tjbt
饼	bkuc
嗅	xqk
豁	hogk
棚	pgm
煤	mwh
框	klm
绸	izs
殖	vidq
券	qrdf
蒸	vgc
蒸	vgh
熄	xihx
疤	bab
蒲	puc
稚	viht
莺	yknb
冀	jiba
冀	jibc
稻	dch
葡	pucf
侃	kjr
捆	kyf
澈	ied
毯	tjm
傍	bhr
旬	xyg
旬	xyog
呕	ou
梧	wum
寓	yubs
寓	yvbs
粘	nmm
粘	vjmk
滨	bbd
薪	xbcj
阱	jke
撩	lnf
舔	tmux
辖	xxik
舜	uyv
舜	uyx
梨	lim
猾	hxq
抿	mbf
禹	yup
禹	yvp
啼	tik
炭	tjuh
砚	yjue
玑	jiw
掐	qxf
夭	ycp
榻	tam
哉	zdgk
哉	zdk
逮	ddz
旱	hjo
驴	lvm
甄	vfwt
煮	vuho
憋	bpx
缴	jns
蕊	rvc
稽	qiho
绯	fws
喽	lzk
涡	god
滥	ljd
搓	cofg
颓	tvy
瞅	izo
铮	vgjx
纲	ghs
揍	zzfd
鹅	een
氓	mgw
瑾	jbw
肝	gjo
踉	llz
讪	ujyu
箫	xnvb
腊	lao
霓	niy
惫	bwxt
淌	thd
霹	piyu
垫	dmt
跄	qlz
茨	cic
刁	dnv
禄	luud
膜	moo
诅	zuy
擂	lwf
轴	vzi
厥	jti
讥	jiyj
厄	eei
胶	jnoi
扛	khfg
惕	tix
瞟	pno
凸	tuaa
肘	vzo
媛	yrn
拧	nkf
浙	ved
奎	kvdt
熏	xyh
沁	qbd
骏	jym
笙	ugv
岔	iau
沮	jvd
颅	luy
酥	suy
冶	yedk
嗽	szkr
舵	dov
燥	zch
拙	vofu
蛊	gum
瓣	bjg
吭	hhk
绫	lks
蝴	hui
罐	grf
糖	thm
蹙	cuz
琢	vow
漾	yhdy
绅	ufs
怠	ddxk
嗷	aok
沦	lyd
鸭	yaj
鸭	yanj
涅	npd
驭	yum
驭	yvm
咏	ysk
窒	vixt
槐	hkm
凳	dgj
臀	tyo
伞	sjr
懊	aox
雳	liyl
逾	yuzl
逾	yvzl
唬	hukj
葫	huc
闺	gvmt
咸	xmwk
镶	xlj
萄	tcc
梢	ucm
嗜	uiko
戳	io
铲	ijj
缪	mnsp
猩	xkq
跺	dozm
蟒	mhi
詹	vjdk
詹	vjw
詹	vjy
晒	ud
浦	pudf
邹	zze
黝	yzh
筷	kkv
狰	vgq
霖	lbym
炫	xrh
凹	aoa
伶	lkrs
揣	ik
窘	js
悸	jixz
垮	kxt
噜	luk
颔	hjyk
嚼	jnk
嚼	jtk
尿	nnu
沼	vcd
塘	tht
肋	leo
簇	cuv
哆	dok
兢	jkk
琐	sow
颁	bjy
泻	xpdy
鞠	jvgm
匿	nik
膨	pgo
酿	nly
颂	ssy
瘾	ybb
栖	qimk
蔚	wwcc
楠	njm
帜	vij
剔	tilw
靴	xtg
萌	mgc
棘	jicb
棘	jicm
娥	eeng
沌	dyd
谜	miy
觅	mij
砂	uau
脯	fuof
脯	puo
讳	hvy
螺	loi
晖	hvoi
韧	rfw
瞻	vjo
蜡	lai
瀑	pud
璧	biwu
璧	biy
蚕	cji
聋	lse
漓	lids
踱	doz
谣	ycy
敷	fuww
偎	wwrd
绢	jrs
噩	eew
搔	scf
晏	yjon
匣	xxkj
倔	jtr
蹬	dgz
苑	yrc
婶	ufn
歼	jmdu
缉	jise
缉	jiss
彰	vhp
拇	muf
寥	lnbp
昼	vzia
弊	bic
坪	pkt
敝	biw
裘	qqy
呸	pwk
憎	zgx
镔	bbj
悯	mbx
舆	yube
舆	yui
舆	yujb
舆	yvbe
舆	yvi
舆	yvjb
诵	ssyy
拎	lbf
唾	tok
瑛	ykw
枢	uumq
叭	pakb
挚	vifw
揖	yife
揖	yifs
兑	dvb
蜘	viik
秉	bkhx
荫	ybco
衅	xbxu
壤	rht
匀	yyg
驯	xym
浊	vod
惚	huxx
牟	mzn
牟	muns
呛	qlk
祁	qie
祁	qiue
娴	xmn
蜥	xiij
炒	ich
婕	jpnr
甸	dmgt
惮	djx
碟	dpu
谐	xpyo
叟	szj
叟	szy
猝	cuq
侥	jnr
斟	vfd
啤	pik
髓	svg
寰	hrbn
峙	viuc
赦	ueiw
赦	uew
噪	zck
枭	xnn
浇	jnde
腮	sdo
遏	eez
哽	ggk
芽	yac
婪	ljn
倭	wor
卵	lre
卵	lrmd
暧	aio
阙	qtmr
诏	vcy
炙	viho
炙	vioh
祟	svuk
拣	jmf
邸	die
骸	hdg
谬	mq
磋	cou
涕	tid
瀚	hjdd
邢	xke
捶	ivf
袱	fuy
洽	qxd
峭	qnu
巩	gsgf
檀	tjma
赎	uub
祀	sius
滕	tgo
柬	jmmb
柬	jmmk
嵩	ssu
嬉	xin
僚	lnr
睬	cdo
葱	csc
嬷	mans
缸	ghf
杉	uam
虔	qmhw
娲	wann
拽	vk
廓	kog
玮	wwww
蔷	qlc
恃	uix
竿	gjv
恙	yhx
绒	rss
瑚	huwo
漪	yidk
鹃	jrno
睫	jpo
鸽	genk
陕	uje
钞	icj
蝙	bmi
搀	ijf
袅	nnn
袅	nny
蝇	yki
佬	lcr
蚂	mai
蚊	wfi
翡	fwye
朔	uoo
踹	ikz
嗖	szk
芊	qmc
崎	qiuk
啃	kfk
璋	vhw
慷	khx
咋	vak
咋	zak
檐	yjmk
鞍	ang
剿	jnlm
腑	fuoc
悚	ssxb
缎	drs
匈	xsg
厕	cei
鹫	jqny
涟	lmd
虾	xxi
漩	xrdr
聆	lkes
栅	vamc
搐	iuf
鸾	lrnb
蓓	bwc
扒	bafb
扒	paf
穹	qsx
瑕	xxw
珀	pew
珀	pow
锥	vvj
矫	jnu
庐	lug
暑	uuo
溶	rsd
靡	mif
晦	hvo
喳	iak
咄	doki
咄	dokk
咄	doku
巅	dmur
墟	xut
煎	jmhd
芯	xbc
亢	khw
掳	luf
屯	tya
叽	jikj
曦	xiog
獠	lnq
厘	liit
懦	nox
渣	vad
桀	jpm
恬	tmx
缀	vvs
褪	tyy
嵋	mwum
筝	vgvx
秽	hvh
庇	big
绊	bjs
褚	iuyo
拯	vgfa
衲	nay
眺	tno
悴	cvx
驹	jvm
钝	dyj
酋	qqb
酋	qqqk
酋	qqyb
珂	kew
祢	miu
狙	jvq
汰	tddd
汰	tddt
镯	voj
贿	hvb
铠	kdjj
粥	vzg
佟	tsrd
芮	rvcn
奄	yjdd
怅	ihxi
剖	pz
伽	qpr
忡	isx
萎	wwcn
凿	zcku
凿	zcy
凿	zok
凿	zoyk
鬟	hri
奠	dmq
熠	yiho
憔	qnx
钮	nqj
妩	wune
妩	wuny
抡	lyf
崆	ksu
弛	iig
褐	hey
勘	kjlu
妲	dan
唰	uxk
惺	xkxt
膏	gco
筠	jyv
贬	bmb
绚	xrs
嗨	hdk
怦	pgx
晤	wuo
俐	lirl
窦	dzx
驿	yimu
棱	lkm
竺	vuve
烙	lch
睿	rvo
锣	loj
溺	nidd
恺	kdxj
缔	dis
牡	munt
鬓	bbi
藩	fjct
谕	yuyl
谕	yvyl
庵	angd
憨	hjxw
瘟	wfb
钗	idj
昕	xbo
徊	hks
偌	ror
髯	rji
缰	jlsa
庶	uug
札	vamv
缭	lns
徘	pds
曙	uuoo
阀	fam
殆	ddd
巳	sivv
纬	wwsw
缄	jms
澎	pgd
掣	iefd
惘	whxv
惘	whxw
槽	ccm
诣	yiyo
曳	yeoq
娄	lzm
娄	lzn
胤	ybo
胤	ybp
惋	wjx
虬	qqi
倡	ihro
芭	bac
琛	ifw
肴	ycou
肴	ycxo
蹭	cgz
庚	ggg
飙	bnfq
仕	uiru
貂	dnvk
嚓	cak
蜴	yiiw
募	mul
昱	yuoa
昱	yvoa
圳	vft
氧	yhqy
悻	xkx
佯	yhry
锵	qljc
隋	sveo
笃	duv
筱	xnvw
忑	tex
捅	tsf
捺	nafx
茉	mocm
萤	ykib
佗	tor
睨	nioe
邃	svzu
谴	qmyz
霏	fwye
屎	uium
乒	pkp
乒	pkq
谍	dpy
缅	mmsk
忐	tjx
暄	xroa
簌	suv
鲸	jkyx
涎	xmd
瞩	vuo
攒	zjf
蟹	xpin
茄	qpc
漱	uudr
饲	siu
嗣	sik
嗣	sis
诫	jpyg
阐	ijm
瑭	thw
熔	rsh
冽	lpd
棕	zsm
酱	jlyx
辫	bmsu
辙	vei
闵	mbm
殴	ouu
蛙	wai
滢	ykdy
晁	ico
删	ujc
删	ujl
裔	yiyk
膳	ujo
殃	yhdd
蔼	aicv
茱	vucw
苛	kec
跷	qnz
痊	qrb
樵	qnmh
烘	hsh
癫	dmbr
懿	yiux
懿	yiyx
扼	eef
吆	ycks
鸠	jqnj
茧	jmci
孜	ziw
侨	qnr
幡	fjjt
咎	jqk
蔬	uuc
酣	hjy
亵	xpw
亵	xpyw
哝	nsk
隧	svez
禾	hep
纺	fhs
黏	nmh
黏	nmuk
黏	nmv
湃	pdd
绛	jls
崛	jtu
嘈	cck
眈	djoe
皙	xibj
礁	jnuh
琅	lhw
睦	muot
薰	xych
璐	luw
蹿	crz
邑	yikb
躇	iuz
菌	jyc
枣	zcc
踌	izzc
迢	tnzk
赃	zhb
臻	vfv
苇	wwcw
篝	gzv
袜	way
崭	vju
屿	yuu
屿	yvu
娆	rcn
靳	jbg
咨	zikr
煜	yuha
煜	yvha
聿	yuve
聿	yuxu
聿	yvve
聿	yvxu
陨	yyer
鸳	yrnv
榴	lqm
帷	wwjt
钵	bojb
毋	wuv
橙	igm
雌	civ
丙	bka
琥	huw
匡	klk
狩	uzq
芜	wuc
羿	yiyc
璀	cvw
鲨	uayu
冕	mmoe
讷	ney
蠕	ruia
砌	qiud
戾	lihq
掺	ijfp
拈	nmfk
酌	voy
殇	uhd
忒	teg
忒	tvg
铅	qmjk
戎	rsg
蹑	npzy
唠	lck
苔	tdc
栩	xum
烨	yeh
吝	lbk
啜	iok
涣	hrd
甬	yss
甬	ysys
莞	grc
恻	cex
雏	iuv
窖	jnx
傀	kvr
蜷	qri
岱	ddu
疙	geb
飒	sal
衮	gyw
衮	gyys
谑	xtyx
乓	phd
乓	php
乓	phq
棣	dim
磅	bhu
焱	yjhh
猖	ihq
簿	buvc
譬	piy
羁	jism
戬	jmgo
拗	aof
煦	xuhk
烬	jbh
伫	vura
葵	kvc
镰	lmjb
瘩	dab
趾	viz
攸	yzrw
剌	lal
唧	jike
睽	kvod
坝	bat
紊	wfsw
渍	zidr
迳	jkz
靶	bag
糙	ccmz
宦	hrbi
吮	uyk
勺	ucg
祯	vfur
邯	hje
鄂	eee
窑	ycx
圭	gvt
侈	iir
粪	ffmb
杠	ghm
鸯	yhn
炬	jvh
浏	lqdl
橡	xlmu
孰	uuw
琶	pab
琶	paw
俨	yjr
泓	hsds
涧	jmdo
呗	bdk
麾	hvm
昵	niob
屹	yiuv
恤	xux
寐	mwb
婧	jkn
闸	vam
韶	ucy
菇	guc
靓	llq
椒	jnmy
荀	xyc
癸	gvdd
癸	gvtd
饕	tcu
啐	cvk
疮	ilb
岑	cf
辎	ziit
攘	rhf
琵	piw
稷	jihw
肮	agoj
矜	jbm
楣	mwmo
渎	dudd
荧	ykh
噎	yeka
呱	gxk
崽	zdu
饵	eru
拷	kcfv
锭	dkjr
缥	pns
瘪	bpb
瞠	igo
沪	hudu
奚	xids
奚	xivd
籁	ldv
湮	yjdt
萦	yks
劭	ucl
铛	dhj
茗	mkc
弑	uigg
弑	uigm
弑	uixg
痹	bibj
飕	szfy
铿	kgj
璨	cjw
赘	vvb
缨	yksn
畴	izt
儡	lwr
冢	vsb
辐	fui
蜈	wui
珞	low
鞑	dag
咻	xqkm
笈	jivj
扈	huhb
壑	het
骰	tzg
撰	vrf
鲲	kyy
噤	jbk
煽	ujhd
玺	xiw
玺	xiyx
炳	bkh
捻	nmf
诶	ei
嗒	tak
锯	jvj
浣	hrde
窿	lsx
坞	wut
鑫	xbjj
磷	lbu
蜒	yjiz
噔	dgk
绎	yisu
咔	kakb
扉	fwh
阖	hemm
穗	svh
叁	sjs
茸	rsce
踞	jvzk
皂	zcb
璞	puw
垢	gzt
枷	jxmk
珏	jtw
骋	igmv
矗	iuvq
缇	tisr
蹊	xizd
粟	sum
呦	yzkl
驸	fumc
唆	sok
馒	mju
寅	ybbb
撮	zof
羹	ggy
楮	iumo
峦	lru
灶	zcht
餮	tpu
靥	yei
嬴	yknf
遐	xxz
胭	yjoy
顼	xuwr
榕	rsm
胯	kxo
迂	yuzy
迂	yvzy
惦	dmx
伎	jiry
诬	wuya
诬	wuyg
癌	aib
桨	jlm
黠	xxh
逵	kvz
韬	tcw
嫡	din
悼	dcx
喏	nok
帛	boj
俭	jmra
啄	vok
咣	glk
铐	kcj
咫	vii
钳	qmjg
骼	geg
舷	xmv
祠	ciuk
箍	guvk
箍	guvz
橱	ium
鳄	eeyv
袂	mwyd
溟	mkd
锈	xqj
篱	livs
缈	mns
淤	yudd
淤	yvdd
铎	doju
囔	nhk
蚣	gsi
痞	pibk
吒	vakq
迄	qizv
稼	jxh
汀	tkd
槛	kjm
漉	ludb
椎	ivm
椎	vvm
辗	vjin
滤	lvd
洼	wad
醇	iyy
瘤	lqb
桅	wwm
喵	mnk
亥	hdw
渝	yudl
渝	yvdl
惬	qpxk
淼	mndd
咛	nkk
蛾	eeig
筛	udv
髻	jiik
幌	hlje
笺	jmvj
憧	isxt
梗	ggm
颍	ykdr
颍	ykyd
瓢	png
馀	yuum
馀	yvum
殉	xyd
翟	vdy
盎	agm
濒	bbdr
簧	hlv
馈	kvu
孺	ruz
伢	yar
闽	mbi
闽	mbmi
楷	kdm
亘	gfa
亘	gfe
亘	gfo
惴	vvx
瓒	zjw
笋	syv
咀	jvkq
幺	ycvs
蒜	src
掂	dmf
杵	iumu
瞑	mko
兖	yjwe
峒	tsu
颐	yiir
颐	yiyi
曜	ycot
螂	lhi
毗	pitb
飓	jvfb
缆	ljs
芥	gdc
缤	bbs
蜿	wji
翊	yil
卉	hvuc
屉	tiuu
翱	aoyu
拴	ur
湄	mwd
稠	izh
桦	hxm
鹊	qtn
咂	zakz
燎	lnh
谏	jmyb
贮	iub
猥	wwq
峥	vgu
溯	sud
佼	jnri
喋	dpk
诩	xuyd
渥	wodt
曝	puod
剃	til
邺	yeea
羔	gcy
匾	bmk
汲	jidj
邬	wuew
赂	lub
炜	wwhw
锢	guj
吠	fwkq
锄	iujl
蛤	gei
藻	zccm
烹	pgh
蹋	taz
垦	kft
迥	jsz
岐	qiuy
耷	dae
隘	aie
淬	cvd
嚅	ruk
慵	ysx
烽	fgh
诲	hvym
橘	jvmk
翌	yild
濮	pudd
蟾	ijik
垣	yrta
锺	vsjt
抉	jtf
茬	iact
啷	lhk
淇	qidb
硝	xnu
沥	lidl
褥	ruyc
踝	hkz
矶	jiuj
骁	xnme
酝	yyys
梓	zimu
唷	yok
玎	dkw
憬	jkxx
霭	aiy
蕉	jnc
眦	zio
墩	dyt
毡	vjmk
蕃	fjct
弼	bigg
肇	vcyw
阑	ljmb
垄	lst
晟	ugog
呲	cik
毓	yumv
毓	yvmv
痪	hrb
陇	lsel
鳌	aoyw
袒	tjya
谛	diyj
忏	ijx
拌	bjfu
臾	yuj
臾	yvj
瀛	ykd
簪	zjv
懵	mgx
纶	grs
跤	jnz
胴	dso
浚	jyd
唏	xikj
筏	fav
甥	ugnt
甥	ugul
蝗	hli
癞	ldb
瓮	wgw
驮	dom
涤	didm
捍	hjfu
膺	ykgo
铳	isj
芹	qbc
嘭	pgk
骥	jimb
炕	khh
匐	fugt
羌	qlyv
娓	wwnq
壕	hct
宓	mibb
隼	syvu
泌	midb
嗫	npky
桔	jpmk
圃	puk
抒	uuf
稣	suym
瓯	ouw
鲤	liy
磐	pju
萃	cvc
魃	bagy
侬	nsr
讼	ssys
萼	eec
皎	jnb
簸	bovy
姒	sin
叼	dnkd
茎	jkc
瞿	quv
剁	dol
篆	vrv
羲	xiyg
骡	lom
鹦	yknn
蕙	hvcx
隅	yues
隅	yves
瘸	qtb
炊	ivh
饷	xluk
辄	veiv
嘤	ykkn
颌	heyr
腆	tmo
嫖	pnn
惆	izxv
媲	pin
馁	nwu
娉	pkn
褒	bcw
褒	bcym
旖	yifk
馋	iju
噘	jtkr
呤	lkks
缜	vfs
荃	qrc
捋	lof
捋	lvfc
胥	xuo
潺	ijd
卯	mce
婵	ijn
撅	jtfr
涔	cfd
舫	fhv
柿	uimj
偕	xpr
汩	gudo
榨	vame
苞	pcc
胄	vzoy
坍	tjtd
麓	lul
鸥	oun
掬	jvfm
礴	bouc
轧	gai
轧	yaiv
纣	vzs
淀	dmd
糜	mim
昙	tjo
壹	yiua
埔	put
诃	heyk
魇	yjg
魇	yjis
凋	dnd
蹂	rzz
荼	tuc
镑	bhj
鹉	wung
臧	zhi
臧	zhv
臧	zhw
褂	gxy
筐	klv
纨	wjs
筵	yjvz
轼	uii
蘑	mock
潞	lud
榆	yuml
榆	yvml
沣	fgdu
黔	qmh
玟	wfw
婊	bnn
旌	jkff
痉	jkb
魑	iigs
嫦	ihnj
卞	bmw
瘴	vhbu
丕	pia
丕	piba
贽	vibw
袄	aoy
砾	liux
挛	lrf
麴	qumm
麴	qumx
腋	yeo
隽	jrv
躏	lbzt
撂	lnfk
偃	yjry
馅	xmu
醺	xyyh
嗥	hcku
渭	wwdo
阉	yjmd
蟆	maid
盅	vsm
沓	dad
沓	tado
榭	xpmc
睐	ldo
婀	eenk
哒	dak
啬	sek
啬	seu
郢	yke
噼	piku
琬	wjwv
栓	urm
冗	rsb
睚	yao
硫	lqu
癖	pibu
霈	pwyj
甭	bgy
侏	vurw
皑	aibj
拄	vuf
夙	suj
渲	xrda
秤	pkh
攫	jtfy
岌	jiuj
岌	jiuz
遽	jvzu
蛆	qui
赧	nji
踵	vsz
汴	bmdb
鸨	bcn
剐	gxln
窈	ycxl
潼	tsd
靼	daga
睑	jmoa
霁	jiya
沅	yrde
卤	luak
掰	bdff
攥	zrf
鹭	lunk
藕	ouc
颚	eey
蛰	veiw
幔	mjj
腼	mmok
篡	crv
恣	zix
蟠	pji
噌	cgk
嫔	pbnb
裆	dhy
哺	buk
跚	ujz
馥	fuxw
孚	fuzz
僖	xirk
窕	tnx
盂	yumy
盂	yvmy
钊	vcj
囤	tyk
喟	kvko
跛	boz
刨	bcls
刨	pcl
槌	ivmz
臊	sco
苜	muco
渤	bodl
螳	thi
肾	ufo
荤	hyc
捎	ucf
镭	lwj
糗	qqmq
薯	uuco
徨	hls
蜕	tvi
瑙	ncw
噫	yikx
鳖	bpy
妤	yuna
妤	yvna
谪	vey
贲	bfb
隗	kve
裟	uayu
擞	szf
濑	lddr
绔	kus
鳅	qqyh
戍	uuwd
摹	mofd
堑	qmt
绾	wjsk
捱	aift
旎	nifb
谄	ijyj
谒	yey
谧	miym
嚏	tikr
苋	xmce
恸	tsx
粤	ytmv
粤	ytp
姣	jnni
碳	tju
殒	yyd
哂	ufkk
龌	woit
啾	jqkh
蹒	pjz
蝼	lzi
龊	ioir
娼	ihn
揩	kdf
沂	yidj
舶	bovo
泞	nkdd
啻	iikj
阜	fuuk
弋	yia
恪	kex
蜃	ufi
搪	thf
辘	luib
挲	saf
挲	sof
娑	son
嗝	geka
饺	jnui
桉	anm
岖	quuq
杳	ycm
碾	nmu
妪	yunq
妪	yvnq
袈	jxyk
赈	vfbn
摒	bkf
孵	fulz
菡	hjc
哐	klkk
羚	lkys
撬	qnf
颉	jpyk
颉	xpyk
晔	yeou
罔	whkv
倜	tir
倌	grr
藐	mnc
髦	mci
髦	mcm
猊	niq
汐	xidx
颦	pbbr
颦	pbv
臌	guoy
獒	aoq
粼	lbm
杞	qimj
蚌	bgi
郸	djeu
揄	yufl
揄	yvfl
竣	jyl
嗲	dxk
瞌	keo
胚	pwo
愠	yyx
谙	any
恁	nfx
龇	zii
啵	bok
匍	pug
脓	nso
撵	nmfi
痰	tjbh
蛹	ysi
觎	yujl
觎	yvjl
畿	jigt
畿	jiyt
殛	jida
泯	mbd
讹	eeyq
潦	lnd
犁	lin
苓	lkcd
犷	glq
俟	sird
邝	kle
弈	yicb
呓	yikv
汛	xydu
螓	qbi
觊	jij
玷	dmw
瞰	kjo
槟	bbmb
椰	yem
垠	ybt
邕	ysib
邕	ysyv
臆	yiox
钛	tdj
挎	kxf
粱	llmb
涸	hedg
糯	nom
霾	mdy
禧	xiuk
俸	fgr
箕	jivb
坷	ket
祗	viud
熹	xihk
俑	ysry
怂	ssx
噙	qbk
湍	trd
赣	gjvr
芋	yuc
芋	yvc
咝	sika
潋	lmdw
噶	gak
巽	xyb
巽	xysb
汕	ujd
仞	rfrd
釜	fufa
鬃	zsi
嗵	tsk
颀	qij
颀	qiy
锚	mcjt
螭	iiis
洵	xydo
犸	maq
珈	jxw
魍	whg
摁	enf
疵	cibb
忤	wuxu
汾	ffdd
汜	sids
琰	yjw
褛	lvy
惰	dox
蚯	qqig
斓	ljw
觐	jbjt
梆	bhme
漳	vhdu
镣	lnj
贻	yibk
粲	cjm
恿	ysxy
谲	jtyk
咿	yiky
咤	vakq
篓	lzv
飚	bnfh
篑	kvv
憩	qix
椭	tom
睥	piot
沽	gud
犄	jink
怏	yhxd
魉	llg
鼾	hjbu
堰	yjt
齑	jiwa
齑	jiwj
帚	vzj
帚	vzx
亟	jia
亟	jila
镀	duj
骠	pnmx
苯	bfc
宸	ifb
僮	tsr
僮	vlr
阗	tmm
榄	ljme
辇	nmi
豺	idv
翦	jmyd
纰	pis
阂	hemr
旃	vjfd
荦	lon
蚓	ybi
趄	qpz
猬	wwqo
劾	hel
趔	lpz
蜻	qkio
嵘	rsu
铝	lvj
滇	dmdb
呷	gakj
呷	jxkj
呷	xxkj
暹	xmz
蠡	liiu
淄	zidt
囵	lyk
掸	djfu
溉	gdd
坳	aot
轲	kei
皋	gcb
骜	aom
螃	phi
帧	vgj
蘅	hgc
剽	pnl
坂	bjt
涓	jrd
魈	xng
怆	ilxv
袤	mcw
袤	mcy
嗳	aiky
踊	ysz
锏	jmjo
濡	ruda
昀	yyod
鹞	ycnk
氲	yyq
厩	jqi
徙	xir
徙	xisr
瑁	mcwo
箩	lov
斡	wodr
斡	wouu
抠	kzfq
褶	veyo
痣	vibx
晾	llox
廿	nma
揶	yefe
炖	dyh
氤	ybq
蹩	bpz
芍	ucc
愫	suxx
玳	ddw
嗬	hekk
臼	jqpa
淅	xidj
嘣	bgk
桧	gvms
腺	xmod
壬	rfp
瘁	cvb
堇	jbnt
侗	dsr
赁	lbb
匝	zaj
匝	zakj
孱	ijuz
灸	jqh
褴	ljy
镂	lzj
畸	jitk
碴	vau
羯	jpyv
暨	jiga
谤	bhy
彝	yicx
彝	yivc
嘹	lnk
雹	bcys
忱	ifx
蔫	nmc
荔	licl
鲛	jnyi
硅	gvu
刽	gvls
悖	bwxz
脐	qioa
骧	xlmn
夥	hogx
盹	dyo
孪	lrz
谆	vyy
殡	bbdb
诌	vzy
琊	yaw
敕	iiw
禺	yuas
禺	yuos
禺	yvas
禺	yvos
罂	ykf
犊	dund
滟	yjdb
藜	licd
蟑	vhi
郦	lie
绥	svs
讧	hsy
潢	hldb
夔	kvb
橄	gjmw
桢	vfmr
酆	fge
淆	ycd
涮	urd
蜗	woi
垛	dotm
啕	tck
孬	ncb
臃	yso
澹	djdk
澹	tjdk
耘	yyl
徵	visw
銮	lrj
豚	tyou
蓟	jicl
汶	wfdi
皿	mba
皿	mbka
遑	hlz
倨	jvrk
燧	svhz
佻	tnr
诘	jpy
碉	dnuv
摞	lofx
镐	gcj
诽	fwy
掖	yefd
掖	yefn
峋	xyu
戛	jxg
蒯	kkl
叵	pek
叵	pok
泗	sids
鄢	yjeh
鏖	aol
邋	laz
舐	uiuq
獗	jtq
酉	yzak
煊	xrha
嗟	jpkg
忻	xbxj
泱	yhdd
蔻	kzc
蓁	vfc
琮	csw
遢	tazd
庖	pcg
帼	gojg
琏	lmwz
诋	diy
骊	limd
荻	dich
遨	aoz
俪	lird
秧	yhh
怵	iux
瘠	jibo
诠	qryt
忪	ssxs
鹄	hun
卟	bukb
腴	yuor
腴	yvor
嶙	lbua
犒	kcn
挞	taf
焊	hjh
碱	jmu
傥	thre
迩	erz
馊	szu
摺	vefo
珩	hgwd
葳	wwcg
绉	vzsx
斫	vouj
跆	tdz
珉	mbwq
泠	lkdd
忸	nqx
闩	urma
鸵	ton
彗	hvxu
麝	uel
耙	bal
岷	mbu
鸶	sina
粽	zsmx
蝈	goi
闳	hsm
骛	wumw
佝	gzr
蜓	tkiz
笆	bavv
怩	nix
奂	hrdd
掇	dof
艮	gfv
舀	ycj
舀	ycv
膘	bno
踮	dmz
匮	kvk
濠	hcdu
狒	fwq
宕	dhb
皖	wjbe
燮	xph
燮	xpyh
邙	mhe
喙	hvku
莓	mwc
颛	vry
椿	iym
陲	ive
恫	dsxt
钹	bojy
檄	ximw
绡	xns
鳍	qiyo
椁	gomz
偻	lzr
纾	uusa
鹧	ven
弭	mige
弭	migu
漕	ccd
荑	tic
荑	yicy
贰	erb
贰	erg
槿	jbmt
牒	dpp
鸢	yrng
鸢	yry
砺	liuw
雉	viut
鸪	gunk
绺	lqs
橇	qnm
跻	jiza
轶	yiid
戊	wuap
猷	yzqk
锹	qnj
衾	qby
钺	ytjg
祚	zoue
闾	lvmk
涝	lcd
荥	xkd
逅	hzz
肪	fho
囱	csp
洱	erde
洱	erds
峪	yuuk
峪	yvuk
鄱	pee
鄱	poe
箬	rov
嫒	ain
繇	yzs
繇	yzvx
繇	yzxk
繇	ycsk
繇	ycsu
繇	ycvx
繇	ycxk
莆	fucf
阪	bje
镳	bnjh
浃	jxd
佞	nkr
麋	mil
搡	shf
蘸	vjc
挝	vxf
挝	wof
岈	yauy
唳	likq
娣	dinp
忾	kdxv
戌	xuw
幄	woj
氢	qkq
霰	xmyw
蔺	lbc
骅	hxmu
蚱	vai
谀	yuyr
谀	yvyr
俦	izrc
昶	ihoy
撸	lufo
狻	srq
荏	rfc
磬	qku
昴	mcoe
杈	iam
闰	rym
缮	ujs
谚	yjyp
龛	kjlk
鸩	vfn
谗	ijyd
砥	diu
俎	zuq
瘀	yubd
瘀	yvbd
邂	xpz
沏	qidd
邈	mnz
埠	but
坯	pit
咭	qxk
缙	jbso
蹇	jmzb
俾	bir
蜚	fwi
箐	qkv
籽	zim
阚	hjm
嗄	aakw
嗄	uakw
钠	naj
泾	jkdg
腓	fwoe
驽	num
辍	ioi
鞅	yhg
蹶	jtz
迤	yizy
诮	qnyo
哔	bik
赳	jqz
刎	wfl
聒	goek
抨	pgfu
腌	aao
佥	qmra
炷	vuhw
淙	csd
饯	jmuj
垩	eet
磺	hlu
鳗	mjyy
钏	irj
氅	ihmw
胛	jxoj
遛	lqz
涿	vodu
酪	lcy
糠	khm
翕	xiyk
姝	uun
佶	jir
茴	hvc
呔	ddkt
檬	mgmu
衩	iayc
柩	jqmk
恹	yjx
翳	yiyy
纂	zrs
纂	zrv
姹	ian
浒	xud
跖	vizk
琨	kyw
铄	uoj
镌	jrjn
佃	dmr
钜	jvjj
嗑	kekm
沱	tod
膻	ujoa
楔	xpmd
徇	xyso
懑	mfx
豸	vipp
儆	jkr
貉	hev
潸	ujdo
仨	sar
讫	qiyv
圜	yrkn
孀	uln
秣	mohm
蜍	iuim
汨	mido
柠	nkm
唁	yjkk
舄	xijh
呶	nck
戗	qlgv
璎	ykwn
莜	yzcw
泸	ludu
谟	moy
椋	llmx
扪	mff
聃	djer
辔	pwi
逖	tizh
猡	loq
剜	wjl
佰	bdro
掴	gof
绶	uzs
茁	voc
罄	qkfy
町	dkt
龅	bci
蛀	vuit
诳	kly
颧	qryt
嵇	jihu
谩	mjy
砝	fau
殓	lmda
胫	jkog
螟	mki
玖	jqwj
蛭	viit
祛	quus
裨	biyu
赝	yjbt
赝	yjib
氐	dip
氐	diud
湫	qqdh
葆	bccm
蒺	jicd
睇	dio
樽	zym
绦	tcs
涪	fudk
啮	npk
锲	qpj
懔	lbx
囡	njkn
蹴	cuzy
篙	gcv
葩	pac
濯	vodt
矍	jto
矍	jtyt
溥	pudc
藓	xmc
铨	qrj
盥	grme
黜	iuh
覃	qbx
覃	tjxu
煅	drh
谡	suyw
坨	tot
淞	ssds
铤	tkj
犟	jlni
璜	hlw
铀	yzj
驷	sim
樟	vhmu
猕	miq
菠	boc
鱿	yzyy
瘌	lab
诰	gcyk
滂	phdw
葭	jxcy
槁	gcmk
獐	vhq
栾	lrm
饪	rfu
殄	tmdp
栉	vime
酵	jny
噱	jtku
噱	xtk
醐	huy
锉	coj
崧	ssus
砧	vfu
蔗	vec
牦	mcn
榷	qtm
泵	bgu
嫱	qln
槊	uom
醍	tiyr
逡	jyz
赡	ujb
鎏	lqj
鸷	vin
灞	bad
荪	syc
骓	vvmt
酗	xuyx
咩	mpk
箴	vfvg
哓	xnke
蚤	zci
罹	lis
馍	mou
滓	zidu
鹗	eenv
釉	yzc
釉	yzp
棂	lkmh
赊	ueb
熨	yyh
塾	uutw
瑗	yrw
锟	kyj
挹	yifb
夯	hhd
囫	hukw
诙	hvyh
酡	toy
痍	yiby
痿	wwb
绌	ius
莘	ufc
殁	mody
兕	sie
刍	iud
奘	vld
獬	xpqn
箸	vuvo
锷	eej
崴	wwug
纭	yyss
骞	qmb
骞	qmm
锃	zgj
蝮	fuiw
柑	gjmg
秆	gjh
圉	yuku
圉	yvku
馗	kvj
嶂	vhu
莒	jvck
膑	bbo
荟	hvcs
豢	hru
灏	hcdr
脶	loo
衢	qus
仄	zei
鹘	gugn
痘	dzb
嚯	hok
碇	dku
晷	gvok
渚	vudo
碜	ifu
蛎	liiw
隍	hle
砣	tou
谔	eeyv
泅	qqd
骈	pmmc
懋	mcx
仝	tsrg
稔	rfh
泫	xrd
哞	mzk
乜	mpvv
诓	klyk
蓿	xqc
蓿	xuco
桠	yam
耒	lwa
糅	rzm
烯	xihj
镫	dgja
貅	xqv
猱	ncq
犴	hjq
纫	rfs
褓	bcym
蕲	qicj
偈	jprv
溧	lidm
訇	hsgk
媾	gzn
榛	vfmm
郏	jxe
葺	qice
葺	qics
铩	uaj
蚨	fuid
掾	yrfu
靛	dmqr
螯	aoi
耦	oul
萋	qicn
侩	kkr
恽	yyxi
徉	yhs
枰	pkm
鹜	wunw
褫	iiyj
琚	jvw
蜮	yuig
蜮	yvig
抻	iff
襁	qly
遴	lbz
蓑	soc
皈	gvby
娩	mmn
虱	uiip
虱	uivi
菟	tucd
阈	yumg
阈	yvmg
觞	uhj
呖	likl
箝	qmvg
狎	xxqj
邳	piea
邳	piep
轾	viit
幂	mibj
阡	qme
忝	tmxd
窳	yuxg
窳	yvxg
貔	piv
炅	gvo
炅	jsho
炅	jso
舢	ujv
铢	vujw
糨	jlmi
髭	ziib
抟	trf
沆	hhdj
铣	xmje
腩	njo
烩	hvhs
锴	kdjo
殚	djdu
秸	jphk
砀	dhu
氮	djq
孑	jpa
愎	bix
睢	svot
逦	liz
薜	bicu
嘞	lwk
狴	biq
悌	tixp
猢	huqo
爻	yci
牍	dup
羸	lwyf
囗	kza
撺	crf
鹑	iyn
缃	xlso
饽	bouz
嶷	yiur
蒿	hcc
蝾	rsim
稹	vfh
雒	lovk
仃	dkr
俅	qqr
狍	pcq
梏	gumk
橐	tomk
韪	wwuw
橹	lum
鳕	xtyx
轸	vfi
黢	quh
徜	ihs
桎	vimt
鬣	lpi
擢	voft
肓	hlow
泷	lsd
镏	lqjt
呙	gok
璺	wfwb
璺	wfyb
铡	vaj
碘	dmu
镁	mwj
伥	ihri
珐	faw
辂	luik
崂	lcu
炝	qlh
祉	viuv
狲	syq
榔	lhm
钙	gdj
媪	aon
珲	hyw
珲	hvw
肛	gho
濂	lmdb
芩	qbcv
诿	wwyn
镞	zuj
鼬	yzuy
臬	npzm
岫	xquy
氯	lvq
阆	lhmg
箔	bov
貊	mov
澧	lida
饨	tyu
蜇	veij
馄	hyu
蜢	mgi
镛	ysj
寮	lnbx
蛔	hvi
诨	hyy
酊	dkyd
璁	cswx
骢	csmx
砒	piub
纛	dcd
楸	qqm
蟊	mcip
煲	bchm
爿	pja
爿	pjv
谌	ifyu
谌	ifyv
狷	jrq
聩	kver
媸	iin
掼	grfr
蛐	quiq
莠	yzcn
钨	wuj
镝	dijk
怼	dvx
旮	gao
酩	mky
韫	yyw
诟	gzy
硭	mhu
摈	bbf
蚋	rvi
赭	veio
絷	visw
歃	uaq
黩	duh
耆	qil
闱	wwmw
嘬	zoky
飨	xlux
茯	fucq
邴	bke
缛	rus
驺	zzm
訾	ziyb
轱	guik
卅	saa
祆	xmud
鲧	gyy
甯	nkb
甯	nky
蹉	coz
氨	anq
遒	qqzy
僭	jmro
谯	qnyh
倥	ksr
孢	bcz
嵬	wwus
誊	tgy
旯	laoj
妁	uon
岬	jxuj
孛	bwz
泖	mcd
裾	jvyk
榈	lvmk
荚	jxc
跎	toz
囿	yzko
悒	yixb
檑	lwm
谥	uiym
谶	ifyg
蚺	rjir
痂	jxb
虺	hvwi
牯	gunk
镗	thjt
煨	wwhd
饴	yiuk
獾	hrq
眇	mnop
眇	mnou
闫	yjme
伉	khr
祧	tnu
胪	luou
啖	djk
钴	gujk
揆	kvf
苻	fucc
錾	zjj
鼹	yjun
阒	qumq
笞	iivk
豕	uiad
耄	mcl
撷	xpfr
椤	lomx
痔	vibc
菀	wjc
嫫	mon
蟋	xii
拮	jpfk
暝	mkob
岿	kvux
阕	qtmd
滁	iudm
弁	bmsc
荇	xkc
逶	wwzn
蚪	dzi
喑	ybko
蟀	uki
嘁	qikg
茕	qsc
埙	xyt
獭	taq
觥	gsj
晗	hjok
蝌	keiu
俚	lirt
磔	veu
墒	uht
搽	iafm
滦	lrd
姘	pbnc
湎	mmdk
螫	uiiw
畹	wjt
笮	zev
饬	iiul
菅	jmck
肱	gso
徕	lds
傈	lirm
汞	gsd
蓐	rucc
徭	ycs
鳝	ujyk
巯	qqs
鲽	dpym
铆	mcje
剡	yjl
猁	liql
柚	yzm
逑	qqz
捭	bdfu
脔	lrr
鬈	qriv
哙	kkk
铂	bojo
挈	qpf
绻	qrs
跹	xmzz
瑷	aiwy
铖	igj
炻	uih
癣	xrby
颢	hcy
裱	bny
蕤	rvct
悱	fwx
猞	ueqk
赅	gdb
楹	ykmm
恚	hvxt
潍	wwdt
衽	rfyu
貘	movd
钎	qmju
凼	dhk
蜉	fuiz
粕	pem
粕	pom
钿	dmjt
涞	ldd
雩	yuyk
鲫	jiye
傩	nor
莳	uicc
斛	huj
珙	gswb
纥	ges
筅	xmve
胰	yioy
荜	bicu
焘	dchc
焘	tch
怄	oux
栎	ytmx
讴	ouy
洌	lpdl
觜	zvj
瘙	scb
唿	hukx
缳	hrsn
戕	qlg
锝	dej
埂	ggt
拊	fufc
讦	jpyu
螈	yrix
锌	xbju
郗	xiej
仵	wuru
烊	yhhy
篁	hlvt
搴	qmfb
獍	jkqe
杷	pam
脍	kko
醴	liya
鹂	lind
邰	tde
郜	gce
纩	kls
堞	dptm
鹬	yunk
鹬	yvnk
牝	pbn
湟	hld
酃	lkek
冼	xmde
氦	hdq
锒	lhj
篾	mpv
缦	mjs
杌	wume
硌	geu
骝	lqmt
碣	jpuv
鏊	aoj
虻	mgiv
虻	mgiw
膂	lvo
咴	hvkh
缟	gcs
荞	qnc
偬	zsr
暾	tyow
窨	ybxo
鼐	nddn
鼐	ndnv
帏	wwj
洮	tcdv
胱	glo
铉	xrj
鲟	xyyc
竦	ssl
虢	goh
椽	irm
韭	jqa
韭	jqf
佤	war
蕨	jtc
狯	kkq
屐	jiuy
癯	qub
鳃	sdy
苌	ihc
侔	mzr
腚	dkor
腱	jmo
圻	qitj
痨	lcbl
眙	yiok
竽	yuv
竽	yvv
缢	yism
辚	lbi
尜	gaxx
趺	fuzd
茔	ykt
蝰	kvi
囹	lkks
洇	ybdy
鼋	yrme
鼋	yryd
芫	yrce
赍	jibb
赍	jiur
宥	yzbo
樘	thmt
酶	mwym
墉	yst
嘌	pnk
恂	xyx
罅	xxf
镊	npjy
椴	drm
彀	gzu
洹	hrda
盱	xuoy
噻	sdk
旄	mcf
犍	jmnz
庹	tog
欹	qiqk
珥	erw
吡	bikb
撄	ykfn
狃	nqq
裢	lmy
镙	lojx
圩	xuty
铬	gej
馐	xqu
峄	yiuu
馏	lqut
搠	uof
炔	qth
踟	iizk
鼍	tokd
鼍	toma
仟	qmr
鹌	ann
戡	kjg
苫	ujck
襦	ruy
擀	gjf
娈	lrn
昃	zeo
荛	rcc
龈	ybig
焖	mfh
诤	vgyx
峤	qnua
犰	qqq
蟥	hlib
蹼	puz
殳	uujy
妣	binb
楫	jime
楫	jims
燹	xmh
缱	qmsz
厣	yjij
厣	yjj
傣	ddr
狁	yyqe
帔	pwj
锰	mgj
圄	yukk
圄	yvkk
痢	lib
嵯	coug
樨	ximn
纡	yusy
纡	yvsy
畲	uet
瘐	yubr
瘐	yvbr
腭	eeo
瓴	lkws
蠹	dui
裣	lmya
郓	yyei
柞	zam
砦	vdu
杼	vuma
闼	tamz
鞒	qnga
芨	jicj
蛉	lkis
骐	qimb
吖	aak
瘿	ykbn
笳	jxv
郧	yyer
黟	yihx
舛	irxa
钾	jxj
憷	iuxr
稞	kehm
颏	keyr
佚	yird
苡	yicr
勐	mgl
淖	ncd
澍	uudc
勖	xul
铰	jnji
褡	day
诜	xmye
薨	hscb
薨	hss
濉	svd
檫	iamx
郇	hre
骘	vimp
凫	funj
垭	yat
罨	yjsd
邗	hjeu
钯	baj
搦	nof
荠	jica
喁	ysks
枋	fhm
浔	xydc
煸	bmhc
矽	xiux
苕	tnc
謇	jmyb
垓	gdt
沔	mmdg
粑	bam
蝓	yuil
蝓	yvil
躅	vuzi
锨	xmj
瀣	xpda
迓	yaz
杓	ucmu
喈	jpk
烷	wjh
矾	fjuf
缁	zist
蜊	liil
陉	xkeg
堠	hzt
鄯	ujek
幛	vhju
愀	qnxh
瓤	rhg
蕈	xycu
踯	vize
鲵	niye
刭	jklg
怫	fuxf
罴	pih
坩	gjt
焙	bwh
氰	qkqo
渑	mmdd
疥	jpba
肜	rso
氟	fuq
鲰	zzyy
疟	ntb
笫	ziv
褰	qmyb
痼	gubg
鲑	gvyt
黍	uuhd
沭	uudu
缗	mbs
菸	yjcd
悭	qmxt
疱	pcb
衿	jbyv
艏	uzv
裎	igyt
孳	ziz
庠	xlgy
旒	lqf
栳	lcm
茏	lsc
阄	jqm
亳	bowq
艨	mgvu
邛	qse
麂	jilj
尻	kcu
樯	qlmh
豌	wjdv
踽	jvzs
鲈	luyu
艄	ucvo
鲶	nmyx
眭	svo
陂	bwe
榉	jvmu
氖	ndq
笏	huv
廪	lbg
怛	dax
蚍	pii
铙	ncj
殍	pndz
泶	xtd
淝	fwdb
菘	ssc
蒹	jmcb
忉	dcxd
桁	hgm
疹	vfbp
蝣	yziz
喱	likt
妊	rfn
萑	hrc
擘	bofu
逋	buz
埚	got
苒	rjc
锗	vej
唢	sokr
谰	ljyb
歙	xiq
焯	ioh
矬	cout
疽	jvbq
艟	isv
趸	dyzw
蹰	iuzc
荩	jbc
縻	mims
縻	mis
佧	kar
叻	lek
趿	tazj
勰	xpl
嘏	gugy
桫	somp
桫	somu
侪	idr
疴	kebk
翥	vuyo
蚝	hci
鲠	ggyi
雎	jvv
毂	guu
茑	nnc
觚	gujg
阋	xime
洄	hvdh
焓	hjhk
跗	fuzc
猗	yiq
胺	ano
鹕	huno
笤	tnv
跸	bizu
钬	hojh
镪	qlj
馕	nhu
疡	yhbp
篦	bivb
鹈	tin
踅	xtz
棼	fff
睾	gcp
睾	gcx
鹳	grn
漭	mhd
烃	tkh
瞽	guoy
逄	phz
锍	lqjv
哚	dokm
砬	lau
蝥	mciw
钲	vgjv
陟	viep
耋	dpl
酮	tsy
塄	lgt
痫	xmbm
蚧	jpi
埘	uit
枸	gzmk
柢	dimd
潆	ykdx
笄	jivc
醮	jnyh
彖	tre
彖	tru
彖	trv
稗	bdh
窠	kexm
萘	ndcx
郯	tje
掮	qmfo
尢	wha
尢	yzav
尢	yzuv
鲇	nmy
鼙	piby
鼙	pig
畦	qit
舸	gev
帑	thj
睃	soo
蚜	yaiy
溘	kedm
蠃	loif
岢	keuk
矸	gju
鸱	iind
狳	yuqm
狳	yvqm
祜	huuk
囟	xbp
扦	qmf
枥	liml
庾	yug
庾	yvg
菔	fucy
蟛	pgi
嗉	suk
擤	xkf
莪	eecg
觋	xija
觋	xijg
醪	lcyp
倬	vor
爰	yrv
蚰	yzi
轳	lui
锱	zij
鬻	yugg
鬻	yuma
鬻	yvgg
鬻	yvma
鳏	gry
栲	kcm
渌	ludd
蛄	gui
嬗	ujna
谘	ziy
鋈	wujd
阍	hym
杲	gcom
柘	vem
毖	bibb
禳	rhu
馔	vrub
鳐	ycyk
鳟	zyy
耔	zil
辊	gyi
镍	npj
侑	yzro
娠	ufnn
槎	iamg
芾	fwcj
豳	bbu
钤	qmjv
锕	aaj
孥	nuz
綦	qisb
锑	tij
洙	vudw
榫	sym
疣	yzb
砭	bmu
筮	uiva
酽	yjyi
愆	qmx
栀	vimv
耪	phl
薅	hccc
蜞	qiib
崤	xnuo
椟	dumd
糁	sjm
茇	bacy
啁	vzkv
氪	keq
萁	qicb
龃	jvi
墀	iitn
芪	qicq
莰	kjc
菏	heck
嵊	ugub
蛩	qsi
鞯	jmgz
楂	vama
缒	vvsz
饣	uipa
乩	jivk
捌	bafl
毽	jmmz
愍	mbxw
瘢	bjby
铋	bij
铧	hxj
髋	krg
鹚	cin
儋	djr
奁	lmdq
樾	ytmg
滹	hudh
穑	seh
茌	iic
骶	digd
刖	ytl
嫜	vhn
溏	thdk
螽	vsd
螽	vsi
囝	jmk
戽	huhu
橛	jtm
舂	isf
舂	isjd
遄	irz
坭	nit
澶	ijda
熵	uhh
镬	hoj
飧	syu
枞	csm
柙	xxm
硎	xkul
缯	zgs
蔌	sucr
鲂	fhyw
冱	hudh
岙	aou
殂	cud
艉	wwv
蠼	quiy
匏	pcbk
痈	ysb
鹾	col
尕	gan
尕	gax
攮	nhf
樗	iumk
皲	jyp
髡	kyi
坻	ditd
伧	ifr
剀	kdl
椐	jvmk
瓠	hugv
讣	fuyb
髁	keg
龉	yuik
龉	yvik
彘	viv
棹	vcm
疠	libw
薮	szc
隈	wwed
龋	quis
朐	quo
橼	yrm
芰	jicy
圹	klt
敉	mimw
暌	kvo
饧	xku
泔	gjd
赜	zeir
黧	lih
筚	bivu
蓖	bicb
鸬	lun
蚬	xmi
醯	xiym
钪	khj
餍	yjig
餍	yjuq
鸹	gxn
哏	gfk
甑	zgw
疋	piar
疋	pivr
膣	viot
螅	xiix
锞	kejm
髫	tni
宄	gvbj
摭	vifh
檠	qkm
盍	hems
绂	fusy
骟	ujmd
棰	ivmi
棰	ivmu
缡	liss
苷	gjc
蹁	pmzc
铗	jxjd
鞣	rzg
圯	yit
涑	sudb
箜	ksv
芎	xsc
蔟	cuc
觯	viju
鍪	mzj
镟	xrjr
夤	ybx
妫	gvn
妫	wwnw
熘	lqh
硼	pguo
秫	uuh
阏	yjmd
飑	bnf
啭	vrk
枳	vimb
礅	dyuw
耨	nz
茭	jnci
钡	bwj
捩	lpf
柁	tomb
苴	jvcq
铊	taj
寤	wubk
牖	yzpf
赀	zibb
醚	miyz
柽	igmt
栌	lumu
肄	yiyd
脘	wjoe
酎	vzyc
鲳	ihy
柒	qimq
浠	xidj
蛳	siij
壅	ystt
枇	pim
楱	czm
焐	wuh
秭	zih
笥	sivk
茈	zic
蒌	lzc
谵	vjyk
跏	jxzk
镆	moj
怙	huxk
枵	xnmv
痱	fwbe
膈	geo
卮	vipv
圊	qkk
圮	pitj
堀	kut
氚	irq
皴	cyp
绐	ddsk
蟮	uji
邡	fhew
庑	wuge
庑	wugy
廨	xpgn
钭	dzj
觳	huuy
闶	khmj
檗	bomu
漯	tadx
瓿	buwk
眚	ugot
芴	wucw
诂	guyk
郴	ife
鳓	ley
俣	yurd
俣	yvrd
徼	jnsw
桡	rcm
楗	jmmz
莨	lhc
酰	xmye
雠	izyt
喾	kuxk
揿	qbfr
笊	vcv
苎	nkc
黥	qkh
僳	surm
芏	duc
菖	ihco
蓊	wgc
袢	pjy
馑	jbut
卺	jbe
垆	lut
旆	pwf
曛	xyo
汊	iad
硒	xiuk
穰	rhh
粳	jkmi
酾	uiyd
酾	udy
鲷	dny
鹣	jmnb
塬	yrtx
曩	nho
莴	woc
蕞	zvc
蘖	npm
怃	wuxe
欤	yuqr
欤	yvqr
玢	ffw
蕖	quc
镒	yijm
厝	coi
坶	mut
屣	xiur
揎	xrfa
榧	fwm
芑	qicj
蓥	ykj
钣	bjj
鬲	liaa
鳔	bnyx
鼗	tcg
鼗	tcv
仂	ler
婺	wunw
嫠	liwn
愦	kvxr
癍	bjbt
癔	yibx
碓	dvu
箧	qpv
缶	fzp
蘧	qucz
妗	jbn
幞	fujd
沤	oud
痦	wub
蛑	mzi
詈	lisk
钚	bujb
铴	thjp
锆	gcjk
丌	jiaa
丌	wuaa
岘	xmue
枧	jmme
柰	ndm
浜	bhd
蓼	lnc
蛞	koi
鄣	vheu
偾	ffrr
藿	hoct
酢	zoy
铟	ybjy
锛	bfj
阊	ihm
骖	cjmp
鲆	pky
檩	lbmx
燔	fjht
猓	goq
蘼	mic
趵	bczu
酲	igyk
鹩	lnn
乇	top
屙	eeuk
揸	vaf
碛	qiur
笸	pev
笸	pov
赓	ggb
赓	gggr
鄄	jre
铱	yij
黻	fubb
伲	nirb
缂	kes
蜣	qli
蜩	tniv
谝	pmyc
铍	pij
伛	yurq
伛	yvrq
傧	bbr
揠	yafy
昝	zjob
溽	rudc
胙	zooe
萏	djc
隹	vvp
隹	vvr
麈	vult
妯	vzn
孓	jtvd
溱	vfdm
碚	bwuk
蕺	jicg
锊	ltj
镧	ljjb
髀	bigu
坫	dmtk
崃	ldum
戢	jigs
糌	zjm
缬	xps
邶	bweb
坼	iet
梃	tkm
瞢	mgco
缧	lwsx
菽	uucy
豉	iidy
仳	pirb
堙	ybtt
忭	bmx
砷	ufuu
筌	qrv
箪	djv
艿	ndcn
郅	viet
鲢	lmyz
鳎	tay
厍	ueii
哕	hvkx
廑	jbgt
敫	jnww
栊	lsm
癜	dmby
碹	xru
磙	gyu
笾	bmv
篪	iivj
缌	sisx
苣	jvcj
荨	xycc
诹	zzy
诼	voyu
钒	fjif
嗍	soko
槠	vumo
欷	xiqj
淦	gjdj
甏	bgw
胝	viod
蓍	uico
蛱	jxi
裉	kfy
辏	czi
颞	npy
麸	fum
娌	lint
椹	ufm
缫	scs
翮	heya
诒	yiyk
郾	yje
铯	sej
锂	lij
鞫	jvgk
卣	yzbk
圬	wutk
尥	lnw
尥	lny
槲	humu
氘	dcq
瘘	lzb
耩	jll
轫	rfi
迨	ddzk
馓	sju
啉	lbkm
圪	get
廴	zzg
泺	lodl
熳	mjh
璩	quw
胗	vfo
苁	cscr
薹	tdct
锘	noj
阌	wfmy
鳊	bmyc
唑	zokt
溻	tad
瘰	lob
砗	ieu
砩	fuuf
羝	diyd
茺	isc
蓠	lics
俳	pdr
刳	kul
唣	zckq
悝	kdxt
悝	kvxa
慊	qmxb
瘳	izb
茼	tsc
麇	jylm
麇	qyl
黾	mbk
嗾	szkd
嵛	yuul
嵛	yvul
杩	mamm
狨	rsq
狺	ybqk
痧	uab
砜	fguf
缍	dos
芡	qmcr
蓣	yucr
顸	hjyu
槭	qimg
溲	szd
痤	cob
眄	mmog
糍	cim
葚	ufcu
郐	kke
酹	lwyc
镢	jtj
隳	hve
隳	hvxo
鹋	mnnt
唛	makw
嬖	binu
怍	zox
朊	rro
涫	grdk
绲	gys
胼	pmo
腧	yuol
腧	yvol
葑	fgcc
蠓	mgiu
踬	vizr
鞲	gzgr
饫	yuud
饫	yvud
刈	yili
垲	kdt
嵴	jiuo
帻	zej
旰	gjou
畚	bft
荭	hsc
萸	yucr
萸	yvcr
蘩	fjcx
颃	hhy
颟	mjyr
鸲	qunk
龠	ytr
呒	emk
嗌	yikm
疸	djba
硖	xxud
绁	xpsu
耧	lzl
蚴	yzil
蛸	uci
裰	doy
謦	qkyy
跣	xmze
踺	jmzz
逯	luz
陔	gde
凇	ssd
堋	pgt
屦	jvun
峁	mcu
廛	ijg
栝	gxm
磴	dgua
篌	hzv
芘	bicb
葸	xicx
薏	yicx
踔	ioz
鄞	ybet
醢	hdy
铒	erj
镲	iajx
鲮	lkyw
仉	vhrj
侉	kxr
桄	glm
泮	pjdu
燠	yuhd
燠	yvhd
犭	qrp
皤	pebt
皤	pobt
粝	limw
蹀	dpzm
颡	shy
鲞	xlyd
唪	fgk
嗪	qbkm
掭	tmf
畈	fjty
簦	dgv
绨	tis
胍	gxo
胲	gdo
舻	luvu
铘	yej
锩	jrj
鲋	fuyc
崮	guug
庋	gvg
毳	cvmq
毳	qnmq
箅	bivj
缣	jmsb
菹	zuc
虿	idi
谇	svy
贶	klb
陧	npet
隰	xieh
僬	jnrh
匦	gvk
垧	uhtk
疔	dkb
肭	nao
蝤	qqik
谖	xry
趑	zizr
轭	eeiv
酐	gjyu
醅	pwyk
醑	xuyo
醛	qry
锬	tjjh
劂	jtl
垅	lstl
悛	qrx
戥	dgg
拶	zaf
硷	jmua
笕	jmve
簟	dmv
莼	iyc
蒴	uoc
藁	gcc
诖	gxyt
谠	dhye
谳	yjyq
邾	vue
陴	pie
鬏	jqih
龀	ifib
剞	jilk
劬	qul
埸	yitw
嬲	nnnl
嵝	lzu
搿	geff
搿	geh
柝	tomi
桴	fumz
洧	wwdo
浯	wudk
疝	ujbu
笱	gzvk
肽	tdod
肽	tdot
舯	vsv
艋	mgv
芤	kzcv
葙	xlco
鲔	wwyo
鸸	ern
佾	yiro
墁	mjt
嫘	lwn
榇	ifm
煳	huho
硪	wou
礞	mguu
菰	gucg
蚵	keik
趱	zjz
躜	zrz
钼	mujo
鲱	fwye
呋	fukd
媵	ykon
崦	yjud
楝	lmm
潲	ucd
獯	xyq
瘵	vdbx
绀	gjs
绋	fusf
莩	fucz
觫	sujb
辋	whi
镡	tjju
髂	gegk
髂	qxg
鬯	ihb
鹨	lqn
亓	qiea
劓	yilj
埕	igtt
曷	heo
洚	jlda
碲	diuj
磲	quum
粜	tnm
绱	uhs
芄	wjcw
酚	ffy
铪	haj
髌	bbg
鲥	uiyc
俜	pkr
刿	gvl
吣	qbkx
垤	dpt
枘	rvm
氽	tyd
氽	tyr
溷	hydk
甍	mgcw
笪	dava
胬	nur
舨	bjvy
芟	ujcy
蒽	enc
銎	qsj
铵	anj
锶	sijx
骱	jpga
鹆	yunk
岣	gzuk
岵	huuk
怿	yixu
慝	texn
挢	jnfa
掎	jifk
毹	uuml
汆	crd
沲	tody
湔	jmdl
甙	ddgg
罟	gus
羼	ijuy
菝	bacy
讵	jvy
诎	quyu
谮	zfy
赉	ldbm
郄	qpe
鐾	bwju
鲎	hzyb
啶	dkkr
塍	igot
屺	qiuj
庥	xqg
掊	pzf
撙	zyf
柃	lkms
檎	qbm
毵	sjmp
渖	ufdu
砘	dyu
窭	jvxn
肟	woo
蔸	dzc
蚶	hji
蛏	igi
躞	xpzy
酯	viy
锾	hrj
饩	xiuv
劢	mdl
嘧	miku
嵫	ziu
擐	hrfn
湓	pfd
蝻	njiu
蠖	hoi
觖	jtjd
跬	kvzt
鳜	gvyr
仡	ger
垌	dst
氆	pum
氇	lumo
汔	qidv
篼	dzve
缑	gzs
舾	xivk
莸	yzcy
蛲	nci
蠛	mpi
蠲	jry
褊	bmyc
醣	thyk
骀	tdm
倮	lor
僦	jqr
崾	ycu
渫	xpdm
瘗	yibt
箦	zevr
肼	jkoj
腽	wao
臁	lmob
舳	vuvy
芈	mia
荽	svc
蒉	kvcr
蛴	qii
袼	gey
跫	qsz
遘	gzz
儇	xrr
埽	sct
庀	pigb
戆	ghx
扃	jshk
搛	jmfb
杪	mnm
浼	mwde
滏	fuda
瓞	dpg
疃	trt
砟	vaue
硗	qnue
禊	xiud
篥	livm
簋	gvv
綮	qks
苤	ppc
踣	bozk
躐	lpzv
酴	tuy
钽	tjj
锸	iaj
锼	szjy
阃	kym
鞔	mjg
鲭	qkyo
鹪	jnnh
黪	cjhp
黼	fufb
榀	pbm
榘	jvmj
浍	kkd
炱	tdh
煺	tvh
犋	jvn
砻	lsu
秕	bihb
籼	xmmu
耜	sil
肀	npv
肫	vyo
肷	qmo
胂	ufou
莛	tkc
裥	jmyo
逭	hrzk
钋	pej
钋	poj
钌	lnjl
钸	bujj
髑	dug
鳆	fuyw
鼯	wuuk
佴	err
吲	ybka
帱	dcj
搌	vjf
擗	pifu
桷	jtmy
氡	dsq
氩	yaq
溴	xqd
畋	tmtw
硐	dsut
糇	hzm
腠	czo
葶	tkcd
袷	qxy
陬	zzey
黉	hsx
龆	tnik
哜	qika
埴	vitq
岜	bau
徂	cus
惝	thx
扌	uza
烀	huhh
眢	yro
瞵	lboa
筇	qsv
簏	luv
芗	xlc
蝽	iyio
蟪	hvix
郫	pieu
钕	nvj
钫	fhj
镉	geja
镘	mjjy
颥	ruya
黹	viab
黹	viyb
坜	lit
埤	pitu
楦	xrm
氙	xmqu
澌	sidj
畛	vftp
疳	gjb
瘅	djbu
砉	hxf
砉	hxuu
砹	aiui
碡	vzu
穸	xixx
缵	zrsb
羟	qlyg
膦	lbo
菪	dhck
虼	geiv
蛘	yhi
螨	mjir
裼	tiyw
讠	yjdv
迕	wuz
铈	uijj
锇	eejg
锔	jvjk
锪	hojx
镓	jxju
镦	dvj
镱	yijx
霪	yby
骒	kemm
鹁	bon
冁	ijdn
哿	gekk
噍	jnkh
埝	nmt
弪	jkg
攉	hof
浞	vowd
潴	vudo
畀	bitj
籴	dirm
罱	ljsu
羰	thy
胨	dsod
胩	kao
舴	zeve
苊	eecv
茆	mcce
茛	gfc
蒇	ijc
虮	jiij
蠊	lmi
裒	gzyj
裒	pzw
襞	biyu
觇	ijjk
轺	ycik
锿	aij
髹	xqim
鸫	dsn
哌	pdk
垸	yrte
埏	yjtz
墼	jity
帙	vijd
悃	kyx
揲	dpfm
晡	buo
榍	xpmo
榱	cvmn
殪	yida
淠	pidj
漤	ljdn
疬	libl
砑	yauy
缲	qns
缲	scsm
罘	fusb
苈	licl
萆	bicu
谂	ufyx
鄹	zzed
鄹	zzen
酞	tdy
钔	mfj
铥	dqj
镅	mwjo
髟	bni
鲡	liyd
鲦	tny
鳇	hlyt
鹇	xmnm
鹱	huny
埒	lpt
岽	dsu
悫	qtx
攵	pup
桊	jrm
桕	jqmj
槔	gcmu
溆	xudy
漶	hrdx
牾	wunk
畎	qrt
疖	jpbe
矧	ufua
稂	lhh
窀	vyx
籀	vzv
腈	jkoo
苄	bmc
薷	ruca
褙	bwy
赙	fubc
跽	jizx
钐	ujj
锖	qljo
镎	najf
饔	ysu
骣	ijmz
鳙	ysy
坌	bftd
氍	qumt
沩	wwdw
洫	xudm
澉	gjdw
瀹	ytd
爨	crh
珧	ycwv
瘊	hzb
瞍	szo
硇	ncu
筘	kzv
粢	zimr
聍	nke
舁	yucj
舁	yujc
舁	yvcj
舁	yvjc
艚	ccv
荸	bicz
蜱	piiu
钍	tuj
铞	dnjj
铫	ycjv
骺	hzg
鲼	ffyr
劐	hol
哳	vakj
唼	uakn
忮	vixy
恝	jxx
戋	jmg
椠	qmmj
瘕	jxby
瘛	iibx
瘼	mobd
祓	fuuy
窆	bmxz
窬	yzxl
窬	yuxl
篚	fwvf
粞	ximk
羧	soy
脬	pco
艽	jncj
葜	qxc
蓰	xicr
觌	dijd
豇	jldg
轵	viib
醵	jvyu
铌	nij
镄	fwj
阼	zoe
鞴	bwg
鲅	bayy
鲒	jpyk
埯	ant
夂	wfp
恧	nvx
憝	dvxw
搋	ikf
氕	ppq
洳	rudk
浈	vfdr
濞	bidj
礤	cau
聱	aoe
蟓	xliu
襻	pjyf
趼	jmzc
迮	zez
钆	gaj
铷	ruj
镨	pujo
驵	zhm
鲣	jmyt
鳘	mby
鸺	xqn
嚆	hckk
堍	tut
嶝	dgu
巛	irvv
廒	aog
桤	qimj
橥	vumo
爝	jth
甾	zit
甾	zdit
痄	vab
癀	hlbb
筲	ucv
箨	tovu
罾	zgso
耵	dke
舣	yivi
荬	mdc
蕹	wgct
诔	lwyl
赆	jbb
蹯	fjzt
钇	yijv
钶	kej
铕	yzjo
镤	pujd
鲚	jiya
鲻	ziyt
鳢	liya
鹛	mwno
塥	geta
庳	bigu
怊	icx
捃	jyf
揞	anfo
洎	jido
涠	wwdw
滠	uedy
猸	mwq
甓	piwu
瘃	vubu
瞀	mcow
砼	tsug
礓	jlu
绠	ggs
耱	mol
脎	sao
脒	miom
脞	coo
萜	tpc
蕻	hscb
薤	xpc
衤	yidd
跞	lizx
轹	liix
锎	kdjc
锓	qbjy
馇	iaua
鲐	tdyk
鲩	hrye
仫	mur
垡	fat
垴	nct
岍	qmuc
崞	gou
枨	igmi
毪	mum
牮	jmng
癃	lsb
眍	kzo
眵	iio
稃	fuh
筢	pavb
腙	zso
舭	bivb
菥	xicj
蜾	goim
螬	cci
螵	pni
衄	nvxi
谫	jmyd
躔	ijz
郛	fuez
酤	guyk
钷	pejk
钷	pejp
钷	pojk
钷	pojp
锫	pwjk
镩	crj
阢	wue
鼷	xiud
劁	qnl
埭	ddt
墚	llt
摅	uufx
撖	hjfw
泐	led
滗	bidm
牿	gunk
犏	pmn
猹	vaq
疰	vub
痃	xrbs
痖	yaba
瘥	idb
磉	shum
礻	uidd
箢	yrvv
簖	drv
缋	hvsr
缏	bmsi
耥	thl
脲	nno
膪	iko
苠	mbc
茳	jlcg
莶	xmca
蒎	pdc
蒡	phc
虍	huaq
螗	thik
贳	uibu
軎	wwi
醌	kyyb
醭	buyd
铹	lcjl
铼	ldj
镥	luj
阽	dme
馘	goug
鲺	uiyi
鹎	bwn
鼽	qqbj
傺	iirx
勹	bcp
喹	kvkt
彡	ujp
戤	gdg
攴	pea
攴	poay
瀵	ffdb
灬	hodd
叆	aiyy
唵	ankd
垵	antn
瘭	bnb
.	begc
屄	biub
碥	bmuc
邠	bbed
梹	bkmb
稖	bwhk
肏	ccr
吋	cykc
悰	csxx
屌	dnu
珰	dhw
赕	djbh
梼	dcmc
敠	dopy
惇	dyxz
绖	dpst
饤	dkud
鲕	ery
覅	fnwn
鼢	ffu
艴	fufb
蜅	fujf
觏	gzjr
洸	gld
饹	geuk
筻	ghv
啯	gokg
爟	grht
鲴	guyg
铦	gxjk
滉	hlde
龁	heiv
姮	hgna
绗	hhsd
耠	holk
嬛	hrnn
轷	huih
翚	hvyi
诪	izyc
锠	ihjo
浐	ijdi
耖	icl
舡	irvg
弶	jlgx
击正码为jik	jieu
击正码为jik	jiuu
惓	jrx
唶	jpko
夼	kld
劻	kllk
蒈	kdc
铦	koj
堃	kytw
剋	kw
蒗	lhcg
铑	lcj
耢	lcl
嫪	lcnp
蔹	lmcw
粦	lbma
硵	luuk
箓	luvd
稆	lvhk
〇	lko
礌	lwut
悗	mfxe
幪	mgju
厖	mhil
铓	mhj
悗	mjxe
霂	muy
秾	nsh
洴	pkdc
呯	pkk
珮	pww
赇	qqbq
辁	qrit
袪	quys
苘	qkc
庼	qkgr
纴	rfsu
甤	rvu
螋	szi
偲	sirx
鳋	scy
窣	suxu
脩	tnro
铽	tej
铦	tmj
聤	tke
谉	ufy
浉	uidj
湜	uidr
齄	vaba
荮	vzc
喆	vejk
喆	vekk
椓	vomu
禚	vouh
缊	wfsm
尫	whwt
钖	xijp
晞	xioj
窸	xixx
铦	xmjk
猃	xmqa
夐	xrwo
夐	xsdw
夐	xsw
茓	xtcb
彐	xtv
糈	xumo
谞	xuyo
浥	yidb
酏	yiyy
茚	ybce
涢	yydr

#
候	hzru
侯	hzru
嚇	xxkv
嚇	hekv
粒	liml
慄	lixm
笠	livl
弨	icgk
暱	niok
㗎	jxkm
㗎	gakm
㓤	jidu
㷫	hkhh
㞹	keek
劏	thdx
劏	tsdx
䟴	vfzy
䢛	jszk
餸	ssiz
祐	yzpk
婠	wjnk
婠	wank
玥	ytwo
嫚	mjny
鞬	jmgz
琍	liwd
琭	luwd
珣	xywo
艹	ccaa
濛	mgdn
燊	ufhm
櫈	dgmj
珋	lqwe
弇	yjrc
蠔	hcin
邨	cyea
珺	jywk
氹	tfdg
氹	dhdg
痾	oobk
痾	eebk
痾	vebk
伕	furf
彿	fupa
潾	lbda
呎	iikn
棻	ffcm
珪	gvwt
傕	qtra
傕	jtra
牠	tanx
亍	iuea
瑱	vfwb
翃	hsuy
洨	xndx
瓘	grwa
睒	ujoj
彧	yukd
炘	xbhj
劼	jpul
冏	jskk
牤	mhnv
矞	yusk
矞	xusk
矞	jtsk
甦	suaa
愔	ybxo
崁	kjeq
鞳	tagk
茀	fuca
浬	lidt
槃	pjmv
磻	pjut
磻	bout
倕	ivrt
崟	ybuj
吔	yekx
蹓	lqzt
泚	cidb
佺	qrrw
冮	ghdg
嗞	ziks
苾	bicp
蹚	thzt
徬	phrf
鄠	hueg
畤	vitc
畤	uitc
畤	iztc
妳	ninx
崚	lkew
崚	lgew
皦	jnbw
愬	soxb
亶	djwa
杻	nqma
杻	izma
旻	mbow
嗐	hdkk
澥	xpdn
堉	yuto
彳	iipa
迴	hvzk
傢	jxru
瑢	rswk
捽	zofu
岞	zoua
皞	hcbu
炆	wfhw
邽	gvet
牴	dind
詻	eeyk
垚	yctt
蹧	zczo
帨	uvje
睏	kyok
吽	hskn
楙	mcmm
惛	mfxo
惛	hyxo
觿	xijk
蹐	jizo
摽	bnfx
廾	gsaa
祼	grum
毐	aiup
岨	jueq
呣	omkd
呣	mzkd
呣	vmkd
龢	herh
啗	djka
柷	vume
柷	iume
勍	qkwl
糸	mivx
屝	fwua
碁	qiqu
傒	xird
浡	bodz
扆	yihy
絜	xpxf
絜	jpxf
琇	xqwg
囍	xiuk
晫	voou
訄	qqjy
靺	mogm
斝	jxku
滘	jndk
靿	ycgl
尪	whuw
翛	xnry
簰	pdvu
霑	vjyk
跂	qizy
偰	xprd
隄	dier
玠	jpwa
暸	lnox
葖	tucd
厶	sivd
敔	yuwk
撢	djfu
昉	fhof
婞	xknu
晢	veof
瑯	lhwe
旐	vcfd
曈	tsot
拏	naun
忳	vyxv
忳	tyxv
忳	dyxv
亹	wwwa
亹	mfwa
畬	yurt
畬	uert
迍	vyzv
唸	nmkx
匚	klav
臑	ncoa
氾	fjdv
璠	fjwt
迺	ndzx
脷	liod
	cjhp
	dadz
	wokn
	yajp
屮	ieva
黐	iips
魆	xugg
骻	kxgg
鞨	hegr
鞧	qqgy
鞡	lagl
鞁	bwgy
隩	yued
隩	aoed
閪	hwmx
鎅	gdja
郿	mwev
郃	heer
邅	vjza
迆	yizx
迆	tozx
軚	tdid
踦	qizk
踡	qrzv
踎	bwzk
踄	uezp
跼	juzk
跦	vuzm
趌	jptk
趌	jitk
貍	lipt
裇	svpx
衒	xrrd
蚆	baiv
薢	xpcn
萩	qqch
莙	jyck
苳	dscd
芣	fucx
芃	pgcd
腒	juok
翀	isya
羓	bayv
罉	chru
缹	fzhf
粃	bamp
粃	pamp
筊	jnvx
竑	hsls
窊	wabn
禘	dipj
祫	xxpk
祊	bgpf
祂	tapx
礵	ulio
磡	kjul
碔	wuud
砵	boia
砲	pciv
砢	louk
砆	fuun
矻	kuug
瞭	lnox
瞓	ffoa
瞓	xyoa
瞇	mioz
睺	hzou
眛	mwon
盦	anmr
盉	hemh
皕	biab
畑	tmht
甴	zaka
璿	xrwo
璟	jkwx
璈	aoww
瑄	xrwa
琤	igwb
珢	ybwy
珢	kfwy
珅	ufwa
玦	jtwd
玘	qiwv
玕	gjwu
獴	mgqn
狉	piqa
犺	khqj
犇	bfnn
燘	mwhw
煆	xxhy
焠	cvhu
焜	kyhp
焗	juhk
焌	quhw
焌	jyhw
烱	jlhk
烱	jshk
烝	vghv
烜	xrha
烚	xxhk
瀍	ijdt
濬	jydo
湉	tmdk
淴	hudx
浛	hjdk
洑	fudq
沚	vidv
沘	bidp
汭	rvdl
毬	qqmd
歔	xuhq
欸	eisq
欸	aisq
欸	vdsq
枱	tdmk
枱	simk
枱	cimk
槥	hvme
榅	wfmm
榖	guuy
棓	pzmk
棓	bwmk
棓	bhmk
栟	bfmc
柮	vome
柤	vamq
曱	gaka
曌	vcog
昇	ugoc
昄	bjoy
攰	lwul
攰	gvul
擝	mgfm
揾	wffm
搲	wafg
搣	mifa
搣	mpfa
搊	izfg
揼	dyfd
揼	djfd
揹	bwfo
揳	xpfd
揗	uyfo
掹	mgfm
掤	bffo
捵	dmfb
捵	nmfb
捯	dcfd
拑	qmfc
抦	bkfr
抔	pzfx
抌	vffe
抆	mffw
抆	wffw
扽	dffv
扱	xifn
扞	hjfu
懞	mgxx
慓	pnxx
恓	xixx
恓	qixx
怗	tpxk
弢	tcgy
弔	dnga
弍	ered
庤	vigc
巉	ijev
嶒	cgeo
嵖	iaea
屘	miuz
屘	mjuz
尐	dixn
宬	igbg
宧	yiba
孖	zizz
孖	mazz
孅	xmig
孅	qmig
嫲	manm
嫑	mqan
嫑	bcan
嫐	ncnn
婼	ronk
婥	ionu
妠	njnr
妠	nanr
奭	uidb
奡	aoaa
奅	pcue
奀	nfad
奀	enad
墑	ditk
堨	yetr
堨	eetr
堨	aitr
堨	vdtr
垺	pztz
垺	futz
囸	rikv
囷	qykh
囧	jskk
囜	nbks
嚟	lwkd
嚟	likd
嚄	ooky
嚄	hoky
噏	haky
噏	xiky
噉	djkw
噃	bokt
嘥	sdkr
嘢	yeka
嘡	thkt
嘚	dekc
嘅	geke
嗻	vukh
嗻	vekh
嗱	naku
嗰	gekk
嗮	sdky
喺	xiox
喯	bfkc
喫	iikd
喨	llkj
喐	yuek
喎	wdkk
啲	dikd
啱	njou
啱	yjou
啫	veko
啫	uiko
啩	gxkd
啋	cdkm
唦	uakp
唥	lhks
唞	tcku
唞	dzku
唓	ieki
唎	likd
哣	dzka
哣	pzka
哋	dikx
咹	eekn
咹	ankn
咹	vjkn
咲	grkd
咥	dpkt
咗	zoog
咑	dakd
咈	fuka
咇	bikx
咁	gjoc
呪	vzkr
吅	sskk
吅	xrkk
厾	dugs
卲	uced
卬	yhep
卬	ahep
卐	wjxx
卍	wjxx
卌	xiaa
匽	yjkn
剦	yjdd
剒	codc
冧	lfbm
冇	mcik
兲	tmwb
僰	bora
僜	dgra
僇	lurp
俵	bnry
俬	sirs
係	xirx
侂	torq
侁	ufre
佽	cirr
佸	hork
佢	kork
佢	qurk
佖	birb
佁	yirk
佁	iirk
伾	pira
伭	xrrd
伭	xmrd
伋	jirn
伈	xbrx
乸	naxd
乂	yipn
丏	mmag
○	lkvv
䁖	lzon
㧐	ssfy
䲟	ybye
䓫	qick
唡	llkr
鸧	chnr
䂮	ltuf
纻	vusa
䃅	diuu
䴙	pinu
䶮	yjld
讬	toyv
㑩	lord
镕	rsjk
䣘	thet
飏	yhfp
㭎	ghmx
鹠	lqnp
旸	yhop
䥽	pojy
赑	bibb
梿	lmmz
㧟	kkfk
㖞	wokn
䓨	ykcf
狝	xmqx
鸮	xnnk
㑊	yird
㤘	vzxe
䢺	iuei
䐃	jsoh
㴔	yidx
㴔	sedx
㛹	pmnn
㭕	qums
鹒	ggng
㙍	doty
荙	dacz
䓬	vocu
䏝	vrod
䗴	tkiz
㸌	hoha
䴖	jkno
䅟	cjhp
䴓	uinj
㛚	tsna
㛃	jpnf
㙘	yctn
䏡	uiox
㟃	siek
䃎	vaux
㳇	fudx
赒	vzbk
䌹	jssk
鹙	qqng
㳚	yudd
㰀	limd
䲠	iyyo
鳀	tiar
跶	dazz
祃	mapm
䥺	yajp
硚	qnua
𩠌	ssuz
㓥	thde
㠓	mgen
䗖	diij
㵐	jtdq
镋	thje
䓖	qscl
﻿的	dede
臜	zaob
祎	yipa
鲌	boab
鲌	baab
䴗	jund
㕮	tnkx
㕮	fukx
㠇	jqed
䢼	gseb
捡	jmfa
㫰	lhon
䴔	jnnx
䜣	ybyj
䜣	xiyj
䜣	xbyj
鸰	lknr
玱	qlwv
玱	chwv
亸	dowu
䗪	vegi
伣	qmrj
㬚	ieow
㻬	tuwg
鲗	zwyd
㥄	lkxw
㧑	wwfd
𠝹	jpdt
䎖	zgyo
䝙	iuvx
㘎	hjkw
莅	licl
㮾	lhmd
䎃	rjya
䏲	tiop
䏲	dpop
䴘	tinj
㽏	gjda
阓	gvmb
䓛	quci
䓛	guci
䓛	fuci
㶶	nshn
㳠	dadz
䦃	vojo
䗛	xqio
㬎	xmho
锽	hljw
黡	yjvi
㙦	xptr
㿠	hlbe
镮	hrjy
驲	rimo
滪	yudb
䴕	lpnd
㬊	hroy
玙	yuwa
㶲	ysha
㸆	kcha
骉	bnmm
㺄	yuqd
㳘	isde
鹮	hrns
啰	lokd
㑇	vzre
䲢	tgoy
瞭	leox
傢	jxrn
迴	hvzk
係	xirx
係	jirx
伕	furf
唸	nmkx
揹	bwfo
睏	kyok
彿	fupa
彿	fopa
俬	sirs
昇	ugoc
濛	mgdn
懞	mgxx
牴	dind
氾	fjdv
弔	dnga
暱	niok
蠔	hcin
甦	suaa
喎	wokk
嚇	xxkv
嚇	hekv
餸	ssiz
劏	thdx
慄	lixm
痾	kebk
瞭	lnox
觝	dijd
晳	xioj
荨	qmcc
食	yirg
槭	semg
卜	bua
韫	wfw
莒	juck
偻	lvr
狙	juq
聚	jue
炮	bch
溺	nndd
傀	gvr
仇	qqr
溱	qbdm
舡	ghvg
贮	vub
大	ddun
苹	pgc
苕	ucc
券	xrdf
瘕	xxby
铊	toj
拗	nqfl
崴	wdug
柢	iimd
巛	vevv
戆	vlx
涡	wod
嬛	xrnn
圻	ybtj
系	jisp
褪	tvy
铪	kej
俩	llrl
驮	tom
朴	pum
玟	mbw
砉	xuuu
著	voc
啁	vckv
呔	tdkt
郇	xye
龃	jui
种	ish
什	uiru
槟	bkmb
句	gzg
吁	yuky
囤	dyk
镐	hcj
淖	iod
柁	domb
嚓	iak
逡	qyz
翟	diy
单	ujb
攒	crfr
鹘	hugn
柏	bom
峤	jnua
仔	zdr
蚌	bhi
据	jufk
属	vuu
哕	ytkx
诒	ddyk
得	dwrc
熨	yuh
咯	kakk
怍	vaxa
栖	ximk
窭	juxn
驹	jum
称	ifhx
覅	mqwn
不	buad
砩	fwuf
裳	ihy
栝	kom
杓	bnmu
扛	ghfg
颤	vjy
安	anbn
枞	zsm
芾	fucj
唶	coko
烙	loh
扁	pmh
膀	pho
钖	yhjp
枸	jumk
淖	vod
酢	cuya
箐	jkv
莶	lmca
峙	uiuc
提	dif
郄	xie
麽	mom
阏	eemd
纰	bis
桡	ncm
么	mops
咽	yek
伽	gar
哜	jika
颌	geyr
莆	pucf
炬	juh
桧	hvms
沲	dody
裨	piyu
磅	phu
槛	jmm
熟	uuh
仡	yir
次	cidr
乇	vep
糜	mwm
苴	jucq
啁	tnkv
啉	ljkm
堕	hvt
眭	gvo
宿	xqb
贾	jxxb
铫	tnjv
菊	juc
踽	juzs
佴	ndr
渑	ugdd
契	xpd
腌	yjov
阢	wwe
发	favy
劲	jkl
蛸	xni
耙	palb
淳	vyd
鲑	xpyt
伺	sir
疽	jubq
拓	tafk
单	ijb
叨	tck
合	gerk
泷	uld
莞	wjc
褚	veyo
褚	vuyo
彷	fhs
剡	ujl
觜	zijb
圜	hrkn
圩	wwty
肮	ahoj
榉	jumu
澍	vudc
挲	uaf
苴	iacq
玢	bbw
慊	qpxb
窨	xyxo
锯	juj
摄	npf
歙	ueq
艾	yicx
荥	ykd
臂	bwo
颈	ggyg
卒	cuwu
蛤	hai
句	jug
龟	jyd
忾	xixv
肋	lwo
垌	tst
呙	wdk
辗	nmin
浍	hvd
沮	jud
嘞	lek
硌	lou
饹	leuk
廑	qbgt
就	jqwy
粢	cimr
绰	ios
惓	qrx
铫	dnjv
呒	omk
藏	zhci
价	jpr
还	hrzb
贲	bib
嘲	vck
町	tkt
挟	jxfd
犋	jun
蓼	luc
戛	gag
淆	xnd
宓	fubb
艽	qqcj
膪	vdo
膪	vao
姣	xnni
给	jisk
徵	vgsw
茄	jxc
惝	ihx
辟	bix
砬	liu
拮	jxfk
秤	igh
乘	ugp
茈	cic
朝	vcuo
埏	ujtz
呐	nekn
鞔	mfg
曝	bcod
可	kedk
脩	xqro
裼	xiyw
屦	juun
铣	xije
匙	uiub
脉	moo
钜	jujj
赚	zjb
矜	grm
乜	npvv
吡	pikb
隽	jyv
度	dogy
呲	zik
惮	dax
缊	yysm
嗯	ogk
鬲	geaa
撮	cofy
胖	pjo
嗒	dak
藉	jpc
堋	bgt
和	hehk
漯	lodx
落	lack
彭	bhp
综	zgsx
矩	juuj
昂	ahoe
伯	bor
芥	jpc
掸	ujfu
似	uir
朐	iyo
被	piyy
嘘	uik
帱	izj
埋	mjt
濞	pidj
苣	qucj
綮	qis
核	hum
糁	ufm
隋	doeo
腊	xio
鞘	ucgo
乐	ytpm
佃	tmr
蒡	bhc
醵	juyu
琚	juw
浒	hud
钿	tmjt
都	dueo
吱	vik
侥	ycr
揲	uefm
厕	sii
的	debd
咭	kak
的	dibd
约	ycs
呙	hek
娜	non
揣	trfa
传	vrrd
黾	mmk
黾	mgk
拘	juf
芫	yjce
囗	wwa
二	eraa
弹	tjg
佛	fura
峒	dsu
差	idg
圈	qrk
差	cig
剿	iclm
剧	jul
缴	vos
朴	pom
呗	bwk
讵	juy
识	viy
术	vum
疟	ycb
棱	lgm
曾	zgbo
吖	yaka
塑	sut
椐	jumk
於	wuf
芘	picb
椹	vfm
悝	lixa
拒	juf
呙	gxk
泌	bidb
盛	igm
没	mwdy
没	mody
澄	dgd
犴	anq
雎	juv
隳	doxo
栎	limx
偈	jirv
蒉	kkcr
勃	bwl
咀	jukq
棣	ddm
络	lcsk
芴	hucw
骠	bnmx
咯	lokk
喋	vak
跞	lozx
绿	lvs
焯	ich
畜	xut
柞	vam
凹	waaa
罢	piss
颉	jxyk
栅	cemc
纶	lys
车	juqu
嬷	mons
裾	juyk
侧	zdr
哏	hfk
茜	qmck
勒	lwg
拌	pjfu
了	levv
了	lnvv
螫	veiw
匮	gvk
阿	eeek
肀	yiv
啜	ikk
嬛	qsnn
淌	ihd
惧	juxb
薄	boc
楱	zzm
龟	qqd
棹	vom
靖	qklo
揣	vvfa
帱	czj
蚵	eeik
宛	yrbv
具	jub
揭	qifv
括	kof
蜅	pujf
梼	izmc
呙	wak
呙	wok
庳	bwgu
唛	mdkw
靓	jkq
局	juu
坻	iitd
貉	mov
犍	qmnz
阚	kjm
巨	juk
晟	igog
出	iuaa
汶	mfdi
伧	cfr
卡	qxab
矜	qbm
校	jnm
栅	ujmc
稽	jiho
啐	qik
苞	bcc
臭	xqz
棣	tim
膻	djoa
迫	pdl
蟒	mgi
侗	tsr
榘	jumj
胳	gaok
龈	kfig
鳜	jtyr
踞	juzk
笮	zov
伽	jxr
乾	qmq
眙	iiok
辗	zjin
折	uef
尉	yucx
举	jux
镡	xbju
拶	zjf
参	ufsp
鞫	jugk
喳	vak
喏	rek
率	ukwu
桁	hhm
咭	jik
睥	biot
焯	voh
个	gera
哦	ook
郦	vie
吓	hek
蕃	boct
铤	dkj
杉	ujm
诘	jiy
潢	gldb
居	juuk
謦	qiyy
梼	tcmc
莨	llc
垸	hrte
忪	vsxs
地	dety
漯	lwdx
侧	vdr
诜	ufye
掺	xmfp
落	lcck
区	ouk
俟	qird
肫	iyo
血	xpp
广	gldi
冯	pkd
帑	nuj
叭	bakb
柜	jumj
旰	hjou
橘	jumk
碣	yauv
翟	zdy
嗯	enk
掬	jufm
省	xko
缪	mzsp
楂	iama
缪	mqsp
锔	jujk
汩	yudo
抢	igf
趄	juz
嗌	aikm
恶	wux
苎	vuc
番	pjt
氓	mhw
飓	jufb
佚	dprd
咖	gakk
隗	wwe
淠	pwdj
解	xpj
帧	vfj
和	hohk
掺	ujfp
腧	uuol
和	huhk
瞿	juv
召	uck
蹊	qizd
铛	igj
遽	juzu
纥	hes
陂	pie
陂	poe
貉	hcv
轧	vaiv
碴	iau
桔	jumk
郐	gve
俱	jur
吭	kgk
埔	but
倨	jurk
蔓	wjc
唔	wukk
瘥	cdb
距	juz
咋	zek
荠	qica
楷	jpm
栝	tmm
便	pmr
谌	ufyv
调	tnyv
婶	sfn
胲	hdo
猹	iaq
壳	qnu
攵	wfp
鞠	jugm
屯	vya
镡	ijju
苣	jucj
六	luwb
莘	xbc
菀	yyc
揞	yefo
揞	yjfo
