我们	wom
中国	vsg
代表	ddb
怎么	zfm
问题	wft
思想	six
可能	ken
目前	muq
文学	wfx
新闻	xbw
大学	dax
纷纷	fff
工作	gsz
发现	fax
组织	zuv
还是	hdu
如何	ruh
参加	cjj
首先	uzx
创造	ilz
成功	igg
最近	zvj
责任	zer
目标	mub
电话	dmh
服务	fuw
属于	uuy
比赛	bis
证明	vgm
重视	vsu
价格	jxg
农业	nsy
曾经	cgj
共同	gst
增强	zgq
人口	rfk
主体	vut
财政	cdv
死亡	siw
贸易	mcy
用户	ysh
功能	gsn
本人	bfr
这个	vwg
社会	ueh
得到	ded
进行	jbx
群众	qyv
那么	nam
大家	daj
存在	cyz
家庭	jxt
农民	nsm
你们	nim
或者	hov
认真	rfv
也是	yeu
传统	irt
保持	bci
年轻	nmq
电影	dmy
去年	qun
更加	ggj
抓住	vxv
安排	anp
行为	xkw
日子	riz
也许	yex
铁路	tpl
分钟	ffv
容易	rsy
损失	syu
状况	vlk
西方	xif
达到	ddc
扩大	kod
不管	bug
增长	zgv
强烈	qll
文字	wfz
发出	fai
访问	fhw
表达	bnd
慢慢	emm
分子	ffz
应用	yky
岗位	ghw
年度	nmd
肯定	kfd
电脑	dmn
改善	gdu
得了	del
名字	mkz
不错	buc
江西	jlx
走私	zzs
快乐	kkl
必要	biy
大会	dah
特色	tes
渐渐	ejj
承认	igr
完整	wjv
东北	dsb
当年	dhn
此后	cih
探索	tjs
口号	kzh
春天	iyt
加快	jxk
剩下	ugx
相比	xlb
外汇	wdh
层次	cgc
产权	ijq
采用	cdy
道理	dcl
内地	nwd
哪个	nwg
确认	qtr
上级	uhj
广告	glg
命令	mkl
公开	gsk
随便	svb
超越	icy
湖北	hub
反而	fje
身份	uff
广泛	glf
勇气	ysq
工具	gsj
从中	csv
反复	fjf
大门	dam
罚款	fak
日常	rii
合格	heg
电池	dmi
冲动	isd
轰炸	hsv
恶劣	eel
共有	gsy
拆迁	idq
哪个	nag
安慰	anw
南宁	njn
温柔	wfr
发起	faq
绿洲	lvv
睡眠	uvm
共享	gsx
这些	vwx
人民	rfm
开始	kdu
然而	rje
希望	xiw
虽然	svr
特别	teb
帮助	bhv
条件	tnj
经验	jky
根本	gfb
能力	ngl
人类	rfl
单位	djw
包括	bck
身体	uft
农村	nsc
报告	bcg
不但	bud
双方	ulf
坚持	jmi
调整	tnv
后来	hzl
调查	dni
重大	vsd
感情	gjq
根据	gfj
处于	iuy
面前	mmq
状态	vlt
回来	hvl
破坏	poh
改造	gdz
材料	cdl
熟悉	uux
确定	qtd
明天	mkt
哪里	nal
按照	anv
观念	grn
法律	fal
无论	wul
构成	gzi
当地	dhd
话题	hxt
少年	ucn
配合	pwh
亚洲	yav
加强	jxq
综合	zsh
行业	hhy
再次	zdc
持续	iix
下降	xxj
银行	ybh
有所	yzs
对象	dvx
休息	xqx
把握	baw
展开	vjk
从来	csl
反应	fjy
高度	gcd
特殊	teu
严格	yjg
周围	vzw
关键	grj
就业	jqy
整体	vgt
放心	fhx
条例	tnl
当前	dhq
哲学	vex
奇迹	qji
刺激	cij
女人	nvr
判决	pjj
爱国	aig
类型	lxk
培训	pwx
盲目	mhm
保留	bcl
相同	xlt
生物	ugw
配备	pwb
刚才	ghc
球员	qqy
登记	dgj
促使	cuu
灾难	zdn
回头	hvt
汇报	hvb
压力	yal
否则	fzz
内涵	nwh
重庆	isq
足球	zuq
设立	uel
编辑	bmj
上面	uhm
循环	xyh
听说	tku
哪些	nax
考验	kcy
遵循	zyx
浪费	lhf
车间	iej
比例	bil
大量	dal
转变	vrb
南方	njf
文件	wfj
体会	tih
性格	xkg
观察	gri
内心	nwx
日期	riq
履行	lvx
动员	dsy
动作	dsz
儿女	ern
当作	dhz
合法	hef
后悔	hzh
好好	hch
算了	srl
凝聚	nkj
早日	zcr
赶快	gjk
水泥	uvn
各自	gez
赔偿	pwi
传达	ird
农场	nsi
散文	sjw
出国	iug
加速	jxs
生日	ugr
过渡	god
联络	lml
来源	ldy
持久	iij
桌子	voz
其余	qyu
外出	wdi
外商	wdu
如同	rut
迫切	poq
黑暗	hwa
嗓子	shz
导演	dcy
开口	kdk
开会	kdh
或许	hox
足够	zug
平凡	pkf
下班	xxb
红军	hsj
滋味	ziw
商量	uhl
广州	glv
白色	bds
信号	xbh
草原	ccy
热爱	rea
准确	vyq
考古	kcg
灵活	lkh
尊严	zyy
江南	jln
果然	gor
早上	zcu
摸索	mos
从前	csq
赛场	sdi
打算	das
分配	ffp
财产	cdi
财务	cdw
燃烧	rju
保健	bcj
宏伟	hsw
公平	gsp
哪儿	nae
风力	fgl
水果	uvg
反正	fjv
高考	gck
独自	duz
严厉	yjl
承诺	ign
投诉	tzs
透露	tzl
合适	heu
爱人	air
睡着	uvv
装饰	vlu
财经	cdj
帽子	mcz
操心	ccx
果实	gou
车门	iem
偏差	pmi
笑话	xnh
烦恼	fjn
高手	gcu
难怪	njg
体能	tin
提问	tiw
网友	why
疗效	lnx
丑恶	ize
走势	zzu
屡次	lvc
后院	hzy
才华	cdh
脉搏	mdb
按时	anu
时间	uij
因为	ybw
而且	erq
为了	wwl
如果	rug
青年	qkn
城市	igu
正在	vgz
公司	gss
日本	rib
中心	vsx
处理	iul
困难	kyn
内容	nwr
随着	svv
有关	yzg
总是	zsu
民族	mbz
比较	bij
支持	evi
女子	nvz
感觉	gjj
别人	bpr
面积	mmj
胜利	ugl
进步	jbb
追求	vvq
时期	uqi
充满	ism
之前	viq
满足	mjz
明确	mkq
热情	req
原来	yrl
提高	tig
选择	xrz
行动	xkd
儿童	ert
看见	kjj
标准	bnv
作家	zoj
前面	qmm
参观	cjg
专门	vrm
水平	uvp
方便	fhb
生存	ugc
总理	zsl
年龄	nml
来自	ldz
顺利	uyl
内部	nwb
冲突	ist
系统	xit
突然	tur
资格	zig
法规	fag
规划	gvh
考察	kci
超过	icg
民间	mbj
从事	csu
推广	tvg
本来	bfl
欧洲	ouv
说明	uom
讨论	tcl
表演	bny
漂亮	pnl
标题	bnt
看法	kjf
品牌	pbp
好像	hcx
爱情	aiq
算是	sru
定期	dkq
涉及	uej
保险	bcx
初步	iub
升级	ugj
总结	zsj
脱离	tol
森林	sfl
学会	xth
平衡	pkh
红色	hss
亲自	qbz
确立	qtl
明年	mkn
更为	ggw
样子	yhz
对面	dvm
对待	dvd
耐心	ndx
流通	lqt
快速	kks
害怕	hdp
消除	xni
能否	ngf
协调	xpt
能源	ngy
空气	ksq
专业	vry
某些	mzx
提前	tiq
忘记	whj
全球	qrq
特点	ted
发布	fab
软件	rrj
取消	qux
正文	vgw
东方	dsf
挂钩	gxg
河南	hen
抗战	khv
吸取	xiq
叶子	yez
高潮	gci
说道	uod
千万	qmw
宁夏	nkx
爱心	aix
谈论	tjl
税务	uvw
口气	kzq
老婆	lcp
场所	ihs
容量	rsl
亏损	kvs
股份	guf
股票	gup
首脑	uzn
收到	uzd
迎接	ykj
总体	zst
面子	mmz
纲要	ghy
开心	kxb
装备	vlb
金额	jbe
密集	mij
普查	pui
通常	tsi
邀请	ycq
车辆	iel
奉献	fgx
百年	bdn
内在	nwz
捐赠	jrz
货物	how
期限	qix
违法	wwf
代价	ddj
评论	pkl
配置	pwv
亲爱	qba
更新	ggx
上年	uhn
广场	gli
沙发	uaf
月份	ytf
热闹	ren
立法	lif
用于	ysy
参与	cjy
岁月	svy
领先	lkx
马路	mal
过年	gon
双重	uli
车子	iez
敏感	mbg
暂时	zju
强大	qld
论证	lyv
恐怕	ksp
男人	njr
军区	jyq
欧盟	oum
发放	faf
品种	pvs
最好	zvh
最为	zvw
情景	qkj
头脑	tzn
而后	erh
率先	ukx
准则	vyz
贫穷	pbq
号码	hcm
话说	hxu
盼望	pjw
水库	uvk
慷慨	khk
口袋	kzd
设置	uev
分类	ffl
脑子	ncz
罕见	hjj
场地	ihd
天文	tmw
压迫	yap
散发	sjf
责令	zel
夺取	doq
寿命	uzm
恰好	qxh
免费	mmf
秋天	qqt
跨越	kxy
农田	nst
航天	hht
再度	zdd
拖欠	toq
两旁	llp
困扰	kyr
如下	rux
摇头	yct
黑色	hws
柔和	rzh
录取	luq
到位	dcw
学历	xtl
违规	wwg
约束	ytu
测试	ceu
平稳	pkw
滚滚	gyg
图案	tua
排名	pdm
侵害	qbh
弱点	rod
得罪	dez
上课	uhk
扩展	kov
腊月	lay
明明	mkm
心思	xbs
听取	tkq
热心	rex
播出	boi
参考	cjk
天才	tmc
天真	tmv
灵感	lkg
蒙古	mgg
过于	goy
钞票	icp
团伙	trh
风气	fgq
笑容	xnr
增多	zgd
邪恶	xpe
大气	daq
客人	ker
专题	vrt
窗户	ilh
特征	tev
温暖	wfn
原始	yru
眼前	yjq
全年	qrn
法庭	fat
成本	igb
案例	anl
正好	vgh
透明	tzm
人工	rfg
人家	rfj
楼梯	lzt
干扰	gjr
顾问	guw
多年	don
桥梁	qnl
求实	qqu
破产	poi
来往	ldw
装修	vlx
年级	nmj
航线	hhx
童年	tsn
黑人	hwr
才能	cdn
开办	kdb
获取	hoq
毛病	mcb
厕所	ces
策划	ceh
评选	pkx
苹果	pkg
派遣	pdq
红旗	hsq
得意	dey
上班	uhb
创意	ily
天子	tmz
诉讼	sus
国债	gov
朗诵	lhs
辛勤	xbq
民办	mbb
超出	ici
超前	icq
车站	iev
混合	hyh
糊涂	hut
强制	qlv
答应	day
扭头	nqt
怀念	hkn
妹子	mwz
缘故	yrg
本科	bfk
偶尔	oue
体力	til
谁知	uwv
旋转	xrv
门窗	mfi
旅馆	lvg
动静	dsj
灭亡	mpw
认同	rft
中途	vst
忠诚	vsi
盘算	pjs
分手	ffu
睡觉	uvj
陈旧	ifj
纯洁	iyj
常规	ihg
别致	bpv
总共	zsg
来去	ldq
漂泊	pnb
仍旧	rgj
再见	zdj
君子	jyz
沧桑	chs
茶馆	iag
彩色	cds
倒退	dct
虚报	xub
内衣	nwy
冒险	mcx
改为	gdw
评判	pkp
指望	viw
狂热	klr
资讯	zix
喇嘛	lam
用品	ysp
共鸣	gsm
天黑	tmh
江湖	jlh
超额	ice
小鸟	xnn
增高	zgg
能耐	ngn
大腿	dat
坏人	hkr
本该	bfg
奔腾	bft
温泉	wfq
王后	whh
全额	qre
成才	igc
全文	qrw
选题	xrt
刻意	eky
濒临	bbl
丢人	dqr
表露	bnl
扫兴	scx
品味	pbw
贫寒	pbh
花儿	hxe
冷酷	lgk
女友	nvy
宽厚	krh
擦洗	cax
射门	uem
口径	kzj
水草	uvc
粗暴	cub
黑洞	hwd
振作	vfz
喷嚏	pft
派头	pdt
缺损	qts
准时	vyu
惨重	cjv
恩人	enr
偏见	pmj
打扰	dar
情况	qkk
影响	ykx
就是	jqu
完全	wjq
能够	ngg
表现	bnx
朋友	pgy
改革	gdg
努力	nul
当然	dhr
合作	hez
交通	jnt
错误	cow
病人	bkr
促进	cuj
提供	tgs
组成	zui
追求	vqq
热烈	rel
尊重	zyv
专家	vrj
管理	grl
看来	kjl
女儿	nve
色彩	sec
设备	ueb
交换	jnh
类型	lwx
出去	iuq
少数	ucu
外面	wdm
财富	cdf
昨天	zot
目光	mug
寻找	xyv
光荣	glr
消费	xnf
美丽	mwl
权利	qrl
门口	mfk
旅游	lvy
所在	soz
描写	mnx
情节	qjp
老实	lcu
图片	tup
多次	doc
收购	uzg
外来	wdl
回去	hvq
良心	llx
可怜	kel
到处	dci
安心	anx
慢慢	mjm
哈哈	hah
垃圾	laj
辛苦	xbk
操作	ccz
补充	bui
黄色	hls
尊敬	zyj
歌曲	geq
风格	fgg
同情	tsq
忽然	hur
论文	lyw
上去	uhq
空间	ksj
难道	njd
网上	whu
网站	whv
照顾	vcg
嘴巴	zvb
轻松	qks
嫂子	scz
工会	gsh
化学	hxx
中年	vsn
宽阔	krk
充足	isz
剥削	box
挖掘	waj
起步	qib
咖啡	kaf
短期	drq
收藏	uzc
码头	mat
总之	zsv
棉花	mmh
夸张	kxv
来回	ldh
持有	iiy
再现	zdx
两边	llb
节奏	jpz
悲哀	bwa
要是	ycu
疼痛	tgt
否定	fzd
珍贵	vfg
精品	jkp
测量	cel
平常	pki
夏天	xxt
途中	tuv
洪水	hsu
得知	dev
扩散	kos
拉萨	las
场合	ihh
心态	xbt
怎能	zfn
天上	tmu
猛烈	mgl
民航	mbh
日记	rij
恶化	eeh
各位	gew
怕是	pau
增收	zgu
同期	tqi
可爱	kea
可怕	kep
纽带	nqd
多半	dob
窗口	ilk
脾气	piq
没事	mwu
盈利	ykl
提案	tia
辽宁	lnn
门票	mfp
淘汰	tct
正如	vgr
东南	dsn
投标	tzb
所致	sov
二者	erv
购物	gzw
挑选	tnx
单纯	dji
瞄准	mnv
耗费	hcf
好评	hcp
花卉	hxh
搜索	szs
少爷	ucy
少儿	uce
女生	nvu
宽容	krr
前期	qmq
娃娃	waw
春秋	iyq
根源	gfy
骨头	gut
短暂	drz
多元	doy
废物	fww
传说	iru
洽谈	qxt
婴儿	yke
连年	lmn
迷人	mir
再三	zds
恰恰	eqq
层面	cgm
彩电	cdd
点评	dmp
放开	fhk
学位	xtw
左边	zob
座位	zow
祖先	zux
改正	gdv
侧面	cem
只管	vig
母子	muz
突发	tuf
钦佩	qbp
确诊	qtv
肮脏	ahz
海岸	hda
上方	uhf
上涨	uhv
光滑	glh
傻子	uaz
傻瓜	uag
长篇	ihp
虐待	ntd
明知	mkv
太平	tdp
供求	gsq
跟前	gfq
聆听	lkt
住宿	vus
俗称	sui
过后	goh
怒气	nuq
流程	lqi
追问	vvw
杀害	uah
站住	vjv
关头	grt
默契	moq
敏锐	mbr
咱俩	zjl
护送	hus
扭转	nqv
空白	ksb
转换	vrh
南北	njb
难忘	njw
皮鞋	pix
均衡	jyh
赌博	dub
恰恰	qxq
汹涌	xsy
精力	ejl
雄厚	xsh
关切	grq
观光	grg
观看	grk
整个	vgg
规矩	gvj
周期	vzq
全身	qru
朝气	vcq
抽调	izd
桃花	tch
就此	jqc
纠正	jqv
软弱	rrr
罪犯	zvf
罪恶	zve
屡屡	lvl
正派	vgp
请问	qkw
倾听	qkt
投票	tzp
头痛	tzt
透彻	tzi
列举	lpj
挑剔	tnt
胆子	djz
衰退	ukt
档案	dha
垂直	ivv
看似	kjs
和谐	hex
苦恼	kun
抗体	kht
频道	pbd
频率	pbl
人性	rfx
好奇	hcq
好事	hcu
辞退	cit
钻研	zry
华南	hxn
搜寻	szx
女工	nvg
博爱	boa
爱好	aih
早期	zcq
糟糕	zcg
袜子	waz
贪污	tjw
色情	seq
愤怒	ffn
赚钱	vrq
老兄	lcx
老区	lcq
口岸	kza
乐园	ley
水利	uvl
水土	uvt
脸孔	lmk
捍卫	hjw
山头	ujt
侵占	qbv
善良	ujl
容忍	rsr
融资	rsz
压缩	yas
正好	vhc
报送	bcs
储存	iuc
出头	iut
债权	vdq
挫折	cov
篮子	ljz
省份	ugf
别扭	bpn
箱子	xlz
总裁	zsc
妥协	tox
面包	mmb
钢琴	ghq
并存	bkc
连夜	lmy
农家	nsj
着重	vov
碰见	pgj
年内	nmn
灭绝	mpj
在场	zdi
外语	wdy
朴实	puu
仓库	chk
苍蝇	chy
区区	quq
背诵	bws
黑夜	hwy
柔道	rzd
腾飞	tgf
私自	siz
白菜	bdc
柔软	rzr
奈何	ndh
左侧	zoc
削减	xtj
获胜	hou
惊恐	jkk
阻碍	zua
跳水	tnu
代谢	ddx
目录	mul
下跌	xxd
排水	pdu
排列	pdl
变迁	bmq
漫步	mjb
资深	ziu
恳求	kfq
缺口	qtk
缺陷	qtx
得胜	deu
沙滩	uat
扩建	koj
名额	mke
心目	xbm
名片	mkp
常见	ihj
热衷	rev
热门	rem
天色	tms
修复	xqf
不如	bur
麻将	maj
塑料	sul
讲台	jlt
讲解	jlj
过错	goc
追逐	vvv
留念	lqn
地盘	dip
撤销	iex
快活	kkh
片刻	pmk
从业	csy
暂缓	zjh
能耗	ngh
比方	bif
推算	tvs
沮丧	jus
空洞	ksd
怀抱	hkb
特长	tei
特务	tew
某某	mzm
谋划	mzh
奔驰	bfi
本月	bfy
文书	wfu
呕吐	out
堵塞	dus
栏杆	ljg
怪事	gku
性别	xkb
往日	whr
泡沫	pcm
聊天	lnt
发作	faz
发觉	faj
发财	fac
丑闻	izw
筹措	izc
日夜	riy
日后	rih
逃避	tcb
丢掉	dqd
旅途	lvt
检讨	jmt
凑巧	czq
劣质	lpv
聘任	pbr
娘子	nlz
好人	hcr
好友	hcy
好在	hcz
算盘	srp
野草	yec
燃气	rjq
女王	nvw
女仆	nvp
牵挂	qmg
前天	qmt
宁愿	nky
盘活	pjh
环绕	hrr
切割	qpg
刷新	uxx
早晚	zcw
老者	lcv
分成	ffi
恼怒	ncn
纯属	iyu
春光	iyg
天鹅	tme
存储	cyi
保密	bcm
短信	drx
处女	iun
泡菜	pcc
腼腆	mmt
匀称	yyi
冰冷	bkl
秋风	qqf
农历	nsl
浓缩	nss
痴情	iiq
蔑视	mpu
再造	zdz
外人	wdr
外形	wdx
存放	cyf
汇总	hvz
退却	tvq
嘿嘿	hwh
切身	qpu
燃油	rjy
然则	rjz
肉眼	rzy
下周	xxv
耐力	ndl
栅栏	val
火速	hos
枯燥	kuz
眷恋	jrl
库房	kuf
冒充	mci
足足	zuz
测验	cey
改换	gdh
平素	pks
儿科	erk
喷泉	pfq
狂欢	klh
牧场	mui
哼哼	hgh
拍照	pdv
蝙蝠	bmf
撇开	ppk
害人	hdr
弱小	rox
特此	tec
澳洲	aov
操劳	ccl
惹人	rer
热土	ret
残忍	cjr
惶恐	hlk
奖惩	jli
怒火	nuh
车速	ies
快感	kkg
鸟枪	nnq
偏离	pml
风味	fgw
海风	hdf
魂魄	hyp
混同	hyt
从头	cst
暗自	anz
能人	ngr
赛马	sdm
塞外	sdw
调任	dnr
可否	kef
大王	daw
牛车	nqi
空手	ksu
空难	ksn
男儿	nje
男排	njp
批次	pic
阔别	kob
谋杀	mzu
本息	bfx
仁爱	rfa
性急	xkj
胸襟	xsj
熊猫	xsm
拐杖	gkv
拐卖	gkm
怪诞	gkd
星座	xkz
料理	lnl
周日	vzr
发火	fah
喧闹	xrn
日照	riv
讨债	tcv
逃难	tcn
淘金	tcj
门锁	mfs
软盘	rrp
肥胖	fwp
丢弃	dqq
屡遭	lvz
头像	tzx
婊子	bnz
表嫂	bns
率真	ukv
看到	kjd
垂危	ivw
吹奏	ivz
灭族	mpz
妙语	mny
候鸟	hzn
润泽	ryz
词组	ciz
高高	gcg
染指	rjv
钻心	zrx
冷宫	lgg
帖子	tpz
空出	ksi
老早	lcz
口感	kzg
乐事	leu
顶层	dkc
根除	gfi
拿出	nai
窥破	kvp
较高	jng
存入	cyr
存活	cyh
责骂	zem
肥皂	fwz
错开	cok
很少	hfu
丘陵	qql
甚而	ufe
暖冬	nrd
装潢	vlh
粗心	cux
谜团	mit
推脱	tvt
藏语	zhy
会展	hvv
让其	rhq
我想	wox
苍穹	chq
沧海	chh
苍天	cht
狂奔	klb
查问	iaw
娘胎	nlt
谬误	mqw
骗术	pmu
蚌壳	bhk
贴面	tpm
私奔	sib
祷告	dcg
慨然	kdr
血色	xts
展区	vjq
枯萎	kuw
贸然	mcr
册子	cez
该死	gds
邪念	xpn
瑕疵	xxc
横贯	hgg
侵吞	qbt
满腔	mjq
光速	gls
沙盘	uap
创制	ilv
揣度	ikd
你所	nis
撇下	ppx
名贵	mkg
杂音	zay
约会	yth
草率	ccu
热身	reu
残缺	cjq
拆散	ids
给他	gwt
靠岸	kca
鳞片	lbp
彻夜	iey
快慢	kkm
偏爱	pma
怕人	par
默认	mor
混杂	hyz
增资	zgz
打岔	dai
特工	teg
南宋	njs
兴致	xkv
找寻	vcx
抽身	izu
拉起	laq
揣测	ikc
酒鬼	jqg
最美	zvm
充实	isu
阿姨	aay
冷静	lgj
沸腾	fwt
藏族	zhz
娘家	nlj
白宫	bdg
月光	ytg
对抗	dvk
暂行	zjx
救灾	jqz
无穷	wuq
列席	lpx
当天	dht
骚扰	scr
抗灾	khz
线条	xmt
稍微	ucw
冷暖	lgn
冷水	lgu
中期	vsq
宽敞	kri
前年	qmn
糟蹋	zct
惬意	qpy
造型	zcx
铁人	tpr
沉思	ifs
算法	srf
口头	kzt
乐趣	leq
传送	irs
卡车	kai
卡片	kap
旁听	pht
茫然	mhr
股权	guq
抱歉	bcq
守候	uzh
错过	cog
蚂蚁	may
总的	zsd
运费	yyf
运河	yyh
对岸	dva
联防	lmf
暖和	nrh
登陆	dgl
暖气	nrq
荣幸	rsx
捉弄	von
扰乱	rcl
抵触	dii
铺路	pul
谱写	pux
菩萨	pus
容纳	rsn
让步	rhb
捆绑	kyb
酿成	nli
悲痛	bwt
卑鄙	bwb
区分	quf
双层	ulc
黑白	hwb
森严	sfy
腾空	tgk
爹娘	dpn
盗版	dcb
扎根	vag
防守	fhu
血肉	xtr
卖弄	mdn
捐助	jrv
精华	jkh
阻挠	zun
撒谎	sah
横幅	hgf
亲眼	qby
若是	rou
杂文	zaw
样品	yhp
用餐	ysc
考评	kcp
荒唐	hlt
铃声	lku
把戏	bax
留言	lqy
留存	lqc
萧条	xnt
犯规	fjg
在外	zdw
扭亏	nqk
恐慌	ksh
坏事	hku
助手	vuu
谋求	mzq
本文	bfw
体重	tiv
迎合	ykh
匈奴	xsn
胸膛	xst
往年	whn
劝告	qrg
周旋	vzx
形容	xkr
旋律	xrl
选购	xrg
逃跑	tcp
剖面	pzm
门类	mfl
隐瞒	ybm
丢失	dqu
投案	tza
索赔	sop
说情	uoq
索取	soq
烈火	lph
列出	lpi
卵巢	lri
骚动	scd
调和	tnh
骚乱	scl
衰竭	ukj
扫除	sci
扫清	scq
扫射	scu
炊烟	ivy
品尝	pbi
后方	hzf
后劲	hzj
好感	hcg
液态	yet
次序	cix
团圆	try
钻石	zru
冷清	lgq
冷藏	lgc
女郎	nvl
宽裕	kry
款项	krx
宽松	krs
凝固	nkg
凝视	nku
波涛	bot
欢心	hrx
切除	qpi
绑票	bhp
切勿	qpw
贴身	tpu
铁丝	tps
色泽	sez
龙虾	lsx
算计	srj
螺旋	lox
口味	kzw
算命	srm
奢望	uew
隔阂	geh
口令	kzl
水产	uvi
晨光	ifg
脑海	nch
卡通	kat
传言	iry
霸权	baq
定做	dkz
订购	dkg
定名	dkm
纯真	iyv
跟随	gfs
调拨	dnb
彷徨	phh
刁难	dnn
船夫	irf
张嘴	vhz
张扬	vhy
涨幅	vhf
短处	dri
累赘	lwv
散布	sjb
额度	eed
掉头	dnt
马虎	mah
恰似	qxs
相爱	xla
项链	xll
迎战	ykv
面试	mmu
随机	svj
过关	gog
刚好	ghh
灯泡	dgp
来年	ldn
身高	ufg
飘逸	pny
票据	pnj
着想	vox
烹饪	pgr
绕道	rcd
行情	hhq
行家	hhj
葬送	zhs
在逃	zdt
栽培	zdp
外观	wdg
外套	wdt
乾坤	qmk
让路	rhl
苍白	chb
藏书	chu
苍老	chl
入住	ruv
查找	iav
顺便	uyb
顺从	uyc
迫于	poy
能动	ngd
爽朗	ull
窘迫	jsp
迥异	jsy
否决	fzj
冉冉	rjr
柔情	rzq
蹂躏	rzl
拜托	bdt
作案	zoa
略略	ltl
开赛	kds
奶粉	ndf
内幕	nwm
谋略	mzl
枯竭	kuj
苦衷	kuv
作祟	zos
暗算	ans
怪异	gky
岂能	qin
阻挡	zud
洒脱	sat
撒娇	saj
瓶子	pkz
凭证	pkv
瓶颈	pkj
时光	uig
蛤蟆	ham
木耳	mue
哈达	had
横扫	hgs
排序	pdx
穷人	qsr
穷困	qsk
确凿	qtz
得分	def
伤感	uhg
光彩	glc
上演	uhy
床头	ilt
揣摩	ikm
傲慢	aom
逆转	niv
名师	mku
咋办	zab
挺拔	tkb
热带	red
怎的	zfd
勇猛	ysm
勇士	ysu
惨遭	cjz
柴草	idc
岁末	svm
对称	dvi
天涯	tmy
随心	svx
天亮	tml
考证	kcv
随同	svt
黄牛	hln
黄瓜	hlg
素描	sum
尽头	jbt
梦幻	mgh
诉说	suu
搞笑	gcx
狼狈	lhb
郎中	lhv
病痛	bkt
吝啬	lbs
奴才	nuc
抓捕	vxb
调换	dnh
坠落	vvl
追查	vvi
吵闹	icn
早年	zcn
车祸	ieh
鸟类	nnl
责怪	zeg
战败	vjb
片段	pmd
奉陪	fgp
篇幅	pmf
翠绿	cvl
混淆	hyx
聪慧	csh
憎恨	zgh
增量	zgl
按钮	ann
烦人	fjr
推敲	tqn
彼岸	bia
赛跑	sdp
退伍	tvw
稿子	gcz
克制	kev
退让	tvr
牛马	nqm
空运	ksy
睿智	rvv
瑞雪	rvx
转弯	vrw
专心	vrx
转告	vrg
坏话	hkh
戳记	ioj
推倒	tvd
男性	njx
推测	tvc
胆量	djl
怨恨	yrh
谋反	mzf
奔跑	bfp
文稿	wfg
篡改	crg
赌场	dui
兄长	xsv
幸好	xkh
收看	uzk
性爱	xka
乖乖	gkg
王子	whz
权衡	qrh
形似	xks
嫩绿	nfl
丑陋	izl
抽签	izq
抽空	izk
日头	rit
狰狞	vgn
软化	rrh
软骨	rrg
门徒	mft
阴暗	yba
见闻	jmw
凑近	czj
正色	vgs
说破	uop
飘然	pnr
动感	dsg
透气	tzq
头昏	tzh
插画	iah
投机	tzj
表格	bng
表层	bnc
插曲	iaq
猎狗	lpg
挑逗	tnd
狗屁	gzp
调侃	tnk
寡人	gxr
帅才	ukc
当众	dhv
扫帚	scv
吹牛	ivn
垂钓	ivd
说笑	uox
苗条	mnt
妙计	mnj
拼死	pbs
贫瘠	pbj
拼音	pby
折合	veh
厚望	hzw
野人	yer
花瓶	hxp
花纹	hxw
搜捕	szb
冷汗	lgh
女装	nvv
女方	nvf
中肯	vsk
宽慰	krw
剥皮	bop
还债	hrv
且慢	qpm
帮凶	bhx
造访	zcf
蛙泳	way
隆起	lsq
感触	gji
老公	lcg
老成	lci
感恩	gje
酸苦	srk
落难	lon
裸露	lol
裸体	lot
口水	kzu
口信	kzx
口语	kzy
乐天	let
水族	uvz
扣除	kzi
水表	uvb
淳朴	iyp
肠胃	ihw
嫦娥	ihe
袅袅	nnn
魁梧	kvw
黑手	hwu
账号	vhh
蠢人	iyr
短语	dry
断然	drr
短促	drc
短发	drf
择优	zey
责难	zen
棍子	gyz
费神	fwu
撮合	coh
生病	ugb
别离	bpl
恰如	qxr
享福	xlf
硬盘	ykp
萦绕	ykr
樱桃	ykt
炮制	pcv
总务	zsw
纵情	zsq
赔罪	pwz
脱产	toi
港台	ght
阻拦	zul
并称	bki
暖流	nrl
咖喱	gal
登报	dgb
登门	dgm
孙女	syn
深奥	ufa
深造	ufz
暖意	nry
刷子	uxz
谨防	jbf
酌情	voq
蓬松	pgs
粗俗	cus
粗犷	cug
粗话	cuh
从宽	csk
航班	hhb
在乎	zdh
脏腑	zhf
歪曲	wdq
脱俗	tos
窝囊	won
苍茫	chm
藏品	chp
凉快	llk
捷径	jpj
困顿	kyd
鲲鹏	kyp
通话	tsh
插入	iar
入网	ruw
顺序	uyx
缠绕	ijr
顺风	uyf
破案	poa
破碎	pos
备用	bwy
谬论	mql
爽快	ulk
要好	ych
黑窝	hww
茄子	qpz
柔顺	rzu
丧礼	shl
染色	rjs
耐看	ndk
放屁	fhp
学年	xtn
内疚	nwj
学成	xti
坑人	kgr
作曲	zoq
冒汗	mch
矛头	mct
决胜	jtu
撒网	saw
撒泼	sap
儿戏	erx
喷发	pff
喷灌	pfg
盆景	pfj
喷射	pfu
狂风	klf
失色	uis
矿藏	klc
狂妄	klw
横渡	hgd
涂抹	tum
排版	pdb
变态	bmt
叛逆	pjn
红枣	hsz
宏图	hst
匹配	ppw
得悉	dex
上传	uhi
扩容	kor
拉倒	lad
床上	ilu
垦荒	kfh
恶棍	eeg
杂质	zav
杂草	zac
乐章	ytv
决裂	jtl
月初	yti
月报	ytb
热诚	rei
残存	cjc
考点	kcd
拷贝	kcb
荒废	hlf
蒙骗	mgp
俗气	suq
恩怨	eny
恩泽	enz
尊贵	zyg
降幅	jlf
浪涛	lht
怒视	nuu
吞没	tym
怒斥	nui
光标	glb
抓瞎	vxx
浏览	lql
炒作	icz
双亲	ulq
双面	ulm
车位	iew
鸟巢	nni
责问	zew
尿素	nns
鼠标	uub
怕死	pas
小气	xnq
昏聩	hyk
浑然	hyr
润笔	ryb
润湿	ryu
增援	zgy
从速	css
润滑	ryh
润色	rys
增容	zgr
赞歌	zjg
呼叫	huj
强求	qlq
枪毙	qlb
三个	sjg
轮换	lyh
推行	tvx
声卡	ugk
牛皮	nqp
牛仔	nqz
牛市	nqu
转盘	vrp
推拿	tvn
特批	tep
超人	icr
没想	mwx
阔气	koq
圆润	yrr
篡位	crw
本分	bff
文采	wfc
卡壳	qxk
藕粉	ouf
偶数	ouu
黑锅	hwg
胸前	xsq
胸围	xsw
秋色	qqs
很早	hfz
怪罪	gkz
拐角	gkj
怪病	gkb
很难	hfn
送出	ssi
送进	ssj
疗养	lny
凑凑	czc
周遭	vzz
诚心	igx
谁人	uwr
发怒	fan
沼泽	vcz
筹码	izm
门人	mfr
日光	rig
日内	rin
走好	zzh
贪财	tjc
门市	mfu
他也	tay
爬虫	pai
最高	zvg
滤波	lvb
凑数	czu
解围	jpw
绕圈	rcq
头寸	tzc
头上	tzu
表外	bnw
说完	uow
所列	sol
所处	soi
猎物	lpw
索然	sor
乱码	lrm
乱开	lrk
乱套	lrt
挂彩	gxc
活在	hoz
挂在	gxz
减额	jme
搔痒	scy
拽起	vkq
看出	kji
看着	kjv
看我	kjw
垂爱	iva
佛山	fou
吹吹	ivi
蓬莱	pgl
总怕	zsp
秒表	mnb
润肤	ryf
贫嘴	pbz
这种	vev
肉丸	rzw
肉铺	rzp
碰碰	pgp
窜逃	crt
好啊	hca
做到	zod
也难	yen
做了	zol
也算	yes
说出	uoi
还好	hdh
找你	vcn
团年	trn
都可	dzk
都没	dzm
漏气	lzq
楼盘	lzp
搜罗	szl
稍作	ucz
韶关	ucg
冷场	lgi
女童	nvt
女模	nvm
挂着	gxv
中方	vsf
宽窄	krv
中魔	vsm
宽体	krt
宽了	krl
宽带	krd
热吻	rew
凝练	nkl
千里	qml
凝重	nkv
凝望	nkw
重重	isi
盘起	pjq
换票	hrp
换了	hrl
软饭	rrf
艾滋	aiz
挨着	aiv
够好	gzh
早死	zcs
铁腕	tpw
挖煤	wam
佛堂	fot
色弱	ser
色鬼	seg
龙井	lsj
空了	ksl
擦汗	cah
一个	yig
擦掉	cad
贪念	tjn
吞服	tyf
赶跑	gjp
酸痛	srt
口算	kzs
抠门	kzm
勒紧	lej
乐子	lez
勒索	les
水色	uvs
刁蛮	dnm
掉了	dnl
捏碎	nps
闹铃	ncl
恼人	ncr
脑髓	ncs
薯片	uup
卡号	kah
卡纸	kav
盯住	dkv
定下	dkx
怕你	pan
定能	dkn
寒酸	hjs
常备	ihb
凑够	czg
传闻	irw
穿好	irh
这种	vwv
这点	vwd
切开	qpk
跟打	gfd
煽情	ujq
亏了	kvl
很准	hfv
很久	hfj
旁证	phv
川菜	irc
存档	cyd
容身	rsu
何求	heq
芒果	mhg
春兰	iyl
纯白	iyb
端倪	drn
短短	drd
雷池	lwi
滚存	gyc
翁婿	wgx
飞蛾	fwe
多处	doi
多了	dol
首尔	uze
斋菜	vdc
收市	uzu
措辞	coc
生在	ugz
甭管	bgg
很有	hfy
很痛	hft
很晚	hfw
很忙	hfm
别管	bpg
很惨	hfc
别吵	bpi
很多	hfd
抛下	pcx
泡汤	pct
抛洒	pcs
抛售	pcu
泡妞	pcn
总括	zsk
调往	dnw
泼妇	pof
云贵	yyg
花在	hxz
挪动	nod
刚柔	ghr
港片	ghp
长者	vhv
联通	lmt
挂了	gxl
改了	gdl
浪人	lhr
暖暖	nrn
跨行	kxh
夸口	kxk
跨过	kxg
等你	dgn
跨省	kxu
赖皮	ldp
脓包	nsb
浓重	nsv
飘在	pnz
暖色	nrs
票数	pnu
暖身	nru
飘忽	pnh
撞死	vls
吃素	iis
年报	nmb
仍需	rgx
迷你	min
仍会	rgh
扔了	rgl
仍能	rgn
群友	qyy
灭顶	mpd
灭门	mpm
绕着	rcv
绕过	rcg
航拍	hhp
行货	hhh
藏人	zhr
在前	zdq
再忙	zdm
再来	zdl
赃官	zhg
外孙	wds
扑火	puh
追忆	vvy
普照	puv
托词	toc
拓荒	toh
群舞	qyw
存根	cyg
酸味	srw
只能	vin
我为	wow
亮色	lls
两句	llj
双人	ulr
女权	nvq
困了	kyl
查出	iai
入门	rum
层高	cgg
顺道	uyd
顺耳	uye
顺滑	uyh
准入	vyr
去过	qug
北大	bwd
妖怪	ycg
黑了	hwl
黑金	hwj
黑发	hwf
黑招	hwv
某位	mzw
谁的	uwd
肉包	rzb
踩踏	cdt
彩信	cdx
粗口	cuk
帮我	bhw
桑拿	shn
跌回	dph
染发	rjf
风中	fgv
疯牛	fgn
略宽	ltk
略差	lti
色狼	sel
排忧	pdy
开颜	kdy
开盘	kdp
耐用	ndy
乍现	vax
分隔	ffg
乍闻	vaw
内附	nwf
哪吒	nev
噱头	xtt
学到	xtd
学名	xtm
多问	dow
拴住	urv
眷顾	jrg
酷热	kur
买家	mdj
迈出	mdi
麦克	mdk
买票	mdp
捐物	jrw
坐在	zoz
吃了	iil
冲入	isr
三种	sjv
德文	dew
怪他	gkt
毛孔	mck
猫狗	mcg
垂死	ivs
送上	ssu
尾盘	wwp
组图	zut
租售	zuu
撒开	sak
洒满	sam
洒遍	sab
撒野	say
撒气	saq
撒种	sav
册封	cef
太热	tdr
太窄	tdv
改写	gdx
带来	ddl
喷出	pfi
喷雾	pfw
怕痒	pay
狂潮	kli
狂傲	kla
狂躁	klz
哈佛	haf
夏普	xxp
滚热	gyr
所获	soh
图文	tuw
突起	tuq
恳谈	kft
派送	pds
排挤	pdj
排尿	pdn
排行	pdh
排骨	pdg
多好	doh
率由	uky
帅气	ukq
杂差	zai
红人	hsr
咋搞	zag
钻入	zrr
满分	mjf
字符	zif
摔倒	ukd
杂项	zax
肉酱	rzj
慢跑	mjp
拨给	bog
雀巢	qti
更热	ggr
更早	ggz
更多	ggd
更好	ggh
还将	hdj
若在	roz
若无	row
爬起	paq
尚在	uhz
逛街	glj
光年	gln
括号	koh
送回	ssh
阔少	kou
拉尿	lan
拉回	lah
拉高	lag
谁不	uwb
创出	ili
懂了	dsl
揣着	ikv
揣想	ikx
逆耳	nie
你会	nih
昂起	ahq
嗓门	shm
名画	mkh
懊悔	aoh
咋了	zal
恩德	end
扎染	zar
杂谈	zat
月内	ytn
听了	tkl
换上	hru
草屋	ccw
草签	ccq
草拟	ccn
太难	tdn
太高	tdg
热播	reb
怎讲	zfj
怎不	zfb
拨号	boh
惨败	cjb
参评	cjp
拆字	idz
拆开	idk
碎了	svl
随风	svf
跟我	gfw
跟他	gft
烤瓷	kcc
考勤	kcq
靠在	kcz
考入	kcr
对着	dvv
对人	dvr
给我	gww
不能	bun
不会	buh
不全	buq
不二	bue
另附	lkf
仍可	rgk
黄泉	hlq
马表	mab
甩卖	ukm
若有	roy
猛男	mgn
俗物	suw
蒙头	mgt
两耳	lle
恩情	enq
给人	gwr
将为	jlw
略好	lth
将其	jlq
将在	jlz
独享	dux
读完	duw
日日	rir
闽南	mbn
努嘴	nuz
吞掉	tyd
驽钝	nud
总能	zsn
光头	glt
追捧	vvp
超薄	icb
双掌	ulv
各项	gex
快要	kky
快走	kkz
快慰	kkw
车库	iek
快报	kkb
快捷	kkj
车内	ien
鸟瞰	nnk
鸟鸣	nnm
鸟儿	nne
偏移	pmy
海豚	hdt
怕他	pat
模特	mot
婚否	hyf
婚庆	hyq
润物	ryw
从犯	csf
闰月	ryy
酒肉	jqr
赠品	zgp
赞颂	zjs
烦了	fjl
翻倍	fjb
我在	woz
安插	ani
增发	zgf
烦死	fjs
三资	sjz
我所	wos
调去	dnq
能将	ngj
赛制	sdv
腮腺	sdx
都能	dzn
赛后	sdh
过小	gox
上次	uhc
上屏	uhp
他想	tax
高亮	gcl
搞清	gcq
大额	dae
纽约	nqy
牛郎	nql
空位	ksw
贼胆	zwd
瑞士	rvu
转载	vrz
转存	vrc
转念	vrn
转到	vrd
赚了	vrl
怀中	hkv
怀旧	hkj
坏了	hkl
戳破	iop
特来	tel
南侧	njc
男孩	njh
难求	njq
美色	mws
美钞	mwi
某天	mzt
某部	mzb
某次	mzc
并将	bkj
本行	bfh
紊乱	wfl
订票	dkp
文案	wfa
均能	jyn
别去	bpq
呕气	ouq
别怕	bpp
掐住	qxv
雄姿	xsz
延安	yja
篮筐	ljk
懒人	ljr
简拼	ejp
怪人	gkr
怪话	gkh
忘了	whl
怪了	gkl
网速	whs
开往	kdw
疗程	lni
全副	qrf
帮你	bhn
擦破	cap
规劝	gvq
办好	bjh
橙色	igs
跪下	gvx
发音	fay
绑在	bhz
谁能	uwn
发暗	faa
妈的	mad
找我	vcw
丑女	izn
门内	mfn
日文	riw
日晒	riu
套现	tcx
淘气	tcq
掏出	tci
走在	zzz
走开	zzk
走高	zzg
弹出	tji
就会	jqh
门边	mfb
门规	mfg
门前	mfq
软卧	rrw
软体	rrt
软驱	rrq
他来	tal
暖春	nri
最长	zvi
最新	zvx
最热	zvr
最怕	zvp
顽抗	wjk
万元	wjy
万人	wjr
他所	tas
嘴里	zvl
丢下	dqx
丢丑	dqi
面容	mmr
凑合	czh
溃疡	kvy
类别	lwb
首创	uzi
年月	nmy
丧气	shq
清早	qkz
洞察	dsi
伉俪	khl
厚道	hzd
涅槃	npp
填充	tmi
牙膏	yag
摘除	vdi
马鞍	maa
泡影	pcy
恋情	lmq
破财	poc
年尾	nmw
碰巧	pgq
米饭	mif
粗放	cuf
粗鲁	cul
让座	rhz
尿布	nnb
区间	quj
黑马	hwm
黑车	hwi
桑蚕	shc
染病	rjb
闯荡	ild
内存	nwc
麦穗	mds
卖钱	mdq
短途	drt
泪痕	lwh
撒尿	san
而非	erf
喷洒	pfs
狂笑	klx
哈欠	haq
杂货	zah
满口	mjk
撇嘴	ppz
亲耳	qbe
若非	rof
疟疾	ntj
杂念	zan
草稿	ccg
拆卸	idx
花招	hxv
哪样	nay
另类	lkl
恩惠	enh
浪子	lhz
奴役	nuy
怒骂	num
沦陷	lyx
炒菜	icc
锐气	rvq
坏死	hks
蜕变	tvb
没法	mwf
废人	fwr
行骗	xkp
嫩芽	nfy
所需	sox
滚烫	gyt
日历	ril
备注	bwv
情面	qkm
飘飘	pnp
漂浮	pnf
插头	iat
烈女	lpn
乱搞	lrg
乱子	lrz
扫黄	sch
扫过	scg
当红	dhh
当官	dhg
扫尾	scw
看看	kjk
看报	kjb
看在	kjz
顺着	uyv
准能	vyn
妙处	mni
拼图	pbt
拼凑	pbc
折算	ves
窜出	cri
好色	hcs
好难	hcn
划算	hxs
告退	gct
陋俗	lzs
漏网	lzw
搜狐	szh
冷色	lgs
挂机	gxj
挂上	gxu
钟爱	vsa
种菜	vsc
挂心	gxx
宽幅	krf
惹眼	rey
宁死	nks
博弈	boy
博取	boq
播送	bos
判官	pjg
盘绕	pjr
欢腾	hrt
爱恋	ail
哀愁	aii
早盘	zcp
贴图	tpt
铁杆	tpg
龙宫	lsg
色素	ses
色相	sex
色盲	sem
龙袍	lsp
聋哑	lsy
擦干	cag
分号	ffh
酸软	srr
扣子	kzz
口内	kzn
趁早	ifz
捏成	npi
挠痒	ncy
闹鬼	ncg
闹钟	ncv
卡拉	kal
定会	dkh
顶峰	dkf
厂长	ihv
赔钱	pwq
传出	iri
跟风	gff
葵花	kvh
溃逃	kvt
哪位	naw
空头	kst
存取	cyq
雅虎	yah
穿过	irg
长孙	vhs
涨停	vht
又在	yzz
断根	drg
垒球	lwq
棍棒	gyb
滚开	gyk
扫平	scp
债款	vdk
守则	uzz
首推	uzt
声母	ugm
搪瓷	thc
马戏	max
很热	hfr
很爱	hfa
总称	zsi
陪你	pwn
敲诈	qnv
翘楚	qni
韵母	yym
随你	svn
仍未	rgw
港币	ghb
令牌	lkp
并在	bkz
损益	syy
暖风	nrf
浓香	nsx
弄清	nsq
暖瓶	nrp
剽窃	pnq
撞车	vli
撞墙	vlq
刷牙	uxy
刷毛	uxm
灼痛	vot
碰壁	pgb
粗体	cut
米色	mis
绕场	rci
绕远	rcy
藏香	zhx
酸奶	srn
脱位	tow
裙裤	qyk
回暖	hvn
让你	rhn
我要	woy
均可	jyk
藏匿	chn
插座	iaz
曾任	cgr
迥然	jsr
酿制	nlv
版块	bjk
掺和	ijh
产科	ijk
婆媳	pox
备查	bwi
双击	ulj
背囊	bwn
黑体	hwt
车次	iec
吹干	ivg
揉搓	rzc
才敢	cdg
财宝	cdb
疼爱	tga
丧胆	shd
丧钟	shv
软了	rrl
开了	kdl
开凿	kdz
榨菜	vac
炸死	vas
渣土	vat
哭喊	kuh
重回	ish
给了	gwl
散伙	sjh
怪才	gkc
斗殴	dzo
侧耳	cee
改日	gdr
代码	ddm
吓死	xxs
亨通	hgt
衡阳	hgy
穷酸	qss
编码	bmm
判词	pjc
鬼才	gvc
攀岩	pjy
红利	hsl
捏弄	npn
更烦	ggf
若何	roh
送死	sss
拉票	lap
落下	lax
腊肉	lar
虐杀	ntu
昵称	nii
寻人	xyr
犹太	yzt
名为	mkw
杂色	zas
杂牌	zap
邮费	yzf
绝招	jtv
听凭	tkp
停下	tkx
草图	cct
草酸	ccs
草包	ccb
春夏	iyx
太好	tdh
太小	tdx
等他	dgt
热裤	rek
惹祸	reh
怎会	zfh
洋葱	yhc
说了	uol
准将	vyj
拆台	idt
拆毁	idh
混拼	ehp
洒下	sax
拿起	naq
对公	dvg
给谁	gwu
哪天	nat
烤箱	kcx
领班	lkb
俗念	sun
恩爱	ena
聋子	lsz
尊称	zyi
尊容	zyr
降至	jlv
临海	lbh
奴仆	nup
臀围	tyw
怒放	nuf
罢手	bau
疤痕	bah
抓出	vxi
抓药	vxy
留着	lqv
留情	lqq
光束	glu
追杀	vvu
鸟粪	nnf
还想	hdx
还能	hdn
婚变	hyb
闰年	ryn
暂不	zjb
反查	fji
晒干	udg
暂缺	zjq
很烦	hff
阔佬	kol
怪癖	gkp
很怕	hfp
送你	ssn
送给	ssg
店面	dmm
全屏	qrp
嫩苗	nfm
嫩白	nfb
哪位	nww
讨饶	tcr
走吧	zzb
剖白	pzb
软座	rrz
他给	tag
最能	zvn
最大	zvd
我听	wot
捉鬼	vog
借钱	jpq
放了	fhl
偷窥	tzk
贼船	zwi
标识	bnu
表壳	bnk
标出	bni
头尾	tzw
所提	sot
乱发	lrf
劣评	lpp
乱窜	lrc
乱花	lrh
乱扔	lrr
乱转	lrv
挑起	tnq
乱想	lrx
调高	tng
而不	erb
条码	tnm
勾选	gzx
豁免	hom
挂出	gxi
单击	djj
单面	djm
骚客	sck
明暗	mka
摔伤	uku
摔死	uks
帅哥	ukg
摔坏	ukh
当了	dhl
看你	kjn
看下	kjx
而来	erl
垂询	ivx
顺嘴	uyz
卖给	mdg
炕上	khu
苗人	mnr
妙文	mnw
这位	vew
说过	uog
后市	hzu
后嗣	hzs
算好	srh
篡权	crq
试试	euu
做好	zoh
也该	yeg
作弄	zon
此番	cif
此处	cii
此类	cil
列表	lpb
女孩	nvh
整句	evj
僧众	sgv
普洱	pue
咋的	zad
楼上	lzu
稍停	uct
烧钱	ucq
冷了	lgl
冷冰	lgb
冷傲	lga
冷僻	lgp
女色	nvs
女厕	nvc
早知	zcv
女奴	nvn
挂网	gxw
宽频	krp
凝听	nkt
抓狂	vxk
盘亏	pjk
盘升	pju
团购	trg
还给	hrg
挨打	aid
眷爱	jra
捐出	jri
早了	zcl
早就	zcj
拆了	idl
贴出	tpi
贴好	tph
贴着	tpv
哇塞	was
挖取	waq
色诱	sey
空仓	ksc
擦去	caq
擦肩	caj
擦除	cai
擦亮	cal
擦擦	cac
擦背	cab
探长	tjv
弹奏	tjz
抓到	vxd
老头	lct
趁你	ifn
算出	sri
算算	srs
都是	dzu
都想	dzx
洛阳	loy
这边	veb
乐和	leh
趁此	ifc
捏揉	npr
卡巴	kab
卡死	kas
卡在	kaz
盯死	dks
春花	iyh
常在	ihz
跟上	gfu
配菜	pwc
这回	vwh
跟你	gfn
跟了	gfl
这边	vwb
亏钱	kvq
楼下	lzx
存盘	cyp
存为	cyw
雅兴	yax
披在	piz
说着	uov
断开	drk
三重	sji
三年	sjn
散了	sjl
切碎	qps
择期	zeq
吹了	ivl
债台	vdt
摘得	vdd
摘花	vdh
放在	fhz
首页	uzy
错码	com
升高	ugg
躺着	thv
唐宋	ths
骂人	mar
很好	hfh
很长	hfi
很快	hfk
很累	hfl
别催	bpc
别急	bpj
别忙	bpm
抬起	tdq
很高	hfg
憋死	bps
别提	bpt
想你	xln
跑进	pcj
陪陪	pwp
配股	pwg
赔了	pwl
搜狗	szg
全拼	eqp
瞧瞧	qnq
拖把	tob
对了	dvl
仍是	rgu
港式	ghu
刚出	ghi
速配	sup
求购	qqg
并可	bkk
并重	bkv
病死	bks
狼皮	lhp
跨年	kxn
孙儿	sye
等人	dgr
等我	dgw
来了	ldl
来岁	lds
给出	gwi
给回	gwh
浓浓	nsn
给钱	gwq
弄脏	nsz
弄破	nsp
弄湿	nsu
票务	pnw
飘着	pnv
装在	vlz
耍宝	uxb
桌布	vob
掉下	dnx
捉虫	voi
捧走	pgz
扔到	rgd
扔给	rgg
迷上	miu
绕行	rcx
绕弯	rcw
饶人	rcr
绕回	rch
行数	hhu
行规	hhg
行内	hhn
脏活	zhh
再过	zdg
脏了	zhl
外侧	wdc
外壳	wdk
谱曲	puq
戎装	rsv
融为	rsw
让行	rhx
让出	rhi
让道	rhd
我来	wol
我会	woh
我国	wog
栓牢	url
藏在	chz
两种	llv
两年	lln
截屏	jpp
差了	ial
困住	kyv
查案	iaa
入列	rul
如不	rub
茶肆	ias
𩠌	ssu
入市	ruu
娘亲	nlq
娘们	nlm
娘俩	nll
半场	bji
双子	ulz
尿壶	nnh
扔出	rgi
准尉	vyw
谁说	uwu
谁肯	uwk
黑字	hwz
黑屏	hwp
都给	dzg
窘态	jst
若不	rob
腾讯	tgx
腾出	tgi
柔肠	rzi
帮他	bht
揉着	rzv
跌至	dpv
跌入	dpr
桑巴	shb
跌价	dpj
贴片	tpp
百度	bdd
摆在	bdz
快说	kku
四次	sic
略慢	ltm
到此	dcc
到时	dcu
癫狂	dmk
尝尝	eii
虚增	xuz
开年	kdn
放过	fhg
奶嘴	ndz
内胎	nwt
榨汁	vav
作出	zoi
内衬	nwi
火鸟	hon
垂头	ivt
祸胎	hot
哭声	kuu
卷面	jrm
哭了	kul
买入	mdr
卷筒	jrt
重阳	isy
重塑	iss
冲高	isg
三天	sjt
三级	sjj
太笨	tdb
怪你	gkn
雷劈	lwp
累了	lwl
乱说	lru
都听	dzt
扔钱	rgq
洒在	saz
乱用	lry
囊肿	nhv
侧边	ceb
改成	gdi
二次	erc
待批	ddp
而成	eri
带给	ddg
喷火	pfh
缩放	sof
哈勃	hab
木牌	mup
狂拼	klp
肯为	kfw
横在	hgz
恒生	hgu
横批	hgp
恒久	hgj
排位	pdw
徒儿	tue
吐纳	tun
摔在	ukz
多人	dor
红粉	hsf
瞒着	mjv
列明	lpm
慢热	mjr
确有	qty
更少	ggu
更强	ggq
更惨	ggc
弱了	rol
若其	roq
怕怕	pap
上岸	uha
送我	ssw
路边	lub
光凭	glp
扩胸	kox
扩增	koz
谁在	uwz
傻了	ual
谁来	uwl
谁敢	uwg
长发	ihf
虐囚	ntq
冻死	dss
窗缝	ilf
你来	nil
摘自	vdz
跌去	dpq
有违	yzw
刷屏	uxp
缺钙	qtg
新版	xbb
粤菜	ytc
操盘	ccp
骗我	pmw
太长	tdi
等下	dgx
热评	rep
热键	rej
常来	ihl
祝你	vun
太晚	tdw
胖妞	phn
怎可	zfk
怎敢	zfg
走进	zzj
给你	gwn
柴米	idm
拆掉	idd
哪边	nab
那好	nah
哪次	nac
哪点	nad
哪种	nav
拿走	naz
对此	dvc
天年	tmn
考考	kck
随我	svw
对私	dvs
不算	bus
马刺	mac
若没	rom
恩公	eng
高人	gcr
赛扬	sdy
吞了	tyl
褪去	tyq
拔出	bai
总想	zsx
总有	zsy
更差	ggi
流入	lqr
留给	lqg
留空	lqk
追回	vvh
追高	vvg
第二	die
朝外	icw
走了	zzl
杀猪	uav
双拼	ulp
双倍	ulb
快跑	kkp
鸟叫	nnj
站在	vjz
战平	vjp
鸟人	nnr
辣味	law
抛出	pci
得票	dep
偏高	pmg
还算	hds
还差	hdi
爬到	pad
怕黑	pah
末位	mow
摸出	moi
从今	csj
婚车	hyi
婚介	hyj
婚俗	hys
从早	csz
虐俘	ntf
润唇	ryi
咱就	zjj
暂存	zjc
增仓	zgc
卡位	kaw
能者	ngv
赛道	sdd
三等	sjd
敲开	qnk
韵频	yyp
牛尾	nqw
牛逼	nqb
牛股	nqg
空门	ksm
空空	ksk
窗外	ilw
戳到	iod
每人	mwr
扩音	koy
你该	nig
你我	niw
某种	mzv
掉在	dnz
本门	bfm
本在	bfz
绕开	rck
窜升	cru
别忘	bpw
算过	srg
行了	xkl
雄鹿	xsl
手里	uzl
算作	srz
棍法	gyf
还真	hdv
怪我	gkw
网盘	whp
宋体	sst
送至	ssv
送去	ssq
半仓	bjc
松开	ssk
抛入	pcr
跑了	pcl
周天	vzt
惩恶	ige
嫩肤	nff
嫩草	nfc
嫩滑	nfh
招财	vcc
找出	vci
找来	vcl
找人	vcr
抽干	izg
抽出	izi
臭屁	izp
龙虎	lsh
日暮	rim
睁开	vgk
走完	zzw
走着	zzv
猛地	mgd
走台	zzt
走出	zzi
剖开	pzk
软垫	rrd
软硬	rry
铁板	tpb
踏着	tav
他会	tah
拴在	urz
爬过	pag
哪年	nwn
刚走	ghz
醉态	zvt
晚了	wjl
他为	taw
最早	zvz
丢给	dqg
去死	qus
丢开	dqk