一下	yi xx
一世	yi ui
一世龙门	yi ui ls mf
一个骨	yi ge gu
一举	yi ju
一了百当	yi le bd dh
一了百当	yi ln bd dh
一仆一碌	yi pu yi lu
一介	yi jp
一代	yi dd
一代文宗	yi dd wf zs
一以当十	yi yi dh ui
一传十	yi ir ui
一体	yi ti
一体同心	yi ti ts xb
一傅众咻	yi fu vs xq
一元化	yi yr hx
一再	yi zd
一刹那	yi ia na
一刻	yi ke
一刻千金	yi ke qm jb
一前一后	yi qm yi hz
一半	yi bj
一去不回	yi qu bu hv
一去不返	yi qu bu fj
一口价	yi kz jp
一口价	yi kz jx
一句话	yi ju hx
一只屐	yi vi ji
一向	yi xl
一味	yi ww
一唱一和	yi ih yi he
一啲	yi di
一块	yi kk
一塌胡涂	yi ta hu tu
一声令下	yi ug lk xx
一夫当关万夫莫开	yi fu dh gr wj fu mo kd
一头烟	yi tz yj
一孔之见	yi ks vi jm
一字不苟	yi zi bu gz
一字之师	yi zi vi ui
一家子	yi jx zi
一寸丹心	yi cy dj xb
一对	yi dv
一小撮	yi xn co
一展风采	yi vj fg cd
一己之私	yi ji vi si
一带	yi dd
一年到头	yi nm dc tz
一式两份	yi ui ll ff
一律	yi lv
一德一心	yi de yi xb
一心	yi xb
一心一德	yi xb yi de
一忍再忍	yi rf zd rf
一息尚存	yi xi uh cy
一手	yi uz
一把手	yi ba uz
一报还一报	yi bc hd yi bc
一报还一报	yi bc hr yi bc
一担担	yi dj dj
一拍两散	yi pd ll sj
一撇嘢	yi pp ye
一整套	yi vg tc
一无所成	yi mo so ig
一无所成	yi wu so ig
一日到黑	yi ri dc hw
一早	yi zc
一时	yi ui
一时时	yi ui ui
一时间	yi ui jm
一暴十寒	yi pu ui hj
一条心	yi tn xb
一来	yi ld
一枝公	yi vi gs
一气	yi qi
一水之隔	yi uv vi ge
一波又起	yi bo yz qi
一波未平	yi bo ww pk
一派	yi pd
一流	yi lq
一炮而红	yi bc er hs
一炮而红	yi pc er hs
一瓣心香	yi bj xb xl
一生	yi ug
一番话	yi fj hx
一瘸一拐	yi qt yi gk
一盅两件	yi vs ll jm
一盘水	yi pj uv
一直	yi vi
一相情愿	yi xl qk yr
一瞬间	yi uy jm
一碧万顷	yi bi wj qk
一碧千里	yi bi qm li
一端	yi dr
一级	yi ji
一脉相承	yi md xl ig
一脚踢	yi jn ti
一般性	yi bj xk
一表人才	yi bn rf cd
一览表	yi lj bn
一角	yi jn
一言一行	yi yj yi xk
一言堂	yi yj th
一语成谶	yi yu ig if
一身正气	yi uf vg qi
一身蚁	yi uf yi
一轮红日	yi ly hs ri
一边	yi bm
一连	yi lm
一连串	yi lm ir
一针一线	yi vf yi xm
一镬熟	yi ho uu
一镬熟	yi ho uz
一面	yi mm
一面之缘	yi mm vi yr
一颈血	yi gg xp
一颈血	yi gg xt
一颈血	yi jk xp
一颈血	yi jk xt
一馈十起	yi kv ui qi
一麟半爪	yi lb bj vc
一麟半爪	yi lb bj vx
一齐	yi qi
丁丑	dk iz
丁亥	dk hd
丁卯	dk mc
丁巳	dk si
丁未	dk ww
丁酉	dk yz
丁香	dk xl
七一	qi yi
七七八八	qi qi ba ba
七国咁乱	qi go gj lr
七大	qi da
七大	qi dd
七巧板	qi qn bj
七年	qi nm
七情上面	qi qk uh mm
七成	qi ig
七横八竖	qi hg ba uu
七步成诗	qi bu ig ui
七绝	qi jt
万万	wj wj
万事	wj ui
万事通	wj ui ts
万嘱咐	wj vu fu
万夫不当	wj fu bu dh
万宝路	wj bc lu
万家生佛	wj jx ug fo
万家生佛	wj jx ug fu
万年	wj nm
万年青	wj nm qk
万念俱焚	wj nm ju ff
万木葱茏	wj mu cs ls
万死一生	wj si yi ug
万水千山	wj uv qm uj
万物	wj wu
万物初醒	wj wu iu xk
万物皆备于我	wj wu jp bw yu wo
万种	wj is
万种	wj vs
万籁	wj ld
万里无云	wj li wu yy
丈夫	vh fu
三伏	sj fu
三叉	sj ia
三叉苏	sj ia su
三唔识七	sj wu ui qi
三唔识七	sj wu vi qi
三天打鱼两天晒网	sj tm da yu ll tm ud wh
三尖八角	sj jm ba jn
三尖八角	sj jm ba jt
三幅被	sj fu bw
三幅被	sj fu pi
三废	sj fw
三座大山	sj zo da uj
三弦	sj xm
三扒两拨	sj ba ll bo
三扒两拨	sj pa ll bo
三文治	sj wf vi
三文鱼	sj wf yu
三昧	sj mw
三民主义	sj mb vu yi
三洋	sj yh
三粒星	sj li xk
三索	sj so
三维	sj ww
三角洲	sj jn vz
上下班	uh xx bj
上下级	uh xx ji
上不得台盘	uh bu de td pj
上不得台盘	uh bu dw td pj
上乘	uh ig
上书	uh uu
上任	uh rf
上冻	uh ds
上告	uh gc
上品	uh pb
上善若水	uh uj ro uv
上场	uh ih
上契	uh qi
上契	uh xp
上好	uh hc
上家	uh jx
上尉	uh ww
上届	uh jp
上山下乡	uh uj xx xl
上峰	uh fg
上工	uh gs
上昼	uh vz
上架	uh jx
上梁不正	uh ll bu vg
上水	uh uv
上溯	uh su
上漏下湿	uh lz xx ui
上相	uh xl
上窜下跳	uh cr xx tn
上缴	uh jn
上肢	uh vi
上议院	uh yi yr
上访	uh fh
上蹿下跳	uh cr xx tn
上载	uh zd
上道	uh dc
上限	uh xm
上风	uh fg
下乡	xx xl
下人	xx rf
下任	xx rf
下低	xx di
下功夫	xx gs fu
下地	xx di
下工	xx gs
下扒	xx ba
下扒	xx pa
下扒轻轻	xx ba qk qk
下扒轻轻	xx pa qk qk
下摆	xx bd
下放	xx fh
下水道	xx uv dc
下滑	xx hx
下爬	xx pa
下级	xx ji
下脚料	xx jn ln
下蛋	xx dj
下议院	xx yi yr
下野	xx ye
下限	xx xm
下陷	xx xm
下马威	xx ma ww
不丹	bu dj
不为所动	bu ww so ds
不乏	bu fa
不仅仅	bu jb jb
不以为奇	bu yi ww ji
不以为奇	bu yi ww qi
不住	bu vu
不依	bu yi
不便	bu bm
不值一文	bu vi yi wf
不再	bu zd
不分皂白	bu ff zc bd
不列颠	bu lp dm
不利	bu li
不力	bu li
不单	bu dj
不只	bu vi
不可一世	bu ke yi ui
不可抗力	bu ke kh li
不可收拾	bu ke uz ui
不可磨灭	bu ke mo mp
不可胜数	bu ke ug uu
不可计数	bu ke ji uu
不可逾越	bu ke yu yt
不合	bu he
不同流俗	bu ts lq su
不名一钱	bu mk yi qm
不周	bu vz
不善	bu uj
不定	bu dk
不对	bu dv
不已	bu yi
不幸	bu xk
不得善终	bu de uj vs
不得善终	bu dw uj vs
不得要领	bu de yc lk
不忘沟壑	bu wh gz he
不忠	bu vs
不急之务	bu ji vi wu
不怨	bu yr
不恭	bu gs
不息	bu xi
不恶而严	bu ee er yj
不恶而严	bu wu er yj
不愧为	bu kv ww
不愧屋漏	bu kv wu lz
不成方圆	bu ig fh yr
不扶自直	bu fu zi vi
不拘	bu ju
不教而杀	bu jn er ua
不敢旁鹜	bu gj ph wu
不无遗憾	bu mo yi hj
不无遗憾	bu wu yi hj
不时	bu ui
不易	bu yi
不易一字	bu yi yi zi
不服	bu fu
不期而然	bu qi er rj
不次之迁	bu ci vi qm
不止	bu vi
不死不活	bu si bu ho
不比	bu bi
不求有功	bu qq yz gs
不法	bu fa
不溜	bu lq
不独	bu du
不甘	bu gj
不甘后人	bu gj hz rf
不甘雌伏	bu gj ci fu
不甚了了	bu uf le le
不甚了了	bu uf ln ln
不由得	bu yz de
不畏	bu ww
不畏强暴	bu ww ql bc
不疾不徐	bu ji bu xu
不看	bu kj
不眠	bu mm
不着	bu vc
不着	bu ve
不着	bu vo
不瞒	bu mj
不矜不伐	bu gr bu fa
不矜不伐	bu jb bu fa
不矜不伐	bu qb bu fa
不知其可	bu vi qi ke
不知去向	bu vi qu xl
不知肉味	bu vi rz ww
不确定性	bu qt dk xk
不禁	bu jb
不移	bu yi
不稳	bu wf
不端	bu dr
不等式	bu dg ui
不纯	bu iy
不结盟	bu jp mg
不胜枚举	bu ug mw ju
不能不	bu ng bu
不致	bu vi
不致于	bu vi yu
不苟言笑	bu gz yj xn
不虞之誉	bu yu vi yu
不见	bu jm
不见泰山	bu jm td uj
不解之缘	bu jp vi yr
不言而信	bu yj er xb
不言自明	bu yj zi mk
不语	bu yu
不误	bu wu
不谋而同	bu mz er ts
不谋而和	bu mz er he
不谋而和	bu mz er ho
不谋而和	bu mz er hu
不贞	bu vf
不负	bu fu
不足为怪	bu zu ww gk
不轨	bu gv
不辞辛劳	bu ci xb lc
不辞辛苦	bu ci xb ku
不辱使命	bu ru ui mk
不远千里	bu yr qm li
不适	bu ui
不通	bu ts
不道德	bu dc de
不避斧钺	bu bi fu yt
不锈钢	bu xq gh
不长	bu ih
不长	bu vh
不间断	bu jm dr
不闻	bu wf
不需	bu xu
不露	bu lu
不露	bu lz
不靠	bu kc
不须	bu xu
不预则废	bu yu ze fw
不食之地	bu si vi de
不食之地	bu si vi di
不食之地	bu ui vi de
不食之地	bu ui vi di
不食之地	bu yi vi de
不食之地	bu yi vi di
不食周粟	bu si vz su
不食周粟	bu ui vz su
不食周粟	bu yi vz su
不饮盗泉	bu yb dc qr
不齿	bu ii
与之	yu vi
与人	yu rf
与他	yu ta
与会	yu hv
与你	yu ni
与其	yu qi
与其说	yu qi uo
与其说	yu qi uv
与其说	yu qi yt
与年俱增	yu nm ju zg
与此	yu ci
与此同时	yu ci ts ui
丑事	iz ui
丑剧	iz ju
丑化	iz hx
丑样	iz yh
专一	vr yi
专业化	vr ye hx
专业课	vr ye ke
专为	vr ww
专书	vr uu
专利局	vr li ju
专利权	vr li qr
专制	vr vi
专区	vr qu
专号	vr hc
专场	vr ih
专攻	vr gs
专机	vr ji
专款	vr kr
专治	vr vi
专电	vr dm
专稿	vr gc
专署	vr uu
专著	vr vu
专门利人	vr mf li rf
专集	vr ji
且听	qp tk
世上无难事只怕有心人	ui uh mo nj ui vi pa yz xb rf
世上无难事只怕有心人	ui uh wu nj ui vi pa yz xb rf
世世代代	ui ui dd dd
世事	ui ui
世人	ui rf
世代	ui dd
世代相传	ui dd xl ir
世俗	ui su
世务	ui wu
世博	ui bo
世卫	ui ww
世嘉	ui jx
世家	ui jx
世尊	ui zy
世态	ui td
世情	ui qk
世故	ui gu
世族	ui zu
世界仔	ui jp zd
世界仔	ui jp zi
世界性	ui jp xk
世界杯	ui jp bw
世界语	ui jp yu
世相	ui xl
世纪	ui ji
世纪初	ui ji iu
世行	ui hh
世行	ui xk
世袭	ui xi
世说新语	ui uo xb yu
世说新语	ui uv xb yu
世说新语	ui yt xb yu
世贸	ui mc
世间	ui jm
世面	ui mm
丙午	bk wu
丙子	bk zi
丙寅	bk yb
丙戌	bk xu
丙申	bk uf
丙级	bk ji
丙纶	bk ly
丙辰	bk if
丙醇	bk iy
业大	ye da
业经	ye jk
业障	ye vh
丛书	cs uu
丛刊	cs kj
东东	ds ds
东临	ds lb
东乡	ds xl
东京	ds jk
东北风	ds bw fg
东吴	ds wu
东头	ds tz
东夷	ds yi
东宫	ds gs
东扶西倒	ds fu xi dc
东方欲晓	ds fh yu xn
东洋	ds yh
东经	ds jk
东芝	ds vi
东逃西散	ds tc xi sj
东道	ds dc
东道国	ds dc go
东面	ds mm
东鳞西爪	ds lb xi vc
丝线	si xm
丝织	si vi
丝织品	si vi pb
丞相	ig xl
丢卒保车	dq zu bc ju
丢生	dq ug
丢面子	dq mm zi
两便	ll bm
两头唔到岸	ll tz wu dc an
两性	ll xk
两抠	ll kz
两极	ll ji
两栖	ll qi
两睇	ll di
两重性	ll is xk
两面性	ll mm xk
两鬓	ll bb
严严实实	yj yj ui ui
严于	yj yu
严于律己	yj yu lv ji
严以律己宽以待人	yj yi lv ji kr yi dd rf
严刑	yj xk
严历	yj li
严守	yj uz
严实	yj ui
严寒	yj hj
严惩不贷	yj ig bu dd
严整	yj vg
严正	yj vg
严气正性	yj qi vg xk
严词	yj ci
严辞	yj ci
丧事	sh ui
丧家之狗	sh jx vi gz
丧葬费	sh zh fw
个个	ge ge
个人	ge rf
个人主义	ge rf vu yi
个人所得税	ge rf so de uv
个人所得税	ge rf so dw uv
个体户	ge ti hu
个唱	ge ih
个喎	ge wd
个噃	ge bo
个子	ge zi
中下游	vs xx yz
中世纪	vs ui ji
中伤	vs uh
中低档	vs di dh
中信	vs xb
中兴	vs xk
中农	vs ns
中医师	vs yi ui
中医院	vs yi yr
中华民国	vs hx mb go
中南	vs nj
中卫	vs ww
中原逐鹿	vs yr vu lu
中和	vs he
中国海	vs go hd
中国画	vs go hx
中国话	vs go hx
中坚	vs jm
中型	vs xk
中子	vs zi
中宣部	vs xr bu
中将	vs jl
中小	vs xn
中小企	vs xn qi
中小型	vs xn xk
中小学校	vs xn xt xn
中小学生	vs xn xt ug
中山装	vs uj vl
中师	vs ui
中年人	vs nm rf
中庸	vs ys
中式	vs ui
中成药	vs ig yc
中指	vs vi
中日	vs ri
中暑	vs uu
中标	vs bn
中止	vs vi
中法	vs fa
中流击楫	vs lq ji ji
中用	vs ys
中的	vs de
中看	vs kj
中程	vs ig
中空	vs ks
中立	vs li
中立国	vs li go
中策	vs ce
中篇	vs pm
中纪委	vs ji ww
中继	vs ji
中继线	vs ji xm
中苏	vs su
中草药	vs cc yc
中药	vs yc
中药材	vs yc cd
中行	vs hh
中行	vs xk
中装	vs vl
中褛	vs lv
中转	vs vr
中选	vs xr
中速	vs su
中间商	vs jm uh
中间派	vs jm pd
中队长	vs dv vh
中青年	vs qk nm
中风	vs fg
中饭	vs fj
中饱私囊	vs bc si nh
中高级	vs gc ji
丰产	fg ij
丰台	fg td
丰姿	fg zi
丰年	fg nm
丰沛	fg pw
丰裕	fg yu
丰采	fg cd
串连	ir lm
串通	ir ts
临事而惧	lb ui er ju
临场	lb ih
临安	lb an
临幸	lb xk
临时工	lb ui gs
临江	lb jl
临沂	lb yi
临深履薄	lb uf lv bc
临界点	lb jp dm
临老学吹打	lb lc xt iv da
临街	lb jp
临难不惧	lb nj bu ju
丹书	dj uu
丹尼尔	dj ni er
丹心	dj xb
丹红	dj hs
丹药	dj yc
为之	ww vi
为伍	ww wu
为例	ww li
为公	ww gs
为名	ww mk
为咗	ww zo
为数	ww uu
为数不多	ww uu bu do
为数众多	ww uu vs do
为时	ww ui
为期	ww qi
为止	ww vi
为民请命	ww mb qk mk
为生	ww ug
为由	ww yz
为皮	ww pi
为辅	ww fu
主义	vu yi
主人	vu rf
主人公	vu rf gs
主人家	vu rf jx
主人翁	vu rf wg
主刑	vu xk
主力	vu li
主力军	vu li jy
主动性	vu ds xk
主动权	vu ds qr
主动脉	vu ds md
主外	vu wd
主妇	vu fu
主官	vu gr
主客观	vu ke gr
主宰	vu zd
主将	vu jl
主峰	vu fg
主席团	vu xi tr
主心骨	vu xb gu
主意	vu yi
主战场	vu vj ih
主持人	vu ii rf
主攻手	vu gs uz
主教	vu jn
主教练	vu jn lm
主旨	vu vi
主权国	vu qr go
主板	vu bj
主治	vu vi
主犯	vu fj
主航道	vu hh dc
主见	vu jm
主观主义	vu gr vu yi
主讲	vu jl
主课	vu ke
主轴	vu vz
主队	vu dv
主题歌	vu ti ge
主题词	vu ti ci
主食	vu ui
丽日临空	li ri lb ks
丽水	li uv
举不胜举	ju bu ug ju
举世	ju ui
举人	ju rf
举例	ju li
举报人	ju bc rf
举杯	ju bw
举步维艰	ju bu ww jm
举袖为云	ju xq ww yy
举重	ju vs
乃是	nd ui
久久	jq jq
久别重逢	jq bp is fg
久安	jq an
久居	jq ju
久已	jq yi
久悬不决	jq xr bu jt
久拖不决	jq to bu jt
久经	jq jk
久经沙场	jq jk ua ih
久远	jq yr
义举	yi ju
义乌	yi wu
义务兵	yi wu bk
义务教育	yi wu jn yu
义勇军	yi ys jy
义卖	yi md
义和团	yi he tr
义士	yi ui
义愤	yi ff
义无返顾	yi mo fj gu
义无返顾	yi wu fj gu
义正词严	yi vg ci yj
义气	yi qi
义演	yi yj
义理	yi li
之上	vi uh
之下	vi xx
之不过	vi bu go
之久	vi jq
之争	vi vg
之余	vi yu
之势	vi ui
之嘛	vi ma
之声	vi ug
之处	vi iu
之嫌	vi xm
之家	vi jx
之情	vi qk
之时	vi ui
之星	vi xk
之最	vi zv
之死靡它	vi si mi ta
之称	vi if
之称	vi ig
之窗	vi il
之行	vi hh
之行	vi xk
之际	vi ji
乌云翻滚	wu yy fj gy
乌兹别克斯坦	wu ci bp ke si tj
乌兹别克斯坦	wu zi bp ke si tj
乌卒卒	wu cu cu
乌卒卒	wu cu zu
乌卒卒	wu zu cu
乌卒卒	wu zu zu
乌发	wu fa
乌喱单刀	wu li dj dc
乌喱单刀	wu li ij dc
乌喱单刀	wu li uj dc
乌江	wu jl
乌眉瞌睡	wu mw ke uv
乌纱帽	wu ua mc
乏力	fa li
乐呵呵	le he he
乐声	yt ug
乐府	yt fu
乐滋滋	le zi zi
乐舞	yt wu
乐融融	le rs rs
乐音	yt yb
乒乓波	pk ph bo
乒乓球	pk ph qq
乒坛	pk tj
乒铃唪唥	pk lk fg lh
乔丹	qn dj
乔治	qn vi
乖舛	gk ir
乖迕	gk wu
乘兴	ig xk
乘务员	ig wu yr
乘势	ig ui
乘员	ig yr
乘数	ig uu
乘机	ig ji
乘法	ig fa
乘积	ig ji
乘长风破万里浪	ig ih fg po wj li lh
乘长风破万里浪	ig vh fg po wj li lh
乘长风破万里浪	ug ih fg po wj li lh
乘长风破万里浪	ug vh fg po wj li lh
乘除	ig iu
乘隙	ig xi
乘风破浪	ig fg po lh
乙丑	yi iz
乙亥	yi hd
乙卯	yi mc
乙型	yi xk
乙巳	yi si
乙未	yi ww
乙烯	yi xi
乙等	yi dg
乙类	yi lw
乙级	yi ji
乙酉	yi yz
乙醇	yi iy
乜嘢话	mp ye hx
乜嘢话	np ye hx
乜滞	mp vi
乜滞	np vi
乜都假	mp du jx
乜都假	mp dz jx
乜都假	np du jx
乜都假	np dz jx
九九金	jq jq jb
九儒十丐	jq ru ui gd
九唔搭八	jq wu da ba
九大簋	jq da gv
九大簋	jq dd gv
九尾狐	jq ww hu
九泉	jq qr
九泉之下	jq qr vi xx
九洲	jq vz
九牛二虎	jq nq er hu
乞人憎	qi rf zg
乞儿	qi er
乞嗤	qi ii
乞求	qi qq
乞浆得酒	qi jl de jq
乞浆得酒	qi jl dw jq
习习	xi xi
习气	xi qi
乡下	xl xx
乡下人	xl xx rf
乡亲	xl qb
乡勇	xl ys
乡巴佬	xl ba lc
乡思	xl si
乡级	xl ji
乡邻	xl lb
乡里	xl li
书名	uu mk
书后	uu hz
书展	uu vj
书市	uu ui
书报	uu bc
书摘	uu vd
书架	uu jx
书橱	uu iu
书法家	uu fa jx
书法展	uu fa vj
书目	uu mu
书箱	uu xl
书记	uu ji
书院	uu yr
书香	uu xl
买位	md ww
买壳	md ke
买壳	md qn
买帐	md vh
买方	md fh
买春	md iy
乱丢	lr dq
乱哄哄	lr hs hs
乱嗡	lr wg
乱象	lr xl
乱龙	lr ls
乳业	ru ye
乳晕	ru yy
乳白色	ru bd se
乳类	ru lw
乳虎	ru hu
乸型	na xk
乾州	qm vz
了不得	ln bu de
了望	le wh
了望	ln wh
了结	ln jp
争办	vg bj
争当	vg dh
争执	vg vi
争斤论两	vg jb ly ll
争权	vg qr
争气	vg qi
争相	vg xl
争胜	vg ug
争衡	vg hg
争论不休	vg ly bu xq
争鸣	vg mk
事不师古	ui bu ui gu
事业心	ui ye xb
事主	ui vu
事事	ui ui
事例	ui li
事先	ui xm
事典	ui dm
事务	ui wu
事后	ui hz
事头	ui tz
事头婆	ui tz po
事宜	ui yi
事实上	ui ui uh
事急马行田	ui ji ma hh tm
事急马行田	ui ji ma xk tm
事无不可对人言	ui mo bu ke dv rf yj
事无不可对人言	ui wu bu ke dv rf yj
事物	ui wu
事理	ui li
事由	ui yz
事端	ui dr
事过境迁	ui go jk qm
事迹	ui ji
事隔	ui ge
二人同心其利断金	er rf ts xb qi li dr jb
二打六	er da lq
二打六	er da lu
二桃杀三士	er tc ua sj ui
二泉映月	er qr yk yt
二门	er mf
于今	yu jb
于归	yu gv
于心何忍	yu xb he rf
于是乎	yu ui hu
于此	yu ci
亏得	kv de
云中白鹤	yy vs bd he
云南省	yy nj ug
云团	yy tr
云母	yy mu
云浮	yy fu
云消雨散	yy xn yu sj
云端	yy dr
云行雨施	yy hh yu ui
云行雨施	yy xk yu ui
云集	yy ji
云雨	yy yu
云龙	yy ls
互保	hu bc
互利	hu li
互助组	hu vu zu
互帮互学	hu bh hu xt
互换	hu hr
互联网	hu lm wh
五一	wu yi
五保户	wu bc hu
五台山	wu td uj
五味	wu ww
五四	wu si
五官	wu gr
五岳	wu yt
五指	wu vi
五星	wu xk
五笔	wu bi
五笔加加	wu bi jx jx
五行	wu xk
五角大楼	wu jn da lz
五角星	wu jn xk
五讲四美	wu jl si mw
五谷	wu gu
五金	wu jb
五雷轰顶	wu lw hs dk
五黄六月	wu hl lq yt
井架	jk jx
亚东	ya ds
亚热带	ya re dd
亚特兰大	ya te lj da
亚特兰大	ya te lj dd
亚视	ya ui
亚运	ya yy
亚运会	ya yy hv
亚运村	ya yy cy
亚里士多德	ya li ui do de
亚马逊	ya ma xy
亚齐	ya qi
亡命	wh mk
亡国	wh go
亡戟得矛	wh ji de mc
亡戟得矛	wh ji dw mc
交口	jn kz
交口称赞	jn kz ig zj
交响乐	jn xl yt
交响曲	jn xl qu
交响诗	jn xl ui
交好	jn hc
交工	jn gs
交底	jn di
交待	jn dd
交心	jn xb
交情	jn qk
交手	jn uz
交换机	jn hr ji
交接班	jn jp bj
交易会	jn yi hv
交更	jn gg
交流会	jn lq hv
交火	jn ho
交点	jn dm
交班	jn bj
交电	jn dm
交税	jn uv
交纳	jn na
交谊舞	jn yi wu
交费	jn fw
交还	jn hr
交通线	jn ts xm
交通网	jn ts wh
交通费	jn ts fw
交道	jn dc
交际	jn ji
亦可	yi ke
亦然	yi rj
亦算	yi sr
产业界	ij ye jp
产妇	ij fu
亨利	hg li
享年	xl nm
享有盛誉	xl yz ug yu
享誉	xl yu
京东	jk ds
京九	jk jq
京华	jk hx
京哈	jk ha
京师	jk ui
京广	jk gl
京戏	jk xi
京沪	jk hu
京胡	jk hu
京郊	jk jn
亮出	ll iu
亮晶晶	ll jk jk
亮红灯	ll hs dg
亲事	qb ui
亲传	qb ir
亲传	qb vr
亲传	qk ir
亲传	qk vr
亲兄弟	qb xs di
亲切感	qb qp gj
亲如	qb ru
亲如	qk ru
亲如兄弟	qb ru xs di
亲密无间	qb mi wu jm
亲手	qb uz
亲朋戚友	qb pg qi yz
亲朋戚友	qk pg qi yz
亲民	qb mb
亲民	qk mb
亲痛仇快	qb ts iz kk
亲笔信	qb bi xb
亲缘	qb yr
亲美	qb mw
亲美	qk mw
亳州	bo vz
亵玩	xp wj
人不知	rf bu vi
人世	rf ui
人世间	rf ui jm
人为	rf ww
人事	rf ui
人事处	rf ui iu
人事局	rf ui ju
人事部	rf ui bu
人代会	rf dd hv
人伦	rf ly
人力车	rf li ie
人名	rf mk
人命	rf mk
人哋	rf di
人士	rf ui
人声	rf ug
人声喧哗	rf ug xr hx
人声嘈杂	rf ug cc za
人外有人	rf wd yz rf
人多手杂	rf do uz za
人头涌涌	rf tz ys ys
人如潮涌	rf ru ic ys
人尽可夫	rf jb ke fu
人工湖	rf gs hu
人强马壮	rf jl ma vl
人强马壮	rf ql ma vl
人微权轻	rf ww qr qk
人心	rf xb
人心浮动	rf xb fu ds
人心涣散	rf xb hr sj
人心齐	rf xb qi
人手	rf uz
人手一册	rf uz yi ce
人数	rf uu
人有我有	rf yz wo yz
人机	rf ji
人梯	rf ti
人次	rf ci
人武部	rf wu bu
人氏	rf ui
人治	rf vi
人物	rf wu
人物画	rf wu hx
人生观	rf ug gr
人祸	rf ho
人缘	rf yr
人证	rf vg
人质	rf vi
人贩	rf fj
人身	rf uf
人造卫星	rf zc ww xk
人逢喜事精神爽	rf fg xi ui jk uf ul
亿万	yi wj
亿元	yi yr
什么样	uf me yh
什锦	ui jb
仁义	rf yi
仁人志士	rf rf vi ui
仁川	rf ir
仁心仁闻	rf xb rf wf
仁科	rf ke
仁言利博	rf yj li bo
仅供	jb gs
仇口	iz kz
仇口	qq kz
今人	jb rf
今冬	jb ds
今春	jb iy
今译	jb yi
介子	jp zi
介绍人	jp uc rf
介绍信	jp uc xb
介词	jp ci
介质	jp vi
介面	jp mm
仍有	rg yz
从从容容	cs cs rs rs
从化市	cs hx ui
从后	cs hz
从命	cs mk
从善如登	cs uj ru dg
从头至尾	cs tz vi ww
从师	cs ui
从恶如崩	cs ee ru bg
从恶如崩	cs wu ru bg
从新	cs xb
从未有过	cs ww yz go
从艺	cs yi
仓猝	ch cu
仓鼠	ch uu
仔乸	zd na
仔乸	zi na
仔仔细细	zi zi xi xi
仔大仔世界	zd da zd ui jp
仔大仔世界	zd da zi ui jp
仔大仔世界	zd dd zd ui jp
仔大仔世界	zd dd zi ui jp
仔大仔世界	zi da zd ui jp
仔大仔世界	zi da zi ui jp
仔大仔世界	zi dd zd ui jp
仔大仔世界	zi dd zi ui jp
仔猪	zi vu
仔细老婆嫩	zd xi lc po nf
仔细老婆嫩	zi xi lc po nf
仕女	ui nv
他乡	ta xl
他们	ta mf
付之东流	fu vi ds lq
付印	fu yb
付帐	fu vh
付账	fu vh
付费	fu fw
仙人	xm rf
仙人掌	xm rf vh
仙境	xm jk
仙姿玉貌	xm zi yu mc
仙童	xm ts
仙逝	xm ui
仙都唔仙下	xm du wu xm xx
仙都唔仙下	xm dz wu xm xx
仙鹤	xm he
仟眠	qm mm
代之	dd vi
代名词	dd mk ci
代培	dd pw
代序	dd xu
代数	dd uu
代理人	dd li rf
代用品	dd ys pb
代职	dd vi
代表团	dd bn tr
代表性	dd bn xk
代购	dd gz
令人注目	lk rf vu mu
以一当十	yi yi dh ui
以东	yi ds
以儆效尤	yi jk xn yz
以北	yi bw
以南	yi nj
以外	yi wd
以太	yi td
以太网	yi td wh
以少胜多	yi uc ug do
以往	yi wh
以德报德	yi de bc de
以文会友	yi wf hv yz
以文会友	yi wf kk yz
以期	yi qi
以来	yi ld
以此	yi ci
以沫相濡	yi mo xl ru
以泪洗面	yi lw xi mm
以疏间亲	yi uu jm qb
以疏间亲	yi uu jm qk
以直报怨	yi vi bc yr
以简驭繁	yi jm yu fj
以绝后患	yi jt hz hr
以至	yi vi
以至于	yi vi yu
以致	yi vi
以蠡测海	yi li ce hd
以西	yi xi
仪仗	yi vh
仪仗队	yi vh dv
仪器	yi qi
仪式	yi ui
仰不愧天	yh bu kv tm
仰屋着书	yh wu vc uu
仰屋着书	yh wu ve uu
仰屋着书	yh wu vo uu
仲夏	vs xx
仲尼	vs ni
仲涛	vs tc
仳离	pi li
仵工	wu gs
价值观	jx vi gr
价码	jx ma
任君	rf jy
任期	rf qi
份内	ff nw
份量	ff ll
仿佯	fh yh
仿制	fh vi
仿制品	fh vi pb
仿古	fh gu
仿生	fh ug
仿真	fh vf
仿真度	fh vf do
仿真度	fh vf du
企业主	qi ye vu
企业化	qi ye hx
企业家	qi ye jx
企业界	qi ye jp
企事业	qi ui ye
企人边	qi rf bm
企堂	qi th
企望	qi wh
企求	qi qq
企盼	qi pj
伊利	yi li
伊利诺斯	yi li no si
伊始	yi ui
伊宁	yi nk
伊斯兰	yi si lj
伊斯兰教	yi si lj jn
伊甸	yi dm
伊甸园	yi dm yr
伊肯	yi kf
伏击战	fu ji vj
伏匿匿	fu ni ni
伏法	fu fa
伏法受诛	fu fa uz vu
伏特	fu te
伏罪	fu zv
伏羲	fu xi
伏魔	fu mo
伏龙凤雏	fu ls fg iu
休会	xq hv
休养	xq yh
休市	xq ui
休憩	xq qi
休整	xq vg
休斯敦	xq si dy
休止符	xq vi fu
众擎易举	vs qk yi ju
众议员	vs yi yr
众议院	vs yi yr
优于	yz yu
优先权	yz xm qr
优哉游哉	yz zd yz zd
优异	yz yi
优待	yz dd
优抚	yz fu
优派	yz pd
优游	yz yz
优生	yz ug
优生优育	yz ug yz yu
优育	yz yu
优胜	yz ug
优胜者	yz ug ve
优裕	yz yu
优越性	yz yt xk
优越感	yz yt gj
优选	yz xr
伙头	ho tz
伙食费	ho ui fw
会上	hv uh
会会	hv hv
会会	hv kk
会会	kk hv
会会	kk kk
会刊	hv kj
会务	hv wu
会友	hv yz
会合	hv he
会员国	hv yr go
会员证	hv yr vg
会址	hv vi
会客室	hv ke ui
会师	hv ui
会心	hv xb
会意	hv yi
会战	hv vj
会操	hv cc
会旗	hv qi
会期	hv qi
会标	hv bn
会演	hv yj
会理	hv li
会理	kk li
会社	hv ue
会社	kk ue
会聚	hv ju
会计师	kk ji ui
会议室	hv yi ui
会议桌	hv yi vo
会议桌	kk yi vo
会长	hv ih
会长	hv vh
会风	hv fg
伛偻	yu lv
伛偻	yu lz
伟人	ww rf
伟力	ww li
伟男	ww nj
伟绩	ww ji
传动	ir ds
传家宝	ir jx bc
传导	ir dc
传感器	ir gj qi
传染病	ir rj bk
传略	vr lt
传票	ir pn
传记	vr ji
传诵	ir ss
传达室	ir da ui
传送带	ir ss dd
传阅	ir yt
传颂	ir ss
伤亡	uh wh
伤兵	uh bk
伤势	uh ui
伤及	uh ji
伤害	uh hd
伤残人	uh cj rf
伤病员	uh bk yr
伤筋动骨	uh jb ds gu
伦巴	ly ba
伦理学	ly li xt
伪币	ww bi
伪证	ww vg
伫立	vu li
伯仲	bo vs
伯娘	bd nl
伯娘	bo nl
伯父	bo fu
伯爷	bd ye
伯爷	bo ye
伯爷公	bd ye gs
伯爷公	bo ye gs
估价	gu jx
伴月	bj yt
伶俐	lk li
伸曲	uf qu
伸长	uf ih
伺候	ci hz
伺机	si ji
似是	ui ui
似模似样	ui mo ui yh
似模似样	ui mu ui yh
似水流年	ui uv lq nm
似的	ui de
伽利略	jx li lt
伾伾	pi pi
但又	dj yz
位居	ww ju
位移	ww yi
低下	di xx
低产	di ij
低产田	di ij tm
低压	di ya
低回	di hv
低威	di ww
低年级	di nm ji
低微	di ww
低效	di xn
低波	di bo
低端	di dr
低胸	di xs
低腰	di yc
低谷	di gu
低贱	di jm
住地	vu di
住宅区	vu vd qu
住家工	vu jx gs
住家男人	vu jx nj rf
住手	vu uz
住持	vu ii
住院	vu yr
佐证	zo vg
体例	ti li
体协	ti xp
体型	ti xk
体委	ti ww
体式	ti ui
体形	ti xk
体彩	ti cd
体罚	ti fa
体育课	ti yu ke
体表	ti bn
体裁	ti cd
何妨	he fh
何尝	he ih
何许	he xu
佗佗拧	to to nk
佗衰家	to uk jx
余力	yu li
余年	yu nm
余粮	yu ll
余音	yu yb
余韵	yu yy
佛教徒	fo jn tu
佛罗里达	fo lo li da
佛都有火	fo du yz ho
佛都有火	fo dz yz ho
佛都有火	fu du yz ho
佛都有火	fu dz yz ho
作东	zo ds
作主	zo vu
作价	zo jx
作假	zo jx
作到	zo dc
作协	zo xp
作大	zo da
作大	zo dd
作成	zo ig
作曲家	zo qu jx
作法	zo fa
作用力	zo ys li
你一言	ni yi yj
你哋	ni di
佢哋	ko di
佢哋	qu di
佣兵	ys bk
佩剑	pw jm
佩带	pw dd
佳丽	jx li
佳人	jx rf
佳句	jx ju
佳品	jx pb
佳境	jx jk
佳期	jx qi
佳绩	jx ji
佳节	jx jp
佳话	jx hx
佼佼者	jn jn ve
使之	ui vi
使乜	ui mp
使乜	ui np
使乜讲	ui mp jl
使乜讲	ui np jl
使人	ui rf
使徒	ui tu
使用权	ui ys qr
使节	ui jp
侁侁	uf uf
侃侃	kj kj
例举	li ju
例会	li hv
例汤	li th
例程	li ig
例行	li xk
例行公事	li xk gs ui
例证	li vg
例题	li ti
侍候	ui hz
侍奉	ui fg
侏儒	vu ru
侘傺	ia ii
供书教学	gs uu jn xt
供品	gs pb
供应量	gs yk ll
供稿	gs gc
供给	gs ji
供认	gs rf
供销	gs xn
供销社	gs xn ue
供需	gs xu
依仗	yi vh
依依惜别	yi yi xi bp
依倚	yi yi
依存	yi cy
依山傍水	yi uj bh uv
依次	yi ci
依违	yi ww
依附	yi fu
侠客	xx ke
侦察兵	vf ia bk
侦察员	vf ia yr
侦察机	vf ia ji
侧侧膊	ce ce bo
侧侧膊	ce vd bo
侧侧膊	ce zd bo
侧侧膊	vd ce bo
侧侧膊	vd vd bo
侧侧膊	vd zd bo
侧侧膊	zd ce bo
侧侧膊	zd vd bo
侧侧膊	zd zd bo
侧重点	ce vs dm
侨乡	qn xl
侨兴	qn xk
侨务	qn wu
侨商	qn uh
侨属	qn uu
侨汇	qn hv
侨界	qn jp
侨眷	qn jr
侵略者	qb lt ve
侵蚀	qb ui
便娟	bm jr
便娟	pm jr
便携	bm xp
便携	pm xp
便携式	bm xp ui
便服	bm fu
便衣	bm yi
便道	bm dc
促织	cu vi
促进会	cu jb hv
俄亥俄	ee hd ee
俄勒冈	ee le gh
俄勒冈	ee lw gh
俄国	ee go
俄语	ee yu
俏媚	qn mw
俏货	qn ho
俗名	su mk
俗话说	su hx uo
俘获	fu ho
俚语	li yu
保住	bc vu
保值	bc vi
保守党	bc uz dh
保守派	bc uz pd
保密性	bc mi xk
保护伞	bc hu sj
保时捷	bc ui jp
保有	bc yz
保温瓶	bc wf pk
保皇派	bc hl pd
保监会	bc jm hv
保监会	bc jm kk
保票	bc pn
保管员	bc gr yr
保育员	bc yu yr
保育院	bc yu yr
保苗	bc mn
保荐	bc jm
保证书	bc vg uu
保送	bc ss
保释	bc ui
保量	bc ll
保镖	bc bn
保险柜	bc xm gv
保险箱	bc xm xl
保驾	bc jx
保鲜	bc xm
信义	xb yi
信件	xb jm
信任感	xb rf gj
信使	xb ui
信号弹	xb hc dj
信号灯	xb hc dg
信天游	xb tm yz
信奉	xb fg
信守	xb uz
信心百倍	xb xb bd bw
信念	xb nm
信息量	xb xi ll
信手	xb uz
信教	xb jn
信条	xb tn
信用卡	xb ys ka
信用社	xb ys ue
信笔	xb bi
信笺	xb jm
信誓	xb ui
信访	xb fh
信贷员	xb dd yr
信赏必罚	xb uh bi fa
信阳	xb yh
信马由缰	xb ma yz jl
俣俣	yu yu
俭可养廉	jm ke yh lm
俭朴	jm pu
修剪	xq jm
修定	xq dk
修整	xq vg
修旧利废	xq jq li fw
修正主义	xq vg vu yi
修水	xq uv
修理业	xq li ye
修理厂	xq li ih
修葺	xq qi
修身洁行	xq uf jp hh
修身洁行	xq uf jp xk
修道院	xq dc yr
俯仰	fu yh
俯仰之间	fu yh vi jm
俯拾即是	fu ui ji ui
俯拾皆市	fu ui jp ui
俯瞰	fu kj
俯视	fu ui
俯首听命	fu uz tk mk
俺们	an mf
俾倪	bi ni
倍受	bw uz
倍数	bw uu
倏地	uu di
倏忽	uu hu
倒伏	dc fu
倒汗水	dc hj uv
倒泻	dc xp
倒泻箩蟹	dc xp lo xp
倒班	dc bj
倒立	dc li
倒米	dc mi
倒置	dc vi
倔头巷	jt tz hh
倔头巷	jt tz xl
倔头路	jt tz lu
倔擂槌	jt lw iv
倔犟	jt jl
倘能	th ng
候机室	hz ji ui
候车室	hz ie ui
候选人	hz xr rf
候镬	hz ho
候驾	hz jx
倚仗	yi vh
倚势凌人	yi ui lk rf
倚天	yi tm
借一借	jp yi jp
借以	jp yi
借古喻今	jp gu yu jb
借咗聋耳陈只耳	jp zo ls er if vi er
借啲意	jp di yi
借据	jp ju
借支	jp vi
借故	jp gu
借机	jp ji
借歪	jp wd
借箸代筹	jp vu dd iz
借读	jp du
借调	jp dn
借贷	jp dd
借道	jp dc
倡议书	ih yi uu
倥偬	ks zs
债券	vd qr
债务人	vd wu rf
债权人	vd qr rf
值勤	vi qb
值日	vi ri
值此	vi ci
值班室	vi bj ui
值钱	vi qm
倾倒	qk dc
倾向性	qk xl xk
倾心	qk xb
倾心吐胆	qk xb tu dj
倾泄	qk xp
倾注	qk vu
倾泻	qk xp
倾耳注目	qk er vu mu
倾耳而听	qk er er tk
倾覆	qk fu
倾角	qk jn
偃蹇	yj jm
假作	jx zo
假使	jx ui
假借	jx jp
假假地	jx jx de
假假地	jx jx di
假大空	jx da ks
假如	jx ru
假想	jx xl
假戏	jx xi
假手于人	jx uz yu rf
假扮	jx bj
假牙	jx ya
假痴不癫	jx ii bu dm
假肢	jx vi
假药	jx yc
假证	jx vg
假象	jx xl
假账	jx vh
假货	jx ho
假途灭虢	jx tu mp go
假释	jx ui
偏听偏信	pm tk pm xb
偏好	pm hc
偏废	pm fw
偏瘫	pm tj
偓佺	wo qr
偓促	wo cu
做七	zo qi
做世界	zo ui jp
做为	zo ww
做乜	zo mp
做乜	zo np
做人世	zo rf ui
做低	zo di
做假	zo jx
做出	zo iu
做功	zo gs
做嘢	zo ye
做客	zo ke
做活	zo ho
做生不如做熟	zo ug bu ru zo uu
做生不如做熟	zo ug bu ru zo uz
做绝	zo jt
做账	zo vh
做鬼做马	zo gv zo ma
停办	tk bj
停息	tk xi
停机坪	tk ji pk
停歇	tk xp
停滞	tk vi
停职	tk vi
停航	tk hh
停课	tk ke
健身房	jm uf fh
偲偲	si si
偷人	tz rf
偷腥	tz xk
偷运	tz yy
偷鸡唔到蚀楂米	tz ji wu dc ui ia mi
偷鸡唔到蚀楂米	tz ji wu dc ui va mi
傥荡	th dh
储值票	iu vi pn
储户	iu hu
储蓄所	iu xu so
储藏室	iu ch ui
储藏量	iu ch ll
傲人	ao rf
傲游	ao yz
傲然矗立	ao rj iu li
傲睨万物	ao ni wj wu
傻下傻下	ua xx ua xx
傻事	ua ui
傻傻更更	ua ua gg gg
傻气	ua qi
像片	xl pm
像章	xl vh
僵化	jl hx
僵死	jl si
僻价	pi jp
僻价	pi jx
儒将	ru jl
儒教	ru jn
兀自	wu zi
元件	yr jm
元曲	yr qu
充气	is qi
充盈	is yk
充饥	is ji
先人	xm rf
先公后私	xm gs hz si
先哲	xm ve
先嗰排	xm ge pd
先声	xm ug
先天下之忧而忧后天下之乐而乐	xm tm xx vi yz er yz hz tm xx vi le er le
先天下之忧而忧后天下之乐而乐	xm tm xx vi yz er yz hz tm xx vi le er yt
先天下之忧而忧后天下之乐而乐	xm tm xx vi yz er yz hz tm xx vi yt er le
先天下之忧而忧后天下之乐而乐	xm tm xx vi yz er yz hz tm xx vi yt er yt
先导	xm dc
先手	xm uz
先是	xm ui
先期	xm qi
先河	xm he
先知	xm vi
先行	xm xk
先行者	xm xk ve
先贤	xm xm
先进性	xm jb xk
先遣	xm qm
先遣队	xm qm dv
先锋队	xm fg dv
先驱者	xm qu ve
光华	gl hx
光合作用	gl he zo ys
光大	gl da
光彩夺目	gl cd do mu
光明灿烂	gl mk cj lj
光暗掣	gl an ie
光栅	gl uj
光波	gl bo
光洁	gl jp
光热	gl re
光焰	gl yj
光电子	gl dm zi
光纤	gl xm
光绪	gl xu
光脱脱	gl to to
光荣榜	gl rs bh
光趟	gl th
光辉灿烂	gl hv cj lj
光风霁月	gl fg ji yt
克戟	ke ji
克扣	ke kz
克林顿	ke lb dy
克雷	ke lw
免职	mm vi
兑付	dv fu
兑换券	dv hr qr
党中央	dh vs yh
党产	dh ij
党代表	dh dd bn
党刊	dh kj
党务	dh wu
党史	dh ui
党团	dh tr
党团员	dh tr yr
党委会	dh ww hv
党小组	dh xn zu
党性	dh xk
党总支	dh zs vi
党报	dh bc
党支部	dh vi bu
党政军	dh vg jy
党旗	dh qi
党禁	dh jb
党籍	dh ji
党纪	dh ji
党纪国法	dh ji go fa
党组织	dh zu vi
党群	dh qy
党规	dh gv
党锢	dh gu
党阀	dh fa
党风	dh fg
党龄	dh lk
兜鍪	dz mz
入世	ru ui
入主	ru vu
入便	ru bm
入便	ru pm
入冬	ru ds
入团	ru tr
入土	ru tu
入场券	ru ih qr
入墙柜	ru ql gv
入墙柜	ru ql ju
入夏	ru xx
入夜	ru ye
入学	ru xt
入息	ru xi
入托	ru to
入时	ru ui
入狱	ru yu
入画	ru hx
入神	ru uf
入肉	ru rz
入魔	ru mo
全乡	qr xl
全书	qr uu
全优	qr yz
全党	qr dh
全力	qr li
全区	qr ou
全区	qr qu
全厂	qr ih
全国性	qr go xk
全境	qr jk
全天候	qr tm hz
全套	qr tc
全家福	qr jx fu
全州	qr vz
全市	qr ui
全托	qr to
全数	qr uu
全日制	qr ri vi
全歼	qr jm
全球性	qr qq xk
全盛	qr ug
全程	qr ig
全线	qr xm
全路	qr lu
全身心	qr uf xb
全运会	qr yy hv
全长	qr ih
全集	qr ji
全靠	qr kc
八卦掌	ba gx vh
八方支援	ba fh vi yr
八旗	ba qi
八路军	ba lu jy
公事	gs ui
公仔书	gs zd uu
公仔书	gs zi uu
公使	gs ui
公信	gs xb
公元	gs yr
公公	gs gs
公公婆婆	gs gs po po
公共场所	gs gs ih so
公决	gs jt
公判	gs pj
公历	gs li
公器	gs qi
公国	gs go
公婆	gs po
公子	gs zi
公审	gs uf
公开信	gs kd xb
公开赛	gs kd sd
公式化	gs ui hx
公心	gs xb
公愤	gs ff
公房	gs fh
公才公望	gs cd gs wh
公报	gs bc
公敌	gs di
公有	gs yz
公有制	gs yz vi
公检法	gs jm fa
公民权	gs mb qr
公海	gs hd
公物	gs wu
公理	gs li
公益金	gs yi jb
公示	gs ui
公私	gs si
公积金	gs ji jb
公粮	gs ll
公认	gs rf
公证	gs vg
公诉人	gs su rf
公路桥	gs lu qn
公馆	gs gr
公鸡	gs ji
六书	lq uu
六亲无靠	lq qb wu kc
六月飞霜	lq yt fw ul
六月飞霜	lu yt fw ul
六畜	lq iu
兰州市	lj vz ui
共事	gs ui
共产党人	gs ij dh rf
共同体	gs ts ti
共和	gs he
共和党	gs he dh
共度	gs du
共推	gs tv
共渡	gs du
共生	gs ug
共用	gs ys
共管	gs gr
共聚	gs ju
共舞	gs wu
共计	gs ji
共识	gs ui
共谋	gs mz
共赏	gs uh
共进	gs jb
共需	gs xu
共青团	gs qk tr
共青团员	gs qk tr yr
关怀备注	gr hk bw vu
关怀备至	gr hk bw vi
关汉卿	gr hj qk
关税	gr uv
关系户	gr xi hu
关系网	gr xi wh
关节炎	gr jp yj
关键性	gr jm xk
兴云致雨	xk yy vi yu
兴亡	xk wh
兴修	xk xq
兴冲冲	xk is is
兴利除害	xk li iu hd
兴味盎然	xk ww ag rj
兴学	xk xt
兴许	xk xu
兴起	xk qi
兴高彩烈	xk gc cd lp
兵乱	bk lr
兵力	bk li
兵变	bk bm
兵员	bk yr
兵家	bk jx
兵工厂	bk gs ih
兵役	bk yi
兵役法	bk yi fa
兵微将寡	bk ww jl gx
兵操	bk cc
兵站	bk vj
其一	qi yi
其义自见	qi yi zi jm
其势汹汹	qi ui xs xs
其后	qi hz
其奈我何	qi nd wo he
其它	qi ta
其间	qi jm
其馀	qi yu
典礼	dm li
典章	dm vh
典籍	dm ji
养子	yh zi
养护	yh hu
养殖业	yh vi ye
养殖场	yh vi ih
养母	yh mu
养父	yh fu
养生之道	yh ug vi dc
养神	yh uf
养老金	yh lc jb
养老院	yh lc yr
养路	yh lu
养身	yh uf
兼修	jm xq
兼具	jm ju
兼听	jm tk
兼夹	jm ga
兼夹	jm jx
兼容并包	jm rs bk bc
兼收	jm uz
兼管	jm gr
兼职	jm vi
兼营	jm yk
兼课	jm ke
兼顾	jm gu
兽交	uz jn
兽医	uz yi
兽疫	uz yi
兽类	uz lw
冀南	ji nj
内分泌	nw ff mi
内助	nw vu
内子	nw zi
内有	nw yz
内河	nw he
内海	nw hd
内燃机	nw rj ji
内经	nw jk
内脂	nw vi
内陆国	nw lu go
内陆河	nw lu he
内顾之忧	nw gu vi yz
冇乜	mc mp
冇乜	mc np
冇交易	mc jn yi
冇修	mc xq
冇几何	mc ji he
冇厘搭霎	mc li da ua
冇厘神气	mc li uf qi
冇口齿	mc kz ii
冇啖好食	mc dj hc si
冇啖好食	mc dj hc ui
冇啖好食	mc dj hc yi
冇声气	mc ug qi
冇尾飞砣	mc ww fw to
冇得	mc de
冇得	mc dw
冇得倾	mc de qk
冇得倾	mc dw qk
冇得顶	mc de dk
冇得顶	mc dw dk
冇心机	mc xb ji
冇手尾	mc uz ww
冇掩鸡笼	mc yj ji ls
冇料	mc ln
冇时定	mc ui dk
冇晒表情	mc ud bn qk
冇有怕	mc yz pa
冇理由	mc li yz
冇瘾	mc yb
冇相干	mc xl gj
冇眼睇	mc yj di
冇穿冇烂	mc ir mc lj
冇符	mc fu
冇米粥	mc mi vz
冇耳性	mc er xk
冇脑	mc nc
冇行	mc hh
冇行	mc xk
冇计	mc ji
冇记性	mc ji xk
冇谱	mc pu
冇走鸡	mc zz ji
冇雷公咁远	mc lw gs gj yr
再不	zd bu
再审	zd uf
再生产	zd ug ij
再聊	zd ln
再起	zd qi
冒进	mc jb
写字台	xp zi td
写意	xp yi
写手	xp uz
冚唪唥	kj fg lh
冚家铲	kj jx ij
冚旗	kj qi
冚档	kj dh
军中	jy vs
军乐团	jy yt tr
军乐队	jy yt dv
军事家	jy ui jx
军令状	jy lk vl
军体	jy ti
军兵种	jy bk vs
军分区	jy ff qu
军功	jy gs
军功章	jy gs vh
军务	jy wu
军国	jy go
军国主义	jy go vu yi
军垦	jy kf
军士	jy ui
军委	jy ww
军威	jy ww
军属	jy uu
军工	jy gs
军师	jy ui
军徽	jy hv
军操	jy cc
军政	jy vg
军旗	jy qi
军机	jy ji
军法	jy fa
军烈属	jy lp uu
军界	jy jp
军礼	jy li
军粮	jy ll
军统	jy ts
军职	jy vi
军衔	jy xm
军衣	jy yi
军装警员	jy vl jk yr
军资	jy zi
军转	jy vr
军转办	jy vr bj
军部	jy bu
军需	jy xu
军马	jy ma
军龄	jy lk
农业国	ns ye go
农业税	ns ye uv
农事	ns ui
农产品	ns ij pb
农会	ns hv
农副业	ns fu ye
农场主	ns ih vu
农妇	ns fu
农学	ns xt
农学院	ns xt yr
农家肥	ns jx fw
农工	ns gs
农技	ns ji
农时	ns ui
农机	ns ji
农机具	ns ji ju
农林	ns lb
农牧业	ns mu ye
农膜	ns mo
农舍	ns ue
农谚	ns yj
农贷	ns dd
农资	ns zi
冠军赛	gr jy sd
冠心病	gr xb bk
冠捷	gr jp
冠绝一时	gr jt yi ui
冠群	gr qy
冤家	yr jx
冤枉	yr wh
冤枉嚟瘟疫去	yr wh li wf yi qu
冤枉嚟瘟疫去	yr wh lw wf yi qu
冤枉路	yr wh lu
冤鬼	yr gv
冥王	mk wh
冥王星	mk wh xk
冧巴	lf ba
冧庄	lf vl
冧歌	lf ge
冧篷头	lf pg tz
冬令营	ds lk yk
冬常服	ds ih fu
冬景	ds jk
冬暖夏凉	ds nr xx ll
冬泳	ds ys
冬烘	ds hs
冬瓜豆腐	ds gx dz fu
冬节	ds jp
冬衣	ds yi
冬运会	ds yy hv
冰刀	bk dc
冰壶秋月	bk hu qq yt
冰封大地	bk fg da de
冰封大地	bk fg da di
冰封大地	bk fg dd de
冰封大地	bk fg dd di
冰封雪盖	bk fg xt gd
冰峰	bk fg
冰毒	bk du
冰清玉润	bk qk yu ry
冲击波	is ji bo
冲剂	is ji
冲压	is ya
冲开	is kd
冲撞	is vl
冲灯	is dg
冲积	is ji
冲绳	is ug
冲锋	is fg
冲锋枪	is fg ql
决不	jt bu
决定论	jt dk ly
决意	jt yi
决无	jt mo
决无	jt wu
决案	jt an
决计	jt ji
决赛权	jt sd qr
决非	jt fw
冷不防	lg bu fh
冷库	lg ku
冷板凳	lg bj dg
冷语冰人	lg yu bk rf
冻亲	ds qb
冻亲	ds qk
冻冰冰	ds bk bk
冻害	ds hd
冻过水	ds go uv
净值	jk vi
净利	jk li
净化	jk hx
净重	jk vs
净面	jk mm
凄婉	qi wj
凄怆	qi il
准格尔	vy ge er
准确性	vy qt xk
凉山	ll uj
凉浸浸	ll jb jb
凉透	ll tz
凌夷	lk yi
凌空	lk ks
减仓	jm ch
减免	jm mm
减刑	jm xk
减持	jm ii
减灾	jm zd
凑啱	cz nj
凑啱	cz yj
凑效	cz xn
凝胶	nk jn
凝药	nk yc
凝集	nk ji
几何	ji he
几内亚	ji nw ya
几时	ji ui
几率	ji lv
几种	ji vs
凡人	fj rf
凡例	fj li
凡属	fj uu
凡属	fj vu
凡是	fj ui
凤头猪肚	fg tz vu du
凭陵	pk lk
凯西	kd xi
凸出	tu iu
凸起	tu qi
出世	iu ui
出世纸	iu ui vi
出乱子	iu lr zi
出事	iu ui
出于	iu yu
出人意外	iu rf yi wd
出以公心	iu yi gs xb
出价	iu jx
出众	iu vs
出使	iu ui
出出进进	iu iu jb jb
出击	iu ji
出力	iu li
出厂	iu ih
出厂价	iu ih jx
出发地	iu fa di
出发点	iu fa dm
出处	iu iu
出外	iu wd
出奇	iu qi
出嫁	iu jx
出尽八宝	iu jb ba bc
出局	iu ju
出工	iu gs
出师	iu ui
出师不利	iu ui bu li
出得厅堂入得厨房	iu de tk th ru de iu fh
出得厅堂入得厨房	iu de tk th ru dw iu fh
出得厅堂入得厨房	iu dw tk th ru de iu fh
出得厅堂入得厨房	iu dw tk th ru dw iu fh
出息	iu xi
出手	iu uz
出操	iu cc
出术	iu uu
出术	iu vu
出格	iu ge
出毛病	iu mc bk
出气	iu qi
出污泥而不染	iu wu ni er bu rj
出没	iu mo
出浴	iu yu
出海	iu hd
出炉	iu lu
出版物	iu bj wu
出狱	iu yu
出猫	iu mc
出生率	iu ug lv
出界	iu jp
出监	iu jm
出示	iu ui
出神	iu uf
出租车	iu zu ie
出站	iu vj
出纳员	iu na yr
出线	iu xm
出线权	iu xm qr
出航	iu hh
出苗	iu mn
出蛊惑	iu gu ho
出血	iu xp
出血	iu xt
出行	iu xk
出让	iu rh
出访	iu fh
出谋献策	iu mz xm ce
出资	iu zi
出车	iu ie
出轨	iu gv
出阵	iu vf
出风头	iu fg tz
击中	ji vs
击剑	ji jm
击打	ji da
击毁	ji hv
击破	ji po
击节叹赏	ji jp tj uh
击退	ji tv
凼凼转	dh dh vr
函件	hj jm
凿空	zc ks
凿穿	zc ir
刀下	dc xx
刀仔锯大树	dc zd ju da uu
刀仔锯大树	dc zd ju dd uu
刀仔锯大树	dc zi ju da uu
刀仔锯大树	dc zi ju dd uu
刀伤	dc uh
刀具	dc ju
刀刃	dc rf
刀刻	dc ke
刀削	dc xn
刀削	dc xt
刀口	dc kz
刀耕火种	dc gg ho vs
刁侨扭拧	dn qn nq nk
分之	ff vi
分公司	ff gs si
分册	ff ce
分分秒秒	ff ff mn mn
分分钟	ff ff vs
分列式	ff lp ui
分场	ff ih
分居	ff ju
分房	ff fh
分晓	ff xn
分期	ff qi
分机	ff ji
分析师	ff xi ui
分校	ff xn
分母	ff mu
分水岭	ff uv lk
分洪	ff hs
分界	ff jp
分等	ff dg
分米	ff mi
分红	ff hs
分给	ff gw
分给	ff ji
分脏	ff zh
分设	ff ue
分赴	ff fu
分辩率	ff bm lv
分辩率	ff bm uk
分部	ff bu
分野	ff ye
分门别户	ff mf bp hu
分门别类	ff mf bp lw
切切	qp qp
切切实实	qp qp ui ui
切削	qp xn
切实可行	qp ui ke xk
切实有力	qp ui yz li
切忌	qp ji
刊号	kj hc
刊头	kj tz
刊文	kj wf
刊载	kj zd
刍荛	iu rc
刎颈	wf gg
刎颈	wf jk
刑事	xk ui
刑事犯	xk ui fj
刑戮	xk lu
刑期	xk qi
刑罚	xk fa
刑讯	xk xy
划不来	hx bu ld
划出	hx iu
划界	hx jp
划线	hx xm
列国	lp go
列宁	lp nk
列宁主义	lp nk vu yi
列宁格勒	lp nk ge le
列宁格勒	lp nk ge lw
列强	lp ql
列车员	lp ie yr
刘伯承	lq bd ig
刘伯承	lq bo ig
刘伯温	lq bd wf
刘伯温	lq bo wf
刘墉	lq ys
刘备	lq bw
刘少奇	lq uc qi
刘德华	lq de hx
刘欢	lq hr
刘禅	lq ij
刘禅	lq uj
刘禹锡	lq yu xi
刘秀	lq xq
刘翔	lq xl
刘邦	lq bh
刚直不阿	gh vi bu ee
刚肠嫉恶	gh ih ji ee
刚肠嫉恶	gh ih ji wu
创世	il ui
创伤	il uh
创刊号	il kj hc
创利	il li
创始人	il ui rf
创维	il ww
创见	il jm
创造力	il zc li
创造性	il zc xk
初中生	iu vs ug
初具	iu ju
初具规模	iu ju gv mo
初创	iu il
初四	iu si
初夏	iu xx
初始	iu ui
初审	iu uf
初小	iu xn
初战	iu vj
初战告捷	iu vj gc jp
初版	iu bj
初生	iu ug
初衷	iu vs
初试	iu ui
初选	iu xr
删节	uj jp
判例	pj li
判决书	pj jt uu
判断力	pj dr li
判涣	pj hr
判罪	pj zv
利利是是	li li ui ui
利利索索	li li so so
利器	li qi
利国	li go
利害	li hd
利己	li ji
利是封	li ui fg
利比亚	li bi ya
利物浦	li wu pu
利益均沾	li yi jy vj
利盟	li mg
利诱	li yz
别具匠心	bp ju jl xb
别动队	bp ds dv
别风淮雨	bp fg hk yu
刮龙	gx ls
到会	dc hv
到其时	dc qi ui
到喉唔到肺	dc hz wu dc fw
到点	dc dm
到职	dc vi
到账	dc vh
制剂	vi ji
制动	vi ds
制备	vi bw
制导	vi dc
制度化	vi du hx
制式	vi ui
制得过	vi de go
制得过	vi dw go
制成	vi ig
制成品	vi ig pb
制服	vi fu
制法	vi fa
制片厂	vi pm ih
制版	vi bj
制盐	vi yj
制程	vi ig
制药	vi yc
制衣	vi yi
制订	vi dk
制造业	vi zc ye
制造商	vi zc uh
制高点	vi gc dm
刹住	ia vu
刹住	ua vu
刺史	ci ui
刺头	ci tz
刺戳	ci io
刺槐	ci hk
刺激性	ci ji xk
刻划	ke hx
刻毒	ke du
刽子手	gv zi uz
剂型	ji xk
剃眼眉	ti yj mw
剃须	ti xu
削尖	xn jm
削尖	xt jm
削成	xn ig
削成	xt ig
前个排	qm ge pd
前人	qm rf
前人栽树后人乘凉	qm rf zd uu hz rf ig ll
前人栽树后人乘凉	qm rf zd uu hz rf ug ll
前夫	qm fu
前头	qm tz
前奏曲	qm zz qu
前妻	qm qi
前敌	qm di
前科	qm ke
前程万里	qm ig wj li
前程似锦	qm ig si jb
前站	qm vj
前端	qm dr
前线	qm xm
前苏联	qm su lm
前言	qm yj
前车可鉴	qm ie ke jm
前车可鉴	qm ju ke jm
前送	qm ss
前驱	qm qu
剑指	jm vi
剑术	jm uu
剔手边	ti uz bm
剔除	ti iu
剞劂	ji jt
剥光猪	bc gl vu
剥光猪	bo gl vu
剥削阶级	bo xt jp ji
剥离	bo li
剥落	bo lo
剥蚀	bo ui
剦狗	yj gz
剧中人	ju vs rf
剧作者	ju zo ve
剧变	ju bm
剧种	ju vs
剩番	ug fj
剩番	ug pj
剪刀	jm dc
剪刀差	jm dc ia
剪子	jm zi
剪影	jm yk
剪枝	jm vi
剪纸	jm vi
剪裁	jm cd
副产品	fu ij pb
副作用	fu zo ys
副官	fu gr
副手	fu uz
副教授	fu jn uz
副职	fu vi
副题	fu ti
副食	fu ui
副食品	fu ui pb
割地	ge di
割据	ge ju
割断	ge dr
割禾青	ge he qk
劏死牛	th si nq
劏死牛	ts si nq
力争上游	li vg uh yz
力克	li ke
力士	li ui
劝慰	qr ww
办事处	bj ui iu
办公桌	bj gs vo
办到	bj dc
办厂	bj ih
办房	bj fh
办班	bj bj
办馆	bj gr
功业	gs ye
功利	gs li
功名	gs mk
功底	gs di
功德	gs de
功成不居	gs ig bu ju
功成名遂	gs ig mk sv
功标青史	gs bn qk ui
功用	gs ys
功绩	gs ji
功薄蝉翼	gs bc ij yi
功薄蝉翼	gs bo ij yi
加之	jx vi
加仑	jx ly
加以	jx yi
加价	jx jx
加元	jx yr
加剧	jx ju
加力	jx li
加勒比	jx le bi
加勒比	jx lw bi
加塞	jx sd
加宽	jx kr
加尔各答	jx er ge da
加尔文	jx er wf
加州	jx vz
加工业	jx gs ye
加工厂	jx gs ih
加底	jx di
加拿大	jx na da
加沙	jx ua
加班加点	jx bj jx dm
加班费	jx bj fw
加精	jx jk
加速器	jx su qi
加速度	jx su du
加靳比	jx jb bi
加餸	jx ss
加高	jx gc
务使	wu ui
务农	wu ns
务实	wu ui
务虚	wu xu
劣质品	lp vi pb
动不动	ds bu ds
动员令	ds yr lk
动土	ds tu
动机	ds ji
动植物	ds vi wu
动武	ds wu
动物学	ds wu xt
动画片	ds hx pm
动脑筋	ds nc jb
动议	ds yi
助听器	vu tk qi
助学金	vu xt jb
助我张目	vu wo vh mu
助推器	vu tv qi
助攻	vu gs
助教	vu jn
助理员	vu li yr
助长	vu vh
努尔哈赤	nu er ha ii
劫机	jp ji
劲头	jb tz
劳务费	lc wu fw
劳动力	lc ds li
劳动局	lc ds ju
劳动日	lc ds ri
劳动者	lc ds ve
劳动节	lc ds jp
劳工	lc gs
劳役	lc yi
劳拉	lc la
劳教所	lc jn so
劳资	lc zi
势不可当	ui bu ke dh
势凶夹狼	ui xs ga lh
势凶夹狼	ui xs jx lh
势利	ui li
势力	ui li
势单力薄	ui dj li bo
势头	ui tz
势态	ui td
勃勃	bo bo
勇于	ys yu
勇冠	ys gr
勇猛果敢	ys mg go gj
勇猛精进	ys mg jk jb
勘误	kj wu
勤俭持家	qb jm ii jx
勤务员	qb wu yr
勤杂工	qb za gs
勤苦	qb ku
勾地	gz de
勾地	gz di
勾搭	gz da
勾通	gz ts
匀巡	yy xy
匀循	yy xy
包产	bc ij
包修	bc xq
包剪抌	bc jm vf
包围圈	bc ww qr
包工	bc gs
包干制	bc gj vi
包机	bc ji
包涵	bc hj
包租婆	bc zu po
包钢	bc gh
包销	bc xn
包顶颈	bc dk gg
包顶颈	bc dk jk
匈牙利	xs ya li
化为泡影	hx ww pc yk
化公为私	hx gs ww si
化合物	hx he wu
化学家	hx xt jx
化工厂	hx gs ih
化肥	hx fw
化装	hx vl
化验单	hx yj dj
化验单	hx yj ij
化验单	hx yj uj
化验室	hx yj ui
化骨龙	hx gu ls
北伐	bw fa
北伐军	bw fa jy
北大仓	bw da ch
北宋	bw ss
北极圈	bw ji qr
北极熊	bw ji xs
北电	bw dm
北纬	bw ww
北航	bw hh
北芪	bw qi
北雁南飞	bw yj nj fw
北面	bw mm
北风呼啸	bw fg hu xn
北麓	bw lu
匠心独运	jl xb du yy
匡算	kl sr
匣子	xx zi
匹夫	pi fu
匹夫有责	pi fu yz ze
区委	qu ww
医书	yi uu
医保	yi bc
医务	yi wu
医嘱	yi vu
医大	yi da
医大	yi dd
医学院	yi xt yr
医师	yi ui
医术	yi uu
医治	yi vi
医用	yi ys
医科	yi ke
医肚	yi du
医药费	yi yc fw
匼匝	ke za
匼匝	qx za
匾额	bm ee
匿埋	ni md
匿埋	ni mj
十一月	ui yi yt
十三陵	ui sj lk
十传百	ui ir bd
十佳	ui jx
十冬腊月	ui ds la yt
十字	ui zi
十字军	ui zi jy
十字路口	ui zi lu kz
十字车	ui zi ie
十字车	ui zi ju
十足十	ui zu ui
十载寒窗	ui zd hj il
千伏	qm fu
千千万万	qm qm wj wj
千古绝唱	qm gu jt ih
千叮咛	qm dk nk
千山万壑	qm uj wj he
千岁	qm sv
千差万别	qm ia wj bp
千斤	qm jb
千斤顶	qm jb dk
千百万	qm bd wj
千祁	qm qi
千虑一失	qm lv yi ui
千虑一得	qm lv yi de
千载一时	qm zd yi ui
千里之堤	qm li vi di
千里眼	qm li yj
千里马	qm li ma
千金	qm jb
千门万户	qm mf wj hu
千难万险	qm nj wj xm
千难万难	qm nj wj nj
升堂入室	ug th ru ui
升幅	ug fu
升旗	ug qi
升格	ug ge
升起	ug qi
升迁	ug qm
午夜	wu ye
午宴	wu yj
午时	wu ui
午间	wu jm
半价	bj jx
半决赛	bj jt sd
半唐番	bj th fj
半唐番	bj th pj
半圆形	bj yr xk
半壁江山	bj bi jl uj
半壁河山	bj bi he uj
半天吊	bj tm dn
半导体	bj dc ti
半封建	bj fg jm
半成品	bj ig pb
半文盲	bj wf mh
半旧	bj jq
半晌	bj uh
半月刊	bj yt kj
半点	bj dm
半球	bj qq
半自动	bj zi ds
半边天	bj bm tm
华为	hx ww
华工	hx gs
华灯初上	hx dg iu uh
华盛顿	hx ug dy
华硕	hx uo
华章	hx vh
华罗庚	hx lo gg
华语	hx yu
华贵	hx gv
华阴	hx yb
协作	xp zo
协力	xp li
协议书	xp yi uu
卓识	vo ui
卓跞	vo li
卓跞	vo lo
单个	dj ge
单产	dj ij
单企人	dj qi rf
单企人	ij qi rf
单企人	uj qi rf
单体	dj ti
单刀	dj dc
单单	dj dj
单吊西	dj dn xi
单吊西	ij dn xi
单吊西	uj dn xi
单子	dj zi
单干	dj gj
单打	dj da
单打独斗	dj da du dz
单打独斗	ij da du dz
单打独斗	uj da du dz
单机	dj ji
单片机	dj pm ji
单片机	ij pm ji
单片机	uj pm ji
单线	dj xm
单细胞	dj xi bc
单行本	dj xk bf
单衣	dj yi
单身汉	dj uf hj
单车径	dj ie jk
单车径	dj ju jk
单车径	ij ie jk
单车径	ij ju jk
单车径	uj ie jk
单车径	uj ju jk
单边	dj bm
单项	dj xl
卖主	md vu
卖仔莫摸头	md zd mo mo tz
卖仔莫摸头	md zi mo mo tz
卖价	md jx
卖儿鬻女	md er yu nv
卖剩蔗	md ug ve
卖咸鸭蛋	md xm ya dj
卖国贼	md go zw
卖埠	md bu
卖大包	md da bc
卖大包	md dd bc
卖家	md jx
卖方	md fh
卖猪仔	md vu zd
卖猪仔	md vu zi
卖飞	md fw
卖鱼佬洗身	md yu lc xi uf
南乳花生	nj ru hx ug
南京市	nj jk ui
南国	nj go
南宁市	nj nk ui
南安	nj an
南岭	nj lk
南平	nj pk
南昌市	nj ih ui
南朝鲜	nj ic xm
南朝鲜	nj vc xm
南海	nj hd
南纬	nj ww
南通	nj ts
南阳	nj yh
南面	nj mm
南麓	nj lu
博古知今	bo gu vi jb
博命	bo mk
博士后	bo ui hz
博士生	bo ui ug
博大	bo da
博学	bo xt
博施济众	bo ui ji vs
博物院	bo wu yr
博物馆	bo wu gr
博览	bo lj
博采众长	bo cd vs ih
卜卜脆	bo bo cv
卜卜脆	bo bu cv
卜卜脆	bu bo cv
卜卜脆	bu bu cv
占先	vj xm
占有量	vj yz ll
占领区	vj lk qu
卡特	ka te
卡特	qx te
卡罅	ka xx
卡罅	qx xx
卡脖子	qx bo zi
卡莉	ka li
卡莉	qx li
卢旺达	lu wh da
卢比	lu bi
卢氏	lu ui
卤水	lu uv
卧具	wo ju
卧车	wo ie
卫兵	ww bk
卫国	ww go
卫士	ww ui
卫戍	ww uu
卫戍区	ww uu qu
卫星城	ww xk ig
卫生员	ww ug yr
卫生所	ww ug so
卫生纸	ww ug vi
卫生部	ww ug bu
卫生间	ww ug jm
卫生院	ww ug yr
卫队	ww dv
卬卬	ah ah
卬卬	ah yh
卬卬	yh ah
卬卬	yh yh
印刷业	yb ux ye
印刷品	yb ux pb
印刷机	yb ux ji
印加	yb jx
印发	yb fa
印巴	yb ba
印数	yb uu
印油	yb yz
印泥	yb ni
印第安纳	yb di an na
印行	yb xk
印鉴	yb jm
危亡	ww wh
危危乎	ww ww hu
危及	ww ji
危害性	ww hd xk
危局	ww ju
危急	ww ji
危言危行	ww yj ww hh
危言危行	ww yj ww xk
危重	ww vs
危难	ww nj
即位	ji ww
即便	ji bm
即兴	ji xk
即刻	ji ke
即可	ji ke
即时	ji ui
即映即有	ji yk ji yz
即景	ji jk
即系	ji ji
即系	ji xi
卵细胞	lr xi bc
卷子	jr zi
卸膊	xp bo
厂主	ih vu
厂子	ih zi
厂方	ih fh
厂矿	ih kl
厂规	ih gv
厂部	ih bu
历任	li rf
历史剧	li ui ju
历史性	li ui xk
历史观	li ui gr
历届	li jp
历年	li nm
历时	li ui
历法	li fa
历险	li xm
厉兵秣马	li bk mo ma
压制	ya vi
压力锅	ya li go
压岁钱	ya sv qm
压强	ya ql
压缩机	ya so ji
压轴戏	ya vz xi
厘印	li yb
厘印税	li yb uv
厚实	hz ui
厚德载物	hz de zd wu
原主	yr vu
原则性	yr ze xk
原动力	yr ds li
原址	yr vi
原型	yr xk
原委	yr ww
原子	yr zi
原子核	yr zi he
原子钟	yr zi vs
原审	yr uf
原形	yr xk
原意	yr yi
原故	yr gu
原有	yr yz
原木	yr mu
原样	yr yh
原油	yr yz
原点	yr dm
原物	yr wu
原状	yr vl
原稿	yr gc
原粮	yr ll
原职	yr vi
原著	yr vu
去世	qu ui
去处	qu iu
去粗取精	qu cu qu jk
去职	qu vi
厾背脊	du bw ji
县城	xm ig
县委	xm ww
县市	xm ui
县志	xm vi
县政	xm vg
县级	xm ji
参事	cj ui
参战	cj vj
参拜	cj bd
参照系	cj vc xi
参编	cj bm
参编	uf bm
参考书	cj kc uu
参观团	cj gr tr
参议	cj yi
参议会	cj yi hv
参议员	cj yi yr
参议院	cj yi yr
参谋部	cj mz bu
参谋长	cj mz ih
参谋长	cj mz vh
参预	cj yu
参预	uf yu
叆叇	ai dd
又惊又喜	yz jk yz xi
又红又专	yz hs yz vr
叉电	ia dm
及其	ji qi
及早	ji zc
及时雨	ji ui yu
及格	ji ge
及至	ji vi
友人	yz rf
友协	yz xp
友谊赛	yz yi sd
友达	yz da
双人床	ul rf il
双人舞	ul rf wu
双企人	ul qi rf
双增双节	ul zg ul jp
双月刊	ul yt kj
双格床	ul ge il
双皮奶	ul pi nd
双程证	ul ig vg
双簧管	ul hl gr
双职工	ul vi gs
双轨	ul gv
反之	fj vi
反之亦然	fj vi yi rj
反党	fj dh
反动派	fj ds pd
反叼	fj dn
反响	fj xl
反对派	fj dv pd
反对票	fj dv pn
反应堆	fj yk dv
反悔	fj hv
反攻	fj gs
反潜	fj qm
反观	fj gr
反过来	fj go ld
反过来说	fj go ld uo
反霸	fj ba
反革命	fj ge mk
反黑组	fj hw zu
发令	fa lk
发令枪	fa lk ql
发包	fa bc
发吽哣	fa hs dz
发吽哣	fa hs pz
发嗡风	fa wg fg
发型	fa xk
发声	fa ug
发奋图强	fa ff tu ql
发姣	fa jn
发姣	fa xn
发嬲	fa nn
发展史	fa vj ui
发布会	fa bu hv
发开口梦	fa kd kz mg
发愤	fa ff
发愤图强	fa ff tu ql
发愤忘食	fa ff wh ui
发慌	fa hl
发抆憎	fa mf zg
发抆憎	fa wf zg
发报	fa bc
发掘	fa jt
发改委	fa gd ww
发明家	fa mk jx
发明者	fa mk ve
发泡胶	fa pc jn
发源	fa yr
发炎	fa yj
发烂渣	fa lj va
发球	fa qq
发生器	fa ug qi
发电厂	fa dm ih
发电机	fa dm ji
发电站	fa dm vj
发电量	fa dm ll
发病率	fa bk lv
发端	fa dr
发羊吊	fa yh dn
发脚	fa jn
发脾气	fa pi qi
发臭	fa iz
发花癫	fa hx dm
发茅	fa mc
发行量	fa xk ll
发言稿	fa yj gc
发证	fa vg
发达国家	fa da go jx
发迹	fa ji
发钱寒	fa qm hj
发问	fa wf
发青光	fa qk gl
发鸡盲	fa ji mh
发麻	fa ma
叔仔	uu zd
叔仔	uu zi
叔父	uu fu
取出	qu iu
取景	qu jk
取次	qu ci
取自	qu zi
取道	qu dc
取长补短	qu ih bu dr
受刑	uz xk
受命	uz mk
受审	uz uf
受害人	uz hd rf
受害者	uz hd ve
受敌	uz di
受权	uz qr
受气	uz qi
受灾	uz zd
受理	uz li
受益	uz yi
受益者	uz yi ve
受精	uz jk
受精卵	uz jk lr
受罚	uz fa
受贿	uz hv
受辱	uz ru
受阻	uz zu
受降	uz xl
变化无常	bm hx wu ih
变压器	bm ya qi
变幻	bm hr
变废为宝	bm fw ww bc
变异	bm yi
变性	bm xk
变戏法	bm xi fa
变电所	bm dm so
变电站	bm dm vj
变质	bm vi
变速器	bm su qi
叙事诗	xu ui ui
叙利亚	xu li ya
叙旧	xu jq
口响	kz xl
口哑哑	kz ya ya
口型	kz xk
口子	kz zi
口实	kz ui
口形	kz xk
口水溦	kz uv ww
口水肩	kz uv jm
口疏	kz uu
口痕	kz hf
口福	kz fu
口花花	kz hx hx
口香糖	kz xl th
口齿	kz ii
古书	gu uu
古井无波	gu jk wu bo
古仔	gu zd
古仔	gu zi
古已有之	gu yi yz vi
古拙	gu vo
古文	gu wf
古文字	gu wf zi
古时	gu ui
古月粉	gu yt ff
古灵精怪	gu lk jk gk
古物	gu wu
古生物	gu ug wu
古稀	gu xi
古籍	gu ji
古老石山	gu lc dj uj
古老石山	gu lc ui uj
古董	gu ds
古诗	gu ui
古话	gu hx
古迹	gu ji
古道热肠	gu dc re ih
古都	gu du
古风	gu fg
句式	ju ui
句钟	gz vs
句钟	ju vs
另一方面	lk yi fh mm
另行	lk xk
叨唠	dc lc
只得	vi de
只想	vi xl
只揪	vi jq
只是	vi ui
只眼开只眼闭	vi yj kd vi yj bi
只见	vi jm
只许	vi xu
只身	vi uf
只限	vi xm
只需	vi xu
只须	vi xu
只顾	vi gu
叫作	jn zo
叫做	jn zo
叫嚣	jn xn
叫好	jn hc
叫糊	jn hu
召回	vc hv
召妓	uc ji
召妓	vc ji
召集	vc ji
叮叮当当	dk dk dh dh
可亲可敬	ke qb ke jk
可以攻玉	ke yi gs yu
可使	ke ui
可信度	ke xb du
可卡因	ke ka yb
可可	ke ke
可喜	ke xi
可嘉	ke jx
可怒也	ke nu ye
可按	ke an
可望	ke wh
可疑	ke yi
可知	ke vi
可见光	ke jm gl
可观	ke gr
可视	ke ui
可读性	ke du xk
可鄙	ke bi
台中	td vs
台子	td zi
台属	td uu
台州	td vz
台柱子	td vu zi
台港	td gh
台湾省	td wj ug
台湾省	td wj xk
台独	td du
台盟	td mg
台积电	td ji dm
台联	td lm
台资	td zi
史书	ui uu
史册	ui ce
史前	ui qm
史努比	ui nu bi
史学	ui xt
史官	ui gr
史实	ui ui
史密斯	ui mi si
史料	ui ln
史籍	ui ji
史记	ui ji
史诗	ui ui
史话	ui hx
史迹	ui ji
右便	yz bm
右便	yz pm
右倾	yz qk
右翼	yz yi
右键	yz jm
叶脉	ye md
叶面	ye mm
号召力	hc vc li
号子	hc zi
号手	hc uz
号脉	hc md
司令官	si lk gr
司令部	si lk bu
司务长	si wu vh
司法部	si fa bu
司长	si vh
叹世界	tj ui jp
叻唔切	le wu qp
吁嗟	xu jp
吁嗟	yu jp
吃一堑	ii yi qm
吃不消	ii bu xn
吃老本	ii lc bf
吃苦头	ii ku tz
吃请	ii qk
吃香	ii xl
各业	ge ye
各个	ge ge
各县	ge xm
各大	ge da
各大	ge dd
各异	ge yi
各式	ge ui
各施各法	ge ui ge fa
各省	ge ug
各省	ge xk
各科	ge ke
各自为政	ge zi ww vg
各行其是	ge xk qi ui
吆呼	yc hu
合一	he yi
合乎	he hu
合伙人	he ho rf
合作化	he zo hx
合作社	he zo ue
合剂	he ji
合力	he li
合同制	he ts vi
合同工	he ts gs
合同期	ge ts qi
合同期	he ts qi
合唱团	he ih tr
合围	he ww
合家欢	he jx hr
合并症	he bk vg
合心水	ge xb uv
合心水	he xb uv
合抱	he bc
合格率	he ge lv
合流	he lq
合理化	he li hx
合理性	he li xk
合璧	he bi
合用	he ys
合眼缘	ge yj yr
合眼缘	he yj yr
合算	he sr
合署	he uu
合股	he gu
合肥市	ge fw ui
合肥市	he fw ui
合营	he yk
合订本	he dk bf
合金钢	he jb gh
合龙	he ls
吉信	ji xb
吉凶祸福	ji xs ho fu
吉利	ji li
吉它	ji ta
吉安	ji an
吉庆	ji qk
吉日	ji ri
吉普车	ji pu ie
吉林省	ji lb ug
吉祥	ji xl
吉祥物	ji xl wu
吉隆	ji ls
吉首	ji uz
吊味	dn ww
吊命	dn mk
吊唁	dn yj
吊威也	dn ww ye
吊尾	dn ww
吊环	dn hr
吊瘾	dn yb
吊盐水	dn yj uv
吊起嚟卖	dn qi li md
吊起嚟卖	dn qi lw md
同一性	ts yi xk
同义词	ts yi ci
同乡	ts xl
同事	ts ui
同位素	ts ww su
同化	ts hx
同城	ts ig
同安	ts an
同室操戈	ts ui cc ge
同年	ts nm
同心	ts xb
同心合意	ts xb ge yi
同心合意	ts xb he yi
同志	ts vi
同性	ts xk
同性恋	ts xk lm
同捞同煲	ts lc ts bc
同方	ts fh
同治	ts vi
同济	ts ji
同生共死	ts ug gs si
同盟会	ts mg hv
同盟军	ts mg jy
同盟国	ts mg go
同级	ts ji
同胞	ts bc
同船	ts ir
同道	ts dc
名位	mk ww
名医	mk yi
名古屋	mk gu wu
名噪一时	mk zc yi ui
名城	mk ig
名士	mk ui
名山	mk uj
名山大川	mk uj da ir
名手	mk uz
名次	mk ci
名胜	mk ug
名花	mk hx
名著	mk vu
后世	hz ui
后事	hz ui
后事之师	hz ui vi ui
后仔乸	hz zd na
后仔乸	hz zi na
后任	hz rf
后备军	hz bw jy
后尾枕	hz ww vf
后援	hz yr
后撤	hz ie
后生仔	hz ug zd
后生仔	hz ug zi
后生女	hz ug nv
后继有人	hz ji yz rf
后背	hz bw
后脚	hz jn
后腿	hz tv
后记	hz ji
后辈	hz bw
后进	hz jb
吏治	li vi
向北	xl bw
向导	xl dc
向心力	xl xb li
向日葵	xl ri kv
向着	xl ve
向阳	xl yh
吓倒	xx dc
君主立宪	jy vu li xm
吞吐量	ty tu ll
吞拿鱼	ty na yu
吞食	ty ui
吟沉	yb if
吟诗	yb ui
否决权	fz jt qr
含冤	hj yr
含垢纳污	hj gz na wu
含意	hj yi
含氧量	hj yh ll
含水量	hj uv ll
含笑	hj xn
含糊其词	hj hu qi ci
含羞	hj xq
听晚	tk wj
听朝	tk ic
听朝	tk vc
听朝早	tk ic zc
听朝早	tk vc zc
听诊器	tk vf qi
吮吸	uy xi
启事	qi ui
启功	qi gs
启发性	qi fa xk
启明	qi mk
启明星	qi mk xk
启示	qi ui
启航	qi hh
启运	qi yy
吱吱斟斟	vi vi vf vf
吴江	wu jl
吴牛喘月	wu nq ir yt
吸尘器	xi if qi
吸附	xi fu
吹吹打打	iv iv da da
吻合	wf he
吼声	hz ug
吽哣	hs dz
吽哣	hs pz
呃呃骗骗	ee ee pm pm
呃神骗鬼	ee uf pm gv
呃秤	ee ig
呆呆	dd dd
呆帐	dd vh
呆板	dd bj
呈报	ig bc
呈献	ig xm
呈请	ig qk
告急	gc ji
告慰	gc ww
告捷	gc jp
告终	gc vs
告罄	gc qk
呋喃	fu nj
呔盘	dd pj
呔盘	td pj
员额	yr ee
呜咽	wu ye
呢度	ne do
呢度	ne du
呢度	ni do
呢度	ni du
呢排	ne pd
呢排	ni pd
呢道	ne dc
呢道	ni dc
周口	vz kz
周易	vz yi
周期性	vz qi xk
周界	vz jp
周章	vz vh
周身刀冇张利	vz uf dc mc vh li
周身蚁	vz uf yi
呶呶	nc nc
呼之欲出	hu vi yu iu
呼吸道	hu xi dc
呼牛呼马	hu nq hu ma
命根子	mk gf zi
命水	mk uv
咀嚼	ju jt
咁上下	gj uh xx
咁上近	gj uh jb
咁好	gj hc
咁样	gj yh
咁滞	gj vi
和会	he hv
和头酒	he tz jq
和头酒	ho tz jq
和头酒	hu tz jq
和平共处	he pk gs iu
和平鸽	he pk ge
和煦	he xu
和约	he yt
和衷共济	he vs gs ji
和记	he ji
和记	ho ji
和记	hu ji
和面	ho mm
和黄	he hl
和黄	ho hl
和黄	hu hl
咏叹调	ys tj dn
咕咚	gu ds
咕哩	gu li
咕噜	gu lu
咖啡因	ka fw yb
咨文	zi wf
咪住	mi vu
咪嘴	mi zv
咬唔入	yc wu ru
咬牙切齿	yc ya qp ii
咬紧牙关	yc jb ya gr
咸丰	xm fg
咸唪唥	xm fg lh
咸宁	xm nk
咸湿	xm ui
咸湿佬	xm ui lc
咸肉粽	xm rz zs
咸苦	xm ku
咸虾	xm xx
咸鱼翻生	xm yu fj ug
咿哑	yi ya
咿唔	yi wu
品位	pb ww
品名	pb mk
品性	pb xk
品级	pb ji
哈萨克	ha sa ke
哈萨克族	ha sa ke zu
响声	xl ug
响应	xl yk
响当当	xl dh dh
响彻	xl ie
响音	xl yb
哑语	ya yu
哗变	hx bm
哗啦啦	hx la la
哥白尼	ge bd ni
哨位	uc ww
哨兵	uc bk
哨子	uc zi
哭叫	ku jn
哲学家	ve xt jx
哲理	ve li
哺乳	bu ru
哺乳动物	bu ru ds wu
哺育	bu yu
唁函	yj hj
唆使	so ui
唇枪舌战	iy ql ue vj
唐棣	th dd
唐棣	th di
唐棣	th ti
唐餐	th cj
唔中用	wu vs ys
唔争在	wu vg zd
唔似	wu ui
唔似样	wu ui yh
唔使	wu ui
唔使恨	wu ui hf
唔使慌	wu ui hl
唔使指拟	wu ui vi ni
唔使问阿贵	wu ui wf aa gv
唔使问阿贵	wu ui wf ee gv
唔关事	wu gr ui
唔制	wu vi
唔化	wu hx
唔化算	wu hx sr
唔单只	wu dj vi
唔单只	wu ij vi
唔单只	wu uj vi
唔啱	wu nj
唔啱	wu yj
唔嗲唔吊	wu dx wu dn
唔在讲	wu zd jl
唔够喉	wu gz hz
唔定	wu dk
唔开胃	wu kd ww
唔得掂	wu de dm
唔得掂	wu dw dm
唔得闲	wu de xm
唔得闲	wu dw xm
唔志在	wu vi zd
唔忿气	wu ff qi
唔怪之得	wu gk vi de
唔怪之得	wu gk vi dw
唔抵得	wu di de
唔抵得	wu di dw
唔拘	wu ju
唔捞	wu lc
唔汤唔水	wu th wu uv
唔清唔楚	wu qk wu iu
唔熟唔食	wu uu wu si
唔熟唔食	wu uu wu ui
唔熟唔食	wu uu wu yi
唔熟唔食	wu uz wu si
唔熟唔食	wu uz wu ui
唔熟唔食	wu uz wu yi
唔熟性	wu uu xk
唔熟性	wu uz xk
唔特止	wu te vi
唔生性	wu ug xk
唔知丑	wu vi iz
唔等使	wu dg ui
唔精神	wu jk uf
唔系人噉品	wu ji rf dj pb
唔系人噉品	wu xi rf dj pb
唔系嘅话	wu ji ge hx
唔系嘅话	wu xi ge hx
唔系路	wu ji lu
唔系路	wu xi lu
唔紧要	wu jb yc
唔经唔觉	wu jk wu jn
唔经唔觉	wu jk wu jt
唔自在	wu zi zd
唔觉意	wu jn yi
唔觉意	wu jt yi
唔觉眼	wu jn yj
唔觉眼	wu jt yj
唔话得	wu hx de
唔话得	wu hx dw
唔该你	wu gd ni
唔通气	wu ts qi
唞气	dz qi
唞气	tc qi
唧嘛	ji ma
售予	uz yu
售前	uz qm
售卖	uz md
售票员	uz pn yr
售票处	uz pn iu
售货	uz ho
售货员	uz ho yr
唯命是听	ww mk ui tk
唯我	ww wo
唯物	ww wu
唯物史观	ww wu ui gr
唯物论	ww wu ly
唱作人	ih zo rf
唱反调	ih fj dn
唱口	ih kz
唱和	ih he
唱喏	ih no
唱喏	ih re
唱段	ih dr
唱法	ih fa
唱片	ih pm
唱词	ih ci
唾面自干	to mm zi gj
啁啾	vz jq
啄木鸟	vo mu nn
商业界	uh ye jp
商会	uh hv
商住两用	uh vu ll ys
商务	uh wu
商品房	uh pb fh
商品粮	uh pb ll
商埠	uh bu
商报	uh bc
商机	uh ji
商界	uh jp
商船	uh ir
商议	uh yi
商贾	uh gu
啦啦声	la la ug
啦啦队	la la dv
啰啰挛	lo lo lr
啰噃	lo bo
啰柚	lo yz
啱先	nj xm
啱先	yj xm
啱听	nj tk
啱听	yj tk
啱啱	nj nj
啱啱	nj yj
啱啱	yj nj
啱啱	yj yj
啲咁多	di gj do
喀嚓	ka ia
善人	uj rf
善有善报	uj yz uj bc
善本	uj bf
善气迎人	uj qi yk rf
善长仁翁	uj ih rf wg
善长仁翁	uj vh rf wg
喊包	hj bc
喊惊	hj jk
喊苦喊忽	hj ku hj hu
喊话	hj hx
喐亲	yu qb
喐亲	yu qk
喐手	yu uz
喘气	ir qi
喜出望外	xi iu wh wd
喜剧片	xi ju pm
喜报	xi bc
喜气	xi qi
喜洋洋	xi yh yh
喜滋滋	xi zi zi
喜闻	xi wf
喜雨	xi yu
喜鹊	xi qt
喷吐	pf tu
喷漆	pf qi
喷雾器	pf wu qi
喽口	lz kz
嗓子眼	sh zi yj
嗣后	si hz
嗰头近	ge tz jb
嗰度	ge do
嗰度	ge du
嗰排	ge pd
嗰道	ge dc
嗰阵	ge vf
嘀咕	di gu
嘅啫	ge ui
嘅啫	ge ve
嘅嗻	ge ve
嘅嗻	ge vu
嘈喧巴闭	cc xr ba bi
嘈嘈闭	cc cc bi
嘈生晒	cc ug ud
嘉兴	jx xk
嘉峪关	jx yu gr
嘉陵	jx lk
嘥心机	sd xb ji
嘥气	sd qi
嘱咐	vu fu
嘲哳	ic va
嘲哳	vc va
噉样	dj yh
噍噍	jn jn
器乐	qi yt
器件	qi jm
器物	qi wu
器重	qi vs
嚆矢	hc ui
嚎啕	hc tc
嚎啕大哭	hc tc da ku
嚎啕大哭	hc tc dd ku
囊萤照读	nh yk vc du
囊萤照读	nh yk vc dz
囚室	qq ui
四下	si xx
四世同堂	si ui ts th
四书	si uu
四人帮	si rf bh
四化	si hx
四周	si vz
四块半	si kk bj
四处奔波	si iu bf bo
四季	si ji
四川省	si ir ug
四平	si pk
四时	si ui
四眼佬	si yj lc
四边	si bm
回乡	hv xl
回击	hv ji
回南	hv nj
回响	hv xl
回填	hv tm
回声	hv ug
回复	hv fu
回头客	hv tz ke
回头路	hv tz lu
回忆	hv yi
回收率	hv uz lv
回游	hv yz
回炉	hv lu
回访	hv fh
回路	hv lu
回首	hv uz
回马枪	hv ma ql
因人制宜	yb rf vi yi
因子	yb zi
因时制宜	yb ui vi yi
因由	yb yz
因缘	yb yr
囡囡	nj nj
团中央	tr vs yh
团体操	tr ti cc
团员	tr yr
团拜	tr bd
团支部	tr vi bu
团旗	tr qi
团日	tr ri
团职	tr vi
团部	tr bu
园丁	yr dk
园地	yr di
园子	yr zi
园艺	yr yi
园长	yr vh
困难户	ky nj hu
围垦	ww kf
围巾	ww jb
围歼	ww jm
围追	ww vv
囹圄	lk yu
固之然	gu vi rj
固始	gu ui
固定资产	gu dk zi ij
固步自封	gu bu zi fg
固沙林	gu ua lb
固然之	gu rj vi
固话	gu hx
固顶	gu dk
国书	go uu
国事	go ui
国产货	go ij ho
国企	go qi
国会	go hv
国体	go ti
国内外	go nw wd
国务卿	go wu qk
国务院	go wu yr
国势	go ui
国史	go ui
国君	go jy
国境线	go jk xm
国威	go ww
国宴	go yj
国宾馆	go bb gr
国富民强	go fu mb ql
国库券	go ku qr
国度	go du
国情	go qk
国政	go vg
国教	go jn
国文	go wf
国旗	go qi
国格	go ge
国民军	go mb jy
国民经济	go mb jk ji
国界	go jp
国立	go li
国籍	go ji
国美	go mw
国花	go hx
国语	go yu
国都	go du
国防军	go fh jy
国防部	go fh bu
国际主义	go ji vu yi
国际法	go ji fa
图书室	tu uu ui
图表	tu bn
图象	tu xl
圆圆	yr yr
圆圈	yr qr
圆寂	yr ji
圆明园	yr mk yr
圆木警枕	yr mu jk vf
圆柱	yr vu
圆珠笔	yr vu bi
圆蹄	yr ti
圈阅	qr yt
土专家	tu vr jx
土丘	tu qq
土坡	tu po
土墙	tu ql
土家族	tu jx zu
土层	tu cg
土布	tu bu
土库曼	tu ku mj
土改	tu gd
土政策	tu vg ce
土星	tu xk
土法	tu fa
土石方	tu ui fh
土著	tu vu
土话	tu hx
土质	tu vi
圣人	ug rf
圣地	ug di
圣旨	ug vi
圣母	ug mu
圣水	ug uv
圣诞树	ug dj uu
在先	zd xm
在华	zd hx
在心	zd xb
在押犯	zd ya fj
在教	zd jn
在校生	zd xn ug
在此	zd ci
在读	zd du
在逃犯	zd tc fj
在野党	zd ye dh
圪垯	ge da
地下室	di xx ui
地下水	di xx uv
地中海	di vs hd
地价	di jx
地利	di li
地力	di li
地动仪	di ds yi
地势	di ui
地区性	di qu xk
地图集	de tu ji
地图集	di tu ji
地块	di kk
地域	di yu
地基	di ji
地处	di iu
地头	di tz
地头虫	de tz is
地头虫	di tz is
地委	di ww
地学	di xt
地层	di cg
地市	de ui
地市	di ui
地形图	di xk tu
地心	di xb
地摊	di tj
地支	di vi
地方志	di fh vi
地方戏	di fh xi
地方病	di fh bk
地方税	di fh uv
地狱	di yu
地球仪	di qq yi
地理学	di li xt
地界	di jp
地痞	di pi
地矿	di kl
地磁	di ci
地租	di zu
地空	de ks
地空	di ks
地窖	di jn
地胆	de dj
地胆	di dj
地膜	di mo
地表水	di bn uv
地质	di vi
地道战	di dc vj
地面水	di mm uv
圹埌	kl lh
场子	ih zi
场站	ih vj
场长	ih vh
场院	ih yr
均势	jy ui
均居	jy ju
均应	jy yk
均真	jy vf
坎坎坷坷	kj kj ke ke
坎坷不平	kj ke bu pk
坎头埋墙	kj tz md ql
坎头埋墙	kj tz mj ql
坏书	hk uu
坐以待旦	zo yi dd dj
坐像	zo xl
坐商	zo uh
坐坐	zo zo
坐失	zo ui
坐定粒六	zo dk li lq
坐定粒六	zo dk li lu
坐视	zo ui
坐霸王车	zo ba wh ie
坐霸王车	zo ba wh ju
块状	kk vl
坚冰	jm bk
坚定	jm dk
坚实	jm ui
坚忍不拔	jm rf bu ba
坚持不渝	jm ii bu yu
坚果	jm go
坚毅	jm yi
坚苦卓绝	jm ku vo jt
坚韧	jm rf
坛子	tj zi
坟头	ff tz
坟茔	ff yk
坦桑尼亚	tj sh ni ya
坦诚相见	tj ig xl jm
坦途	tj tu
坷垃	ke la
垃圾参	la ji cj
垃圾参	la ji uf
垓埏	gd uj
垓埏	gd yj
垫子	dm zi
埋便	md bm
埋便	md pm
埋便	mj bm
埋便	mj pm
埋单	md dj
埋尾	md ww
埋尾	mj ww
埋数	md uu
埋数	mj uu
埋站	md vj
埋站	mj vj
城关	ig gr
城根	ig gf
城郊	ig jn
城郭	ig go
城里	ig li
城里人	ig li rf
城防	ig fh
城际	ig ji
埕埕塔塔	ig ig ta ta
培土	pw tu
培植	pw vi
培训班	pw xy bj
基于	ji yu
基围虾	ji ww xx
基址	ji vi
基干	ji gj
基建	ji jm
基数	ji uu
基本上	ji bf uh
基本功	ji bf gs
基本法	ji bf fa
基点	ji dm
基督	ji du
基石	ji ui
基础课	ji iu ke
基站	ji vj
基线	ji xm
基诺	ji no
基辅	ji fu
基金会	ji jb hv
堂倌	th gr
堂吃	th ii
堂座	th zo
堆放	dv fh
堆砌	dv qi
堤坝	di ba
堤溃蚁穴	di kv yi xt
堤防	di fh
堪称	kj ig
堪称一绝	kj ig yi jt
堵住	du vu
塌方	ta fh
塑料布	su ln bu
塑料管	su ln gr
塔吉克	ta ji ke
塔吉克族	ta ji ke zu
塔斯社	ta si ue
塔里木	ta li mu
塞失马盲人瞎马	sd ui ma mh rf xx ma
塞失马盲人瞎马	se ui ma mh rf xx ma
塞浦露斯	sd pu lu si
塞浦露斯	sd pu lz si
塞浦露斯	se pu lu si
塞浦露斯	se pu lz si
填平	tm pk
填料	tm ln
填空	tm ks
填词	tm ci
境地	jk di
境遇	jk yu
墒情	uh qk
墓地	mu di
墓室	mu ui
墓志	mu vi
墓道	mu dc
墙基	ql ji
墙报	ql bc
墙脚	ql jn
增常	zg ih
增殖	zg vi
增至	zg vi
增速	zg su
增长率	zg vh lv
墟冚	xu kj
墨盒	mo he
墨绿色	mo lv se
壁炉	bi lu
壁画	bi hx
壁纸	bi vi
壅蔽	ys bi
士多啤梨	ui do pi li
士多房	ui do fh
士大夫	ui da fu
士巴拿	ui ba na
士担	ui dj
士气	ui qi
士碌架	ui lu jx
士达胆	ui da dj
壬午	rf wu
壬子	rf zi
壬寅	rf yb
壬戌	rf xu
壬申	rf uf
壬辰	rf if
壮士	vl ui
壮实	vl ui
壮志	vl vi
壮歌	vl ge
声势	ug ui
声名大振	ug mk da vf
声名大振	ug mk dd vf
声威	ug ww
声学	ug xt
声张	ug vh
声息	ug xi
声振寰宇	ug vf hr yu
声浪	ug lh
声称	ug ig
声符	ug fu
声誉	ug yu
声誉鹊起	ug yu qt qi
声速	ug su
处世	iu ui
处事	iu ui
处决	iu jt
处境	iu jk
处女作	iu nv zo
处女地	iu nv di
处方	iu fh
处理机	iu li ji
处罚	iu fa
备件	bw jm
备忘录	bw wh lu
备料	bw ln
备考	bw kc
备耕	bw gg
备课	bw ke
备足	bw zu
备齐	bw qi
复信	fu xb
复写	fu xp
复函	fu hj
复刊	fu kj
复制品	fu vi pb
复印机	fu yb ji
复合	fu he
复员	fu yr
复审	fu uf
复旦	fu dj
复杂性	fu za xk
复查	fu ia
复核	fu he
复种	fu vs
复线	fu xm
复议	fu yi
复试	fu ui
复读	fu du
复赛	fu sd
复辟	fu bi
复述	fu uu
夏令营	xx lk yk
夏利	xx li
夏夜	xx ye
夏收	xx uz
夏新	xx xb
夏种	xx vs
夏粮	xx ll
夏雨雨人	xx yu yu rf
夕阳西斜	xi yh xi xp
外乡	wd xl
外乡人	wd xl rf
外交部	wd jn bu
外伤	wd uh
外侮	wd wu
外向型	wd xl xk
外地人	wd di rf
外埠	wd bu
外带	wd dd
外敌	wd di
外敷	wd fu
外来人	wd ld rf
外来户	wd ld hu
外柔中刚	wd rz vs gh
外母	wd mu
外汇券	wd hv qr
外甥	wd ug
外相	wd xl
外祖父	wd zu fu
外线	wd xm
外经	wd jk
外貌	wd mc
外逃	wd tc
外遇	wd yu
多一尐	do yi di
多于	do yu
多价	do jp
多价	do jx
多位	do ww
多办	do bj
多只香炉多只鬼	do vi xl lu do vi gv
多哥	do ge
多国	do go
多多少少	do do uc uc
多多益善	do do yi uj
多媒体	do mw ti
多得	do de
多得	do dw
多方面	do fh mm
多样化	do yh hx
多样性	do yh xk
多民族	do mb zu
多种多样	do vs do yh
多糖	do th
多级	do ji
多边	do bm
多面手	do mm uz
夜冷	ye lg
夜宿	ye su
夜市	ye ui
夜幕低垂	ye mu di iv
夜总会	ye zs hv
夜战	ye vj
夜明珠	ye mk vu
夜晚黑	ye wj hw
夜景	ye jk
夜校	ye xn
夜游	ye yz
夜色柔美	ye se rz mw
夜色柔美	ye ud rz mw
夜色迷人	ye se mi rf
夜色迷人	ye ud mi rf
夜莺	ye yk
夜麻麻	ye ma ma
够照	gz vc
够皮	gz pi
够胆死	gz dj si
大一统	da yi ts
大专生	da vr ug
大业	da ye
大个仔	da ge zd
大个仔	da ge zi
大个仔	dd ge zd
大个仔	dd ge zi
大为	da ww
大举	da ju
大义	da yi
大乡里	da xl li
大乡里	dd xl li
大书特书	da uu te uu
大事记	da ui ji
大人	da rf
大人大姐	da rf da jp
大人大姐	da rf dd jp
大人大姐	dd rf da jp
大人大姐	dd rf dd jp
大件事	da jm ui
大件事	dd jm ui
大任	da rf
大任	dd rf
大伙	da ho
大会堂	da hv th
大作家	da zo jx
大使	da ui
大使馆	da ui gr
大侠	da xx
大便	da bm
大信封	da xb fg
大信封	dd xb fg
大做文章	da zo wf vh
大光灯	da gl dg
大光灯	dd gl dg
大全	da qr
大关	da gr
大兴	da xk
大兵	da bk
大兵团	da bk tr
大刀	da dc
大别山	da bp uj
大剂	da ji
大剂	dd ji
大副	da fu
大力	da li
大力士	da li ui
大办	da bj
大动脉	da ds md
大势	da ui
大半	da bj
大厅	da tk
大叔	da uu
大只佬	da vi lc
大只佬	dd vi lc
大只讲	da vi jl
大只讲	dd vi jl
大只骡骡	da vi lo lo
大只骡骡	dd vi lo lo
大号	da hc
大吃大喝	da ii da he
大同	da ts
大后方	da hz fh
大后日	da hz ri
大后日	dd hz ri
大唐	da th
大唐	dd th
大唔透	da wu tz
大唔透	dd wu tz
大喊十	da hj ui
大喊十	dd hj ui
大喜事	da xi ui
大嘥	da sd
大嘥	dd sd
大器	da qi
大团圆	da tr yr
大团结	da tr jp
大坝	da ba
大型机	da xk ji
大声公	da ug gs
大声公	dd ug gs
大处着眼	da iu vc yj
大处着眼	da iu ve yj
大处着眼	da iu vo yj
大处着眼	dd iu vc yj
大处着眼	dd iu ve yj
大处着眼	dd iu vo yj
大多数	da do uu
大大小小	da da xn xn
大大小小	da dd xn xn
大大小小	dd da xn xn
大大小小	dd dd xn xn
大大话话	da da hx hx
大大话话	da dd hx hx
大大话话	dd da hx hx
大大话话	dd dd hx hx
大头佛	da tz fo
大头佛	da tz fu
大头佛	dd tz fo
大头佛	dd tz fu
大头虾	da tz xx
大头虾	dd tz xx
大奖赛	da jl sd
大好山河	da hc uj he
大好山河	dd hc uj he
大妈	da ma
大妗姐	da jb jp
大妗姐	dd jb jp
大姐	da jp
大姐仔	da jp zd
大姐仔	da jp zi
大姐仔	dd jp zd
大姐仔	dd jp zi
大姑娘	da gu nl
大婆	da po
大婆	dd po
大嫂	da sc
大字	da zi
大字报	da zi bc
大客车	da ke ie
大家庭	da jx tk
大寨	da vd
大将	da jl
大小便	da xn bm
大展	da vj
大师	da ui
大师傅	da ui fu
大帝	da di
大帝	dd di
大幅	da fu
大幅度	da fu du
大干	da gj
大床	da il
大床	dd il
大志	da vi
大懵	da mg
大懵	dd mg
大戏	da xi
大手笔	da uz bi
大打出手	da da iu uz
大抵	da di
大拇指	da mu vi
大拿拿	da na na
大拿拿	dd na na
大捷	da jp
大政	da vg
大敌	da di
大新	da xb
大旱	da hj
大智大勇	da vi da ys
大曲	da qu
大有文章	da yz wf vh
大杀三方	da ua sj fh
大杀三方	dd ua sj fh
大杂院	da za yr
大校	da xn
大梁	da ll
大棒	da bh
大模斯样	da mo si yh
大模斯样	da mu si yh
大模斯样	dd mo si yh
大模斯样	dd mu si yh
大殿	da dm
大气候	da qi hz
大水	da uv
大汉	da hj
大汗淋漓	da hj lb li
大法	da fa
大渡河	da du he
大漠	da mo
大潮	da ic
大炮友	da bc yz
大炮友	da pc yz
大炮友	dd bc yz
大炮友	dd pc yz
大牌档	da pd dh
大牌档	dd pd dh
大猩猩	da xk xk
大班	da bj
大理	da li
大田	da tm
大略	da lt
大癫大废	da dm da fw
大癫大废	da dm dd fw
大癫大废	dd dm da fw
大癫大废	dd dm dd fw
大白	da bd
大白菜	da bd cd
大石责死蟹	da dj ze si xp
大石责死蟹	da ui ze si xp
大石责死蟹	dd dj ze si xp
大石责死蟹	dd ui ze si xp
大破悭囊	da po qm nh
大破悭囊	dd po qm nh
大礼堂	da li th
大祸	da ho
大禹	da yu
大禹	dd yu
大笑	da xn
大笑姑婆	da xn gu po
大笑姑婆	dd xn gu po
大粒佬	da li lc
大粒佬	dd li lc
大细超	da xi ic
大细超	dd xi ic
大老倌	da lc gr
大老倌	dd lc gr
大耳窿	da er ls
大耳窿	dd er ls
大肆	da si
大脚	da jn
大腕	da wj
大自然	da zi rj
大花大朵	da hx da do
大花大朵	da hx dd do
大花大朵	dd hx da do
大花大朵	dd hx dd do
大花筒	da hx ts
大花筒	dd hx ts
大茶饭	da ia fj
大茶饭	dd ia fj
大菜	da cd
大葵扇	da kv uj
大葵扇	dd kv uj
大蒜	da sr
大虾	da xx
大衣	da yi
大西北	da xi bw
大要	da yc
大观	da gr
大规模	da gv mo
大觉瞓	da jn ff
大觉瞓	da jn xy
大觉瞓	da jt ff
大觉瞓	da jt xy
大觉瞓	dd jn ff
大觉瞓	dd jn xy
大觉瞓	dd jt ff
大觉瞓	dd jt xy
大计	da ji
大豆芽	da dz ya
大豆芽	dd dz ya
大败	da bd
大跃进	da yt jb
大路	da lu
大路货	da lu ho
大踏步	da ta bu
大轰大嗡	da hs da wg
大过	da go
大道	da dc
大部	da bu
大部分	da bu ff
大都	da du
大都	da dz
大钱	da qm
大镬饭	da ho fj
大镬饭	dd ho fj
大阪	da bj
大阵仗	da vf vh
大阵仗	dd vf vh
大陆架	da lu jx
大雅	da ya
大雨	da yu
大雨滂沱	da yu ph to
大雨滂沱	dd yu ph to
大雪	da xt
大雪封山	da xt fg uj
大雪封山	dd xt fg uj
大雪纷飞	da xt ff fw
大雾	da wu
大革命	da ge mk
大飞	da fw
大飞	dd fw
大食会	da si hv
大食会	da si kk
大食会	da ui hv
大食会	da ui kk
大食会	da yi hv
大食会	da yi kk
大食会	dd si hv
大食会	dd si kk
大食会	dd ui hv
大食会	dd ui kk
大食会	dd yi hv
大食会	dd yi kk
大食懒	da si lj
大食懒	da ui lj
大食懒	da yi lj
大食懒	dd si lj
大食懒	dd ui lj
大食懒	dd yi lj
大饼	da bk
大髀	da bi
大髀	dd bi
大鱼	da yu
大鱼	dd yu
大鸡唔食细米	da ji wu si xi mi
大鸡唔食细米	da ji wu ui xi mi
大鸡唔食细米	da ji wu yi xi mi
大鸡唔食细米	dd ji wu si xi mi
大鸡唔食细米	dd ji wu ui xi mi
大鸡唔食细米	dd ji wu yi xi mi
大麦	da md
大麻	da ma
大鼓	da gu
天上人间	tm uh rf jm
天不怕	tm bu pa
天主	tm vu
天井	tm jk
天仙	tm xm
天仙局	tm xm ju
天公	tm gs
天兵天将	tm bk tm jl
天南海北	tm nj hd bw
天命	tm mk
天堂尿壶全神贯注	tm th nn hu qr uf gr vu
天堑	tm qm
天外有天	tm wd yz tm
天女散花	tm nv sj hx
天崩地塌	tm bg de ta
天崩地塌	tm bg di ta
天府	tm fu
天敌	tm di
天数	tm uu
天文学	tm wf xt
天文馆	tm wf gr
天时	tm ui
天时冷	tm ui lg
天时暑热	tm ui uu re
天时热	tm ui re
天极	tm ji
天梯	tm ti
天棚	tm pg
天津市	tm jb ui
天涯比邻	tm ya bi lb
天生天养	tm ug tm yh
天穹	tm qs
天网恢恢疏而不漏	tm wh hv hv uu er bu lz
天职	tm vi
天脚底	tm jn di
天象	tm xl
天资	tm zi
天遂人愿	tm sv rf yr
天际	tm ji
天险	tm xm
天马行空	tm ma xk ks
天高云淡	tm gc yy dj
太原	td yr
太原市	td yr ui
太和	td he
太和	td ho
太和	td hu
太子爷	td zi ye
太守	td uz
太平天国	td pk tm go
太平绅士	td pk uf ui
太庙	td mn
太行山	td hh uj
夫子	fu zi
央视	yh ui
失业	ui ye
失主	ui vu
失事	ui ui
失利	ui li
失地	ui di
失声	ui ug
失学	ui xt
失守	ui uz
失实	ui ui
失常	ui ih
失态	ui td
失惊无神	ui jk mo uf
失惊无神	ui jk wu uf
失意	ui yi
失掉	ui dn
失控	ui ks
失散	ui sj
失明	ui mk
失火	ui ho
失物	ui wu
失真	ui vf
失礼	ui li
失禁	ui jb
失职	ui vi
失聪	ui cs
失血	ui xt
失觉	ui jn
失觉	ui jt
失语	ui yu
失误	ui wu
失足	ui zu
失身	ui uf
失重	ui vs
失魂鱼	ui hy yu
头人	tz rf
头啖汤	tz dj th
头壳顶	tz ke dk
头壳顶	tz qn dk
头大冇脑	tz da mc nc
头大冇脑	tz dd mc nc
头头	tz tz
头子	tz zi
头崩额裂	tz bg ee lp
头拧拧	tz nk nk
头槌	tz iv
头球	tz qq
头盔	tz kv
头盖骨	tz gd gu
头羊	tz yh
头耷耷	tz da da
头蜡	tz la
头赤	tz ii
头雁	tz yj
头面人物	tz mm rf wu
头颅	tz lu
头饰	tz ui
夸父追日	kx fu vv ri
夹份	ga ff
夹份	jx ff
夹击	jx ji
夹子	jx zi
夹手夹脚	ga uz ga jn
夹手夹脚	ga uz jx jn
夹手夹脚	jx uz ga jn
夹手夹脚	jx uz jx jn
夹板	jx bj
夹硬	ga yk
夹硬	jx yk
夹道	jx dc
夺魁	do kv
奀瘦	en uz
奀瘦	nf uz
奀袅鬼命	en nn gv mk
奀袅鬼命	nf nn gv mk
奀雌雌	en ci ci
奀雌雌	nf ci ci
奄列	yj lp
奄尖	yj jm
奇丽	qi li
奇事	qi ui
奇兵	qi bk
奇功	qi gs
奇境	ji jk
奇境	qi jk
奇峰	qi fg
奇巧	qi qn
奇才	qi cd
奇景	qi jk
奇瑞	ji rv
奇瑞	qi rv
奇花异果	ji hx yi go
奇花异果	qi hx yi go
奇袭	qi xi
奇观	qi gr
奇遇	qi yu
奇闻	qi wf
奉之	fg vi
奉命唯谨	fg mk ww jb
奉旨成婚	fg vi ig hy
奋力	ff li
奋发	ff fa
奋发有为	ff fa yz ww
奋发蹈厉	ff fa dc li
奋笔疾书	ff bi ji uu
奋起	ff qi
奏折	zz ve
奏鸣曲	zz mk qu
契弟	qi di
契弟	xp di
契机	qi ji
契税	qi uv
契约	qi yt
契阔	qi ko
契阔	xp ko
奔扑	bf pu
奔袭	bf xi
奔走相告	bf zz xl gc
奖学金	jl xt jb
奖罚分明	jl fa ff mk
套印	tc yb
套房	tc fh
套种	tc vs
套话	tc hx
套购	tc gz
套近乎	tc jb hu
奠基	dm ji
奢侈品	ue ii pb
奥美	ao mw
女中音	nv vs yb
女主人	nv vu rf
女仔之家	nv zd vi jx
女仔之家	nv zi vi jx
女娲	nv wa
女式	nv ui
女星	nv xk
女界	nv jp
女真	nv vf
女童院	nv ts yr
女高音	nv gc yb
奴隶	nu li
奴隶制	nu li vi
奴隶社会	nu li ue hv
奶制品	nd vi pb
奸商	jm uh
奸猫	jm mc
奸赖	jm ld
她们	ta mf
好不	hc bu
好人事	hc rf ui
好人好事	hc rf hc ui
好使	hc ui
好受	hc uz
好嘅	hc ge
好嘢	hc ye
好地地	hc de de
好地地	hc de di
好地地	hc di de
好地地	hc di di
好处费	hc iu fw
好多时	hc do ui
好夹	hc ga
好夹	hc jx
好好先生	hc hc xm ug
好容易	hc rs yi
好强	hc ql
好心机	hc xb ji
好找	hc vc
好日子	hc ri zi
好消息	hc xn xi
好眼界	hc yj jp
好端端	hc dr dr
好翻	hc fj
好胜	hc ug
好话	hc hx
好象	hc xl
好问则裕	hc wf ze yu
好闲	hc xm
如临探渊	ru lb tj yr
如常	ru ih
如故	ru gu
如醉如痴	ru zv ru ii
妄言	wh yj
妇人	fu rf
妇幼	fu yz
妈妈声	ma ma ug
妊娠	rf uf
妒嫉	du ji
妓院	ji yr
妖冶	yc ye
妙曼	mn mj
妲己	da ji
妹钉	mw dk
姊夫	zi fu
始于	ui yu
始发	ui fa
始发站	ui fa vj
始建	ui jm
始祖	ui zu
始终不渝	ui vs bu yu
姐手姐脚	jp uz jp jn
姑勿论	gu wu ly
姑息	gu xi
姑爷仔	gu ye zd
姑爷仔	gu ye zi
姓氏	xk ui
姓赖	xk ld
委任	ww rf
委员会	ww yr hv
委员长	ww yr vh
委实	ww ui
委托书	ww to uu
委托人	ww to rf
委曲	ww qu
委蛇	ww ue
姗姗	uj uj
姗姗来迟	uj uj ld ii
姚明	yc mk
姜酌	jl vo
姜醋	jl cu
姣尸扽笃	jn ui df du
姣尸扽笃	xn ui df du
姨仔	yi zd
姨仔	yi zi
姨甥	yi ug
姻娅	yb ya
姽婳	gv hx
姿容	zi rs
威化饼	ww hx bk
威吓	ww he
威士	ww ui
威士忌	ww ui ji
威廉	ww lm
威望素着	ww wh su vc
威望素着	ww wh su ve
威望素着	ww wh su vo
威海	ww hd
威盛	ww ig
威盛	ww ug
威逼	ww bi
威震天下	ww vf tm xx
威风	ww fg
威风八面	ww fg ba mm
娃子	wa zi
娇小	jn xn
娇气	jn qi
娇艳	jn yj
娓娓	ww ww
娘子军	nl zi jy
娼妓	ih ji
婉娩	wj mm
婉言	wj yj
婕妤	jp yu
婚丧嫁娶	hy sh jx qu
婚姻法	hy yb fa
婞直	xk vi
婵媛	ij yr
婵连	ij lm
媒人	mw rf
媞媞	ti ti
嫁人	jx rf
嫁妆	jx vl
嫁衣	jx yi
嫖赌饮吹	pn du yb iv
嫡系	di xi
嬉笑	xi xn
嬉闹	xi nc
嬲爆爆	nn bc bc
子公司	zi gs si
子午线	zi wu xm
子姜	zi jl
子弟兵	zi di bk
子母床	zi mu il
子系统	zi xi ts
子集	zi ji
孑孓	jp jt
孔府	ks fu
孔隙	ks xi
孔雀	ks qt
孕期	yy qi
孖公仔	ma gs zd
孖公仔	ma gs zi
孖公仔	zi gs zd
孖公仔	zi gs zi
孖女	ma nv
孖女	zi nv
孖烟通	ma yj ts
孖烟通	zi yj ts
孖生	ma ug
孖生	zi ug
孖辫	ma bm
孖辫	zi bm
孖铺	ma pu
孖铺	zi pu
字句	zi ju
字号	zi hc
字幕	zi mu
字序	zi xu
字形	zi xk
字样	zi yh
字粒	zi li
字花	zi hx
字距	zi ju
字迹	zi ji
字集	zi ji
字音	zi yb
存储器	cy iu qi
存栏	cy lj
存货	cy ho
孙中山	sy vs uj
孙文	sy wf
孙权	sy qr
孙武	sy wu
孙氏	sy ui
孙膑	sy bb
孝子	xn zi
孝心	xn xb
孟加拉国	mg jx la go
孢子	bc zi
季刊	ji kj
季节性	ji jp xk
季风	ji fg
孤云野鹤	gu yy ye he
孤寂	gu ji
孤寡老人	gu gx lc rf
孤拐	gu gk
孤本	gu bf
孤立	gu li
孤身一人	gu uf yi rf
学业	xt ye
学习班	xt xi bj
学分制	xt ff vi
学制	xt vi
学力	xt li
学友	xt yz
学员	xt yr
学堂	xt th
学士	xt ui
学好	xt hc
学子	xt zi
学师仔	xt ui zd
学师仔	xt ui zi
学时	xt ui
学有专长	xt yz vr ih
学有所成	xt yz so ig
学术性	xt uu xk
学术界	xt uu jp
学杂费	xt za fw
学生会	xt ug hv
学生哥	xt ug ge
学生证	xt ug vg
学童	xt ts
学籍	xt ji
学而不倦	xt er bu jr
学贯中西	xt gr vs xi
学部	xt bu
孩子王	hd zi wh
孰不可忍	uu bu ke rf
孳生	zi ug
宁为玉碎不为瓦全	nk ww yu sv bu ww wa qr
宁折不弯	nk ue bu wj
宁折不弯	nk ve bu wj
宅基地	vd ji di
宇宙观	yu vz gr
宇航员	yu hh yr
守军	uz jy
守势	uz ui
守卫	uz ww
守土有责	uz tu yz ze
守备	uz bw
守宫	uz gs
守敌	uz di
守正不阿	uz vg bu aa
守正不阿	uz vg bu ee
守法	uz fa
守经达权	uz jk da qr
守行为	uz hh ww
守行为	uz xk ww
守门员	uz mf yr
安份守己	an ff uz ji
安保	an bc
安内攘外	an nw rh wd
安南	an nj
安士	an ui
安妮	an ni
安徒生	an tu ug
安老院	an lc yr
安腾	an tg
安达	an da
宋庆龄	ss qk lk
宋明理学	ss mk li xt
宋楚瑜	ss iu yu
完好无损	wj hc wu sy
完小	wj xn
完税	wj uv
宏亮	hs ll
宏基	hs ji
宗师	zs ui
宗旨	zs vi
宗法	zs fa
官仔骨骨	gr zd gu gu
官仔骨骨	gr zi gu gu
官吏	gr li
官商	gr uh
官气	gr qi
官渡	gr du
官职	gr vi
官衔	gr xm
宙斯	vz si
定单	dk dj
定单	dk ij
定单	dk uj
定夺	dk do
定局	dk ju
定居点	dk ju dm
定性	dk xk
定晒形	dk ud xk
定理	dk li
定盘星	dk pj xk
定神	dk uf
定级	dk ji
定西	dk xi
定货	dk ho
定购	dk gz
定过抬油	dk go td yz
宜于	yi yu
宜人	yi rf
宜兴	yi xk
宜得	yi de
宜得	yi dw
宜昌	yi ih
宝刀	bc dc
宝剑	bc jm
宝安	bc an
宝岛	bc dc
宝洁	bc jp
宝玉	bc yu
宝珠	bc vu
实业	ui ye
实习生	ui xi ug
实事	ui ui
实例	ui li
实净	ui jk
实名	ui mk
实地	ui di
实处	ui iu
实心	ui xb
实情	ui qk
实打实	ui da ui
实招	ui vc
实效	ui xn
实时	ui ui
实测	ui ce
实牙实齿	ui ya ui ii
实物	ui wu
实用	ui ys
实职	ui vi
实证	ui vg
实达	ui da
实验室	ui yj ui
审判员	uf pj yr
审判庭	uf pj tk
审察	uf ia
审慎	uf uf
审时度势	uf ui do ui
审校	uf jn
审校	uf xn
审稿	uf gc
审美观	uf mw gr
审视	uf ui
客体	ke ti
客座	ke zo
客服	ke fu
客机	ke ji
客流量	ke lq ll
客船	ke ir
客观性	ke gr xk
客货	ke ho
客运站	ke yy vj
宣传员	xr ir yr
宣传品	xr ir pb
宣传画	xr ir hx
宣传部	xr ir bu
宣传队	xr ir dv
宣战	xr vj
宣纸	xr vi
宣统	xr ts
室内乐	ui nw yt
宪兵	xm bk
宪政	xm vg
宪章	xm vh
宫殿	gs dm
宴席	yj xi
宴请	yj qk
家丁	jx dk
家世	jx ui
家中	jx vs
家乡话	jx xl hx
家书	jx uu
家事	jx ui
家什	jx ui
家信	jx xb
家俬	jx si
家务活	jx wu ho
家史	jx ui
家婆	jx po
家嫂	jx sc
家宴	jx yj
家家	jx jx
家小	jx xn
家居	jx ju
家常便饭	jx ih bm fj
家法	jx fa
家访	jx fh
家长制	jx vh vi
家风	jx fg
容光	rs gl
宽余	kr yu
宽大为怀	kr da ww hk
宽打窄用	kr da vd ys
宾妹	bb mw
宿命论	su mk ly
宿将	su jl
宿愿	su yr
宿敌	su di
寂然无声	ji rj mo ug
寂然无声	ji rj wu ug
寄予	ji yu
寄信	ji xb
寄宿	ji su
寄居	ji ju
寄语	ji yu
寅吃卯粮	yb ii mc ll
密不可分	mi bu ke ff
密件	mi jm
密友	mi yz
密密	mi mi
密密匝匝	mi mi za za
密密麻麻	mi mi ma ma
密布	mi bu
密底算盘	mi di sr pj
密植	mi vi
密歇根	mi xp gf
密电	mi dm
密笼	mi ls
密质质	mi vi vi
密闭	mi bi
密集型	mi ji xk
富丽	fu li
富于	fu yu
富人	fu rf
富余	fu yu
富士	fu ui
富士康	fu ui kh
富士通	fu ui ts
富庶	fu uu
富矿	fu kl
富豪	fu hc
富贵浮云	fu gv fu yy
富饶	fu rc
寒冬腊月	hj ds la yt
寒士	hj ui
寒夜	hj ye
寒底	hj di
寒意	hj yi
寒暑	hj uu
寒暑假	hj uu jx
寒背	hj bw
寒花晚节	hj hx wj jp
寒门	hj mf
寒风刺骨	hj fg ci gu
寓于	yu yu
寓意	yu yi
寓言	yu yj
察看	ia kj
寡佬	gx lc
寡母婆	gx mu po
寤寐	wu mw
寥寥	ln ln
寨子	vd zi
寰宇	hr yu
寰球	hr qq
寸心	cy xb
寸步不让	cy bu bu rh
对仗	dv vh
对劲	dv jb
对华	dv hx
对唔住	dv wu vu
对唱	dv ih
对外开放	dv wd kd fh
对打	dv da
对抗赛	dv kh sd
对换	dv hr
对角	dv jn
对讲机	dv jl ji
寻医	xy yi
寻机	xy ji
寻根	xy gf
导出	dc iu
导师	dc ui
导报	dc bc
导火线	dc ho xm
导言	dc yj
寿光	uz gl
寿星公	uz xk gs
寿险	uz xm
封山	fg uj
封山育林	fg uj yu lb
封建主义	fg jm vu yi
封建社会	fg jm ue hv
封豕长蛇	fg ui ih ue
封豕长蛇	fg ui vh ue
封闭式	fg bi ui
射击	ue ji
射程	ue ig
射线	ue xm
将于	jl yu
将伯之助	jl bd vi vu
将伯之助	jl bo vi vu
将士	jl ui
将官	jl gr
将就	jl jq
将才	jl cd
将有	jl yz
将近	jl jb
小两口	xn ll kz
小事	xn ui
小人	xn rf
小人物	xn rf wu
小伙	xn ho
小伙子	xn ho zi
小传	xn vr
小兄弟	xn xs di
小册子	xn ce zi
小刀	xn dc
小分队	xn ff dv
小厣	xn yj
小号	xn hc
小合唱	xn he ih
小名	xn mk
小商品	xn uh pb
小国	xn go
小圈子	xn qr zi
小夜曲	xn ye qu
小字	xn zi
小字辈	xn zi bw
小学生	xn xt ug
小家庭	xn jx tk
小将	xn jl
小小	xn xn
小小说	xn xn uo
小市民	xn ui mb
小康之家	xn kh vi jx
小弟弟	xn di di
小径	xn jk
小心谨慎	xn xb jb uf
小憩	xn qi
小户	xn hu
小数怕长计	xn uu pa ih ji
小数怕长计	xn uu pa vh ji
小日子	xn ri zi
小时	xn ui
小曲	xn qu
小朋友	xn pg yz
小溪	xn xi
小燕子	xn yj zi
小生	xn ug
小生产	xn ug ij
小百货	xn bd ho
小组长	xn zu vh
小结	xn jp
小节	xn jp
小费	xn fw
小资	xn zi
小道	xn dc
小金库	xn jb ku
小钱	xn qm
小雨	xn yu
小雪	xn xt
小青年	xn qk nm
小鞋	xn xp
小题大作	xn ti da zo
少不了	uc bu ln
少不得	uc bu de
少先队	uc xm dv
少先队员	uc xm dv yr
少壮派	uc vl pd
少尉	uc ww
少年宫	uc nm gs
少年犯	uc nm fj
少有	uc yz
尖兵	jm bk
尖刀	jm dc
尖刻	jm ke
尖尖	jm jm
尖端	jm dr
尖笔甩	jm bi uk
尖顶	jm dk
尚书	uh uu
尚属	uh uu
尚属	uh vu
尚方宝剑	uh fh bc jm
尚无	uh mo
尚无	uh wu
尚武	uh wu
尨茸	ls rs
尨茸	mg rs
尨茸	mh rs
尨茸	ph rs
就任	jq rf
就位	jq ww
就势	jq ui
就嚟	jq li
就嚟	jq lw
就学	jq xt
就已	jq yi
就职	jq vi
就脚	jq jn
就说	jq uo
就说	jq uv
就说	jq yt
尸体	ui ti
尸骨	ui gu
尺子	ii zi
尺牍	ii du
尼克松	ni ke ss
尼古丁	ni gu dk
尽人皆知	jb rf jp vi
尽可能	jb ke ng
尽地一煲	jb de yi bc
尽地一煲	jb di yi bc
尽如	jb ru
尽心尽力	jb xb jb li
尽心竭力	jb xb jp li
尽收眼底	jb uz yj di
尽职	jb vi
尾声	ww ug
尾翼	ww yi
尾随	ww sv
尾龙骨	ww ls gu
尿毒症	nn du vg
局外人	ju wd rf
局限性	ju xm xk
层层叠叠	cg cg dp dp
层峦叠嶂	cg lr dp vh
居于	ju yu
居功	ju gs
居士	ju ui
居室	ju ui
居民点	ju mb dm
居留	ju lq
居留权	ju lq qr
居留证	ju lq vg
屈尾十	qu ww ui
屈戌	qu xu
屈节辱命	qu jp ru mk
屈蛇	qu ue
屈质	qu vi
届时	jp ui
屋契	wu qi
屋契	wu xp
屋子	wu zi
屋脊	wu ji
屋角	wu jn
屎坑关刀	ui kg gr dc
屎坑关刀文唔得武唔得	ui kg gr dc wf wu de wu wu de
屎坑关刀文唔得武唔得	ui kg gr dc wf wu de wu wu dw
屎坑关刀文唔得武唔得	ui kg gr dc wf wu dw wu wu de
屎坑关刀文唔得武唔得	ui kg gr dc wf wu dw wu wu dw
屎片	ui pm
屎计	ui ji
屏息	bk xi
屏气	bk qi
屏气敛息	pk qi lm xi
展台	vj td
展室	vj ui
展览会	vj lj hv
展览馆	vj lj gr
展评	vj pk
展销会	vj xn hv
屘二	mi er
屘二	mj er
属实	uu ui
屠宰场	tu zd ih
屠户	tu hu
屯兵	ty bk
山东省	uj ds ug
山中宰相	uj vs zd xl
山乡	uj xl
山冈	uj gh
山势	uj ui
山包	uj bc
山墙	uj ql
山大斩埋有柴	uj da vj md yz id
山大斩埋有柴	uj da vj mj yz id
山大斩埋有柴	uj dd vj md yz id
山大斩埋有柴	uj dd vj mj yz id
山山水水	uj uj uv uv
山明水秀山穷水尽	uj mk uv xq uj qs uv jb
山梁	uj ll
山水画	uj uv hx
山泥倾泻	uj ni qk xp
山洞	uj ds
山海关	uj hd gr
山海经	uj hd jk
山涧	uj jm
山窿	uj ls
山脊	uj ji
山腰	uj yc
山芋	uj yu
山草药噏得就噏	uj cc yc ha de jq ha
山草药噏得就噏	uj cc yc ha de jq xi
山草药噏得就噏	uj cc yc ha dw jq ha
山草药噏得就噏	uj cc yc ha dw jq xi
山草药噏得就噏	uj cc yc xi de jq ha
山草药噏得就噏	uj cc yc xi de jq xi
山草药噏得就噏	uj cc yc xi dw jq ha
山草药噏得就噏	uj cc yc xi dw jq xi
山药蛋	uj yc dj
山西省	uj xi ug
山货	uj ho
山重水复	uj is uv fu
山重水复	uj vs uv fu
山野	uj ye
山陵	uj lk
山高水长	uj gc uv ih
山麓	uj lu
屹立	yi li
岁寒松柏	sv hj ss bd
岁寒松柏	sv hj ss bo
岂止	qi vi
岂非	qi fw
岌岌贡	ji ji gs
岛国	dc go
岛礁	dc jn
岩浆	yj jl
岩溶	yj rs
岩画	yj hx
岩石	yj ui
岳家	yt jx
岳飞	yt fw
岳高头	yt gc tz
岸防	an fh
峥嵘	vg rs
峨嵋	ee mw
峨嵋山	ee mw uj
峰值	fg vi
峰峦雄伟	fg lr xs ww
峻岭	jy lk
峻峭	jy qn
崄巇	xm xi
崇敬	is jk
崇文	is wf
崔健	cv jm
崔嵬	cv ww
崔巍	cv ww
崖广	ya gl
崚嶒	lg cg
崚嶒	lk cg
崦嵫	yj zi
崩沙	bg ua
崴嵬	ww ww
嵇康	ji kh
嵚崟	qb yb
嵯峨	co ee
嶙峋	lb xy
巉岩	ij yj
巉眼	ij yj
巍巍	ww ww
巍然	ww rj
州立	vz li
巡抚	xy fu
巡洋舰	xy yh jm
巡游	xy yz
巡诊	xy vf
巡逻艇	xy lo tk
巡逻队	xy lo dv
工业化	gs ye hx
工业区	gs ye qu
工业品	gs ye pb
工业国	gs ye go
工业界	gs ye jp
工业部	gs ye bu
工事	gs ui
工人阶级	gs rf jp ji
工伤	gs uh
工余	gs yu
工作台	gs zo td
工作团	gs zo tr
工作日	gs zo ri
工作服	gs zo fu
工作站	gs zo vj
工作组	gs zo zu
工作者	gs zo ve
工作证	gs zo vg
工作量	gs zo ll
工作间	gs zo jm
工作队	gs zo dv
工作面	gs zo mm
工兵	gs bk
工具书	gs ju uu
工农业	gs ns ye
工农兵	gs ns bk
工农联盟	gs ns lm mg
工分	gs ff
工区	gs qu
工友	gs yz
工商业	gs uh ye
工商界	gs uh jp
工商联	gs uh lm
工头	gs tz
工委	gs ww
工学院	gs xt yr
工工整整	gs gs vg vg
工效	gs xn
工整	gs vg
工时	gs ui
工潮	gs ic
工种	gs vs
工科	gs ke
工笔画	gs bi hx
工联	gs lm
工艺	gs yi
工资制	gs zi vi
左传	zo ir
左传	zo vr
左便	zo bm
左便	zo pm
左手便	zo uz bm
左手便	zo uz pm
左提右挈	zo di yz qp
左提右挈	zo ti yz qp
左翼	zo yi
左軚车	zo td ie
左軚车	zo td ju
巧干	qn gj
巧手	qn uz
巧立名目	qn li mk mu
巨响	ju xl
巨商	ju uh
巨型	ju xk
巨头	ju tz
巨子	ju zi
巨幅	ju fu
巨星	ju xk
巨细	ju xi
巨著	ju vu
巨资	ju zi
巩俐	gs li
巫峡	wu xx
巫师	wu ui
巫术	wu uu
差佬	ci lc
差佬	ia lc
差佬	id lc
差唔多	ci wu do
差唔多	ia wu do
差唔多	id wu do
差旅费	id lv fw
差迟	ci ii
差迟	ia ii
差迟	id ii
差错率	ia co lv
己丑	ji iz
己亥	ji hd
己任	ji rf
己卯	ji mc
己巳	ji si
己方	ji fh
己未	ji ww
己酉	ji yz
已久	yi jq
已知	yi vi
已获	yi ho
巴士	ba ui
巴格达	ba ge da
巴比伦	ba bi ly
巴解组织	ba jp zu vi
巴金	ba jb
巷子	xl zi
巷道	hh dc
币值	bi vi
市价	ui jx
市侩	ui kk
市值	ui vi
市内	ui nw
市区	ui qu
市县	ui xm
市委	ui ww
市属	ui uu
市布	ui bu
市府	ui fu
市电	ui dm
市盈率	ui yk lv
市辖区	ui xx qu
市郊	ui jn
市镇	ui vf
市集	ui ji
市面	ui mm
布什	bu ui
布依族	bu yi zu
布冧	bu lf
布升	bu ug
布告	bu gc
布帛蔬栗	bu bo uu li
布拉格	bu la ge
布料	bu ln
布朗	bu lh
布满	bu mj
布网	bu wh
布衣	bu yi
布衣蔬食	bu yi uu si
布衣蔬食	bu yi uu ui
布衣蔬食	bu yi uu yi
布设	bu ue
布谷鸟	bu gu nn
布达佩斯	bu da pw si
布防	bu fh
布隆迪	bu ls di
布雷	bu lw
布鞋	bu xp
帆板	fj bj
师友	ui yz
师团	ui tr
师大	ui da
师徒	ui tu
师法	ui fa
师父	ui fu
师爷	ui ye
师生员工	ui ug yr gs
师职	ui vi
师范	ui fj
师资	ui zi
师部	ui bu
希冀	xi ji
希区柯克	xi ou ke ke
希区柯克	xi qu ke ke
希特勒	xi te le
帐户	vh hu
帐目	vh mu
帕森	pa sf
帘子	lm zi
帝制	di vi
帡幪	pk mg
带兵	dd bk
带头人	dd tz rf
带子	dd zi
带宽	dd kr
带状	dd vl
带电	dd dm
带眼识人	dd yj ui rf
带眼识人	dd yj vi rf
带鱼	dd yu
席子	xi zi
帮下眼	bh xx yj
帮办	bh bj
帮教	bh jn
帷幄	ww wo
常事	ih ui
常任	ih rf
常会	ih hv
常备不懈	ih bw bu xp
常委	ih ww
常委会	ih ww hv
常州	ih vz
常抓不懈	ih vx bu xp
常数	ih uu
常理	ih li
幅员	fu yr
干休所	gj xq so
干劲	gj jb
干吗	gj ma
干妈	gj ma
干将	gj jl
干扰素	gj rc su
干支	gj vi
干果	gj go
干渠	gj qu
干湿褛	gj ui lv
干电池	gj dm ii
干系	gj xi
干群	gj qy
干脆利落	gj cv li lo
干草	gj cc
干警	gj jk
干预	gj yu
干鲜果	gj xm go
平价	pk jx
平信	pk xb
平分	pk ff
平反	pk fj
平均主义	pk jy vu yi
平均值	pk jy vi
平均数	pk jy uu
平安米	pk an mi
平定	pk dk
平实	pk ui
平局	pk ju
平平	pk pk
平平常常	pk pk ih ih
平心静气	pk xb jk qi
平房	pk fh
平整	pk vg
平易	pk yi
平正	pk vg
平沽	pk gu
平炉	pk lu
平视	pk ui
平顶山	pk dk uj
年下	nm xx
年事已高	nm ui yi gc
年产值	nm ij vi
年产量	nm ij ll
年历	nm li
年头	nm tz
年岁	nm sv
年成	nm ig
年景	nm jk
年率	nm lv
年画	nm hx
年货	nm ho
年轻气盛	nm qk qi ug
年鉴	nm jm
年间	nm jm
年青	nm qk
年青人	nm qk rf
年饭	nm fj
并发	bk fa
并发症	bk fa vg
并立	bk li
并网	bk wh
并能	bk ng
并行不悖	bk xk bu bw
并请	bk qk
幸事	xk ui
幸存者	xk cy ve
幻影	hr yk
幻灯片	hr dg pm
幼子	yz zi
幼学壮行	yz xt vl hh
幼学壮行	yz xt vl xk
幼小	yz xn
幼师	yz ui
幼教	yz jn
幼芽	yz ya
幽会	yz hv
幽幽	yz yz
幽深	yz uf
幽门	yz mf
幽雅	yz ya
幽香	yz xl
幽默感	yz mo gj
广东省	gl ds ug
广交会	gl jn hv
广博	gl bo
广州市	gl vz ui
广播剧	gl bo ju
广播员	gl bo yr
广电	gl dm
广达	gl da
庄园	vl yr
庄户人	vl hu rf
庄稼	vl jx
庄稼人	vl jx rf
庄稼地	vl jx di
庄稼汉	vl jx hj
庆典	qk dm
庆功	qk gs
庆幸	qk xk
床下底	il xx di
床笫	il zi
序跋	xu ba
库区	ku qu
库容	ku rs
应从	yk cs
应允	yk yy
应力	yk li
应届	yk jp
应得	yk de
应战	yk vj
应有	yk yz
应试	yk ui
应运	yk yy
底下	di xx
底子	di zi
底板	di bj
底气	di qi
底盘	di pj
底肥	di fw
底衫	di uj
底衫裤	di uj ku
底部	di bu
店员	dm yr
店堂	dm th
店家	dm jx
庙会	mn hv
庙宇	mn yu
庚午	gg wu
庚子	gg zi
庚寅	gg yb
庚戌	gg xu
庚申	gg uf
庚辰	gg if
府上	fu uh
府第	fu di
府邸	fu di
废弃物	fw qi wu
废料	fw ln
废止	fw vi
废气	fw qi
废油	fw yz
度假	du jx
度假屋	do jx wu
度假屋	du jx wu
度数	du uu
度身订造	do uf dk zc
度身订造	du uf dk zc
度量	du ll
度量衡	du ll hg
座右铭	zo yz mk
座次	zo ci
座谈会	zo tj hv
庭园	tk yr
庭审	tk uf
庭院	tk yr
康健	kh jm
康宁	kh nk
康庄大道	kh vl da dc
康有为	kh yz ww
庸中佼佼	ys vs jn jn
庸人	ys rf
庸医	ys yi
庸庸碌碌	ys ys lu lu
廉正	lm vg
廉洁	lm jp
廉记	lm ji
延吉	yj ji
延误	yj wu
建于	jm yu
建交	jm jn
建制	jm vi
建国	jm go
建工	jm gs
建成	jm ig
建材	jm cd
建树	jm uu
建站	jm vj
建筑业	jm vu ye
建设性	jm ue xk
建设者	jm ue ve
建起	jm qi
建都	jm du
开便	kd bm
开便	kd pm
开出	kd iu
开刀	kd dc
开列	kd lp
开化	kd hx
开发区	kd fa qu
开喉	kd hz
开国	kd go
开市	kd ui
开幕词	kd mu ci
开征	kd vg
开心见诚	kd xb jm ig
开战	kd vj
开方	kd fh
开曼	kd mj
开架	kd jx
开眼	kd yj
开矿	kd kl
开禁	kd jb
开脱	kd to
开航	kd hh
开讲	kd jl
开诚相见	kd ig xl jm
开道	kd dc
开镰	kd lm
开门红	kd mf hs
异乡	yi xl
异化	yi hx
异味	yi ww
异域	yi yu
异己	yi ji
异彩	yi cd
异性	yi xk
异族	yi zu
异样	yi yh
异步	yi bu
异物	yi wu
异端	yi dr
异类	yi lw
异议	yi yi
弃旧图新	qi jq tu xb
弃权	qi qr
弃置	qi vi
弃若敝屐	qi ro bi ji
弄堂	ls th
式微	ui ww
弓箭	gs jm
引人	yb rf
引人注意	yb rf vu yi
引人深思	yb rf uf si
引信	yb xb
引力	yb li
引向	yb xl
引咎自责	yb jq zi ze
引子	yb zi
引水	yb uv
引渡	yb du
引申	yb uf
引种	yb vs
引线	yb xm
引航	yb hh
引资	yb zi
引路	yb lu
引退	yb tv
引锥刺股	yb vv ci gu
弘毅	hs yi
弟媳	di xi
张大	vh da
张大	vh dd
张天师遇鬼迷	vh tm ui yu gv mi
张家界	vh jx jp
弧形	hu xk
弯弯	wj wj
弯弯曲曲	wj wj qu qu
弹琴	dj qb
弹琴	tj qb
弹词	tj ci
弹道	dj dc
强人	ql rf
强健	ql jm
强占	ql vj
强压	ql ya
强手	ql uz
强有力	ql yz li
强权政治	ql qr vg vi
强渡	ql du
强风	ql fg
归于	gv yu
归入	gv ru
归公	gv gs
归根结蒂	gv gf jp di
归程	gv ig
归途	gv tu
当佢冇到	dh ko mc dc
当佢冇到	dh qu mc dc
当做	dh zo
当地人	dh di rf
当家作主	dh jx zo vu
当政	dh vg
当班	dh bj
当衰	dh uk
当道	dh dc
录像机	lu xl ji
录像片	lu xl pm
录音带	lu yb dd
录音棚	lu yb pg
形势逼人	xk ui bi rf
形容词	xk rs ci
形式主义	xk ui vu yi
彤云密布九霄云外	ts yy mi bu jq xn yy wd
彩云满天	cd yy mj tm
彩卷	cd jr
彩数	cd uu
彩旗	cd qi
彩灯	cd dg
彩画	cd hx
彩礼	cd li
彩绘	cd hv
彩车	cd ie
彩陶	cd tc
彪炳千秋	bn bk qm qq
彭德怀	pg de hk
彰善瘅恶	vh uj dj ee
影业	yk ye
影像	yk xl
影剧院	yk ju yr
影印	yk yb
影展	yk vj
影相机	yk xl ji
影碟机	yk dp ji
影评	yk pk
影集	yk ji
彳亍	ii iu
彷佛	fh fo
彷佛	fh fu
彷佛	ph fo
彷佛	ph fu
彻里彻外	ie li ie wd
往后	wh hz
往复	wh fu
征召	vg vc
征文	vg wf
征服	vg fu
征购	vg gz
径流	jk lq
径直	jk vi
待客	dd ke
徇众要求	xy vs yc qq
徇私	xy si
律师楼	lv ui lz
律诗	lv ui
徐悲鸿	xu bw hs
徒刑	tu xk
徒弟	tu di
徒费唇舌	tu fw iy ue
得个吉	de ge ji
得个吉	dw ge ji
得人惊	de rf jk
得人惊	dw rf jk
得以	de yi
得利	de li
得势	de ui
得名	de mk
得哥	de ge
得哥	dw ge
得啖笑	de dj xn
得啖笑	dw dj xn
得志	de vi
得戚	de qi
得戚	dw qi
得把口	de ba kz
得把口	dw ba kz
得把声	de ba ug
得把声	dw ba ug
得敕	de ii
得敕	dw ii
得益	de yi
得米	de mi
得米	dw mi
得鱼忘筌	de yu wh qr
徙倚	xi yi
循环赛	xy hr sd
微型	ww xk
微处理器	ww iu li qi
微小	ww xn
微循环	ww xy hr
微微	ww ww
微星	ww xk
微服私访	ww fu si fh
微机	ww ji
微机室	ww ji ui
微波炉	ww bo lu
微生物	ww ug wu
微电脑	ww dm nc
微米	ww mi
微粒	ww li
微细	ww xi
微薄	ww bo
微观	ww gr
微词	ww ci
微辞	ww ci
微风习习	ww fg xi xi
德厚流光	de hz lq gl
德意志	de yi vi
德政	de vg
德智体	de vi ti
德治	de vi
德育	de yu
德行	de xk
德黑兰	de hw lj
徽剧	hv ju
徽号	hv hc
徽州	hv vz
心上人	xb uh rf
心事重重	xb ui is is
心力	xb li
心劲	xb jb
心口翳	xb kz yi
心口针	xb kz vf
心喐喐	xb yu yu
心地	xb di
心坚石穿	xb jm dj ir
心坚石穿	xb jm ui ir
心多多	xb do do
心大心细	xb da xb xi
心大心细	xb dd xb xi
心如刀绞	xb ru dc jn
心室	xb ui
心小志大	xb xn vi da
心小志大	xb xn vi dd
心弦	xb xm
心怀	xb hk
心思思	xb si si
心息	xb xi
心悸	xb ji
心情靓	xb qk jk
心情靓	xb qk ll
心想	xb xl
心意咭	xb yi ji
心意咭	xb yi ka
心慈面善	xb ci mm uj
心慌意乱	xb hl yi lr
心房	xb fh
心手相应	xb uz xl yk
心抱	xb bc
心挂挂	xb gx gx
心曲	xb qu
心气	xb qi
心淡	xb dj
心潮	xb ic
心潮起伏	xb ic qi fu
心熄	xb xi
心理	xb li
心理学	xb li xt
心电图	xb dm tu
心窝子	xb wo zi
心细	xb xi
心绞痛	xb jn ts
心绪	xb xu
心罨	xb yj
心肌	xb ji
心肺	xb fw
心腹	xb fu
心虔志诚	xb qm vi ig
心血管	xb xt gr
心计	xb ji
心迹	xb ji
心郁郁	xb yu yu
心酸	xb sr
心里话	xb li hx
心静	xb jk
心驰神往	xb ii uf wh
必修课	bi xq ke
必有近忧	bi yz jb yz
必然性	bi rj xk
必需	bi xu
忉忉	dc dc
忉怛	dc da
忌妒	ji du
忌讳	ji hv
忍痛	rf ts
忍辱含羞	rf ru hj xq
志向	vi xl
志坚行苦	vi jm hh ku
志坚行苦	vi jm xk ku
志士	vi ui
志士仁人	vi ui rf rf
志愿	vi yr
志愿兵	vi yr bk
志愿军	vi yr jy
志趣	vi qu
忘年交	wh nm jn
忝列	tm lp
忠义	vs yi
忠于	vs yu
忠实	vs ui
忠心	vs xb
忠良	vs ll
忠贞	vs vf
忠骨	vs gu
忧心	yz xb
忧郁	yz yu
快劳	kk lc
快板	kk bj
快脆	kk cv
快过打针	kk go da vf
忽地	hu di
忿恨	ff hf
怀仁	hk rf
怀化	hk hx
怀古	hk gu
怀远	hk yr
态势	td ui
怊怅	ic ih
怔营	vg yk
怜惜	lm xi
思乡	si xl
思思缩缩	si si so so
思想家	si xl jx
思想性	si xl xk
思科	si ke
怡然自得	yi rj zi de
急不可耐	ji bu ke nd
急事	ji ui
急于	ji yu
急件	ji jm
急剧	ji ju
急匆匆	ji cs cs
急急忙忙	ji ji mh mh
急急脚	ji ji jn
急性	ji xk
急性病	ji xk bk
急流	ji lq
急电	ji dm
急病	ji bk
急行军	ji xk jy
急起直追	ji qi vi vv
急速	ji su
急难	ji nj
急需	ji xu
性命	xk mk
性生活	xk ug ho
性药	xk yc
怨气	yr qi
怪唔知	gk wu vi
怯生生	qp ug ug
总书记	zs uu ji
总产值	zs ij vi
总产量	zs ij ll
总值	zs vi
总公司	zs gs si
总动员	zs ds yr
总司令	zs si lk
总后	zs hz
总工	zs gs
总工会	zs gs hv
总指挥	zs vi hv
总揽	zs lj
总攻	zs gs
总政	zs vg
总方针	zs fh vf
总机	zs ji
总汇	zs hv
总管	zs gr
总经理	zs jk li
总罢工	zs ba gs
总署	zs uu
总路线	zs lu xm
总长	zs vh
总队	zs dv
总领事	zs lk ui
恃强凌弱	ui ql lk ro
恋歌	lm ge
恐吓信	ks he xb
恒山	hg uj
恢弘	hv hs
恤发	xu fa
恩恩怨怨	en en yr yr
恪守不渝	ke uz bu yu
恫赫	ds he
恬静	tm jk
恭听	gs tk
息息相通	xi xi xl ts
恳谈会	kf tj hv
恳谈会	kf tj kk
恶人	ee rf
恶梦	ee mg
恶死	ee si
恶死	wu si
恶死能登	ee si ng dg
恶死能登	wu si ng dg
恶毒	ee du
恶狠狠	ee hf hf
恶衣恶食	ee yi ee si
恶衣恶食	ee yi ee ui
恶衣恶食	ee yi ee yi
恶衣恶食	ee yi wu si
恶衣恶食	ee yi wu ui
恶衣恶食	ee yi wu yi
恶衣恶食	wu yi ee si
恶衣恶食	wu yi ee ui
恶衣恶食	wu yi ee yi
恶衣恶食	wu yi wu si
恶衣恶食	wu yi wu ui
恶衣恶食	wu yi wu yi
恶语	ee yu
恹恹	yj yj
恺悌	kd ti
悄悄话	qn qn hx
悉尼	xi ni
悉心	xi xb
悉数	xi uu
悔之晚矣	hv vi wj yi
悔悟	hv wu
悔过	hv go
悟性	wu xk
悠然自得	yz rj zi de
悠长	yz ih
悠闲	yz xm
悬崖勒马	xr ya le ma
悬崖峭壁	xr ya qn bi
悭皮	qm pi
悲凉	bw ll
悲剧性	bw ju xk
悲喜剧	bw xi ju
悲愤	bw ff
悲欣交集	bw xb jn ji
悻悻	xk xk
悼怵	dc iu
悼词	dc ci
情义	qk yi
情势	qk ui
情境	qk jk
情怨理遣	qk yr li qm
情意	qk yi
情报所	qk bc so
情理	qk li
情结	qk jp
情缘	qk yr
情话	qk hx
情谊	qk yi
情随事迁	qk sv ui qm
惊人之举	jk rf vi ju
惊住	jk vu
惊叹号	jk tj hc
惊异	jk yi
惊惶失措	jk hl ui co
惊蛇入草	jk ue ru cc
惊诧	jk ia
惊青	jk qk
惕厉	ti li
惝恍	ih hl
惝恍	th hl
惟恐	ww ks
惟我独尊	ww wo du zy
惟有	ww yz
惟独	ww du
惠灵顿	hv lk dy
惠而浦	hv er pu
惦记	dm ji
惨剧	cj ju
惨淡经营	cj dj jk yk
惨白	cj bd
惩办	ig bj
惩戒	ig jp
惩教署	ig jn uu
惯例	gr li
惯用	gr ys
想像	xl xl
想出	xl iu
想必	xl bi
想想	xl xl
想来	xl ld
想见	xl jm
想话	xl hx
想起	xl qi
惶惶	hl hl
愁眉紧锁	iz mw jb so
愈加	yu jx
愈发	yu fa
愈来愈	yu ld yu
愈演愈烈	yu yj yu lp
愈益	yu yi
意向	yi xl
意向书	yi xl uu
意味	yi ww
意在	yi zd
意境	yi jk
意头	yi tz
意志	yi vi
意愿	yi yr
意旨	yi vi
意气	yi qi
意淫	yi yb
意见书	yi jm uu
意见箱	yi jm xl
意见簿	yi jm bu
意识形态	yi ui xk td
意译	yi yi
意象	yi xl
意趣	yi qu
愚民	yu mb
感伤	gj uh
感化官	gj hx gr
感官	gj gr
感慨万端	gj kd wj dr
感染力	gj rj li
愤世疾俗	ff ui ji su
愤愤	ff ff
愤愤不平	ff ff bu pk
愤慨	ff kd
愤青	ff qk
慌失失	hl ui ui
慌怕	hl pa
慎终追远	uf vs vv yr
慢性病	mj xk bk
慥慥	zc zc
慧眼	hv yj
慭慭	yb yb
慰问信	ww wf xb
慰问品	ww wf pb
慰问团	ww wf tr
慰问电	ww wf dm
慷慨就义	kh kd jq yi
憬悟	jk wu
懂事	ds ui
懈怠	xp dd
懒佬鞋	lj lc xp
懵到上心口	mg dc uh xb kz
懵盛盛	mg ig ig
懵盛盛	mg ig ug
懵盛盛	mg ug ig
懵盛盛	mg ug ug
懵闭闭	mg bi bi
戆居居	gh ju ju
戆居居	vl ju ju
戈壁	ge bi
戊午	wu wu
戊子	wu zi
戊寅	wu yb
戊戌	wu xu
戊申	wu uf
戊辰	wu if
戋戋	jm jm
戎马一生	rs ma yi ug
戎马倥偬	rs ma ks zs
戎马生涯	rs ma ug ya
戏剧	xi ju
戏剧家	xi ju jx
戏文	xi wf
戏曲	xi qu
戏曲界	xi qu jp
戏肉	xi rz
戏言	xi yj
戏谑	xi xt
戏迷	xi mi
成事	ig ui
成人	ig rf
成人电影	ig rf dm yk
成像	ig xl
成名作	ig mk zo
成年人	ig nm rf
成年累月	ig nm lw yt
成心	ig xb
成方	ig fh
成材	ig cd
成村人	ig cy rf
成法	ig fa
成活率	ig ho lv
成灾	ig zd
成盘	ig pj
成绩单	ig ji dj
成色	ig se
成药	ig yc
成衣	ig yi
成见	ig jm
成风	ig fg
成龙配套	ig ls pw tc
我一语	wo yi yu
我党	wo dh
我军	wo jy
我哋	wo di
我方	wo fh
我条仔	wo tn zd
我条仔	wo tn zi
我条女	wo tn nv
我条菜	wo tn cd
我校	wo jn
我校	wo xn
我武惟扬	wo wu ww yh
戒严	jp yj
戒口	jp kz
戒备森严	jp bw sf yj
戒奶	jp nd
戒毒	jp du
戒除	jp iu
戒骄戒操	jp jn jp cc
或是	ho ui
战书	vj uu
战事	vj ui
战例	vj li
战利品	vj li pb
战区	vj qu
战史	vj ui
战国	vj go
战士	vj ui
战天斗地	vj tm dz di
战将	vj jl
战局	vj ju
战斗力	vj dz li
战斗员	vj dz yr
战时	vj ui
战机	vj ji
战略性	vj lt xk
战祸	vj ho
战线	vj xm
戙笃企	ds du qi
戛纳	ga na
戛纳	jx na
戟指怒目	ji vi nu mu
戥穿石	dg ir dj
戥穿石	dg ir ui
戥脚	dg jn
截住	jp vu
截击	jp ji
截断	jp dr
截止	jp vi
截流	jp lq
截肢	jp vi
截长补短	jp ih bu dr
截面	jp mm
戴夫	dd fu
戴维	dd ww
户主	hu vu
户口簿	hu kz bu
户头	hu tz
房价	fh jx
房基	fh ji
房客	fh ke
房檐	fh yj
房龙	fh ls
所剩无几	so ug wu ji
所向无前	so xl mo qm
所向无前	so xl wu qm
所在地	so zd di
所有制	so yz vi
所有权	so yz qr
所有者	so yz ve
所知	so vi
所见	so jm
所部	so bu
扇动	uj ds
扇区	uj qu
扇子	uj zi
扊扅	yj yi
手上	uz uh
手书	uz uu
手势	uz ui
手印	uz yb
手多多	uz do do
手工业	uz gs ye
手工艺	uz gs yi
手工艺品	uz gs yi pb
手巾	uz jb
手巾仔	uz jb zd
手巾仔	uz jb zi
手心	uz xb
手指公	uz vi gs
手指头	uz vi tz
手指尾	uz vi ww
手指模	uz vi mo
手指模	uz vi mu
手指罅	uz vi xx
手推车	uz tv ie
手提包	uz ti bc
手揗脚震	uz uy jn vf
手摇	uz yc
手术刀	uz uu dc
手术台	uz uu td
手术室	uz uu ui
手杖	uz vh
手柄	uz bk
手榴弹	uz lq dj
手气	uz qi
手瓜	uz gx
手甲	uz jx
手电筒	uz dm ts
手痕	uz hf
手笔	uz bi
手艺	uz yi
手记	uz ji
手语	uz yu
手误	uz wu
手足情深	uz zu qk uf
手踭	uz vg
手迹	uz ji
手雷	uz lw
手风琴	uz fg qb
手鼓	uz gu
才是	cd ui
才智	cd vi
扎扎跳	va va tn
扎马	va ma
扑水	pu uv
扑灭	pu mp
扑簌	pu su
扑面	pu mm
扑飞	pu fw
打乞嗤	da qi ii
打交道	da jn dc
打仔	da zd
打仔	da zi
打仗	da vh
打倒	da dc
打倒褪	da dc tv
打倒褪	da dc ty
打假	da jx
打关斗	da gr dz
打冷	da lg
打冷震	da lg vf
打功夫	da gs fu
打占	da vj
打印机	da yb ji
打压	da ya
打反	da fj
打同通	da ts ts
打咭	da ji
打咭	da ka
打响	da xl
打喊露	da hj lu
打喊露	da hj lz
打场	da ih
打大赤肋	da da ii le
打大赤肋	da da ii lw
打大赤肋	da dd ii le
打大赤肋	da dd ii lw
打天下	da tm xx
打头	da tz
打孖	da ma
打孖	da zi
打字机	da zi ji
打思噎	da si ye
打招呼	da vc hu
打掂	da dm
打搏成	da bo ig
打斋	da vd
打斗	da dz
打斧头	da fu tz
打枪	da ql
打架	da jx
打横嚟	da hg li
打横嚟	da hg lw
打死狗讲价	da si gz jl jp
打死狗讲价	da si gz jl jx
打气	da qi
打气筒	da qi ts
打油诗	da yz ui
打法	da fa
打消	da xn
打游击	da yz ji
打火	da ho
打火机	da ho ji
打点	da dm
打烂沙盘问到笃	da lj ua pj wf dc du
打牙铰	da ya jn
打眼	da yj
打簿	da bu
打脚骨	da jn gu
打芡	da qm
打药	da yc
打荷包	da he bc
打蛇随棍上	da ue sv gy uh
打蛇饼	da ue bk
打赌	da du
打赤肋	da ii le
打赤肋	da ii lw
打转	da vr
打边炉	da bm lu
打醒精神	da xk jk uf
打量	da ll
打雀噉眼	da qt dj yj
打靶	da ba
打骂	da ma
打骰	da tz
打麻雀	da ma qt
打鼻鼾	da bi hj
托大脚	to da jn
托大脚	to dd jn
托尔金	to er jb
托手踭	to uz vg
托福	to fu
托赖	to ld
托马斯	to ma si
执业	vi ye
执人口水溦	vi rf kz uv ww
执到宝	vi dc bc
执到正	vi dc vg
执到都喊三声	vi dc du hj sj ug
执到都喊三声	vi dc dz hj sj ug
执包袱	vi bc fu
执头执尾	vi tz vi ww
执委	vi ww
执委会	vi ww hv
执导	vi dc
执意	vi yi
执手尾	vi uz ww
执掌	vi vh
执政党	vi vg dh
执教	vi jn
执条袜带累身家	vi tn wa dd lw uf jx
执死鸡	vi si ji
执法如山	vi fa ru uj
执漏	vi lz
执番条命	vi fj tn mk
执番条命	vi pj tn mk
执番身彩	vi fj uf cd
执番身彩	vi pj uf cd
执笔	vi bi
执药	vi yc
执著	vi vo
执输行头惨过败家	vi uu hh tz cj go bd jx
执输行头惨过败家	vi uu xk tz cj go bd jx
扩大化	ko da hx
扪心无愧	mf xb mo kv
扪心无愧	mf xb wu kv
扬声器	yh ug qi
扬子江	yh zi jl
扬子鳄	yh zi ee
扬弃	yh qi
扬榷	yh qt
扬言	yh yj
扬长	yh ih
扬长补短	yh ih bu dr
扭亏增盈	nq kv zg yk
扭拧	nq nk
扭纹	nq wf
扭计师爷	nq ji ui ye
扭计骰	nq ji tz
扭軚	nq td
扮嘢	bj ye
扮猪食老虎	bj vu si lc hu
扮猪食老虎	bj vu ui lc hu
扮猪食老虎	bj vu yi lc hu
扯猫尾	ie mc ww
扳机	bj ji
扶养	fu yh
扶助	fu vu
扶弱抑强	fu ro yi ql
扶摇	fu yc
扶植	fu vi
扶疏	fu uu
扶贫帮困	fu pb bh ky
批件	pi jm
批发商	pi fa uh
批号	pi hc
批复	pi fu
批转	pi vr
找事	vc ui
找晦气	vc hv qi
找续	vc xu
承你贵言	ig ni gv yj
承包	ig bc
承包制	ig bc vi
承建	ig jm
承继	ig ji
承销	ig xn
技击	ji ji
技术员	ji uu yr
技术性	ji uu xk
技校	ji xn
技法	ji fa
技艺	ji yi
技高一筹	ji gc yi iz
抄件	ic jm
抄牌	ic pd
把头	ba tz
把子	ba zi
把屁	ba pi
把式	ba ui
把手	ba uz
把炮	ba bc
把炮	ba pc
把鬼	ba gv
抌心口	vf xb kz
抑制	yi vi
抑强扶弱	yi ql fu ro
抑或	yi ho
抑止	yi vi
抒写	uu xp
抒发	uu fa
抒情诗	uu qk ui
抓车	vx ie
抓车	vx ju
投书	tz uu
投向	tz xl
投宿	tz su
投掷	tz vi
投机商	tz ji uh
投篮	tz lj
投递员	tz di yr
投降	tz xl
投降主义	tz xl vu yi
抖凉	dz ll
抗原	kh yr
抗御	kh yu
抗日战争	kh ri vj vg
抗日救亡	kh ri jq wh
抗生素	kh ug su
抗药性	kh yc xk
抗菌素	kh jy su
折中	ve vs
折台	ue td
折台	ve td
折回	ve hv
折子戏	ve zi xi
折戟沉沙	ve ji if ua
折节读书	ue jp du uu
折节读书	ue jp dz uu
折节读书	ve jp du uu
折节读书	ve jp dz uu
折衷	ue vs
折衷	ve vs
抚恤金	fu xu jb
抚慰	fu ww
抚育	fu yu
抛掷	pc vi
抛浪头	pc lh tz
抠乱	kz lr
抠搜	kz sz
抢劫犯	ql jp fj
抢建	ql jm
抢手	ql uz
抢收	ql uz
抢种	ql vs
抢购一空	ql gz yi ks
抢运	ql yy
抢闸	ig va
抢闸	ql va
抢险	ql xm
护卫舰	hu ww jm
护城河	hu ig he
护士长	hu ui ih
护士长	hu ui vh
护肤品	hu fu pb
护身符	hu uf fu
报串	bc ir
报仇	bc iz
报偿	bc ih
报关	bc gr
报到	bc dc
报务	bc wu
报告会	bc gc hv
报告团	bc gc tr
报国	bc go
报头	bc tz
报导	bc dc
报捷	bc jp
报收	bc uz
报效	bc xn
报时	bc ui
报春花	bc iy hx
报晓	bc xn
报界	bc jp
报章	bc vh
报账	bc vh
报载	bc zd
披心相付	pi xb xl fu
披红戴花	pi hs dd hx
抬高	td gc
抱养	bc yh
抱病	bc bk
抱诚守真	bc ig uz vf
抱负	bc fu
抵制	di vi
抵得谂	di de uf
抵得谂	di dw uf
抵御	di yu
抵押品	di ya pb
抵挡	di dh
抵牾	di wu
抵谂	di uf
抹台布	ma td bu
抹台布	mo td bu
抹煞	mo ua
押运	ya yy
抽搐	iz iu
抽检	iz jm
抽泣	iz qi
抽穗	iz sv
抽验	iz yj
担子	dj zi
担搁	dj ge
担架	dj jx
拆家	id jx
拆招牌	id vc pd
拆解	id jp
拆解	id xp
拆骨	id gu
拉丁文	la dk wf
拉匀	la yy
拉埋天窗	la md tm il
拉埋天窗	la mj tm il
拉头马	la tz ma
拉帮结派	la bh jp pd
拉开	la kd
拉拉队	la la dv
拉柴	la id
拉美	la mw
拉臣	la if
拉萨市	la sa ui
拉锯战	la ju vj
拍乌蝇	pd wu yk
拍乸	pd na
拍友	pd yz
拍子	pd zi
拍得住	pd de vu
拍得住	pd dw vu
拍心口	pd xb kz
拍手叫好	pd uz jn hc
拍板	pd bj
拍硬档	pd yk dh
拐子佬	gk zi lc
拒不	ju bu
拒捕	ju bu
拒收	ju uz
拒腐防变	ju fu fh bm
拓片	ta pm
拔山举鼎	ba uj ju dk
拔节	ba jp
拔除	ba iu
拖人下水	to rf xx uv
拖卡	to ka
拖卡	to qx
拖手仔	to uz zd
拖手仔	to uz zi
拖肥糖	to fw th
拖船	to ir
拖苏	to su
拗	ao
拗	nq
拗手瓜	ao uz gx
拗手瓜	nq uz gx
拗撬	ao qn
拗撬	nq qn
拗数	ao uu
拗数	nq uu
拗腰	ao yc
拗腰	nq yc
拗颈	ao gg
拗颈	ao jk
拗颈	nq gg
拗颈	nq jk
拘役	ju yi
拘捕	ju bu
拘禁	ju jb
拙笨	vo bf
拚命	pb mk
拚搏	pb bo
招供	vc gs
招待会	vc dd hv
招徕	vc ld
招手	vc uz
招摇	vc yc
招法	vc fa
招积	vc ji
招纸	vc vi
招股	vc gu
招贴画	vc tp hx
拜年	bd nm
拜拜	bd bd
拟订	ni dk
拣饮择食	jm yb vd si
拣饮择食	jm yb vd ui
拣饮择食	jm yb vd yi
拣饮择食	jm yb ze si
拣饮择食	jm yb ze ui
拣饮择食	jm yb ze yi
拥军	ys jy
拥军优属	ys jy yz uu
拥护	ys hu
拥挤不堪	ys ji bu kj
拦蓄	lj xu
拧头	nk tz
拧转	nk vr
拧转头	nk vr tz
拨冗	bo rs
拨出	bo iu
拨剌	bo la
拨动	bo ds
拨叫	bo jn
拮据	jp ju
拱形	gs xk
拱手	gs uz
拱门	gs mf
拳击手	qr ji uz
拳拳	qr qr
拳拳服膺	qr qr fu yk
拳术	qr uu
拾掇	ui do
拾遗	ui yi
拾金不昧	ui jb bu mw
拿手戏	na uz xi
挂号信	gx hc xb
挂图	gx tu
挂车	gx ie
挂钟	gx vs
指事	vi ui
指使	vi ui
指名	vi mk
指天椒	vi tm jn
指天誓日	vi tm ui ri
指定	vi dk
指定动作	vi dk ds zo
指尖	vi jm
指归	vi gv
指战员	vi vj yr
指拟	vi ni
指挥员	vi hv yr
指挥官	vi hv gr
指挥所	vi hv so
指挥棒	vi hv bh
指挥部	vi hv bu
指明	vi mk
指正	vi vg
指法	vi fa
指示	vi ui
指责	vi ze
挑动	tn ds
挑拣	tn jm
挑灯夜战	tn dg ye vj
挑通眼眉	tn ts yj mw
挖潜	wa qm
挖肉罗疮生	wa rz lo il ug
挚友	vi yz
挞沙鱼	ta ua yu
挞订	ta dk
挟带	xp dd
挡板	dh bj
挡箭牌	dh jm pd
挣揣	vg ik
挣揣	vg tr
挣揣	vg vv
挤出	ji iu
挤占	ji vj
挤压	ji ya
挥手	hv uz
挥舞	hv wu
挨年近晚	ai nm jb wj
挨拼	ai pb
挫伤	co uh
振振	vf vf
振振有辞	vf vf yz ci
振荡	vf dh
挺括	tk gx
挺直	tk vi
挺立	tk li
挽回	wj hv
捉人痛脚	vo rf ts jn
捉住	vo vu
捉到鹿唔识脱角	vo dc lu wu ui to jn
捉到鹿唔识脱角	vo dc lu wu ui to jt
捉到鹿唔识脱角	vo dc lu wu vi to jn
捉到鹿唔识脱角	vo dc lu wu vi to jt
捉字虱	vo zi ui
捉摸不定	vo mo bu dk
捉棋	vo qi
捉黄脚鸡	vo hl jn ji
捕镬	bu ho
捕食	bu ui
捞偏门	lc pm mf
捞取	lc qu
捞边行	lc bm hh
捞边行	lc bm xk
损之又损	sy vi yz sy
损手烂脚	sy uz lj jn
换乘	hr ig
换届	hr jp
换文	hr wf
换气	hr qi
换洗	hr xi
换班	hr bj
换画	hr hx
换言之	hr yj vi
换钱	hr qm
换防	hr fh
捣蛋	dc dj
据守	ju uz
据报	ju bc
捱世界	ai ui jp
捱夜	ai ye
捱更抵夜	ai gg di ye
捷克	jp ke
捷达	jp da
捻手	nm uz
掀起	xm qi
掂掇	dm do
掂量	dm ll
授奖	uz jl
授意	uz yi
授粉	uz ff
授精	uz jk
授衔	uz xm
掌上压	vh uh ya
掌上明珠	vh uh mk vu
排坛	pd tj
排头兵	pd tz bk
排字	pd zi
排它	pd ta
排水管	pd uv gr
排水量	pd uv ll
排涝	pd lc
排灌	pd gr
掘头路	jt tz lu
掘进	jt jb
掘金	jt jb
掠夺性	lt do xk
掠过	lt go
探伤	tj uh
探家	tj jx
探求	tj qq
探测器	tj ce qi
探热针	tj re vf
探照灯	tj vc dg
探班	tj bj
探盘	tj pj
探矿	tj kl
探询	tj xy
接二连胜	jp er lm ug
接入	jp ru
接力	jp li
接力棒	jp li bh
接力赛	jp li sd
接办	jp bj
接地	jp di
接头	jp tz
接手	jp uz
接收站	jp uz vj
接济	jp ji
接点	jp dm
接班人	jp bj rf
接生	jp ug
接种	jp vs
接线	jp xm
接见	jp jm
控制器	ks vi qi
控制论	ks vi ly
推出	tv iu
推力	tv li
推土机	tv tu ji
推导	tv dc
推托	tv to
推移	tv yi
推诚相见	tv ig xl jm
推进器	tv jb qi
推送	tv ss
推销员	tv xn yr
掩埋	yj md
掩映	yj yk
掩蔽	yj bi
措措埋埋	co co md md
措措埋埋	co co md mj
措措埋埋	co co mj md
措措埋埋	co co mj mj
掬气	ju qi
掹	mg
提及	ti ji
提审	ti uf
提拨	di bo
提拨	ti bo
提灌	ti gr
提督	ti du
提篮	ti lj
提级	ti ji
提纲挈领	ti gh qp lk
插手	ia uz
插花	ia hx
插话	ia hx
揗揗震	uy uy vf
揗鸡	uy ji
揣测不安	ik ce bu an
揣测不安	tr ce bu an
揣测不安	vv ce bu an
揭幕	jp mu
揭批	jp pi
揭短	jp dr
揭示	jp ui
揭秘	jp mi
援外	yr wd
援建	yr jm
援引	yr yb
揸主意	va vu yi
揸兜	va dz
揸大葵扇	va da kv uj
揸大葵扇	va dd kv uj
揸手	va uz
揸正来做	va vg ld zo
揸腰	va yc
揸车	va ie
揸车	va ju
揽头揽颈	lj tz lj gg
揽头揽颈	lj tz lj jk
揽胜	lj ug
揾人	wf rf
揾食	wf si
揾食	wf ui
揾食	wf yi
揿机	qb ji
揿钉	qb dk
搅屎棍	jn ui gy
搅拌机	jn bj ji
搅珠	jn vu
搏乱	bo lr
搏击	bo ji
搏到尽	bo dc jb
搏动	bo ds
搏命	bo mk
搏彩	bo cd
搏懵	bo mg
搜索引擎	sz so yb qk
搞弯	gc wj
搞搞震	gc gc vf
搞边科	gc bm ke
搬迁户	bj qm hu
搭乘	da ig
搭伙	da ho
搭挡	da dh
搭桥	da qn
搭错线	da co xm
携手并肩	xp uz bk jm
摄制	ue vi
摄取	ue qu
摄影师	ue yk ui
摄影机	ue yk ji
摄氏	ue ui
摄灶罅	np zc xx
摄灶罅	ue zc xx
摄石	np dj
摄石	np ui
摄石	ue dj
摄石	ue ui
摆乌龙	bd wu ls
摆手	bd uz
摆放	bd fh
摆架子	bd jx zi
摆样子	bd yh zi
摆档	bd dh
摆渡	bd du
摆甫士	bd fu ui
摇头摆尾	yc tz bd ww
摇曳	yc ye
摇滚乐	yc gy yt
摇篮曲	yc lj qu
摇身一变	yc uf yi bm
摊位游戏	tj ww yz xi
摊派	tj pd
摒弃	bk qi
摘发	vd fa
摘牌	vd pd
摘编	vd bm
摩尼	mo ni
摩托艇	mo to tk
摩挲	mo sa
摩挲	mo so
摩顶放踵	mo dk fh vs
摸门钉	mo mf dk
摸黑	mo hw
摹写	mo xp
撑竿跳	ig gj tn
撒播	sa bo
撕下	si xx
撞啱	vl nj
撞啱	vl yj
撞彩	vl cd
撞手神	vl uz uf
撞板	vl bj
撞火	vl ho
撞聋	vl ls
撞邪	vl xp
撞邪	vl ye
撤出	ie iu
撤消	ie xn
撩是斗非	ln ui dz fw
撬墙脚	qn ql jn
播客	bo ke
播种机	bo vs ji
播音员	bo yb yr
播音室	bo yb ui
撰稿	vr gc
撰稿人	vr gc rf
撰著	vr vu
撺掇	cr do
撼动	hj ds
撼天动地	hj tm ds di
擂鼓	lw gu
操作员	cc zo yr
操作系统	cc zo xi ts
操行	cc xk
擒青	qb qk
擗炮	pi bc
擗炮	pi pc
擘大口	bo da kz
擘大口	bo dd kz
擘面	bo mm
擝	mg
擦纸胶	ca vi jn
攀枝花	pj vi hx
支书	vi uu
支农	vi ns
支前	vi qm
支吾	vi wu
支委	vi ww
支委会	vi ww hv
支应	vi yk
支支整整	vi vi vg vg
支整	vi vg
支架	vi jx
支流	vi lq
支点	vi dm
支离	vi li
支线	vi xm
支边	vi bm
支部	vi bu
支队	vi dv
收买人命	uz md rf mk
收买佬	uz md lc
收兵	uz bk
收割机	uz ge ji
收发	uz fa
收场	uz ih
收复	uz fu
收审	uz uf
收尾	uz ww
收工	uz gs
收录机	uz lu ji
收支	uz vi
收档	uz dh
收汇	uz hv
收治	uz vi
收爹	uz dp
收科	uz ke
收紧	uz jb
收纳	uz na
收编	uz bm
收缴	uz jn
收藏家	uz ch jx
收集	uz ji
收音	uz yb
改任	gd rf
改型	gd xk
改天换地	gd tm hr di
改弦更张	gd xm gg vh
改称	gd ig
改编	gd bm
改选	gd xr
攻克	gs ke
攻关	gs gr
攻击机	gs ji ji
攻势	gs ui
攻坚	gs jm
攻坚战	gs jm vj
攻城掠地	gs ig lt de
攻城掠地	gs ig lt di
攻苦食淡	gs ku si dj
攻苦食淡	gs ku ui dj
攻苦食淡	gs ku yi dj
攻陷	gs xm
放声气	fh ug qi
放大器	fh da qi
放大镜	fh da jk
放射性	fh ue xk
放射线	fh ue xm
放数	fh uu
放映机	fh yk ji
放晴	fh qk
放火	fh ho
放牛娃	fh nq wa
放疗	fh ln
放眼	fh yj
放眼世界	fh yj ui jp
放空	fh ks
放缓	fh hr
放置	fh vi
放胆	fh dj
放风	fh fg
放飞机	fh fw ji
政事	vg ui
政企	vg qi
政企不分	vg qi bu ff
政体	vg ti
政党	vg dh
政出多门	vg iu do mf
政务	vg wu
政区	vg qu
政局	vg ju
政府军	vg fu jy
政敌	vg di
政权	vg qr
政治家	vg vi jx
政治局	vg vi ju
政治犯	vg vi fj
政治课	vg vi ke
政治部	vg vi bu
政法	vg fa
政界	vg jp
政纪	vg ji
政绩	vg ji
政要	vg yc
政见	vg jm
政论	vg ly
政通人和	vg ts rf he
故事片	gu ui pm
故人	gu rf
故剑情深	gu jm qk uf
故园	gu yr
故旧不弃	gu jq bu qi
故道	gu dc
故都	gu du
故里	gu li
效仿	xn fh
效忠	xn vs
敌伪	di ww
敌占区	di vj qu
敌国	di go
敌意	di yi
敌我矛盾	di wo mc dy
敌方	di fh
敌机	di ji
敌视	di ui
救世主	jq ui vu
救亡	jq wh
救困扶危	jq ky fu ww
救急	jq ji
救护车	jq hu ie
救护队	jq hu dv
救活	jq ho
救济粮	jq ji ll
救济金	jq ji jb
救生圈	jq ug qr
救生艇	jq ug tk
救生衣	jq ug yi
教主	jn vu
教义	jn yi
教书匠	jn uu jl
教具	jn ju
教头	jn tz
教委	jn ww
教学法	jn xt fa
教学片	jn xt pm
教学相长	jn xt xl vh
教室	jn ui
教导员	jn dc yr
教工	jn gs
教廷	jn tk
教条主义	jn tn vu yi
教法	jn fa
教父	jn fu
教益	jn yi
教研	jn yj
教研室	jn yj ui
教科书	jn ke uu
教科文	jn ke wf
教练员	jn lm yr
教练机	jn lm ji
教职员工	jn vi yr gs
教职工	jn vi gs
教育学	jn yu xt
教育家	jn yu jx
教育局	jn yu ju
教育部	jn yu bu
教诲	jn hv
教鞭	jn bm
教龄	jn lk
敞亮	ih ll
敢死队	gj si dv
散仔	sj zd
散仔	sj zi
散失	sj ui
散居	sj ju
散收收	sj uz uz
散文家	sj wf jx
散文诗	sj wf ui
散档	sj dh
散纸	sj vi
散记	sj ji
敦实	dy ui
敬献	jk xm
敬畏	jk ww
敬礼	jk li
敬老慈幼	jk lc ci yz
敬老院	jk lc yr
敬重	jk vs
数万	uu wj
数亿	uu yi
数以百计	uu yi bd ji
数位	uu ww
数十	uu ui
数千	uu qm
数周	uu vz
数学家	uu xt jx
数学课	uu xt ke
数家	uu jx
数尾	uu ww
数据库	uu ju ku
数数	uu uu
数次	uu ci
数理化	uu li hx
数量级	uu ll ji
敲诈勒索	qn va le so
敲门砖	qn mf vr
整党	vg dh
整古做怪	vg gu zo gk
整地	vg di
整整吓	vg vg he
整整吓	vg vg xx
整整齐齐	vg vg qi qi
整机	vg ji
整治	vg vi
整流	vg lq
整编	vg bm
整色水	vg se uv
整色水	vg ud uv
整风	vg fg
整齐划一	vg qi hx yi
敷料	fu ln
敷设	fu ue
文不加点	wf bu jx dm
文丛字顺	wf cs zi uy
文传	wf ir
文体	wf ti
文具盒	wf ju he
文化人	wf hx rf
文化宫	wf hx gs
文化界	wf hx jp
文化部	wf hx bu
文化馆	wf hx gr
文史	wf ui
文告	wf gc
文娱	wf yu
文学界	wf xt jp
文山会海	wf uj hv hd
文工团	wf gs tr
文戏	wf xi
文教	wf jn
文教局	wf jn ju
文明礼貌	wf mk li mc
文武	wf wu
文法	wf fa
文理	wf li
文联	wf lm
文艺界	wf yi jp
文苑	wf yr
文豪	wf hc
斋啡	vd fw
斐然	fw rj
斑痕	bj hf
斑白	bj bd
斗士	dz ui
斗室	dz ui
斗拱	dz gs
斗智	dz vi
斗木	dz mu
斗车	dz ie
料峭	ln qn
斜坡	xp po
斜风细雨未雨绸缪	xp fg xi yu ww yu iz mn
斜风细雨未雨绸缪	xp fg xi yu ww yu iz mq
斜风细雨未雨绸缪	xp fg xi yu ww yu iz mz
斥资	ii zi
斧子	fu zi
斩下眼	vj xx yj
斩六将	vj lq jl
斩到一颈血	vj dc yi gg xp
斩到一颈血	vj dc yi gg xt
斩到一颈血	vj dc yi jk xp
斩到一颈血	vj dc yi jk xt
斩料	vj ln
斩眉斩眼	vj mw vj yj
斩眼	vj yj
斩缆	vj lj
斩脚趾避沙虫	vj jn vi bi ua is
断代史	dr dd ui
断估	dr gu
断头	dr tz
断尾	dr ww
断炊	dr iv
断线	dr xm
断肢	dr vi
断语	dr yu
断路	dr lu
斯坦利	si tj li
斯大林	si da lb
斯文淡定	si wf dj dk
新事	xb ui
新人	xb rf
新人新事	xb rf xb ui
新任	xb rf
新兴	xb xk
新兵	xb bk
新军	xb jy
新净	xb jk
新办	xb bj
新华书店	xb hx uu dm
新华社	xb hx ue
新县	xb xm
新四军	xb si jy
新址	xb vi
新城	xb ig
新奇士	xb ji ui
新奇士	xb qi ui
新娘子	xb nl zi
新式	xb ui
新意	xb yi
新成	xb ig
新教	xb jn
新星	xb xk
新村	xb cy
新法	xb fa
新生	xb ug
新生事物	xb ug ui wu
新纪元	xb ji yr
新老交替	xb lc jn ti
新苗	xb mn
新蓝	xb lj
新西兰	xb xi lj
新诗	xb ui
新近	xb jb
新进	xb jb
新郎	xb lh
新郎哥	xb lh ge
新闻界	xb wf jp
新闻稿	xb wf gc
新风	xb fg
新鲜事	xb xm ui
新鲜滚热辣	xb xm gy re la
方便之门	fh bm vi mf
方便面	fh bm mm
方城	fh ig
方子	fh zi
方家	fh jx
方形	fh xk
方方正正	fh fh vg vg
方方面面	fh fh mm mm
方法论	fh fa ly
方程式	fh ig ui
方面军	fh mm jy
施乐	ui le
施乐	ui yt
施压	ui ya
施放	ui fh
施政	ui vg
施施然	ui ui rj
施用	ui ys
施肥	ui fw
施行	ui xk
旁观者	ph gr ve
旅伴	lv bj
旅游团	lv yz tr
旅游地	lv yz di
旅游者	lv yz ve
旅游鞋	lv yz xp
旅行社	lv xk ue
旋即	xr ji
旋涡	xr wo
旌旗	jk qi
族长	zu vh
旗下	qi xx
旗子	qi zi
旗帜	qi vi
旗帜鲜明	qi vi xm mk
旗手	qi uz
旗杆	qi gj
旗舰	qi jm
无不	wu bu
无为	wu ww
无价之宝	wu jx vi bc
无党派	wu dh pd
无则加勉	wu ze jx mm
无力	wu li
无可比拟	wu ke bi ni
无可非议	wu ke fw yi
无宁	wu nk
无尽	wu jb
无序	wu xu
无庸讳言	wu ys hv yj
无异	wu yi
无忌	mo ji
无忌	wu ji
无意	wu yi
无所不知	wu so bu vi
无政府	wu vg fu
无故	wu gu
无暇	wu xx
无期	wu qi
无机	wu ji
无比	wu bi
无济于事	wu ji yu ui
无烟	wu yj
无烟煤	wu yj mw
无畏	wu ww
无的放矢	wu di fh ui
无益	wu yi
无知	wu vi
无礼	wu li
无神论	wu uf ly
无私无畏	wu si wu ww
无端白事	mo dr bd ui
无端白事	wu dr bd ui
无端端	mo dr dr
无端端	wu dr dr
无线	wu xm
无线电波	wu xm dm bo
无色	wu se
无花果	wu hx go
无视	wu ui
无记名	wu ji mk
无际	wu ji
无须	wu xu
既便	ji bm
既便	ji pm
既往	ji wh
既是	ji ui
既有	ji yz
既能	ji ng
日光灯	ri gl dg
日全食	ri qr ui
日出而作	ri iu er zo
日复一日	ri fu yi ri
日影西斜	ri yk xi xp
日暮途穷	ri mu tu qs
日甚一日	ri uf yi ri
日程表	ri ig bn
日立	ri li
日营	ri yk
日落西山	ri lo xi uj
日间	ri jm
日食	ri ui
日高三尺	ri gc sj ii
旧习	jq xi
旧事	jq ui
旧体诗	jq ti ui
旧址	jq vi
旧宅	jq vd
旧式	jq ui
旧时	jq ui
旧物	jq wu
旧病复发	jq bk fu fa
旧调重弹	jq dn is tj
旧货	jq ho
旧阵时	jq vf ui
旨意	vi yi
早唞	zc dz
早唞	zc tc
早市	zc ui
早排	zc pd
早泄	zc xp
早稻	zc dc
早走早着	zc zz zc vc
早走早着	zc zz zc ve
早走早着	zc zz zc vo
旭日东升	xu ri ds ug
旯旮	la ga
旱冰	hj bk
旱情	hj qk
旱烟	hj yj
旱田	hj tm
旱船	hj ir
旱象	hj xl
旱路	hj lu
时不再来	ui bu zd ld
时不时	ui bu ui
时事	ui ui
时代华纳	ui dd hx na
时令	ui lk
时值	ui vi
时兴	ui xk
时分	ui ff
时势	ui ui
时宜	ui yi
时局	ui ju
时差	ui ia
时常	ui ih
时序	ui xu
时弊	ui bi
时政	ui vg
时效	ui xn
时新	ui xb
时时	ui ui
时机	ui ji
时紧时松	ui jb ui ss
时节	ui jp
时评	ui pk
时运	ui yy
时钟	ui vs
时间差	ui jm ia
时限	ui xm
时隔	ui ge
时鲜	ui xm
旷野	kl ye
旺季	wh ji
昂居	ah ju
昂然	ag rj
昆仑山	ky ly uj
昆剧	ky ju
昆山	ky uj
昆山片玉	ky uj pm yu
昆明市	ky mk ui
昌平	ih pk
昌盛	ih ug
明丽	mk li
明代	mk dd
明令	mk lk
明净	mk jk
明基	mk ji
明德惟馨	mk de ww xb
明斯克	mk si ke
明晃晃	mk hl hl
明晰	mk xi
明理	mk li
明码	mk ma
昒昕	hu xb
易事	yi ui
易于	yi yu
易得	yi de
易得	yi dw
易经	yi jk
易趣	yi qu
易过借火	yi go jp ho
星云	xk yy
星体	xk ti
星夜	xk ye
星星点灯	xk xk dm dg
星星点点	xk xk dm dm
星期一	xk qi yi
星期三	xk qi sj
星期五	xk qi wu
星期六	xk qi lq
星期四	xk qi si
星期日	xk qi ri
星移斗转	xk yi dz vr
星级	xk ji
星罗棋布	xk lo qi bu
星际	xk ji
映像	yk xl
映射	yk ue
映月读书	yk yt du uu
映月读书	yk yt dz uu
映照	yk vc
映雪读书	yk xt du uu
映雪读书	yk xt dz uu
春华秋实	iy hx qq ui
春回大地	iy hv da de
春回大地	iy hv da di
春回大地	iy hv dd de
春回大地	iy hv dd di
春意正浓	iy yi vg ns
春晚	iy wj
春灌	iy gr
春色满圆	iy se mj yr
春色满圆	iy ud mj yr
春花秋月	iy hx qq yt
春蚓秋蛇	iy yb qq ue
春雷滚滚	iy lw gy gy
春风化雨	iy fg hx yu
昧心	mw xb
昨日黄花	zo ri hl hx
昭然	vc rj
昭示	vc ui
昭阳	vc yh
是以	ui yi
是的	ui de
昳丽	dp li
昳丽	yi li
显出	xm iu
显微	xm ww
显灵	xm lk
显眼	xm yj
显示屏	xm ui pk
显要	xm yc
显露	xm lu
晋升	jb ug
晋城	jb ig
晋江	jb jl
晋级	jb ji
晌午	uh wu
晏衍	yj yj
晏觉	yj jn
晏觉	yj jt
晒命	ud mk
晒士	ud ui
晕酡酡	yy to to
晚些	wj xp
晚婚	wj hy
晚稻	wj dc
晚节	wj jp
晚辈	wj bw
晚黑	wj hw
晦涩	hv se
晨光绚丽	if gl xr li
晨星	if xk
晨雾弥漫	if wu mi mj
普京	pu jk
普及本	pu ji bf
普及率	pu ji lv
普快	pu kk
普金	pu jb
普鲁士	pu lu ui
景仰	jk yh
景况	jk kl
景气	jk qi
景泰蓝	jk td lj
景点	jk dm
景致	jk vi
景轰	jk hs
景颇族	jk po zu
晴空	qk ks
晶体	jk ti
晶圆	jk yr
晶片	jk pm
晶莹	jk yk
智利	vi li
智力	vi li
智取	vi qu
智育	vi yu
暂住	zj vu
暑气	uu qi
暑热	uu re
暖气片	nr qi pm
暖粒粒	nr li li
暖融融	nr rs rs
暗室不欺	an ui bu qi
暴利	bc li
暴发	bc fa
暴发户	bc fa hu
暴政	bc vg
暴涨	bc vh
暴雨如注	bc yu ru vu
暴风雨	bc fg yu
暴风雪	bc fg xt
暴风骤雨	bc fg vz yu
曚昽	mg ls
曲棍球	qu gy qq
曲调	qu dn
曲轴	qu vz
曲阜	qu fu
曲靖	qu qk
更生	gg ug
更衣室	gg yi ui
更难	gg nj
曹雪芹	cc xt qb
最不安的饭局	zv bu an de fj ju
最不安的饭局	zv bu an di fj ju
最不花钱的白吃	zv bu hx qm de bd ii
最不花钱的白吃	zv bu hx qm di bd ii
最安静的地方	zv an jk de de fh
最安静的地方	zv an jk de di fh
最安静的地方	zv an jk di de fh
最安静的地方	zv an jk di di fh
最宝贵的话	zv bc gv de hx
最宝贵的话	zv bc gv di hx
最悲惨的世界	zv bw cj de ui jp
最悲惨的世界	zv bw cj di ui jp
最惠国	zv hv go
最爱面子的人	zv ai mm zi de rf
最爱面子的人	zv ai mm zi di rf
最肮脏的财产	zv ah zh de cd ij
最肮脏的财产	zv ah zh di cd ij
月中	yt vs
月全食	yt qr ui
月历	yt li
月夜	yt ye
月宫	yt gs
月明星稀	yt mk xk xi
有为	yz ww
有事	yz ui
有交易	yz jn yi
有余	yz yu
有几何	yz ji he
有分数	yz ff uu
有则改之无则加勉	yz ze gd vi mo ze jx mm
有则改之无则加勉	yz ze gd vi wu ze jx mm
有利于	yz li yu
有力	yz li
有咗	yz zo
有型有款	yz xk yz kr
有增无减	yz zg wu jm
有声气	yz ug qi
有头无尾	yz tz wu ww
有如	yz ru
有始无终	yz ui wu vs
有幸	yz xk
有底	yz di
有形	yz xk
有心人	yz xb rf
有志者事竟成	yz vi ve ui jk ig
有悖于	yz bw yu
有情	yz qk
有意	yz yi
有意无意	yz yi wu yi
有成	yz ig
有所不同	yz so bu ts
有所作为	yz so zo ww
有方	yz fh
有时	yz ui
有时候	yz ui hz
有期	yz qi
有机	yz ji
有机体	yz ji ti
有机物	yz ji wu
有板有眼	yz bj yz yj
有毛有翼	yz mc yz yi
有源	yz yr
有点	yz dm
有理	yz li
有理冇理	yz li mc li
有理有据	yz li yz ju
有生力量	yz ug li ll
有用	yz ys
有益	yz yi
有着数	yz vc uu
有着数	yz ve uu
有着数	yz vo uu
有神论	yz uf ly
有章可循	yz vh ke xy
有线	yz xm
有线电	yz xm dm
有罪	yz zv
有胆有识	yz dj yz ui
有误	yz wu
有说有笑	yz uo yz xn
有赖于	yz ld yu
有路数	yz lu uu
有轨	yz gv
有鉴于此	yz jm yu ci
有限	yz xm
服侍	fu ui
服刑	fu xk
服务业	fu wu ye
服务员	fu wu yr
服务器	fu wu qi
服待	fu dd
服毒	fu du
服气	fu qi
服膺	fu yk
服输	fu uu
朗讯	lh xy
望天打卦	wh tm da gx
望望	wh wh
望洋	wh yh
朝乾夕惕	vc qm xi ti
朝圣	ic ug
朝头早	ic tz zc
朝头早	vc tz zc
朝政	ic vg
朝晖	vc hv
朝鲜族	ic xm zu
期中	qi vs
期满	qi mj
木乃伊	mu nd yi
木兰	mu lj
木口木面	mu kz mu mm
木嘴	mu zv
木头车	mu tz ie
木头车	mu tz ju
木床	mu il
木版	mu bj
木独	mu du
木质	mu vi
木鱼	mu yu
未了	ww ln
未决	ww jt
未完	ww wj
未成	ww ig
未有耐	ww yz nd
未知	ww vi
未经	ww jk
未遭	ww zc
末期	mo qi
末班车	mo bj ie
本世纪	bf ui ji
本义	bf yi
本体	bf ti
本原	bf yr
本县	bf xm
本地姜唔辣	bf de jl wu la
本地姜唔辣	bf di jl wu la
本市	bf ui
本本	bf bf
本来面目	bf ld mm mu
本源	bf yr
本溪	bf xi
本相	bf xl
本科生	bf ke ug
本职	bf vi
术语	uu yu
朱德	vu de
朱熹	vu xi
机井	ji jk
机位	ji ww
机体	ji ti
机关报	ji gr bc
机关枪	ji gr ql
机具	ji ju
机务	ji wu
机动	ji ds
机动性	ji ds xk
机动车	ji ds ie
机器人	ji qi rf
机型	ji xk
机头	ji tz
机心	ji xb
机时	ji ui
机智	ji vi
机枪	ji ql
机械化	ji xp hx
机械厂	ji xp ih
机械手	ji xp uz
机油	ji yz
机理	ji li
机电	ji dm
机种	ji vs
机箱	ji xl
机群	ji qy
机翼	ji yi
机耕	ji gg
机能	ji ng
机要	ji yc
机警	ji jk
机身	ji uf
机车	ji ie
机载	ji zd
机长	ji ih
机长	ji vh
机顶盒	ji dk he
杀人犯	ua rf fj
杀伤力	ua uh li
杀手锏	ua uz jm
杀敌致果	ua di vi go
杀机	ua ji
杀猪宰羊	ua vu zd yh
杂剧	za ju
杂草丛生	za cc cs ug
杂记	za ji
杂货店	za ho dm
权位	qr ww
权力	qr li
权威性	qr ww xk
杆子	gj zi
杆菌	gj jy
李先念	li xm nm
李商隐	li uh yb
李嘉诚	li jx ig
李四光	li si gl
李大钊	li da vc
李子	li zi
李宁	li nk
李敖	li ao
李时珍	li ui vf
李清照	li qk vc
李白	li bd
李逵	li kv
李鹏	li pg
杏仁	xk rf
村头	cy tz
杜志民	du vi mb
杜若	du ro
束缚	uu fu
束身自好	uu uf zi hc
杠铃	gh lk
条型码	tn xk ma
条条框框	tn tn kl kl
条气唔顺	tn qi wu uy
条理	tn li
条纹	tn wf
来京	ld jk
来势	ld ui
来势汹汹	ld ui xs xs
来意	ld yi
来来往往	ld ld wh wh
来源于	ld yr yu
来袭	ld xi
来讲	ld jl
来踪去迹	ld zs qu ji
杨树	yh uu
杭州市	hh vz ui
杯子	bw zi
杰出	jp iu
松人	ss rf
松劲	ss jb
松化	ss hx
松骨	ss gu
松鼠	ss uu
板书	bj uu
板块	bj kk
板子	bj zi
板报	bj bc
板斧	bj fu
板胡	bj hu
板蓝根	bj lj gf
板车	bj ie
板载	bj zd
极乐	ji le
极光	ji gl
极其	ji qi
极具	ji ju
极刑	ji xk
极力	ji li
极化	ji hx
极地	ji di
极好	ji hc
极度	ji du
极易	ji yi
构件	gz jm
枉法	wh fa
枉费	wh fw
枕住	vf vu
枕戈待旦	vf ge dd dj
枕木	vf mu
林产	lb ij
林区	lb qu
林带	lb dd
林檎	lb qb
林海	lb hd
林海雪原	lb hd xt yr
林荫道	lb yb dc
果农	go ns
果占	go vj
果园飘香	go yr pn xl
果实累累	go ui lw lw
果实饱满	go ui bc mj
果木	go mu
果栏	go lj
果酒	go jq
枝叶	vi ye
枝头	vi tz
枝干	vi gj
枝杈	vi ia
枝条	vi tn
枝节	vi jp
枣树	zc uu
枧液	jm ye
枧粉	jm ff
枨鸡	ig ji
枪声	ql ug
枪弹	ql dj
枪战	ql vj
枪支	ql vi
枪杆子	ql gj zi
枯水	ku uv
架世	jx ui
架势	jx ui
架次	jx ci
架设	jx ue
枸橘	gz ju
枸橼	gz yr
枸橼	ju yr
柏树	bd uu
柏油	bd yz
染料	rj ln
柔媚	rz mw
柠檬酸	nk mg sr
查勘	ia kj
查号台	ia hc td
查哨	ia uc
查对	ia dv
查禁	ia jb
查访	ia fh
柬埔寨	jm bu vd
柬埔寨	jm pu vd
柱子	vu zi
柱石	vu ui
柳传志	lq ir vi
柳传志	lq vr vi
柳体	lq ti
柴可夫	id ke fu
柴台	id td
柴哇哇	id wa wa
柴油机	id yz ji
柿子	ui zi
标准件	bn vy jm
标准化	bn vy hx
标准普尔	bn vy pu er
标参	bn cj
标参	bn uf
标号	bn hc
标明	bn mk
标牌	bn pd
标示	bn ui
标青	bn qk
栈道	vj dc
栉风沐雨	vi fg mu yu
栋梁之才	ds ll vi cd
栏河	lj he
树大根深	uu da gf uf
树枝	uu vi
树桩	uu vl
树种	uu vs
树脂	uu vi
树身	uu uf
栖息	qi xi
栖栖	qi qi
栖栖	qi xi
栖栖	xi qi
栖栖	xi xi
栖身	qi uf
栖迟	qi ii
栖迟	xi ii
栝楼	gx lz
栝楼	ko lz
栝楼	tm lz
校务	xn wu
校区	jn ou
校区	jn qu
校区	xn ou
校区	xn qu
校址	xn vi
校官	xn gr
校徽	xn hv
校方	xn fh
校样	jn yh
校正	jn vg
校规	xn gv
栲栳	kc lc
样书	yh uu
样机	yh ji
核减	he jm
核动力	he ds li
核反应	he fj yk
核反应堆	he fj yk dv
核威胁	he ww xp
核子	he zi
核实	he ui
核弹头	he dj tz
核战争	he vj vg
核潜艇	he qm tk
核燃料	he rj ln
核物理	he wu li
核电	he dm
核电站	he dm vj
核糖	he th
核试验	he ui yj
核酸	he sr
根据地	gf ju di
根本性	gf bf xk
格子	ge zi
格律	ge lv
格格	ge ge
格陵兰	ge lk lj
格鲁吉亚	ge lu ji ya
栽植	zd vi
栽种	zd vs
桂花	gv hx
桃李	tc li
桄榔	gl lh
桑梓	sh zi
桑榆暮景	sh yu mu jk
桔子	ju zi
桔槔	jp gc
桔槔	ju gc
桔红色	jp hs se
桔红色	jp hs ud
桔红色	ju hs se
桔红色	ju hs ud
桥头堡	qn tz bc
桥涵	qn hj
桥溜	qn lq
桥身	qn uf
桫椤	so lo
梅花	mw hx
梅花鹿	mw hx lu
梅菜	mw cd
梅雨	mw yu
梆子	bh zi
梗房	gg fh
梗阻	gg zu
梦乡	mg xl
梦秋	mg qq
梨子	li zi
梨树	li uu
梯形	ti xk
梯次	ti ci
梯级	ti ji
梳子	uu zi
梳芙	uu fu
梵蒂冈	fj di gh
梼昧	dc mw
梼昧	iz mw
梼昧	tc mw
梼杌	dc wu
梼杌	iz wu
梼杌	tc wu
检举	jm ju
检字法	jm zi fa
检察	jm ia
检察员	jm ia yr
检察官	jm ia gr
检察长	jm ia vh
检察院	jm ia yr
检疫	jm yi
检阅	jm yt
棉农	mm ns
棉布	mm bu
棉田	mm tm
棉纱	mm ua
棉衣	mm yi
棉衲	mm na
棋友	qi yz
棋圣	qi ug
棋坛	qi tj
棋子	qi zi
棋盘	qi pj
棋类	qi lw
棋艺	qi yi
棋迷	qi mi
棹忌	vc ji
棹忌	vo ji
棺木	gr mu
植保	vi bc
植树	vi uu
植树造林	vi uu zc lb
植株	vi vu
植物园	vi wu yr
植物学	vi wu xt
植物油	vi wu yz
椎间盘	vv jm pj
椰丝	ye si
椰子	ye zi
椰菜花	ye cd hx
楔子	xp zi
楠木	nj mu
楹联	yk lm
楼堂馆所	lz th gr so
楼宇	lz yu
楼板	lz bj
概莫能外	gd mo ng wd
概貌	gd mc
榆林	yu lb
榆树	yu uu
榜首	bh uz
榴弹炮	lq dj pc
樗蒲	iu pu
模拟器	mo ni qi
模棱	mo lg
模模糊糊	mo mo hu hu
横丫肠	hg ya ih
横梁	hg ll
横眉立目	hg mw li mu
横行	hg xk
横街窄巷	hg jp vd hh
横街窄巷	hg jp vd xl
樽枳	zy vi
橄榄绿	gj lj lv
橘子	ju zi
橙子	ig zi
橡皮艇	xl pi tk
檐蛇	yj ue
欠薪	qm xb
欠账	qm vh
次之	ci vi
次品	ci pb
次大陆	ci da lu
次子	ci zi
次次	ci ci
次第	ci di
次长	ci ih
次长	ci vh
欢声雷动	hr ug lw ds
欢宴	hr yj
欢欢喜喜	hr hr xi xi
欢欣	hr xb
欢歌笑语	hr ge xn yu
欢蹦乱跳	hr bg lr tn
欢迎会	hr yk hv
欣喜	xb xi
欣悉	xb xi
欧阳询	ou yh xy
欸乃	ai nd
欸乃	ei nd
欸乃	vd nd
欺压	qi ya
款子	kr zi
款待	kr dd
歇业	xp ye
歇暑	xp uu
歇歇	xp xp
歇脚	xp jn
歉意	qm yi
歉收	qm uz
歉疚	qm jq
歌剧	ge ju
歌剧院	ge ju yr
歌星	ge xk
歌舞剧	ge wu ju
歌舞团	ge wu tr
止境	vi jk
止痛	vi ts
正中	vg vs
正义	vg yi
正义凛然	vg yi lb rj
正事	vg ui
正值	vg vi
正剧	vg ju
正副	vg fu
正史	vg ui
正名	vg mk
正告	vg gc
正嘢	vg ye
正大	vg da
正常值	vg ih vi
正当防卫	vg dh fh ww
正房	vg fh
正教	vg jn
正方形	vg fh xk
正是	vg ui
正气	vg qi
正气凛然	vg qi lb rj
正法	vg fa
正点	vg dm
正电子	vg dm zi
正确性	vg qt xk
正职	vg vi
正规军	vg gv jy
正规化	vg gv hx
正视	vg ui
正解	vg jp
正解	vg xp
正误	vg wu
正负	vg fu
正路	vg lu
正身	vg uf
正轨	vg gv
此事	ci ui
此地无银	ci de mo yb
此地无银	ci de wu yb
此地无银	ci di mo yb
此地无银	ci di wu yb
此致	ci vi
此行	ci xk
此言	ci yj
此项	ci xl
步入	bu ru
步步	bu bu
步步登高	bu bu dg gc
步行	bu xk
步调一致	bu dn yi vi
步长	bu ih
武力	wu li
武士	wu ui
武威	wu ww
武官	wu gr
武将	wu jl
武戏	wu xi
武断	wu dr
武昌	wu ih
武术	wu uu
武汉市	wu hj ui
武生	wu ug
武艺	wu yi
武装部	wu vl bu
歧义	qi yi
歧视	qi ui
歧途	qi tu
歪理	wd li
死亡线	si wh xm
死人	si rf
死估估	si gu gu
死地	si di
死死下	si si xx
死死气	si si qi
死气喉	si qi hz
死牛一便颈	si nq yi bm gg
死牛一便颈	si nq yi bm jk
死牛一便颈	si nq yi pm gg
死牛一便颈	si nq yi pm jk
死硬	si yk
死蛇烂蟮	si ue lj uj
死蛇烂鳝	si ue lj uj
死蠢	si iy
死记	si ji
死鸡撑饭盖	si ji ig fj gd
歼击	jm ji
歼击机	jm ji ji
歼敌	jm di
歼灭战	jm mp vj
残余	cj yu
残垣断壁	cj yr dr bi
残害	cj hd
残局	cj ju
残疾人	cj ji rf
残联	cj lm
残部	cj bu
残酷无情	cj ku wu qk
残阳	cj yh
残阳如血	cj yh ru xp
残阳如血	cj yh ru xt
殖民地	vi mb di
殡仪馆	bb yi gr
殷墟	yb xu
殷实	yb ui
殷殷	yb yb
毁弃	hv qi
毁灭性	hv mp xk
毅然	yi rj
毋宁	wu nk
毋庸	wu ys
母带	mu dd
母本	mu bf
母语	mu yu
每位	mw ww
每台	mw td
每期	mw qi
每每	mw mw
每隔	mw ge
毒气	du qi
毒霸	du ba
比价	bi jx
比例尺	bi li ii
比值	bi vi
比划	bi hx
比如说	bi ru uo
比尔	bi er
比拟	bi ni
比翼齐飞	bi yi qi fw
比试	bi ui
毕业生	bi ye ug
毕加索	bi jx so
毕恭毕敬	bi gs bi jk
毕生	bi ug
毕节	bi jp
毙命	bi mk
毛公仔	mc gs zd
毛公仔	mc gs zi
毛坯	mc pi
毛纺	mc fh
毛线	mc xm
毛衣	mc yi
毡房	vj fh
毫不利己	hc bu li ji
毫不犹豫	hc bu yz yu
毫不留情	hc bu lq qk
毫不相干	hc bu xl gj
毫克	hc ke
毫无例外	hc wu li wd
毫无疑义	hc wu yi yi
毯子	tj zi
毵毵	sj sj
氍毹	qu uu
氏族	ui zu
民主党派	mb vu dh pd
民力	mb li
民品	mb pb
民团	mb tr
民委	mb ww
民盟	mb mg
民进	mb jb
民革	mb ge
气冲牛斗	qi is nq dz
气力	qi li
气动	qi ds
气势	qi ui
气咳	qi ke
气垫	qi dm
气壮如牛	qi vl ru nq
气宇轩昂	qi yu xr ag
气性	qi xk
气愤	qi ff
气昂昂	qi ag ag
气概	qi gd
气泡	qi pc
气管	qi gr
气管炎	qi gr yj
气罗气喘	qi lo qi ir
气象台	qi xl td
气贯长虹	qi gr ih hs
气阀	qi fa
气韵	qi yy
氛围	ff ww
氢弹	qk dj
氤氲	yb yy
氧化物	yh hx wu
氮气	dj qi
氰化	qk hx
水产品	uv ij pb
水仙花	uv xm hx
水兵	uv bk
水利局	uv li ju
水力	uv li
水势	uv ui
水印	uv yb
水合物	uv he wu
水喉铁	uv hz tp
水坑	uv kg
水坝	uv ba
水墨画	uv mo hx
水尾	uv ww
水师	uv ui
水平如镜	uv pk ru jk
水彩画	uv cd hx
水性	uv xk
水情	uv qk
水手	uv uz
水文	uv wf
水文站	uv wf vj
水旱	uv hj
水星	uv xk
水晶宫	uv jk gs
水柱	uv vu
水汪汪	uv wh wh
水流湍急	uv lq tr ji
水浇地	uv jn di
水深	uv uf
水渠	uv qu
水火	uv ho
水灵灵	uv lk lk
水电局	uv dm ju
水电站	uv dm vj
水皮	uv pi
水磨	uv mo
水箱	uv xl
水粉画	uv ff hx
水系	uv xi
水肿	uv vs
水蒸气	uv vg qi
水蛋	uv dj
水警	uv jk
水道	uv dc
水陆	uv lu
水面	uv mm
水饺	uv jn
水龙	uv ls
永世	ys ui
永中	ys vs
永久性	ys jq xk
永垂不朽	ys iv bu xq
汁液	vi ye
汁都捞埋	vi du lc md
汁都捞埋	vi du lc mj
汁都捞埋	vi dz lc md
汁都捞埋	vi dz lc mj
求全	qq qr
求援	qq yr
求是	qq ui
求知	qq vi
求知欲	qq vi yu
汇价	hv jx
汇合	hv he
汇报会	hv bc hv
汇款单	hv kr dj
汉书	hj uu
汉代	hj dd
汉城	hj ig
汉堡包	hj bc bc
汉奸	hj jm
汉子	hj zi
汉文	hj wf
汉白玉	hj bd yu
汍澜	wj lj
汗牛充栋	hj nq is ds
汛情	xy qk
江北	jl bw
江民	jl mb
江水	jl uv
江苏省	jl su ug
江西省	jl xi ug
江陵	jl lk
池子	ii zi
污水	wu uv
污水渠	wu uv qu
污泥浊水	wu ni vo uv
污秽	wu hv
污糟邋遢	wu zc la ta
污蔑	wu mp
污辱	wu ru
汤姆	th mu
汩汩	gu gu
汩没	gu mo
汩没	gu mw
汩没	yu mo
汩没	yu mw
汪延	wh yj
汪洋大海	wh yh da hd
汲水	ji uv
汽化	qi hx
汽笛	qi di
汽车站	qi ie vj
汽轮机	qi ly ji
沁人肺腑	qb rf fw fu
沁阳	qb yh
沃尔玛	wo er ma
沃达丰	wo da fg
沄沄	yy yy
沆瀣	hh xp
沈从文	uf cs wf
沈阳市	uf yh ui
沉没	if mo
沉甸甸	if dm dm
沉积	if ji
沉郁	if yu
沓正	da vg
沓正	ta vg
沙俄	ua ee
沙地	ua di
沙场	ua ih
沙子	ua zi
沙市	ua ui
沙文主义	ua wf vu yi
沙沙	ua ua
沙沙滚	ua ua gy
沙河粉	ua he ff
沙洲	ua vz
沙石	ua ui
沙砾	ua li
沙胆	ua dj
沙茶酱	ua ia jl
没什么	mw uf me
没命	mw mk
没治	mw vi
沥青	li qk
沦陷区	ly xm qu
沧浪	ch lh
沧海横流	ch hd hg lq
沪剧	hu ju
沮洳	ju ru
河北省	he bw ug
河南省	he nj ug
河堤	he di
河套	he tc
河山	he uj
河水	he uv
河滩	he tj
河神	he uf
河谷	he gu
河面	he mm
沸水	fw uv
油井	yz jk
油嘴	yz zv
油坊	yz fh
油墨	yz mo
油多	yz do
油彩	yz cd
油桶	yz ts
油气	yz qi
油水	yz uv
油污	yz wu
油滑	yz hx
油漆	yz qi
油灯	yz dg
油烟	yz yj
油画	yz hx
油矿	yz kl
油管	yz gr
油箱	yz xl
油类	yz lw
油罐	yz gr
油耗	yz hc
油脂	yz vi
油船	yz ir
油角	yz jn
油角	yz jt
油路	yz lu
治外法权	vi wd fa qr
治学	vi xt
治愈	vi yu
治本	vi bf
治标	vi bn
治罪	vi zv
沼气	vc qi
沼泽地	vc ze di
沾满	vj mj
沿江	yj jl
沿袭	yj xi
沿边	yj bm
沿革	yj ge
泄欲	xp yu
泉源	qr yr
泔水	gj uv
法书	fa uu
法事	fa ui
法典	fa dm
法制	fa vi
法力	fa li
法子	fa zi
法家	fa jx
法师	fa ui
法拉利	fa la li
法政	fa vg
法文	fa wf
法新社	fa xb ue
法权	fa qr
法理	fa li
法纪	fa ji
法语	fa yu
法郎	fa lh
泛指	fj vi
泛泛	fj fj
泠泠	lk lk
波兰	bo lj
波多黎各	bo do li ge
波幅	bo fu
波牛	bo nq
波经	bo jk
波谷	bo gu
波霸	bo ba
波音	bo yb
波饼	bo bk
泣涕	qi ti
泥人	ni rf
泥水	ni uv
泥湴	ni bj
泥湴	ni pj
泥瓦匠	ni wa jl
泥石流	ni ui lq
注塑	vu su
注射器	vu ue qi
注目	vu mu
注目礼	vu mu li
注脚	vu jn
泰乐	td le
泰乐	td yt
泰山压顶	td uj ya dk
泰山移	td uj yi
泱泱	yh yh
泵房	bg fh
泵站	bg vj
洁净	jp jk
洋为中用	yh ww vs ys
洋洋大观	yh yh da gr
洋洋得意	yh yh de yi
洋烛	yh vu
洋行	yh hh
洋货	yh ho
洗劫	xi jp
洗劫一空	xi jp yi ks
洗大饼	xi da bk
洗大饼	xi dd bk
洗手	xi uz
洗手奉职	xi uz fg vi
洗楼	xi lz
洗涤剂	xi di ji
洗湿个头	xi ui ge tz
洗漱	xi uu
洗礼	xi li
洗练	xi lm
洗脚唔抹脚	xi jn wu ma jn
洗脚唔抹脚	xi jn wu mo jn
洗衣	xi yi
洗衫板	xi uj bj
洗黑钱	xi hw qm
洛阳纸贵	lo yh vi gv
洞悉	ds xi
洞房	ds fh
津巴布韦	jb ba bu ww
洪武	hs wu
洪水猛兽	hs uv mg uz
洪钟	hs vs
洪魔	hs mo
活动家	ho ds jx
活化石	ho hx ui
活性	ho xk
活性炭	ho xk tj
活期	ho qi
活水	ho uv
活生生	ho ug ug
活脱脱	ho to to
活计	ho ji
活路	ho lu
洽谈会	qx tj hv
派出所	pd iu so
派性	pd xk
派息	pd xi
派拉蒙	pd la mg
派筹	pd iz
派系	pd xi
派街坊	pd jp fh
流下	lq xx
流失	lq ui
流弹	lq dj
流星	lq xk
流星雨	lq xk yu
流水线	lq uv xm
流沙	lq ua
流浪汉	lq lh hj
流离	lq li
流窜犯	lq cr fj
流线型	lq xm xk
流行榜	lq hh bh
流行榜	lq xk bh
流行色	lq xk se
流行语	lq hh yu
流行语	lq xk yu
流言	lq yj
流言飞语	lq yj fw yu
流逝	lq ui
浅析	qm xi
浅水	qm uv
浅滩	qm tj
浇水	jn uv
浇注	jn vu
浇灌	jn gr
浇铸	jn vu
浊亲	vo qb
浊亲	vo qk
浊流	vo lq
测绘局	ce hv ju
济南市	ji nj ui
济困扶危	ji ky fu ww
济宁	ji nk
济弱扶倾	ji ro fu qk
济济一堂	ji ji yi th
济源	ji yr
浑俗和光	hy su he gl
浑厚	hy hz
浑水摸鱼	hy uv mo yu
浓烟滚滚	ns yj gy gy
浓眉大眼	ns mw da yj
浙江省	ve jl ug
浩劫	hc jp
浩大	hc da
浩气	hc qi
浩浩长空	hc hc ih ks
浩浩长空	hc hc vh ks
浩渺	hc mn
浩繁	hc fj
浪头	lh tz
浪漫主义	lh mj vu yi
浮华	fu hx
浮尘	fu if
浮标	fu bn
浮沉	fu if
浮泛	fu fj
浮浅	fu qm
浮游	fu yz
浮萍	fu pk
浴室	yu ui
浴池	yu ii
海事	hd ui
海伦	hd ly
海信	hd xb
海味	hd ww
海地	hd di
海堤	hd di
海岛	hd dc
海平面	hd pk mm
海归	hd gv
海洛因	hd lo yb
海派	hd pd
海淀	hd dm
海潮	hd ic
海疆	hd jl
海皮	hd pi
海绵	hd mm
海豹	hd bc
海防	hd fh
海陆空	hd lq ks
海陆空	hd lu ks
海难	hd nj
海顿	hd dy
浸入	jb ru
浸染	jb rj
浸润	jb ry
浸猪笼	jb vu ls
浸种	jb vs
浸透	jb tz
消亡	xn wh
消协	xn xp
消息人士	xn xi rf ui
消暑	xn uu
消毒剂	xn du ji
消滞	xn vi
消火栓	xn ho ur
消瘦	xn uz
消融	xn rs
消退	xn tv
消逝	xn ui
消长	xn vh
消闲	xn xm
消防喉	xn fh hz
消防车	xn fh ie
消防队	xn fh dv
涉世	ue ui
涉黄	ue hl
涉黑	ue hw
涌浪	ys lh
涓滴归公	jr di gv gs
涕泗	ti si
涝灾	lc zd
涡轮机	wo ly ji
涤荡	di dh
润滑油	ry hx yz
涨至	vh vi
涨落	vh lo
液化	ye hx
液化气	ye hx qi
涵义	hj yi
涵洞	hj ds
涵管	hj gr
淅沥	xi li
淅淅沥沥	xi xi li li
淋巴结	lb ba jp
淋漓	lb li
淋病	lb bk
淘汰赛	tc td sd
淙淙	cs cs
淟涊	tm nm
淡季	dj ji
淡水湖	dj uv hu
淡水鱼	dj uv yu
淡茂茂	dj mc mc
淡薄	dj bo
淤塞	yu se
淤积	yu ji
淫威	yb ww
淫溢	yb yi
淮南	hk nj
淮阴	hk yb
深为	uf ww
深信	uf xb
深切治疗	uf qp vi ln
深刻性	uf ke xk
深化	uf hx
深受	uf uz
深处	uf iu
深得民心	uf de mb xb
深情	uf qk
深情厚意	uf qk hz yi
深情厚谊	uf qk hz yi
深意	uf yi
深明大义	uf mk da yi
深水港	uf uv gh
深知	uf vi
深谷	uf gu
深远	uf yr
深透	uf tz
深重	uf vs
深闺	uf gv
淳厚	iy hz
混交林	hy jn lb
混养	hy yh
混合物	hy he wu
混吉	hy ji
混浊	hy vo
混淆是非	hy xn ui fw
添加剂	tm jx ji
添麻烦	tm ma fj
清亮	qk ll
清代	qk dd
清偿	qk ih
清冷	qk lg
清净	qk jk
清凉油	qk ll yz
清剿	qk jn
清幽	qk yz
清明节	qk mk jp
清晰度	qk xi du
清正	qk vg
清河	qk he
清洁	qk jp
清洗	qk xi
清淡	qk dj
清瘦	qk uz
清纯	qk iy
清茶	qk ia
清补凉	qk bu ll
清规戒律	qk gv jp lv
清运	qk yy
清香	qk xl
清香鲜嫩	qk xl xm nf
渊薮	yr sz
渐入佳境	jm ru jx jk
渐变	jm bm
渐次	jm ci
渐至佳境	jm vi jx jk
渔人之利	yu rf vi li
渔具	yu ju
渔区	yu qu
渔场	yu ih
渔夫	yu fu
渔家	yu jx
渔港	yu gh
渔火	yu ho
渔网	yu wh
渔舟	yu vz
渔轮	yu ly
渗入	uf ru
渡海	du hd
渡过	du go
渣都冇	va du mc
渣都冇	va dz mc
温厚	wf hz
温哥华	wf ge hx
温室	wf ui
温家宝	wf jx bc
温暾	wf ty
温柔敦厚	wf rz dy hz
温润而泽	wf ry er ze
温良恭俭让	wf ll gs jm rh
港务局	gh wu ju
游人	yz rf
游兴	yz xk
游击	yz ji
游击战	yz ji vj
游击队	yz ji dv
游医	yz yi
游历	yz li
游园	yz yr
游园会	yz yr hv
游埠	yz bu
游子	yz zi
游干水	yz gj uv
游弋	yz yi
游戏人间	yz xi rf jm
游泳池	yz ys ii
游泳馆	yz ys gr
游离	yz li
游绳	yz ug
游艺	yz yi
游艺机	yz yi ji
游记	yz ji
渺嘴	mn zv
湉湉	tm tm
湑湑	xu xu
湖北省	hu bw ug
湖区	hu ou
湖区	hu qu
湖南省	hu nj ug
湖州	hu vz
湘赣	xl gj
湛蓝	vj lj
湝湝	jp jp
湮没	yj mo
湿地	ui di
湿度	ui du
湿柴	ui id
湿气	ui qi
湿水鸡	ui uv ji
湿漉漉	ui lu lu
湿碎	ui sv
溃于蚁穴	kv yu yi xt
源流	yr lq
源源	yr yr
溜冰场	lq bk ih
溟蒙	mk mg
溢于言表	yi yu yj bn
溢利	yi li
溯源	su yr
溶剂	rs ji
溶化	rs hx
滂沛	ph pw
滃郁	wg yu
滇池	dm ii
滋事	zi ui
滋油	zi yz
滋油淡定	zi yz dj dk
滋补品	zi bu pb
滑动	hx ds
滑捋捋	hx lo lo
滑捋捋	hx lo lv
滑捋捋	hx lv lo
滑捋捋	hx lv lv
滑梯	hx ti
滑潺潺	hx ij ij
滑牙	hx ya
滑稽戏	hx ji xi
滑翔	hx xl
滑雪	hx xt
滑雪板	hx xt bj
滕州	tg vz
滚水渌脚	gy uv lu jn
滚热辣	gy re la
滚红滚绿	gy hs gy lu
滚红滚绿	gy hs gy lv
滚轴溜冰	gy vz lq bk
滚雪球	gy xt qq
滞后	vi hz
滞销	vi xn
满员	mj yr
满城风雨	mj ig fg yu
满天	mj tm
满头	mj tz
满山红叶	mj uj hs xp
满山红叶	mj uj hs ye
满山遍野	mj uj bm ye
满怀信心	mj hk xb xb
满招损谦受益	mj vc sy qm uz yi
满文	mj wf
满族	mj zu
满洲	mj vz
满洲国	mj vz go
满满	mj mj
满满当当	mj mj dh dh
满眼	mj yj
满肚密圈	mj du mi jr
满肚密圈	mj du mi qr
满腔热情	mj ql re qk
满腹牢骚	mj fu lc sc
滥觞	lj uh
滩地	tj di
滩头	tj tz
滩涂	tj tu
滴水	di uv
滴水成冰	di uv ig bk
滴溜	di lq
漂渺	pn mn
漂漂亮亮	pn pn ll ll
漂移	pn yi
漏税	lz uv
漓江	li jl
演义	yj yi
演习	yj xi
演化	yj hx
演唱会	yj ih hv
演奏员	yj zz yr
演奏家	yj zz jx
演播室	yj bo ui
演示	yj ui
演算	yj sr
演艺	yj yi
演进	yj jb
漠视	mo ui
漫天要价	mj tm yc jx
漫天飞雪	mj tm fw xt
漫漫	mj mj
漫漫长夜	mj mj ih ye
漫漫长夜	mj mj vh ye
漫漶	mj hr
漭漭	mh mh
漯河	lo he
漳州	vh vz
潆洄	yk hv
潇湘	xn xl
潋滟	lm yj
潜入	qm ru
潜台词	qm td ci
潜意识	qm yi ui
潜水员	qm uv yr
潜水艇	qm uv tk
潜质	qm vi
潜返	qm fj
潢洋	gl yh
潢洋	hl yh
潦倒	ln dc
潮头	ic tz
潮汐	ic xi
潮阳	ic yh
潺湲	ij yr
激动人心	ji ds rf xb
激化	ji hx
激奀	ji en
激奀	ji nf
激愤	ji ff
激浊扬清	ji vo yh qk
激起	ji qi
激进	ji jb
濑粉	ld ff
濒于	bb yu
濮阳	pu yh
灌区	gr qu
灌注	gr vu
灌浆	gr jl
灌渠	gr qu
火力	ho li
火势	ho ui
火化	ho hx
火器	ho qi
火树银花	ho uu yb hx
火海	ho hd
火滚	ho gy
火灾	ho zd
火炕	ho kh
火电厂	ho dm ih
火电站	ho dm vj
火箭弹	ho jm dj
火箭炮	ho jm pc
火箭筒	ho jm ts
火花塞	ho hx sd
火药味	ho yc ww
火起	ho qi
火路	ho lu
火车头	ho ie tz
火辣辣	ho la la
火遮眼	ho ve yj
火险	ho xm
火鸡	ho ji
灭火喉	mp ho hz
灯市	dg ui
灯柱	dg vu
灯油火腊	dg yz ho la
灯油火腊	dg yz ho xi
灯胆	dg dj
灰土	hv tu
灰士	hv ui
灰心	hv xb
灰白色	hv bd se
灰白色	hv bd ud
灰蒙蒙	hv mg mg
灰质	hv vi
灵宝	lk bc
灵性	lk xk
灵敏度	lk mb du
灶具	zc ju
炉台	lu td
炉子	lu zi
炉渣	lu va
炉膛	lu th
炊事	iv ui
炊事员	iv ui yr
炊事班	iv ui bj
炊烟四起	iv yj si qi
炎夏	yj xx
炎炎	yj yj
炎症	yj vg
炒买炒卖	ic md ic md
炒家	ic jx
炒黄牛	ic hl nq
炖冬菇	dy ds gu
炖品	dy pb
炮手	pc uz
炮灰	pc hv
炸鱼	va yu
点子	dm zi
点心	dm xb
点拨	dm bo
点搞	dm gc
点明	dm mk
点止	dm vi
点红点绿	dm hs dm lu
点红点绿	dm hs dm lv
点钟	dm vs
炼焦	lm jn
烂命	lj mk
烂头蟀	lj tz uk
烂摊子	lj tj zi
烂溶溶	lj rs rs
烂漫	lj mj
烂瘾	lj yb
烂瞓	lj ff
烂瞓	lj xy
烂蓉蓉	lj rs rs
烂铜烂铁	lj ts lj tp
烂饭	lj fj
烈军属	lp jy uu
烈士	lp ui
烈士墓	lp ui mu
烈属	lp uu
烈日当头	lp ri dh tz
烘云托月	hs yy to yt
烚熟狗头	xx uu gz tz
烚熟狗头	xx uz gz tz
烟仔	yj zd
烟仔	yj zi
烟士	yj ui
烟尘	yj if
烟帽队	yj mc dv
烟波	yj bo
烟波浩淼	yj bo hc mn
烟灰	yj hv
烟灰盅	yj hv vs
烟熏火燎	yj xy ho ln
烟盒	yj he
烟筒	yj ts
烟花	yj hx
烟草业	yj cc ye
烟蒂	yj di
烟雨	yj yu
烟雾	yj wu
烤烟	kc yj
烦燥	fj zc
烦琐	fj so
烧碱	uc jm
烧纸	uc vi
烧结	uc jp
热乎乎	re hu hu
热心肠	re xb ih
热核	re he
热气腾腾	re qi tg tg
热水瓶	re uv pk
热河	re he
热源	re yr
热火	re ho
热电厂	re dm ih
热痱	re fw
热轧	re va
热轧	re ya
烽火台	fg ho td
烽火连天	fg ho lm tm
焊缝	hj fg
焗亲	ju qb
焗亲	ju qk
焗漆	ju qi
焗炉	ju lu
焗盅	ju vs
焚化	ff hx
焚毁	ff hv
焦化	jn hx
焦土	jn tu
焦油	jn yz
焦炉	jn lu
焦炭	jn tj
焰火	yj ho
然之后	rj vi hz
煎饼	jm bk
煜爚	yu yt
煞下煞下	ua xx ua xx
煞住	ua vu
煞掣	ua ie
煤尘	mw if
煤层	mw cg
煤屎	mw ui
煤气喉	mw qi hz
煤气罐	mw qi gr
煤油	mw yz
煤灰	mw hv
煤烟	mw yj
煤田	mw tm
煤窑	mw yc
照会	vc hv
照发	vc fa
照壁	vc bi
照搬	vc bj
照杀	vc ua
照板煮碗	vc bj vu wj
照肺	vc fw
煮饭仔	vu fj zd
煮饭仔	vu fj zi
煲仔菜	bc zd cd
煲仔菜	bc zi cd
煲仔饭	bc zd fj
煲仔饭	bc zi fj
煲冇米粥	bc mc mi vz
熄匙	xi ii
熄匙	xi ui
熊熊	xs xs
熔化	rs hx
熔岩	rs yj
熔炼	rs lm
熔解	rs jp
熔解	rs xp
熟性	uu xk
熟性	uz xk
熟知	uu vi
熟行	uu hh
熟行	uu xk
熟行	uz hh
熟行	uz xk
熟识	uu ui
熟透	uu tz
熟食	uu ui
熟食档	uu si dh
熟食档	uu ui dh
熟食档	uu yi dh
熟食档	uz si dh
熟食档	uz ui dh
熟食档	uz yi dh
熠熟狗头	yi uu gz tz
熠熟狗头	yi uz gz tz
熠熠	yi yi
熠爚	yi yt
燃起	rj qi
燎原之势	ln yr vi ui
燎泡	ln pc
燕京	yj jk
燕婉	yj wj
燕山	yj uj
燕梳	yj uu
燕燕	yj yj
燕语莺声	yj yu yk ug
燕雀安知	yj qt an vi
燕麦	yj md
燥火	zc ho
燮理阴阳	xp li yb yh
爆发力	bc fa li
爆呔	bc dd
爆呔	bc td
爆圻	bc qi
爆圻	bc yb
爆大镬	bc da ho
爆大镬	bc dd ho
爆满	bc mj
爆炒	bc ic
爆炸性	bc va xk
爆煲	bc bc
爆石	bc dj
爆石	bc ui
爆竹	bc vu
爬格仔	pa ge zd
爬格仔	pa ge zi
爬罗剔抉	pa lo ti jt
爬高	pa gc
爱立信	ai li xb
爵士乐	jt ui yt
父女	fu nv
父本	fu bf
爹哋	dp di
片剂	pm ji
片子	pm zi
片断	pm dr
片片	pm pm
片糖	pm th
版式	bj ui
牌位	pd ww
牌号	pd hc
牌坊	pd fh
牌照	pd vc
牙医	ya yi
牙擦	ya ca
牙擦擦	ya ca ca
牙斩斩	ya vj vj
牙烟	ya yj
牙痛噉声	ya ts dj ug
牙罅	ya xx
牙铰	ya jn
牙齿印	ya ii yb
牙齿当金使	ya ii dh jb ui
牛噍牡丹	nq jn mu dj
牛毛细雨	nq mc xi yu
牛油果	nq yz go
牛皮癣	nq pi xr
牛皮纸	nq pi vi
牛精	nq jk
牛羊肉	nq yh rz
牛脷	nq li
牛郎织女	nq lh vi nv
牛鼎烹鸡	nq dk pg ji
牝牡	pb mu
牟取暴利	mz qu bc li
牢牢	lc lc
牧人	mu rf
牧歌	mu ge
牧童	mu ts
牧羊	mu yh
物主	wu vu
物似主人形	wu ui vu rf xk
物力	wu li
物欲	wu yu
物理	wu li
物理学	wu li xt
物腐虫生	wu fu is ug
物证	wu vg
物资局	wu zi ju
牲畜	ug iu
牵制	qm vi
牵引力	qm yb li
牵线	qm xm
牵萝补屋	qm lo bu wu
特委	te ww
特技	te ji
特指	te vi
特效药	te xn yc
特洛伊	te lo yi
特派员	te pd yr
特种兵	te vs bk
特赦	te ue
牺牲品	xi ug pb
犀厉	xi li
犄角	ji jn
犯众憎	fj vs zg
犯愁	fj iz
犰狳	qq yu
犹太人	yz td rf
犹太教	yz td jn
狂犬病	kl qr bk
狂草	kl cc
狂风暴雨大雨淋漓	kl fg bc yu da yu lb li
狂风暴雨大雨淋漓	kl fg bc yu dd yu lb li
狉狉	pi pi
狍子	pc zi
狐狸	hu li
狐疑不决	hu yi bu jt
狐群狗党	hu qy gz dh
狒狒	fw fw
狗乸	gz na
狗公	gz gs
狗咬狗骨	gz yc gz gu
狗爪边	gz vc bm
狗爪边	gz vx bm
狗牙	gz ya
狙击	ju ji
狡黠	jn xx
独具匠心	du ju jl xb
独具特色	du ju te se
独出心裁	du iu xb cd
独到之处	du dc vi iu
独唱	du ih
独善其身	du uj qi uf
独子	du zi
独木舟	du mu vz
独沽一味	du gu yi ww
独生女	du ug nv
独生子	du ug zi
独立团	du li tr
独角戏	du jn xi
独资	du zi
狭长	xx ih
狮城	ui ig
狷介之士	jr jp vi ui
狸猫	li mc
狻猊	sr ni
狼籍	lh ji
狼胎	lh td
猃狁	xm yy
猕猴桃	mi hz tc
猗傩	yi no
猛兽	mg uz
猛咁	mg gj
猛将	mg jl
猛志常在	mg vi ih zd
猛扑	mg pu
猛犸	mg ma
猛跌	mg dp
猛醒	mg xk
猜呈寻	cd ig xy
猞猁	ue li
猩猩	xk xk
猪乸	vu na
猪仔	vu zd
猪场	vu ih
猪头炳	vu tz bk
猪头骨	vu tz gu
猪崽	vu zd
猪横脷	vu hg li
猪瘟	vu wf
猪突豨勇	vu tu xi ys
猪笼入水	vu ls ru uv
猪脚姜	vu jn jl
猪舍	vu ue
猫乸	mc na
猫扑	mc pu
猫王	mc wh
猫鼠同眠	mc uu ts mm
献技	xm ji
献礼	xm li
献艺	xm yi
献花	xm hx
献血	xm xt
献计	xm ji
献词	xm ci
献身	xm uf
献辞	xm ci
獬豸	xp vi
玄学	xr xt
玄虚	xr xu
玄黄	xr hl
玉兰	yu lj
玉器	yu qi
玉林	yu lb
玉洁松贞	yu jp ss vf
玉溪	yu xi
玉石	yu ui
玉米面	yu mi mm
玉雕	yu dn
王位	wh ww
王公	wh gs
王冠	wh gr
王力	wh li
王室	wh ui
王永民	wh ys mb
王爷	wh ye
王羲之	wh xi vi
王铎	wh do
玎玲	dk lk
玎珰	dk dh
玛丽	ma li
玩意	wj yi
玩新人	wj xb rf
玩艺	wj yi
玫瑰色	mw gv se
环卫	hr ww
环城	hr ig
环形	hr xk
环抱	hr bc
环环相扣	hr hr xl kz
环行	hr xk
环首死刑	hr uz si xk
现世	xm ui
现今	xm jb
现代化	xm dd hx
现代史	xm dd ui
现代戏	xm dd xi
现代派	xm dd pd
现代舞	xm dd wu
现任	xm rf
现出	xm iu
现场会	xm ih hv
现实主义	xm ui vu yi
现实性	xm ui xk
现已	xm yi
现役	xm yi
现时	xm ui
现汇	xm hv
现汉	xm hj
现眼	xm yj
现职	xm vi
现金	xm jb
现钱	xm qm
现阶段	xm jp dr
玳瑁	dd mc
玻利维亚	bo li ww ya
玻璃瓶	bo li pk
珊瑚礁	uj hu jn
珍本	vf bf
珍视	vf ui
珐琅	fa lh
珑璁	ls cs
珞巴族	lo ba zu
珠子	vu zi
班主任	bj vu rf
班加罗尔	bj jx lo er
班房	bj fh
班机	bj ji
班马	bj ma
球形	qq xk
球技	qq ji
球状	qq vl
球艺	qq yi
琅玕	lh gj
理事	li ui
理事会	li ui hv
理事长	li ui vh
理化	li hx
理发	li fa
理发师	li fa ui
理喻	li yu
理学	li xt
理工	li gs
理工科	li gs ke
理所当然	li so dh rj
理睬	li cd
理科	li ke
理解力	li jp li
理论家	li ly jx
琉璃	lq li
琉璃瓦	lq li wa
琥珀	hu po
琬圭	wj gv
琬琰	wj yj
琴声	qb ug
琴师	qb ui
琴心剑胆	qb xb jm dj
琴日	qb ri
琴晚	qb wj
琼瑶	qs yc
瑞金	rv jb
瑞雪纷飞	rv xt ff fw
瑰玮	gv ww
璎珞	yk lo
璞玉浑金	pu yu hy jb
瓜农	gx ns
瓢泼大雨大雨倾盆	pn po da yu da yu qk pf
瓢泼大雨大雨倾盆	pn po da yu dd yu qk pf
瓢泼大雨大雨倾盆	pn po dd yu da yu qk pf
瓢泼大雨大雨倾盆	pn po dd yu dd yu qk pf
瓦工	wa gs
瓦当	wa dh
瓦煲	wa bc
瓦通纸	wa ts vi
瓮声瓮气	wg ug wg qi
甘于	gj yu
甘油	gj yz
甘肃省	gj su ug
甘苦	gj ku
甘蓝	gj lj
甚至于	uf vi yu
甜耶耶	tm ye ye
甜菜	tm cd
甜酸苦辣	tm sr ku la
甜食	tm ui
生于	ug yu
生产关系	ug ij gr xi
生产力	ug ij li
生产率	ug ij lv
生产线	ug ij xm
生产者	ug ij ve
生产队	ug ij dv
生人	ug rf
生人唔生胆	ug rf wu ug dj
生前	ug qm
生力军	ug li jy
生勾勾	ug gz gz
生化	ug hx
生埗	ug bu
生威	ug ww
生安白造	ug an bd zc
生就	ug jq
生态学	ug td xt
生性	ug xk
生意人	ug yi rf
生意经	ug yi jk
生招牌	ug vc pd
生擒活捉	ug qb ho vo
生机	ug ji
生机勃勃	ug ji bo bo
生果金	ug go jb
生死与共	ug si yu gs
生殖	ug vi
生母	ug mu
生活费	ug ho fw
生源	ug yr
生父	ug fu
生物体	ug wu ti
生物学	ug wu xt
生物钟	ug wu vs
生猪	ug vu
生理	ug li
生生	ug ug
生生不已	ug ug bu yi
生疑	ug yi
生肖	ug xn
生育	ug yu
生菜	ug cd
生萝卜	ug lo bo
生萝卜	ug lo bu
生计	ug ji
生长期	ug vh qi
生长素	ug vh su
生鸡	ug ji
甡甡	uf uf
用之不竭	ys vi bu jp
用人	ys rf
用作	ys zo
用尽	ys jb
用工	ys gs
用意	ys yi
用时	ys ui
用材林	ys cd lb
用武	ys wu
用水	ys uv
用煤	ys mw
用语	ys yu
用费	ys fw
甩底	uk di
甩拖	uk to
甩皮	uk pi
甩皮甩骨	uk pi uk gu
甩绳马骝	uk ug ma lq
甩肺	uk fw
甩色	uk se
甩色	uk ud
甩身	uk uf
甩须	uk xu
甫士咭	fu ui ji
甫士咭	fu ui ka
田园诗	tm yr ui
田地	tm di
田径赛	tm jk sd
田联	tm lm
由头	yz tz
由此及彼	yz ci ji bi
由此可见	yz ci ke jm
甲午	jx wu
甲午战争	jx wu vj vg
甲壳	jx qn
甲子	jx zi
甲寅	jx yb
甲戌	jx xu
甲板	jx bj
甲烷	jx wj
甲状腺	jx vl xm
甲申	jx uf
甲级	jx ji
甲虫	jx is
甲辰	jx if
甲醇	jx iy
甲鱼	jx yu
申诉	uf su
申请书	uf qk uu
申请人	uf qk rf
申辩	uf bm
电令	dm lk
电信业	dm xb ye
电信号	dm xb hc
电信局	dm xb ju
电光石火	dm gl ui ho
电劈石击	dm pi dj ji
电劈石击	dm pi ui ji
电压	dm ya
电告	dm gc
电场	dm ih
电声	dm ug
电子学	dm zi xt
电子束	dm zi uu
电子琴	dm zi qb
电子管	dm zi gr
电子邮件	dm zi yz jm
电容器	dm rs qi
电心	dm xb
电教	dm jn
电文	dm wf
电机	dm ji
电极	dm ji
电气	dm qi
电波	dm bo
电灯胆	dm dg dj
电炉	dm lu
电瓶	dm pk
电盈	dm yk
电石	dm ui
电码	dm ma
电磁场	dm ci ih
电磁波	dm ci bo
电离层	dm li cg
电视剧	dm ui ju
电视台	dm ui td
电视塔	dm ui ta
电视机	dm ui ji
电视片	dm ui pm
电话机	dm hx ji
电贺	dm he
电量	dm ll
电钮	dm nq
电风扇	dm fg uj
电饭煲	dm fj bc
男中音	nj vs yb
男仔头	nj zd tz
男仔头	nj zi tz
男低音	nj di yb
男单	nj dj
男声	nj ug
男女老少	nj nv lc uc
男妓	nj ji
男方	nj fh
男权	nj qr
男男女女	nj nj nv nv
男界	nj jp
男童院	nj ts yr
男高音	nj gc yb
画像	hx xl
画公仔画出肠	hx gs zd hx iu ih
画公仔画出肠	hx gs zi hx iu ih
画坛	hx tj
画室	hx ui
画师	hx ui
画板	hx bj
画法	hx fa
画片	hx pm
画眉	hx mw
画虎类狗	hx hu lw gz
画院	hx yr
畀你	bi ni
畀心机	bi xb ji
畅游	ih yz
畅达	ih da
界桩	jp vl
界河	jp he
界碑	jp bw
界线	jp xm
畏缩	ww so
畏罪	ww zv
畏首畏尾	ww uz ww ww
留声机	lq ug ji
留学生	lq xt ug
留宿	lq su
留成	lq ig
留有余地	lq yz yu di
留案底	lq an di
留美	lq mw
留言簿	lq yj bu
留连	lq lm
留驻	lq vu
畜力	iu li
畜牧	xu mu
畜牧业	xu mu ye
略为	lt ww
略语	lt yu
番书仔	fj uu zd
番书仔	fj uu zi
番书仔	pj uu zd
番书仔	pj uu zi
畸士	ji ui
畿辅	ji fu
疆域	jl yu
疆界	jl jp
疏堂	uu th
疏松	uu ss
疏财仗义	uu cd vh yi
疑义	yi yi
疑似	yi si
疑心	yi xb
疑点	yi dm
疗养院	ln yh yr
疫区	yi qu
疫病	yi bk
疮痍	il yi
疲乏	pi fa
疾呼	ji hu
疾步	ji bu
疾风	ji fg
疾驰	ji ii
疾驶	ji ui
痄腮	va sd
病倒	bk dc
病危	bk ww
病历	bk li
病原	bk yr
病原体	bk yr ti
病友	bk yz
病史	bk ui
病君	bk jy
病员	bk yr
病愈	bk yu
病灶	bk zc
病理	bk li
病程	bk ig
病虫害	bk is hd
病魔缠身	bk mo ij uf
症结	vg jp
痘皮	dz pi
痛击	ts ji
痛切	ts qp
痛哭	ts ku
痛处	ts iu
痛心	ts xb
痛悼	ts dc
痛感	ts gj
痛打	ts da
痛斥	ts ii
痢疾	li ji
瘌痢	la li
瘛疭	ii zs
瘟疫	wf yi
瘟瘟沌沌	wf wf dy dy
瘟神	wf uf
瘦小	uz xn
瘦蜢蜢	uz mg mg
瘦骨仙	uz gu xm
瘭疽	bn ju
瘰疬	lo li
癫痫	dm xm
癫癫废废	dm dm fw fw
癸丑	gv iz
癸亥	gv hd
癸卯	gv mc
癸巳	gv si
癸未	gv ww
癸酉	gv yz
登基	dg ji
登对	dg dv
登山队	dg uj dv
登机	dg ji
登陆艇	dg lu tk
白云苍狗	bd yy ch gz
白内障	bd nw vh
白区	bd qu
白发苍苍	bd fa ch ch
白咋	bd va
白咋	bd za
白咋	bd ze
白垩纪	bd ee ji
白天鹅	bd tm ee
白山黑水	bd uj hw uv
白布	bd bu
白开水	bd kd uv
白撞	bd vl
白晒晒	bd ud ud
白榄	bd lj
白灰	bd hv
白炽灯	bd ii dg
白班	bd bj
白癜风	bd dm fg
白米	bd mi
白细胞	bd xi bc
白茫茫	bd mh mh
白薯	bd uu
白蚀	bd ui
白蚁	bd yi
白血球	bd xt qq
白血病	bd xt bk
白豆	bd dz
白雪雪	bd xt xt
白饭鱼	bd fj yu
白鳍豚	bd qi ty
白鸽眼	bd ge yj
白鸽笼	bd ge ls
白鹤	bd he
百代	bd dd
百分之	bd ff vi
百分制	bd ff vi
百分比	bd ff bi
百分点	bd ff dm
百厌星	bd yj xk
百口难辩	bd kz nj bm
百叶窗	bd ye il
百孔千疮	bd ks qm il
百家争鸣	bd jx vg mk
百年不遇	bd nm bu yu
百年大计	bd nm da ji
百废俱兴	bd fw ju xk
百慕大	bd mu da
百灵	bd lk
百老汇	bd lc hv
百色	bd se
百色	bd ud
百花园	bd hx yr
百花盛开	bd hx ig kd
百花盛开	bd hx ug kd
百足咁多爪	bd zu gj do vc
百足咁多爪	bd zu gj do vx
百鸟归林	bd dn gv lb
百鸟归林	bd nn gv lb
百鸟鸣春	bd dn mk iy
百鸟鸣春	bd nn mk iy
的卡	de ka
的卡	de qx
的卡	di ka
的卡	di qx
的士	di ui
的士高	de ui gc
的士高	di ui gc
的式	de ui
的式	di ui
的的确确	de de qt qt
的的确确	de di qt qt
的的确确	di de qt qt
的的确确	di di qt qt
的起心肝	de qi xb gj
的起心肝	di qi xb gj
皇历	hl li
皇太子	hl td zi
皇权	hl qr
皇气	hl qi
皎皎	jn jn
皓首穷经	hc uz qs jk
皖南	wj nj
皮子	pi zi
皮影戏	pi yk xi
皮条	pi tn
皮棉	pi mm
皮特	pi te
皮箧	pi qp
皮肤病	pi fu bk
皮袋	pi dd
皮货	pi ho
皮费	pi fw
皱褶	vz ve
盈余	yk yu
益友	yi yz
益发	yi fa
益处	yi iu
益阳	yi yh
盐城	yj ig
盐碱	yj jm
盐碱地	yj jm di
盐蛇	yj ue
监制	jm vi
监听	jm tk
监察	jm ia
监护人	jm hu rf
监测	jm ce
监理	jm li
监禁	jm jb
监粗嚟	jm cu li
监粗嚟	jm cu lw
监视器	jm ui qi
监趸	jm dy
盒子	he zi
盒带	he dd
盖世无双	gd ui wu ul
盖世英雄	gd ui yk xs
盖棺定论	gd gr dk ly
盗卖	dc md
盗权	dc qr
盗窃犯	dc qp fj
盘桓	pj hr
盘货	pj ho
盘陀	pj to
盘马弯弓	pj ma wj gs
盛世	ug ui
盛事	ug ui
盛产	ug ij
盛名	ug mk
盛夏	ug xx
盛宴	ug yj
盛惠	ig hv
盛惠	ug hv
盛誉	ug yu
盟友	mg yz
盟员	mg yr
目不窥园	mu bu kv yr
目不邪视	mu bu xp ui
目不邪视	mu bu ye ui
目光如豆	mu gl ru dz
目光短浅	mu gl dr qm
目击	mu ji
目击者	mu ji ve
目力	mu li
目视	mu ui
盲人瞎马	mh rf xx ma
盲佬	mh lc
盲公竹	mh gs vu
盲动	mh ds
盲头乌蝇	mh tz wu yk
盲年	mh nm
盲摸摸	mh mo mo
盲眼	mh yj
直到	vi dc
直升机	vi ug ji
直属	vi uu
直拍	vi pd
直拨	vi bo
直板	vi bj
直流	vi lq
直程	vi ig
直立	vi li
直笔甩	vi bi uk
直肠	vi ih
直视	vi ui
直角	vi jn
直译	vi yi
直辖市	vi xx ui
直选	vi xr
相交	xl jn
相仿	xl fh
相关性	xl gr xk
相宜	xl yi
相对论	xl dv ly
相当之	xl dh vi
相形见绌	xl xk jm iu
相思	xl si
相持不下	xl ii bu xx
相离	xl li
相继	xl ji
相距	xl ju
相较	xl jn
相通	xl ts
省会	ug hv
省力	ug li
省去	ug qu
省城	ug ig
省市	ug ui
省府	ug fu
省悟	xk wu
省政府	ug vg fu
省界	ug jp
省直	ug vi
省籍	ug ji
省籍	xk ji
省级	ug ji
省镜	ug jk
省镜	xk jk
省长	ug vh
眈天望地	dj tm wh de
眈天望地	dj tm wh di
眉宇	mw yu
眉精眼企	mw jk yj qi
看做	kj zo
看头	kj tz
看守所	kj uz so
看官	kj gr
看轻	kj qk
看透	kj tz
看重	kj vs
真主	vf vu
真人	vf rf
真人真事	vf rf vf ui
真品	vf pb
真善美	vf uj mw
真情实意	vf qk ui yi
真意	vf yi
真是	vf ui
真爱	vf ai
真知	vf vi
真谛	vf di
眯埋眼	mi md yj
眯埋眼	mi mj yj
眼光光	yj gl gl
眼冤	yj yr
眼凸凸	yj tu tu
眼力	yj li
眼定定	yj dk dk
眼崛崛	yj jt jt
眼巴巴	yj ba ba
眼帘	yj lm
眼挹毛	yj yi mc
眼核	yj he
眼核	yj hu
眼湿湿	yj ui ui
眼火爆	yj ho bc
眼热	yj re
眼甘甘	yj gj gj
眼疾手快	yj ji uz kk
眼睁睁	yj vg vg
眼窝	yj wo
眼缘	yj yr
眼肚	yj du
眼色	yj se
眼角高	yj jn gc
眼角高	yj jt gc
眼超超	yj ic ic
眼镜	yj jk
眼镜蛇	yj jk ue
着力点	vc li dm
着力点	ve li dm
着力点	vo li dm
着意	vo yi
着数	vc uu
着眼点	vo yj dm
睇化	di hx
睇医生	di yi ug
睇唔开	di wu kd
睇场	di ih
睇头睇尾	di tz di ww
睇定	di dk
睇数	di uu
睇死	di si
睇水	di uv
睇白	di bd
睇真	di vf
睇衰	di uk
睇送食饭	di ss si fj
睇送食饭	di ss ui fj
睇送食饭	di ss yi fj
睇钱份上	di qm ff uh
睇餸食饭	di ss si fj
睇餸食饭	di ss ui fj
睇餸食饭	di ss yi fj
睚眦	ya zi
睡意	uv yi
督波	du bo
瞓厉颈	ff li gg
瞓厉颈	ff li jk
瞓厉颈	xy li gg
瞓厉颈	xy li jk
瞓身	ff uf
瞓身	xy uf
瞻顾	vj gu
矗立	iu li
矢志	ui vi
矢志不移	ui vi bu yi
知之为知之	vi vi ww vi vi
知了	vi ln
知事	vi ui
知名度	vi mk du
知悉	vi xi
知情人	vi qk rf
知情达理	vi qk da li
知晓	vi xn
知法	vi fa
知法犯法	vi fa fj fa
知觉	vi jt
知识化	vi ui hx
知识性	vi ui xk
知识界	vi ui jp
知识面	vi ui mm
知趣	vi qu
知过必改	vi go bi gd
知青	vi qk
知音	vi yb
矩形	ju xk
矫形	jn xk
矫治	jn vi
短切切	dr qp qp
短平快	dr pk kk
短讯	dr xy
矮凸凸	ai tu tu
矮瓜	ai gx
矮细	ai xi
石像	ui xl
石刻	ui ke
石化	ui hx
石匠	ui jl
石器	ui qi
石墨	ui mo
石子	ui zi
石家庄	ui jx vl
石料	ui ln
石棉	ui mm
石榴	ui lq
石沉大海	ui if da hd
石油气	ui yz qi
石灰	ui hv
石灰岩	ui hv yj
石灰石	ui hv ui
石狮	ui ui
石磨	ui mo
石英	ui yk
石阶	ui jp
矻矻	ku ku
矿业	kl ye
矿务局	kl wu ju
矿坑	kl kg
砂浆	ua jl
砂煲	ua bc
砂煲兄弟	ua bc xs di
砂石	ua ui
砌生猪肉	qi ug vu rz
砍伐	kj fa
砍刀	kj dc
研修生	yj xq ug
研磨	yj mo
研究员	yj jq yr
研究室	yj jq ui
研究所	yj jq so
研究生	yj jq ug
研究者	yj jq ve
研究院	yj jq yr
研讨会	yj tc hv
砖墙	vr ql
砗磲	ie qu
砚台	yj td
砥砺	di li
破伤风	po uh fg
破例	po li
破冰船	po bk ir
破口大骂	po kz da ma
破土	po tu
破坏力	po hk li
破浪前进	po lh qm jb
硅酸盐	gv sr yj
硅钢片	gv gh pm
硕果	uo go
硙硙	ww ww
硝烟	xn yj
硫化	lq hx
硬仗	yk vh
硬功	yk gs
硬化	yk hx
硬性	yk xk
硬指标	yk vi bn
硬是	yk ui
硬晒軚	yk ud td
硬气	yk qi
硬汉	yk hj
硬汉子	yk hj zi
硬笔	yk bi
硬系	yk ji
硬系	yk xi
硬颈	yk gg
硬颈	yk jk
硬骨头	yk gu tz
硭硝	mh xn
确确实实	qt qt ui ui
碌架床	lu jx il
碌柚	lu yz
碌碌无为	lu lu wu ww
碌碡	lq vz
碌葛	lu ge
碎湿湿	sv ui ui
碑刻	bw ke
碔砆	wu fu
碟头饭	dp tz fj
碟机	dp ji
碧玉	bi yu
碧空	bi ks
碧空万里	bi ks wj li
碧空如洗	bi ks ru xi
碧绿	bi lv
碰上	pg uh
碰啱	pg nj
碰啱	pg yj
碰头会	pg tz hv
碰杯	pg bw
碰碰车	pg pg ie
碱性	jm xk
碾子	nm zi
磁力	ci li
磁化	ci hx
磁头	ci tz
磁性	ci xk
磁石	ci ui
磁针	ci vf
磅友	bh yz
磅友	ph yz
磅水	bh uv
磅水	ph uv
磐石之固	pj dj vi gu
磐石之固	pj ui vi gu
磨刀	mo dc
磨拳擦掌	mo qr ca vh
磨杵成针	mo iu ig vf
磨盘	mo pj
磨穿铁砚	mo ir tp yj
磨练	mo lm
礁堡	jn bc
礁石	jn ui
示众	ui vs
示例	ui li
示意	ui yi
礼仪	li yi
礼帽	li mc
礼教	li jn
礼节	li jp
礼衣边	li yi bm
礼遇	li yu
礼金	li jb
社会化	ue hv hx
社会性	ue hv xk
社办	ue bj
社火	ue ho
社稷	ue ji
社队	ue dv
祁连山	qi lm uj
祈望	qi wh
祈求	qi qq
祖坟	zu ff
祖籍	zu ji
祝寿	vu uz
祝词	vu ci
祝辞	vu ci
祝酒歌	vu jq ge
祝酒词	vu jq ci
祝酒辞	vu jq ci
神主牌	uf vu pd
神乎其神	uf hu qi uf
神人	uf rf
神仙肚	uf xm du
神力	uf li
神化	uf hx
神医	uf yi
神台猫屎神憎鬼厌	uf td mc ui uf zg gv yj
神妙	uf mn
神威	uf ww
神志	uf vi
神情	uf qk
神明	uf mk
神枪手	uf ql uz
神楼	uf lz
神气	uf qi
神灵	uf lk
神砂	uf ua
神神化化	uf uf hx hx
神经元	uf jk yr
神经病	uf jk bk
神舟	uf vz
神色	uf se
神通	uf ts
神采	uf cd
神高神大	uf gc uf da
神高神大	uf gc uf dd
票号	pn hc
票箱	pn xl
票证	pn vg
票额	pn ee
祭品	ji pb
祭奠	ji dm
祭旗	ji qi
祭祖	ji zu
禀报	bk bc
禁区	jb qu
禁忌	jb ji
禁毒	jb du
禁锢	jb gu
禁闭	jb bi
福克纳	fu ke na
福分	fu ff
福州市	fu vz ui
福建省	fu jm ug
福星	fu xk
福星高照	fu xk gc vc
福气	fu qi
福清	fu qk
福禄	fu lu
福音	fu yb
福鼎	fu dk
离京	li jk
离合器	li he qi
离境	li jk
离奇	li qi
离子	li zi
离异	li yi
离心力	li xb li
离职	li vi
离间	li jm
禽日	qb ri
秀丽	xq li
秀丽多姿	xq li do zi
私了	si ln
私事	si ui
私交	si jn
私刑	si xk
私己	si ji
私心	si xb
私房	si fh
私有制	si yz vi
私欲	si yu
私立	si li
私货	si ho
秉性	bk xk
秉笔直书	bk bi vi uu
秋播	qq bo
秋收	qq uz
秋粮	qq ll
秋色宜人	qq se yi rf
秋色宜人	qq ud yi rf
秋色迷人	qq se mi rf
秋色迷人	qq ud mi rf
秋菊傲骨	qq ju ao gu
秋菊怒放	qq ju nu fh
秋雨连绵	qq yu lm mm
秋风送爽	qq fg ss ul
种姓	vs xk
种族主义	vs zu vu yi
种植	vs vi
种植业	vs vi ye
种畜	vs iu
种类繁多	is lw fj do
种类繁多	vs lw fj do
种花	vs hx
科协	ke xp
科员	ke yr
科大	ke da
科委	ke ww
科学性	ke xt xk
科学界	ke xt jp
科学院	ke xt yr
科室	ke ui
科工委	ke gs ww
科教片	ke jn pm
科班	ke bj
科盲	ke mh
科研所	ke yj so
科索沃	ke so wo
科级	ke ji
科隆	ke ls
科龙	ke ls
秘书长	mi uu vh
秘史	mi ui
秘捞	bi lc
秘捞	mi lc
秘鲁	bi lu
租户	zu hu
租界	zu jp
秤砣	ig to
秦始皇	qb ui hl
秦镜高悬	qb jk gc xr
积习	ji xi
积劳成疾	ji lc ig ji
积存	ji cy
积弊	ji bi
积怨	ji yr
积木	ji mu
积极分子	ji ji ff zi
积聚	ji ju
积肥	ji fw
积蓄	ji xu
积蚊成雷	ji wf ig lw
称为	ig ww
称之为	ig vi ww
称作	ig zo
称誉	ig yu
称谓	ig ww
移居	yi ju
移山倒海	yi uj dc hd
移山填海	yi uj tm hd
移栽	yi zd
移植	yi vi
移樽就教	yi zy jq jn
移除	yi iu
稀世	xi ui
稀奇	xi qi
稀泥	xi ni
稀疏	xi uu
稀释	xi ui
程式	ig ui
程门立雪	ig mf li xt
稍许	uc xu
税利	uv li
税制	uv vi
税源	uv yr
税目	uv mu
税种	uv vs
稚气	vi qi
稳健	wf jm
稳定性	wf dk xk
稳当	wf dh
稳操左卷	wf cc zo jr
稳稳	wf wf
稳稳当当	wf wf dh dh
稻子	dc zi
稻穗	dc sv
稼穑	jx se
稿源	gc yr
稿纸	gc vi
穰穰	rh rh
穴位	xt ww
穷根	qs gf
空中客车	ks vs ke ie
空勤	ks qb
空域	ks yu
空子	ks zi
空当	ks dh
空投	ks tz
空架子	ks jx zi
空气清醒	ks qi qk xk
空白点	ks bd dm
空空荡荡	ks ks dh dh
空袭	ks xi
空车	ks ie
空转	ks vr
空阔	ks ko
空防	ks fh
空降兵	ks jl bk
穿山甲	ir uj jx
穿崩	ir bg
突击手	tu ji uz
突击队	tu ji dv
突破口	tu po kz
突破性	tu po xk
窄窄	vd vd
窑洞	yc ds
窒头窒势	vi tz vi ui
窗棂	il lk
窝窝头	wo wo tz
窝钉	wo dk
窦口	dz kz
窸窣	xi su
窿窿罅罅	ls ls xx xx
窿路	ls lu
立宪	li xm
立式	li ui
立志	li vi
立意	li yi
立方米	li fh mi
立时	li ui
立杂	li za
立正	li vg
立秋	li qq
立立乱	li li lr
立论	li ly
立足点	li zu dm
立项	li xl
竖立	uu li
竖起	uu qi
站住脚	vj vu jn
竞争力	jk vg li
竞技	jk ji
竞技场	jk ji ih
竞投	jk tz
竞相	jk xl
章草	vh cc
童声	ts ug
童心	ts xb
童话	ts hx
童趣	ts qu
童音	ts yb
竭尽	jp jb
端端正正	dr dr vg vg
竹丝鸡	vu si ji
竹升	vu ug
竹升妹	vu ug mw
竹战	vu vj
竹排	vu pd
竹椅	vu yi
竹楼	vu lz
竹竿	vu gj
竹简	vu jm
竿子	gj zi
笃爆	du bc
笃眼笃鼻	du yj du bi
笃背脊	du bw ji
笊篱	vc li
笋嘢	sy ye
笑到碌地	xn dc lu de
笑到碌地	xn dc lu di
笑口吟吟	xn kz yb yb
笑口噬噬	xn kz ui ui
笑口枣	xn kz zc
笑吟吟	xn yb yb
笑容满面	xn rs mj mm
笑意	xn yi
笑眯眯	xn mi mi
笑笑口	xn xn kz
笑语	xn yu
笑颜	xn yj
笑骑骑	xn qi qi
笔下	bi xx
笔力	bi li
笔势	bi ui
笔尖	bi jm
笔录	bi lu
笔杆子	bi gj zi
笔端	bi dr
笔者	bi ve
笔触	bi iu
笔记本	bi ji bf
笔译	bi yi
笔试	bi ui
笔迹	bi ji
笔锋	bi fg
笙簧	ug hl
笛子	di zi
笠衫	li uj
笠记	li ji
符弗	fu fu
符箓	fu lu
第一把手	di yi ba uz
第一线	di yi xm
第二尐	di er di
第尾	di ww
笸箩	po lo
笸篮	po lj
等次	dg ci
等离子	dg li zi
等离子体	dg li zi ti
筑路	vu lu
筒子楼	ts zi lz
答对	da dv
答疑	da yi
答词	da ci
答话	da hx
答谢	da xp
答道	da dc
策源地	ce yr di
策骑	ce qi
筛子	ud zi
筵席	yj xi
筹备会	iz bw hv
筹委会	iz ww hv
筼筜	yy dh
签保	qm bc
签定	qm dk
签收	qm uz
简介	jm jp
简体字	jm ti zi
简便易行	jm bm yi xk
简写	jm xp
简化字	jm hx zi
简单易行	jm dj yi xk
简历	jm li
简史	jm ui
简捷	jm jp
简政放权	jm vg fh qr
简易	jm yi
简章	jm vh
简练	jm lm
简编	jm bm
简装	jm vl
简言之	jm yj vi
简谱	jm pu
箍煲	gu bc
箍颈	gu gg
箍颈	gu jk
箍颈党	gu gg dh
箍颈党	gu jk dh
箕踞	ji ju
管区	gr qu
管弦乐	gr xm yt
管材	gr cd
管束	gr uu
管理局	gr li ju
管窥	gr kv
管风琴	gr fg qb
箢箕	yr ji
箩底橙	lo di ig
箭步	jm bu
篆书	vr uu
篆刻	vr ke
篓子	lz zi
篮板球	lj bj qq
篱士	li ui
篷车	pg ie
簏簌	lu su
簸箕	bo ji
米汤	mi th
米粒	mi li
米芾	mi fu
米芾	mi fw
米通	mi ts
米饭班主	mi fj bj vu
类人猿	lw rf yr
籽棉	zi mm
粉剂	ff ji
粉擦	ff ca
粉红色	ff hs se
粒声都唔出	li ug du wu iu
粒声都唔出	li ug dz wu iu
粒子	li zi
粒状	li vl
粗生	cu ug
粗粗	cu cu
粗线条	cu xm tn
粗衣淡饭	cu yi dj fj
粗衣粝食	cu yi li si
粗衣粝食	cu yi li ui
粗衣粝食	cu yi li yi
粘土	nm tu
粘性	nm xk
粘米	nm mi
粘米	vj mi
粘结	nm jp
粘膜	nm mo
粤剧	yt ju
粤语残片	yt yu cj pm
粪便	ff bm
粪肥	ff fw
粮价	ll jx
粮单	ll dj
粮单	ll ij
粮单	ll uj
粮商	ll uh
粮库	ll ku
粮店	ll dm
粮棉	ll mm
粮田	ll tm
粮站	ll vj
粮食局	ll ui ju
粳米	jk mi
粼粼	lb lb
精乖伶俐	jk gk lk li
精减	jk jm
精到	jk dc
精制	jk vi
精叻	jk le
精壮	jk vl
精子	jk zi
精干	jk gj
精当	jk dh
精液	jk ye
精深	jk uf
精疲力尽	jk pi li jb
精疲力竭	jk pi li jp
精矿	jk kl
精确度	jk qt du
精神抖擞	jk uf dz sz
精神文明	jk uf wf mk
精神爽利	jk uf ul li
精神病	jk uf bk
精神百倍	jk uf bd bw
精练	jk lm
精细	jk xi
精英	jk yk
精装本	jk vl bf
精诚	jk ig
精诚合作	jk ig he zo
精诚团结	jk ig tr jp
精读	jk du
精过冇尾蛇	jk go mc ww ue
精金良玉	jk jb ll yu
糊口	hu kz
糖不甩	th bu uk
糖尿病	th nn bk
糖环	th hr
糖葫芦	th hu lu
糜烂	mi lj
糟质	zc vi
糟踏	zc ta
糯米糍	no mi ci
系列剧	xi lp ju
系列化	xi lp hx
系列片	xi lp pm
系咁先啦	ji gj xm la
系咁先啦	xi gj xm la
系威系势	ji ww ji ui
系威系势	ji ww xi ui
系威系势	xi ww ji ui
系威系势	xi ww xi ui
系统性	xi ts xk
索气	so qi
索水	so uv
索油	so yz
索贿	so hv
紧巴巴	jb ba ba
紧接	jb jp
紧身	jb uf
紧迫感	jb po gj
紧追不舍	jb vv bu ue
紧邻	jb lb
紫癜	zi dm
紫禁城	zi jb ig
紫红色	zi hs se
紫红色	zi hs ud
絮语	xu yu
繁复	fj fu
繁星	fj xk
繁育	fj yu
繁花	fj hx
纠察队	jq ia dv
纠集	jq ji
红十字	hs ui zi
红十字会	hs ui zi hv
红土	hs tu
红场	hs ih
红宝石	hs bc ui
红帽	hs mc
红当荡	hs dh dh
红旗手	hs qi uz
红星	hs xk
红白事	hs bd ui
红白喜事	hs bd xi ui
红眼病	hs yj bk
红簿仔	hs bu zd
红簿仔	hs bu zi
红粉绯绯	hs ff fw fw
红红火火	hs hs ho ho
红肉	hs rz
红艳艳	hs yj yj
红豆沙	hs dz ua
红领巾	hs lk jb
纤夫	qm fu
纤维素	xm ww su
约数	yt uu
约法	yt fa
约稿	yt gc
级差	ji ia
纨绔	wj ku
纪事	ji ui
纪元	ji yr
纪委	ji ww
纪实	ji ui
纪年	ji nm
纪录	ji lu
纪念册	ji nm ce
纪念堂	ji nm th
纪念塔	ji nm ta
纪念封	ji nm fg
纪念日	ji nm ri
纪念物	ji nm wu
纪念碑	ji nm bw
纪念章	ji nm vh
纪念馆	ji nm gr
纪检	ji jm
纪检委	ji jm ww
纪行	ji xk
纪要	ji yc
纬度	ww du
纭纭	yy yy
纯收入	iy uz ru
纯熟	iy uu
纱厂	ua ih
纵使	zs ui
纵横捭阖	zs hg bd he
纵横驰骋	zs hg ii ig
纵览	zs lj
纵贯	zs gr
纵队	zs dv
纷呈	ff ig
纷纭复杂	ff yy fu za
纷纷扬扬	ff ff yh yh
纸屑	vi xp
纸扎铺	vi va pu
纸板	vi bj
纸板人	vi bj rf
纸片	vi pm
纸牌	vi pd
纸皮石	vi pi dj
纸皮石	vi pi ui
纸盒	vi he
纸箱	vi xl
纸钱	vi qm
纺织	fh vi
纺织业	fh vi ye
纺织厂	fh vi ih
纺织品	fh vi pb
纺锭	fh dk
纽门	nq mf
线上	xm uh
线头	xm tz
线性	xm xk
线材	xm cd
线步	xm bu
线眼	xm yj
线装书	xm vl uu
线辘	xm lu
组件	zu jm
组委会	zu ww hv
组歌	zu ge
组织性	zu vi xk
组织部	zu vi bu
组阁	zu ge
细价	xi jp
细价	xi jx
细佬哥	xi lc ge
细微	xi ww
细胆	xi dj
细胞核	xi bc he
细胞膜	xi bc mo
细蚊仔	xi wf zd
细蚊仔	xi wf zi
细路仔	xi lu zd
细路仔	xi lu zi
细路女	xi lu nv
细部	xi bu
细长	xi ih
细雨	xi yu
织女	vi nv
织布	vi bu
织成	vi ig
织机	vi ji
织物	vi wu
终南捷径	vs nj jp jk
终场	vs ih
终审	vs uf
终将	vs jl
终年	vs nm
终极	vs ji
终点	vs dm
终身制	vs uf vi
绊倒	bj dc
绊脚石	bj jn ui
绍菜	uc cd
经久	jk jq
经委	jk ww
经学	jk xt
经常性	jk ih xk
经手	jk uz
经济学	jk ji xt
经济林	jk ji lb
经济法	jk ji fa
经理	jk li
经管	jk gr
经纪	jk ji
经纬	jk ww
经线	jk xm
经营不善	jk yk bu uj
经贸委	jk mc ww
绒毛	rs mc
绒线	rs xm
结为	jp ww
结伴	jp bj
结余	jp yu
结实	jp ui
结成	jp ig
结束语	jp uu yu
结核	jp he
结核病	jp he bk
结石	jp ui
结结实实	jp jp ui ui
结识	jp ui
绘制	hv vi
给与	gw yu
给与	ji yu
给养	ji yh
给水	ji uv
绚丽多姿	xr li do zi
绚丽多彩	xr li do cd
络绎	lo yi
绝世超伦	jt ui ic ly
绝处逢生	jt iu fg ug
绝对值	jt dv vi
绝对化	jt dv hx
绝无	jt mo
绝无	jt wu
绝桥	jt qn
绝甘分少	jt gj ff uc
绝笔	jt bi
绝经	jt jk
绝迹	jt ji
绝食	jt ui
绞刑	jn xk
统一	ts yi
统一体	ts yi ti
统一性	ts yi xk
统制	ts vi
统帅	ts uk
统治	ts vi
统治阶级	ts vi jp ji
统计学	ts ji xt
统计局	ts ji ju
统计表	ts ji bn
统配	ts pw
统销	ts xn
绣品	xq pb
绣花袋仔人人啱	xq hx dd zd rf rf nj
绣花袋仔人人啱	xq hx dd zd rf rf yj
绣花袋仔人人啱	xq hx dd zi rf rf nj
绣花袋仔人人啱	xq hx dd zi rf rf yj
继之	ji vi
继承人	ji ig rf
继承权	ji ig qr
继父	ji fu
绪言	xu yj
绮丽	qi li
绳趋尺步	ug qu ii bu
维亚康姆	ww ya kh mu
维和	ww he
维妙维肖	ww mn ww xn
维纳斯	ww na si
绵绵不绝	mm mm bu jt
绵羊	mm yh
绵蛮	mm mj
绶带	uz dd
综上所述	zs uh so uu
综合性	zs he xk
综观	zs gr
综述	zs uu
绿水青山	lu uv qk uj
绿水青山	lv uv qk uj
绿油油	lv yz yz
绿肥	lv fw
绿茵茵	lv yb yb
绿草如茵	lu cc ru yb
绿草如茵	lv cc ru yb
绿荫	lv yb
缉捕	ji bu
缉毒	ji du
缉私	ji si
缓冲区	hr is qu
缓刑	hr xk
缓期	hr qi
缓解	hr jp
缔交	di jn
缔约国	di yt go
缕缕	lv lv
编委	bm ww
编审	bm uf
编年体	bm nm ti
编年史	bm nm ui
编成	bm ig
编目	bm mu
编织	bm vi
编辑部	bm ji bu
缘起	yr qi
缙绅	jb uf
缝纫机	fg rf ji
缧绁	lw xp
缩头龟	so tz gv
缩头龟	so tz jy
缩头龟	so tz qq
缩开	so kd
缩数	so uu
缩沙	so ua
缩骨	so gu
缩骨遮	so gu ve
缰绳	jl ug
缴获	jn ho
缺额	qt ee
罐子	gr zi
网景	wh jk
网游	wh yz
网状	wh vl
网罗	wh lo
网路	wh lu
网际	wh ji
罔两	wh ll
罔愆	wh qm
罗伯特	lo bd te
罗伯特	lo bo te
罗唣	lo zc
罗布泊	lo bu po
罗技	lo ji
罗拉	lo la
罗柚	lo yz
罗汉请观音	lo hj qk gr yb
罗织	lo vi
罚球	fa qq
罢啦	ba la
罢啦	pi la
罢官	ba gr
罢市	ba ui
罨耷	yj da
置于	vi yu
置于脑后	vi yu nc hz
置办	vi bj
置备	vi bw
置评	vi pk
置身	vi uf
置顶	vi dk
羁勒	ji le
羁押	ji ya
羁縻	ji mi
羊入虎口	yh ru hu kz
羊城	yh ig
羊毛衫	yh mc uj
羊肠小道	yh ih xn dc
羊质虎皮	yh vi hu pi
美光	mw gl
美军	mw jy
美分	mw ff
美容师	mw rs ui
美报	mw bc
美术家	mw uu jx
美术片	mw uu pm
美术界	mw uu jp
美术馆	mw uu gr
美林	mw lb
美格	mw ge
美泰	mw td
美洲	mw vz
美玉	mw yu
美男	mw nj
美的	mw de
美的	mw di
美眉	mw mw
美联社	mw lm ue
美育	mw yu
美语	mw yu
美谈	mw tj
美貌	mw mc
美金	mw jb
美食	mw ui
美餐	mw cj
羞家	xq jx
羞答答	xq da da
羞羞答答	xq xq da da
羟基	ql ji
群众性	qy vs xk
群像	qy xl
群威群胆	qy ww qy dj
群峰	qy fg
群情	qy qk
群芳	qy fh
群英会	qy yk hv
群落	qy lo
群雄逐鹿	qy xs vu lu
羽坛	yu tj
羽绒服	yu rs fu
羽翼	yu yi
翌年	yi nm
翌日	yi ri
翔实	xl ui
翙翙	hv hv
翠色欲流	cv se yu lq
翠色欲流	cv ud yu lq
翩翩	pm pm
翯翯	he he
翳气	yi qi
翳焗	yi ju
翻云覆雨	fj yy fu yu
翻动	fj ds
翻地	fj di
翻翻	fj fj
翻越	fj yt
翻转	fj vr
翻风	fj fg
耀眼	yc yj
老一辈	lc yi bw
老两口	lc ll kz
老伴	lc bj
老农	lc ns
老前辈	lc qm bw
老办法	lc bj fa
老友鬼鬼	lc yz gv gv
老嘢	lc ye
老坑	lc kg
老大娘	lc da nl
老大爷	lc da ye
老太太	lc td td
老奶奶	lc nd nd
老好人	lc hc rf
老婆仔	lc po zd
老婆仔	lc po zi
老婆婆	lc po po
老定	lc dk
老家	lc jx
老小	lc xn
老差骨	lc ci gu
老差骨	lc ia gu
老差骨	lc id gu
老帅	lc uk
老干部	lc gj bu
老年人	lc nm rf
老式	lc ui
老懵懂	lc mg ds
老搭档	lc da dh
老是	lc ui
老朋友	lc pg yz
老框框	lc kl kl
老泥	lc ni
老泪纵横	lc lw zs hg
老爷爷	lc ye ye
老猫烧须	lc mc uc xu
老生	lc ug
老番	lc fj
老番	lc pj
老积	lc ji
老老少少	lc lc uc uc
老而不	lc er bu
老臣子	lc if zi
老花镜	lc hx jk
老虎乸	lc hu na
老虎蟹	lc hu xp
老蚌生珠	lc bh ug vu
老行专	lc hh vr
老行专	lc xk vr
老衬	lc if
老西	lc xi
老规矩	lc gv ju
老话	lc hx
老调	lc dn
老路	lc lu
老辣	lc la
老酒	lc jq
老骤伏枥	lc vz fu li
老黄牛	lc hl nq
老鼠仔	lc uu zd
老鼠仔	lc uu zi
老鼠货	lc uu ho
考博	kc bo
考据	kc ju
考查	kc ia
考研	kc yj
考绩	kc ji
耍手	ux uz
耐不耐	nd bu nd
耐劳	nd lc
耐唔中	nd wu vs
耐酸	nd sr
耕地	gg di
耕牛	gg nq
耕种	gg vs
耗子	hc zi
耗电	hc dm
耳仔软	er zd rr
耳仔软	er zi rr
耳目众多	er mu vs do
耵聍	dk nk
耶路撒冷	ye lu sa lg
耷头耷脑	da tz da nc
耸入云天	ss ru yy tm
耸立	ss li
聊城	ln ig
聋哑人	ls ya rf
职业病	vi ye bk
职代会	vi dd hv
职别	vi bp
职场	vi ih
职守	vi uz
职称	vi ig
职能	vi ng
职高	vi gc
联会	lm hv
联办	lm bj
联合会	lm he hv
联合国	lm he go
联大	lm da
联席	lm xi
联席会	lm xi hv
联席会	lm xi kk
联接	lm jp
联欢会	lm hr hv
联系	lm xi
联系人	lm xi rf
联结	lm jp
联谊	lm yi
联谊会	lm yi hv
联贯	lm gr
联针	lm vf
聘为	pb ww
聚光灯	ju gl dg
聚变	ju bm
聚合物	ju he wu
聚宝盆	ju bc pf
聚居	ju ju
聚拢	ju ls
聚酯	ju vi
聚首	ju uz
肃反	su fj
肄业	yi ye
肇事者	vc ui ve
肉制品	rz vi pb
肉参	rz cj
肉参	rz uf
肉猪	rz vu
肉联厂	rz lm ih
肉赤	rz ii
肉鸡	rz ji
肌体	ji ti
肌理	ji li
肖像画	xn xl hx
肖恩	xn en
肚屙	du ee
肚耽	du dj
肝火	gj ho
肝部	gj bu
肠梗阻	ih gg zu
肠炎	ih yj
肠衣	ih yi
股利	gu li
股市	gu ui
股金	gu jb
股长	gu vh
股骨	gu gu
肢解	vi jp
肥仔唛	fw zd ma
肥仔唛	fw zd md
肥仔唛	fw zi ma
肥仔唛	fw zi md
肥力	fw li
肥头耷耳	fw tz da er
肥尸大只	fw ui da vi
肥尸大只	fw ui dd vi
肥效	fw xn
肥水	fw uv
肥田	fw tm
肥肥白白	fw fw bd bd
肥腯腯	fw tu tu
肩头	jm tz
肩章	jm vh
肯尼迪	kf ni di
育林	yu lb
育种	yu vs
育苗	yu mn
肺气肿	fw qi vs
肺结核	fw jp he
胀卜卜	vh bo bo
胀卜卜	vh bo bu
胀卜卜	vh bu bo
胀卜卜	vh bu bu
胃溃疡	ww kv yh
胃炎	ww yj
胃肠	ww ih
胃镜	ww jk
胆汁	dj vi
胆生毛	dj ug mc
胆识	dj ui
背书	bw uu
背地里	bw di li
背弃	bw qi
背心袋	bw xb dd
背手影	bw uz yk
背投	bw tz
背部	bw bu
胜仗	ug vh
胜似	ug si
胜瓜	ug gx
胞弟	bc di
胡同	hu ts
胡椒	hu jn
胡涂	hu tu
胡琴	hu qb
胡胡混混	hu hu hy hy
胡适	hu ui
胡锦涛	hu jb tc
胡须佬	hu xu lc
胡须簕特	hu xu le te
胭脂	yj vi
胰岛素	yi dc su
胰腺	yi xm
胳肋底	ga le di
胳肋底	ga lw di
胳肋底	ge le di
胳肋底	ge lw di
胳臂	ge bw
胶印	jn yb
胶合板	jn he bj
胶布	jn bu
胶带	jn dd
胶擦	jn ca
胶水	jn uv
胶皮	jn pi
胶鞋	jn xp
胼胝	pm vi
能为	ng ww
能事	ng ui
能见度	ng jm du
脂肪酸	vi fh sr
脊柱	ji vu
脊梁	ji ll
脊椎动物	ji vv ds wu
脊背	ji bw
脊骨	ji gu
脏兮兮	zh xi xi
脏器	zh qi
脐带	qi dd
脑力劳动	nc li lc ds
脑囟	nc xb
脑溢血	nc yi xt
脑神经	nc uf jk
脑血栓	nc xt ur
脚劲	jn jb
脚掌	jn vh
脚掣	jn ie
脚板	jn bj
脚板底	jn bj di
脚气	jn qi
脚甲	jn jx
脚眼	jn yj
脚趾	jn vi
脚趾公	jn vi gs
脚趾尾	jn vi ww
脚踏	jn ta
脚踭	jn vg
脚骨力	jn gu li
脱僵之马	to jl vi ma
脱盲	to mh
脱粒	to li
脸颊	lm jx
腈纶	jk ly
腊八粥	la ba vz
腊梅	la mw
腌尖	aa jm
腌尖	yj jm
腌臜	aa za
腌臜	yj za
腍善	rf uj
腍柿	rf ui
腐化	fu hx
腐蚀	fu ui
腔调	ql dn
腥膻	xk uj
腰杆	yc gj
腹地	fu di
腹心	fu xb
腹水	fu uv
腹腔	fu ql
腽肭	wa na
膀子	bh zi
膊头	bo tz
膳食	uj ui
臆断	yi dr
自不待言	zi bu dd yj
自主权	zi vu qr
自习	zi xi
自养	zi yh
自决	zi jt
自制	zi vi
自力	zi li
自动化	zi ds hx
自助	zi vu
自勉	zi mm
自卑感	zi bw gj
自卫	zi ww
自圆其说闲言碎语	zi yr qi uo xm yj sv yu
自圆其说闲言碎语	zi yr qi uv xm yj sv yu
自圆其说闲言碎语	zi yr qi yt xm yj sv yu
自备	zi bw
自宫	zi gs
自尽	zi jb
自居	zi ju
自己友	zi ji yz
自幼	zi yz
自序	zi xu
自恃	zi ui
自愧弗如	zi kv fu ru
自愿	zi yr
自慰	zi ww
自成一体	zi ig yi ti
自成一家	zi ig yi jx
自我标榜	zi wo bn bh
自找麻烦	zi vc ma fj
自有	zi yz
自治	zi vi
自治区	zi vi qu
自治县	zi vi xm
自治州	zi vi vz
自流	zi lq
自然村	zi rj cy
自然界	zi rj jp
自燃	zi rj
自由主义	zi yz vu yi
自由度	zi yz du
自由放任	zi yz fh rf
自由泳	zi yz ys
自由港	zi yz gh
自知	zi vi
自立	zi li
自细	zi xi
自给	zi ji
自给有余	zi gw yz yu
自给有余	zi ji yz yu
自绝	zi jt
自荐	zi jm
自让	zi rh
自豪感	zi hc gj
自贡	zi gs
自费	zi fw
自费生	zi fw ug
自转	zi vr
自述	zi uu
自销	zi xn
臭氧	iz yh
臭烹烹	iz pg pg
臭烹烹	xq pg pg
至上	vi uh
至亲	vi qb
至关紧要	vi gr jb yc
至啱	vi nj
至啱	vi yj
至强	vi jl
至强	vi ql
至死不变	vi si bu bm
致以	vi yi
致使	vi ui
致力	vi li
致密	vi mi
致富	vi fu
致意	vi yi
致敬	vi jk
致死	vi si
致电	vi dm
致病	vi bk
致词	vi ci
舅仔	jq zd
舅仔	jq zi
舅舅	jq jq
舆论界	yu ly jp
舍命	ue mk
舍死忘生	ue si wh ug
舒坦	uu tj
舒心	uu xb
舒舒服服	uu uu fu fu
舛错	ir co
舞会	wu hv
舞剑	wu jm
舞场	wu ih
舞坛	wu tj
舞姿	wu zi
舞小姐	wu xn jp
舞弊	wu bi
舞曲	wu qu
舞池	wu ii
舞狮	wu ui
舞蹈家	wu dc jx
舢板	uj bj
舢舨	uj bj
航天器	hh tm qi
航天局	hh tm ju
航天部	hh tm bu
航次	hh ci
航空兵	hh ks bk
航空器	hh ks qi
航空局	hh ks ju
航空港	hh ks gh
航路	hh lu
航迹	hh ji
舰只	jm vi
舰船	jm ir
舰艇	jm tk
舰载	jm zd
舰长	jm vh
舱位	ch ww
舳舻	vu lu
舴艋	ze mg
舷梯	xm ti
舷窗	xm il
船东	ir ds
船坞	ir wu
船头	ir tz
船工	ir gs
船老大	ir lc da
船舶	ir bo
船身	ir uf
艅艎	yu hl
艇家	tk jx
艇屋	tk wu
艨艟	mg is
良友	ll yz
良师	ll ui
良田	ll tm
良种	ll vs
良策	ll ce
良金美玉	ll jb mw yu
艰深	jm uf
艰苦卓绝	jm ku vo jt
艰苦朴素	jm ku pu su
色士风	se ui fg
色士风	ud ui fg
色彩斑斓	se cd bj lj
色拉油	se la yz
色水	se uv
色水	ud uv
艳丽	yj li
艳情	yj qk
艳福	yj fu
艳阳天	yj yh tm
艳阳高照	yj yh gc vc
艺员	yi yr
艺坛	yi tj
艺术品	yi uu pb
艺术团	yi uu tr
艺术家	yi uu jx
艺术性	yi uu xk
艺术界	yi uu jp
艺术馆	yi uu gr
艺校	yi xn
艺界	yi jp
艺苑	yi yr
艾伦	ai ly
艾伦	yi ly
节余	jp yu
节俭	jp jm
节假日	jp jx ri
节制	jp vi
节前	jp qm
节奏感	jp zz gj
节律	jp lv
节支	jp vi
节水	jp uv
节油	jp yz
节电	jp dm
节目单	jp mu dj
节育	jp yu
节节胜利	jp jp ug li
芃芃	pg pg
芊绵	qm mm
芊芊	qm qm
芘芣	bi fu
芘芣	pi fu
芙蕖	fu qu
芜湖	wu hu
芣苜	fu mu
芥蒂	jp di
芦花飘扬	lu hx pn yh
芫荽	yj sv
芭蕉	ba jn
花仔	hx zd
花仔	hx zi
花会	hx hv
花农	hx ns
花哩碌	hx li lu
花哩花碌	hx li hx lu
花坛	hx tj
花女	hx nv
花季	hx ji
花岗岩	hx gh yj
花岗石	hx gh ui
花市	hx ui
花布	hx bu
花弗	hx fu
花旦	hx dj
花期	hx qi
花林	hx lb
花果山	hx go uj
花架子	hx jx zi
花樽	hx zy
花灯	hx dg
花生油	hx ug yz
花生米	hx ug mi
花甲	hx jx
花粉	hx ff
花红柳绿	hx hs lq lv
花色迷人	hx se mi rf
花色迷人	hx ud mi rf
花花绿绿	hx hx lv lv
花菇	hx gu
花轿	hx jn
花靓仔	hx jk zd
花靓仔	hx jk zi
花靓仔	hx ll zd
花靓仔	hx ll zi
花面猫	hx mm mc
花飞蝶舞	hx fw dp wu
花香醉人	hx xl zv rf
花鸟画	hx nn hx
花鼓戏	hx gu xi
芳菲	fh fw
芳香	fh xl
苁蓉	cs rs
苍翠挺拔	ch cv tk ba
苍莽	ch mh
苍髯如戟	ch rj ru ji
苏东坡	su ds po
苏区	su qu
苏宁	su nk
苏联	su lm
苏轼	su ui
苒苒	rj rj
苛求	ke qq
苞米	bc mi
苞谷	bc gu
苣荬	ju md
苣荬	qu md
苤蓝	pp lj
苦功	ku gs
苦口苦面	ku kz ku mm
苦味	ku ww
苦寒	ku hj
苦活	ku ho
苦瓜咁嘅面	ku gx gj ge mm
苦行	ku xk
英军	yk jy
英勇	yk ys
英名	yk mk
英姿	yk zi
英姿焕发	yk zi hr fa
英报	yk bc
英杰	yk jp
英武	yk wu
英里	yk li
英飞凌	yk fw lk
茁壮	vo vl
茂里	mc li
范文	fj wf
茄喱啡	jx li fw
茄喱啡	qp li fw
茅台酒	mc td jq
茅盾	mc dy
茉莉	mo li
茏葱	ls cs
茑萝	nn lo
茧丝	jm si
茧子	jm zi
茯苓	fu lk
茱萸	vu yu
茳芏	jl du
茶具	ia ju
茶农	ia ns
茶场	ia ih
茶座	ia zo
茶炉	ia lu
茶点	ia dm
茶煲	ia bc
茶缸	ia gh
茶芥	ia jp
茶话会	ia hx hv
茶餐厅	ia cj tk
茹蕙	ru hv
茺蔚	is ww
茼蒿	ts hc
荆州	jk vz
荆条	jk tn
荆棘	jk ji
荆钗布裙	jk id bu qy
草场	cc ih
草房	cc fh
草木知威	cc mu vi ww
草根阶层	cc gf jp cg
草皮	cc pi
草绿色	cc lv se
草花头	cc hx tz
草草	cc cc
草袋	cc dd
草长莺飞	cc vh yk fw
荒地	hl di
荒山	hl uj
荔枝	li vi
荜菝	bi ba
荡失路	dh ui lu
荡涤	dh di
荣军	rs jy
荣誉奖	rs yu jl
荣誉感	rs yu gj
荣誉章	rs yu vh
荣辱	rs ru
荧光灯	yk gl dg
荫凉	yb ll
药典	yc dm
药到病除	yc dc bk iu
药学	yc xt
药店	yc dm
药房	yc fh
药材铺	yc cd pu
药理	yc li
药用	yc ys
药膳	yc uj
荸荠	bi qi
荼蘼	tu mi
莙荙	jy da
莨菪	lh dh
莨菪	ll dh
莪术	ee vu
莪蒿	ee hc
莫扎特	mo va te
莫明其妙	mo mk qi mn
莫桑比克	mo sh bi ke
莫衷一是	mo vs yi ui
莱卡	ld ka
莱卡	ld qx
莱菔	ld fu
莲叶满池	lm xp mj ii
莲叶满池	lm ye mj ii
莲子	lm zi
莲子蓉面口	lm zi rs mm kz
莳萝	ui lo
获释	ho ui
菁菁	jk jk
菌种	jy vs
菖蒲	ih pu
菜园	cd yr
菜园子	cd yr zi
菜市场	cd ui ih
菜栏	cd lj
菜窖	cd jn
菜篮子	cd lj zi
菜脯	cd fu
菜脯	cd pu
菜花	cd hx
菜蔬	cd uu
菜薳	cd ww
菜薳	cd yr
菝葜	ba qx
菠萝盖	bo lo gd
菡萏	hj dj
菥蓂	xi mk
菩提树	pu ti uu
菩萨低眉	pu sa di mw
菲薄	fw bo
萆薢	bi xp
萌动	mg ds
萑苇	hr ww
萤火虫	yk ho is
营业员	yk ye yr
营业所	yk ye so
营业税	yk ye uv
营业额	yk ye ee
营养品	yk yh pb
营养素	yk yh su
营利	yk li
营区	yk qu
营口	yk kz
营垒	yk lw
营建	yk jm
营收	yk uz
营生	yk ug
萧山	xn uj
萧萧	xn xn
萨拉热窝	sa la re wo
萨法	sa fa
萨特	sa te
萨达姆	sa da mu
落口供	la kz gs
落口供	lc kz gs
落口供	lo kz gs
落堂	la th
落堂	lc th
落堂	lo th
落妆	la vl
落妆	lc vl
落妆	lo vl
落客	la ke
落客	lc ke
落客	lo ke
落手落脚	la uz la jn
落手落脚	la uz lc jn
落手落脚	la uz lo jn
落手落脚	lc uz la jn
落手落脚	lc uz lc jn
落手落脚	lc uz lo jn
落手落脚	lo uz la jn
落手落脚	lo uz lc jn
落手落脚	lo uz lo jn
落拓	lo to
落晒形	la ud xk
落晒形	lc ud xk
落晒形	lo ud xk
落格	la ge
落格	lc ge
落格	lo ge
落泊	lo bo
落画	la hx
落画	lc hx
落画	lo hx
落膈	la ge
落膈	lc ge
落膈	lo ge
落落难合	la la nj ge
落落难合	la la nj he
落落难合	la lc nj ge
落落难合	la lc nj he
落落难合	la lo nj ge
落落难合	la lo nj he
落落难合	lc la nj ge
落落难合	lc la nj he
落落难合	lc lc nj ge
落落难合	lc lc nj he
落落难合	lc lo nj ge
落落难合	lc lo nj he
落落难合	lo la nj ge
落落难合	lo la nj he
落落难合	lo lc nj ge
落落难合	lo lc nj he
落落难合	lo lo nj ge
落落难合	lo lo nj he
落货	la ho
落货	lc ho
落货	lo ho
落选	lo xr
落雨收柴	la yu uz id
落雨收柴	lc yu uz id
落雨收柴	lo yu uz id
落面	la mm
落面	lc mm
落面	lo mm
落马	lo ma
著书	ve uu
著书	vu uu
著作权	vu zo qr
著录	vu lu
著文	ve wf
著文	vu wf
著者	vu ve
著述	vu uu
葛洲坝	ge vz ba
葡萄干	pu tc gj
葡萄酒	pu tc jq
董事会	ds ui hv
董事长	ds ui vh
董仲舒	ds vs uu
葭莩	jx fu
葱头	cs tz
葳蕤	ww rv
葶苈	tk li
蒋介石	jl jp dj
蒋介石	jl jp ui
蒙住	mg vu
蒙古包	mg gu bc
蒙古族	mg gu zu
蒙头转向	mg tz vr xl
蒙查查	mg ia ia
蒙牛	mg nq
蒙蒙	mg mg
蒙蒙亮	mg mg ll
蒙难	mg nj
蒜子	sr zi
蒲公英	pu gs yk
蒲卢	pu lu
蒲葵	pu kv
蒲飞	pu fw
蒸气	vg qi
蒸汽	vg qi
蒸汽机	vg qi ji
蒸馏水	vg lq uv
蒹葭	jm jx
蒺藜	ji li
蓁艽	vf jn
蓁艽	vf qq
蓁蓁	vf vf
蓄水池	xu uv ii
蓄电池	xu dm ii
蓄积	xu ji
蓇葖	gu tu
蓉蓉烂烂	rs rs lj lj
蓊郁	wg yu
蓑衣	so yi
蓓蕾	bw lw
蓖麻	bi ma
蓝宝石	lj bc ui
蓝布	lj bu
蓝帽子	lj mc zi
蓝皮书	lj pi uu
蓝藻	lj zc
蓝调	lj dn
蓝调	lj tn
蓦地	mo di
蓬蓬勃勃	pg pg bo bo
蔓菁	mj jk
蔗农	ve ns
蔚为壮观	ww ww vl gr
蔚为大观	ww ww da gr
蔚成风气	ww ig fg qi
蔚蓝色	ww lj se
蔫韧	nm rf
蕙心纨质	hv xb wj vi
蕞尔	zv er
蕴涵	yy hj
蕴藉	yy jp
薄利	bo li
薄地	bo di
薄幸	bo xk
薄片	bc pm
薄薄	bc bc
薄雾	bc wu
薄雾	bo wu
薏苡	yi yi
薜荔	bi li
薪俸税	xb fg uv
薯头	uu tz
薯类	uu lw
薯蓣	uu yu
薿薿	ni ni
藏历	zh li
蘅芜	hg wu
蘑菇云	mo gu yy
蘼芜	mi wu
虎口	hu kz
虎威	hu ww
虎子	hu zi
虎落平阳	hu la pk yh
虎落平阳	hu lc pk yh
虎落平阳	hu lo pk yh
虚惊	xu jk
虚高	xu gc
虫害	is hd
虫灾	is zd
虱乸	ui na
虱子	ui zi
虺虺	hv hv
虾仁	xx rf
虾毛	xx mc
虾虾霸霸	xx xx ba ba
虾辘	xx lu
蚊到瞓啦	wf dc ff la
蚊到瞓啦	wf dc xy la
蚊子	wf zi
蚍蜉	pi fu
蚕丝	cj si
蚕茧	cj jm
蚰蜒	yz yj
蚴虬	yz qq
蛀米大虫	vu mi da is
蛀米大虫	vu mi dd is
蛇头	ue tz
蛇蝎心肠	ue xp xb ih
蛇都死	ue du si
蛇都死	ue dz si
蛋散	dj sj
蛐蟮	qu uj
蛙人	wa rf
蛛网	vu wh
蛤乸	ge na
蛤乸	ha na
蛤蜊	ge li
蛴螬	qi cc
蜂星	fg xk
蜂王浆	fg wh jl
蜂窝煤	fg wo mw
蜈蚣	wu gs
蜉蝣	fu yz
蜎蜎	yr yr
蜕化	tv hx
蜗螺	wo lo
蜚声	fw ug
蜚蠊	fw lm
蜞乸	qi na
蜡梅	la mw
蜡青	la qk
蜥蜴	xi yi
蜾蠃	go lo
蜿蜒	wj yj
蝇头微利	yk tz ww li
蝉连	ij lm
蝎子	xp zi
蝗灾	hl zd
蝤蛑	qq mz
蝤蛴	qq qi
蝾螈	rs yr
螟蛉	mk lk
螳臂挡车	th bi dh ie
螳臂挡车	th bi dh ju
螳臂挡车	th bw dh ie
螳臂挡车	th bw dh ju
螳螂捕蝉黄雀在后	th lh bu ij hl qt zd hz
螵蛸	pn xn
螺丝批	lo si pi
螺丝钉	lo si dk
螺旋桨	lo xr jl
螺栓	lo ur
螺蛳	lo si
蟏蛸	xn xn
蟛蜞	pg qi
蟾宫折挂	ij gs ue gx
蟾宫折挂	ij gs ve gx
蟾蜍	ij iu
蠛蠓	mp mg
蠢笨如猪	iy bf ru vu
蠼螋	qu sz
血压计	xt ya ji
血吸虫	xt xi is
血性	xt xk
血流成河	xt lq ig he
血淋淋	xp lb lb
血红蛋白	xt hs dj bd
血缘	xt yr
血肉相连	xt rz xl lm
行不更名坐不改姓	hh bu gg mk zo bu gd xk
行不更名坐不改姓	xk bu gg mk zo bu gd xk
行不由径	hh bu yz jk
行不由径	xk bu yz jk
行事	xk ui
行会	hh hv
行使	xk ui
行咇	hh bi
行咇	xk bi
行埋	hh md
行埋	hh mj
行埋	xk md
行埋	xk mj
行山径	hh uj jk
行山径	xk uj jk
行差踏错	hh ci ta co
行差踏错	hh ia ta co
行差踏错	hh id ta co
行差踏错	xk ci ta co
行差踏错	xk ia ta co
行差踏错	xk id ta co
行径	xk jk
行必果	xk bi go
行政区	xk vg qu
行政村	xk vg cy
行政院	hh vg yr
行政院	xk vg yr
行星	xk xk
行程	xk ig
行署	xk uu
行行企企	hh hh qi qi
行行企企	hh xk qi qi
行行企企	xk hh qi qi
行行企企	xk xk qi qi
行装	xk vl
行路唔带眼	hh lu wu dd yj
行路唔带眼	xk lu wu dd yj
行雷	hh lw
行雷	xk lw
行驶	xk ui
衍生物	yj ug wu
街区	jp qu
街喉	jp hz
街坊	jp fh
街头巷议	jp tz hh yi
街头巷议	jp tz xl yi
街市	jp ui
街症	jp vg
街线	jp xm
街道	jp dc
街面	jp mm
衡器	hg qi
衣兜	yi dz
衣冠	yi gr
衣料	yi ln
衣架	yi jx
衣物	yi wu
衣衫	yi uj
衣袋	yi dd
衣裳	yi uh
衣襟	yi jb
衣角	yi jn
补习	bu xi
补习班	bu xi bj
补发	bu fa
补差	bu ia
补救	bu jq
补给	bu ji
补缺	bu qt
补药	bu yc
补血	bu xt
补课	bu ke
补足	bu zu
表决权	bn jt qr
表哥	bn ge
表弟	bn di
表征	bn vg
表演唱	bn yj ih
表肉	bn rz
表里不一	bn li bu yi
表面化	bn mm hx
衫钮	uj nq
衬里	if li
衰变	uk bm
衰咗	uk zo
衰女	uk nv
衰衰地	uk uk de
衰衰地	uk uk di
衷心	vs xb
衷情	vs qk
衷肠	vs ih
袅袅瘦瘦	nn nn uz uz
袋袋平安	dd dd pk an
袒露	tj lu
袖手傍观	xq uz bh gr
被俘	bw fu
被压迫	bw ya pd
被压迫	bw ya po
被压迫	pi ya pd
被压迫	pi ya po
被告人	bw gc rf
被害	bw hd
被害人	bw hd rf
被害者	bw hd ve
被捕	bw bu
被服	bw fu
被窦	bw dz
被窦	pi dz
被选举权	bw xr ju qr
裁剪	cd jm
裁缝	cd fg
裂化	lp hx
裂谷	lp gu
裂隙	lp xi
装假狗	vl jx gz
装弹弓	vl dj gs
装弹弓	vl tj gs
装机	vl ji
装璜	vl hl
装甲	vl jx
装甲兵	vl jx bk
装甲车	vl jx ie
装船	vl ir
装车	vl ie
装配线	vl pw xm
装饰品	vl ui pb
装香	vl xl
裙脚仔	qy jn zd
裙脚仔	qy jn zi
裙装	qy vl
裙褂	qy gx
裣衽	lm rf
裤头带	ku tz dd
裸戏	lo xi
裹蒸粽	go vg zs
褒善贬恶	bc uj bm ee
褒善贬恶	bc uj bm wu
褒扬	bc yh
褓姆车	bc mu ie
褓姆车	bc mu ju
褡裢	da lm
褥疮	ru il
褪軚	tv td
褪軚	ty td
襁袍	ql pc
襁褓	ql bc
襄樊	xl fj
襄阳	xl yh
西化	xi hx
西北风	xi bw fg
西半球	xi bj qq
西南风	xi nj fg
西城	xi ig
西头	xi tz
西学	xi xt
西式	xi ui
西文	xi wf
西方人	xi fh rf
西施	xi ui
西服	xi fu
西汉	xi hj
西沙	xi ua
西洋	xi yh
西洋参	xi yh uf
西洋菜	xi yh cd
西端	xi dr
西经	xi jk
西装友	xi vl yz
西陆	xi lq
西陆	xi lu
西雅图	xi ya tu
西非	xi fw
要义	yc yi
要事	yc ui
要件	yc jm
要冲	yc is
要务	yc wu
要员	yc yr
要旨	yc vi
要目	yc mu
要饭	yc fj
覆盖率	fu gd lv
见习	jm xi
见利思义	jm li si yi
见危授命	jm ww uz mk
见地	jm di
见得	jm de
见怪不怪	jm gk bu gk
见报	jm bc
见效	jm xn
见步行步	jm bu hh bu
见步行步	jm bu xk bu
见牙唔见眼	jm ya wu jm yj
见状	jm vl
见见	jm jm
见解	jm jp
见识	jm ui
见长	jm ih
见长	jm vh
见面礼	jm mm li
观众席	gr vs xi
观察力	gr ia li
观察员	gr ia yr
观察家	gr ia jx
观战	gr vj
观瞻	gr vj
观礼	gr li
观者如云	gr ve ru yy
观音兵	gr yb bk
规例	gv li
规律性	gv lv xk
规程	gv ig
规章制度	gv vh vi du
规行矩步	gv xk ju bu
规规矩矩	gv gv ju ju
觅食	mi ui
视为	ui ww
视入草芥	ui ru cc jp
视力	ui li
视图	ui tu
视点	ui dm
视线	ui xm
视网膜	ui wh mo
视野	ui ye
觉眼	jn yj
觉眼	jt yj
觉觉猪	jn jn vu
觉觉猪	jn jt vu
觉觉猪	jt jn vu
觉觉猪	jt jt vu
觊觎	ji yu
角落头	jn la tz
角落头	jn lc tz
角落头	jn lo tz
角落头	jt la tz
角落头	jt lc tz
角落头	jt lo tz
角钢	jn gh
解体	jp ti
解开	jp kd
解忧	jp yz
解放区	jp fh qu
解放后	jp fh hz
解放战争	jp fh vj vg
解数	xp uu
解构	jp gz
解毒	jp du
解渴	jp ke
解禁	jp jb
解衣推食	jp yi tv ui
解说词	jp uo ci
解调	jp tn
解除	jp iu
解难	jp nj
触动	iu ds
触及	iu ji
触发	iu fa
触媒	iu mw
触礁	iu jn
觱篥	bi li
觳觫	hu su
言和	yj he
言必信	yj bi xb
言必信行必果	yj bi xb hh bi go
言必信行必果	yj bi xb xk bi go
言必有据	yj bi yz ju
言教	yj jn
言词	yj ci
誓师	ui ui
誓死	ui si
誓言	ui yj
誓词	ui ci
警力	jk li
警卫员	jk ww yr
警句	jk ju
警备区	jk bw qu
警察局	jk ia ju
警戒	jk jp
警戒线	jk jp xm
警报器	jk bc qi
警服	jk fu
警种	jk vs
警笛	jk di
警醒	jk xk
计仔	ji zd
计仔	ji zi
计分	ji ff
计划性	ji hx xk
计划生育	ji hx ug yu
计委	ji ww
计数	ji uu
计时	ji ui
计酬	ji iz
计量	ji ll
订户	dk hu
讣告	fu gc
认亲认戚	rf qb rf qi
认亲认戚	rf qk rf qi
认低威	rf di ww
认住	rf vu
认叻	rf le
认清	rf qk
认知	rf vi
认认真真	rf rf vf vf
认识论	rf ui ly
讥笑	ji xn
讨嫌	tc xm
讨饭	tc fj
训令	xy lk
训练场	xy lm ih
训练有素	xy lm yz su
训练班	xy lm bj
训诫	xy jp
议事	yi ui
议价	yi jx
议会制	yi hv vi
议员	yi yr
议和	yi he
议定	yi dk
议定书	yi dk uu
议席	yi xi
议政	yi vg
议长	yi vh
议院	yi yr
议题	yi ti
讯问	xy wf
记事	ji ui
记分	ji ff
记功	ji gs
记取	ji qu
记叙	ji xu
记叙文	ji xu wf
记忆力	ji yi li
记性	ji xk
记要	ji yc
记账	ji vh
记述	ji uu
讲义	jl yi
讲信修睦	jl xb xq mu
讲堂	jl th
讲大话	jl da hx
讲大话	jl dd hx
讲学	jl xt
讲师	jl ui
讲开又讲	jl kd yz jl
讲打讲杀	jl da jl ua
讲理	jl li
讲耶稣	jl ye su
讲解员	jl jp yr
许可证	xu ke vg
许许多多	xu xu do do
论处	ly iu
论文集	ly wf ji
论理	ly li
讻讻	xs xs
讽一劝百	fg yi qr bd
设伏	ue fu
设计师	ue ji ui
设计者	ue ji ve
设计院	ue ji yr
证实	vg ui
证明书	vg mk uu
证章	vg vh
证言	vg yj
评为	pk ww
评介	pk jp
评剧	pk ju
评功	pk gs
评头品足	pk tz pb zu
评头论足	pk tz ly zu
评委会	pk ww hv
评弹	pk tj
评比	pk bi
评论员	pk ly yr
评话	pk hx
识字	ui zi
识捞	ui lc
识捞	vi lc
识饮识食	ui yb ui si
识饮识食	ui yb ui ui
识饮识食	ui yb ui yi
识饮识食	ui yb vi si
识饮识食	ui yb vi ui
识饮识食	ui yb vi yi
识饮识食	vi yb ui si
识饮识食	vi yb ui ui
识饮识食	vi yb ui yi
识饮识食	vi yb vi si
识饮识食	vi yb vi ui
识饮识食	vi yb vi yi
诈假意	va jx yi
诈傻扮懵	va ua bj mg
诈嗲	va dx
诈型	va xk
诈娇	va jn
诈糊	va hu
诈谛	va di
诉状	su vl
诉讼法	su ss fa
诉诸武力	su vu wu li
诊室	vf ui
诊治	vf vi
词人	ci rf
词句	ci ju
词曲	ci qu
词牌	ci pd
译丛	yi cs
译作	yi zo
译制	yi vi
译文	yi wf
译本	yi bf
译著	yi vu
试制	ui vi
试剂	ui ji
试办	ui bj
试听	ui tk
试想	ui xl
试映	ui yk
试用	ui ys
试用期	ui ys qi
试看	ui kj
试种	ui vs
试管	ui gr
试行	ui xk
试试看	ui ui kj
试金石	ui jb ui
试销	ui xn
试问	ui wf
试题	ui ti
试飞	ui fw
试验田	ui yj tm
诖误	gx wu
诗体	ui ti
诗作	ui zo
诗圣	ui ug
诗坛	ui tj
诗意	ui yi
诗文	ui wf
诗经	ui jk
诗话	ui hx
诗集	ui ji
诘诎	ji qu
诘诎	jp qu
诚信	ig xb
诚实	ig ui
诚挚	ig vi
诚聘	ig pb
诚邀	ig yc
诛杀	vu ua
话之佢	hx vi ko
话之佢	hx vi qu
话剧团	hx ju tr
话务员	hx wu yr
话匣子	hx xx zi
话口未完	hx kz ww wj
话名	hx mk
话咁易	hx gj yi
话唔埋	hx wu md
话唔埋	hx wu mj
话唔定	hx wu dk
话头	hx tz
话头醒尾	hx tz xk ww
话斋	hx vd
话时话	hx ui hx
话茬	hx ia
话费	hx fw
诟詈	gz li
诠释	qr ui
诤友	vg yz
诤言	vg yj
该煨	gd ww
详实	xl ui
详尽	xl jb
详解	xl jp
诧异	ia yi
诬陷	wu xm
语义	yu yi
语境	yu jk
语意	yu yi
语文课	yu wf ke
语气	yu qi
语汇	yu hv
语系	yu xi
语词	yu ci
误事	wu ui
误导	wu dc
误时	wu ui
误点	wu dm
误用	wu ys
误食	wu ui
诱使	yz ui
诱因	yz yb
诱杀	yz ua
说不上	uo bu uh
说到底	uo dc di
说和	uo he
说大话	uo da hx
说时迟	uo ui ii
说是	uo ui
说服力	uo fu li
说空话	uo ks hx
说说笑笑	uo uo xn xn
说说笑笑	uo uv xn xn
说说笑笑	uo yt xn xn
说说笑笑	uv uo xn xn
说说笑笑	uv uv xn xn
说说笑笑	uv yt xn xn
说说笑笑	yt uo xn xn
说说笑笑	yt uv xn xn
说说笑笑	yt yt xn xn
说长道短	uo ih dc dr
请便	qk bm
请功	qk gs
请愿	qk yr
请战	qk vj
请鎗	qk ql
请饮	qk yb
诸位	vu ww
诸如	vu ru
诸葛亮	vu ge ll
读书人	du uu rf
读后感	du hz gj
课件	ke jm
课余	ke yu
课时	ke ui
课目	ke mu
课间	ke jm
谁不知	uv bu vi
谁不知	uw bu vi
谁料	uv ln
谁料	uw ln
谂头	uf tz
谂缩数	uf so uu
调令	dn lk
调头	dn tz
调幅	tn fu
调控	tn ks
调节器	tn jp qi
调解	tn jp
调资	tn zi
调车	dn ie
调车	dn ju
调车	tn ie
调车	tn ju
调转	dn vr
调转头	dn vr tz
调转头	tn vr tz
调运	dn yy
谄谀	ij yu
谆谆	vy vy
谆谆告诫	vy vy gc jp
谆谆教导	vy vy jn dc
谈兴	tj xk
谈吐	tj tu
谈天说地	tj tm uo di
谈心	tj xb
谈笑	tj xn
谈虎色变	tj hu se bm
谈起	tj qi
谋取	mz qu
谐和	xp he
谐调	xp tn
谗谀	ij yu
谚语	yj yu
谡谡	su su
谢意	xp yi
谦让末遑	qm rh mo hl
谨言慎行	jb yj uf xk
谮气	zf qi
谰叻	lj le
谰正经	lj vg jk
谷地	gu di
谷气	gu qi
谷物	gu wu
谷雨	gu yu
豁亮	ho ll
豁口	ho kz
豁达大度	ho da da du
豆丁	dz dk
豆制品	dz vi pb
豆汁	dz vi
豆沙喉	dz ua hz
豆油	dz yz
豆科	dz ke
豆荚	dz jx
豆饼	dz bk
豉汁	ii vi
象样	xl yh
象牙之塔	xl ya vi ta
豪气	hc qi
豪赌	hc du
豫剧	yu ju
豹子	bc zi
豺狐之心	id hu vi xb
豺狼成性	id lh ig xk
贝利	bw li
贝塔斯曼	bw ta si mj
贝多芬	bw do ff
负于	fu yu
负债累累	fu vd lw lw
负数	fu uu
负有	fu yz
负气	fu qi
负荷	fu he
负重	fu vs
财产权	cd ij qr
财季	cd ji
财报	cd bc
财政厅	cd vg tk
财政部	cd vg bu
财权	cd qr
财源	cd yr
财物	cd wu
财神爷	cd uf ye
责任制	ze rf vi
责任心	ze rf xb
责任田	ze rf tm
责编	ze bm
贤人	xm rf
贤哲	xm ve
贤慧	xm hv
贤达	xm da
败北	bd bw
败者	bd ve
败血症	bd xt vg
败露	bd lu
货价	ho jx
货场	ho ih
货机	ho ji
货畅其流	ho ih qi lq
货车	ho ie
货郎	ho lh
质保	vi bc
质子	vi zi
质朴无华	vi pu wu hx
质检	vi jm
贪口爽	tj kz ul
贪大求全	tj da qq qr
贪大求洋	tj da qq yh
贪得意	tj de yi
贪得意	tj dw yi
贪污受贿	tj wu uz hv
贪污犯	tj wu fj
贫困户	pb ky hu
贫困线	pb ky xm
贫弱	pb ro
贫民窟	pb mb ku
贫贱不移	pb jm bu yi
贬义	bm yi
贬值	bm vi
购买力	gz md li
购价	gz jx
购机	gz ji
贮备	vu bw
贮运	vu yy
贯串	gr ir
贲门	bf mf
贴堂	tp th
贴心人	tp xb rf
贴画	tp hx
贴金	tp jb
贴钱买难受	tp qm md nj uz
贴错门神	tp co mf uf
贵国	gv go
贵州省	gv vz ug
贵金属	gv jb uu
贵阳市	gv yh ui
贸促会	mc cu hv
贸易额	mc yi ee
费事	fw ui
费事理	fw ui li
费工	fw gs
贺信	he xb
贺函	he hj
贺年	he nm
贺年片	he nm pm
贺电	he dm
贺礼	he li
贺辞	he ci
贻误	yi wu
贼佬	zw lc
贼佬试沙煲	zw lc ui ua bc
资力	zi li
资助	zi vu
资历	zi li
资本论	zi bf ly
资财	zi cd
赊数	ue uu
赌具	du ju
赎买	uu md
赎罪	uu zv
赏识	uh ui
赏赐	uh ci
赑屃	bi xi
赖死	ld si
赖猫	ld mc
赘述	vv uu
赚头	vr tz
赛迪	sd di
赛门铁克	sd mf tp ke
赞语	zj yu
赞谈不已	zj tj bu yi
赠书	zg uu
赠款	zg kr
赡养	uj yh
赢余	yk yu
赢利	yk li
赢取	yk qu
赢政	yk vg
赤卫队	ii ww dv
赤口	ii kz
赤子	ii zi
赤子之心	ii zi vi xb
赤峰	ii fg
赤心报国	ii xb bc go
赤心相待	ii xb xl dd
赤日炎炎	ii ri yj yj
赤诚	ii ig
赤贫	ii pb
赤道	ii dc
赫哲族	he ve zu
赫德	he de
赫赫	he he
赫鲁晓夫	he lu xn fu
走下坡路	zz xx po lu
走埠	zz bu
走堂	zz th
走失	zz ui
走夹唔唞	zz ga wu dz
走夹唔唞	zz ga wu tc
走夹唔唞	zz jx wu dz
走夹唔唞	zz jx wu tc
走宝	zz bc
走法律罅	zz fa lv xx
走盏	zz vj
走私犯	zz si fj
走精面	zz jk mm
走资派	zz zi pd
走趯	zz ti
走趯	zz yt
走近	zz jb
走道	zz dc
走难	zz nj
走露	zz lu
走露	zz lz
走马看花	zz ma kj hx
走鬼	zz gv
赴美	fu mw
赵体	vc ti
赵孟頫	vc mg fu
赶到	gj dc
赶唔切	gj wu qp
赶时髦	gj ui mc
赶路	gj lu
赶集	gj ji
赶鸭仔	gj ya zd
赶鸭仔	gj ya zi
起义	qi yi
起义军	qi yi jy
起事	qi ui
起价	qi jx
起伏	qi fu
起先	qi xm
起动	qi ds
起名	qi mk
起始	qi ui
起居	qi ju
起底	qi di
起开	qi kd
起早摸黑	qi zc mo hw
起火	qi ho
起用	qi ys
起程	qi ig
起筷	qi kk
起色	qi se
起落架	qi lc jx
起落架	qi lo jx
起见	qi jm
起跑	qi pc
起跑线	qi pc xm
起运	qi yy
起重	qi vs
起镬	qi ho
起飞脚	qi fw jn
起鸡皮	qi ji pi
趁势	if ui
趁墟	if xu
超产	ic ij
超低温	ic di wf
超低空	ic di ks
超值	ic vi
超声	ic ug
超声波	ic ug bo
超导体	ic dc ti
超尘拔俗	ic if ba su
超市	ic ui
超新星	ic xb xk
超期	ic qi
超然物外	ic rj wu wd
超级大国	ic ji da go
超音速	ic yb su
超高	ic gc
越剧	yt ju
越境	yt jk
越是	yt ui
越狱	yt yu
越界	yt jp
越级	yt ji
趋于	qu yu
趋向	qu xl
趑趄	zi ju
趣事	qu ui
足下	zu xx
足球队	zu qq dv
跃破	yt po
跃跃欲试	yt yt yu ui
跃进	yt jb
跋山涉水	ba uj ue uv
跌涨	dp vh
跏趺	jx fu
跑官	pc gr
跛脚佬	bo jn lc
跟头	gf tz
跟尾狗	gf ww gz
跟手尾	gf uz ww
跟红顶白	gf hs dk bd
跨上	kx uh
跨国	kx go
跨年度	kx nm du
跪倒	gv dc
路卡	lu ka
路卡	lu qx
路基	lu ji
路见不平拔刀相助	lu jm bu pk ba dc xl vu
路透社	lu tz ue
路风	lu fg
跳楼货	tn lz ho
跳皮	tn pi
跳糟	tn zc
跳马	tn ma
跷妙	qn mn
跷蹊	qn qi
跼蹐	ju ji
踌躇	iz iu
踎厕	bw ce
踎厕	bw si
踎街	bw jp
踟蹰	ii iu
踩低	cd di
踩单车	cd dj ie
踩单车	cd dj ju
踩单车	cd ij ie
踩单车	cd ij ju
踩单车	cd uj ie
踩单车	cd uj ju
踩场	cd ih
踩死蚁	cd si yi
踩界	cd jp
踩蕉皮	cd jn pi
踩过界	cd go jp
踩雪屐	cd xt ji
踪迹	zs ji
踯躅	vi vu
踽踽	ju ju
蹀躞	dp xp
蹈节死义	dc jp si yi
蹊径	xi jk
蹭蹬	cg dg
蹼泳	pu ys
身世	uf ui
身亡	uf wh
身兴	uf xk
身分	uf ff
身受	uf uz
身后	uf hz
身姿	uf zi
身孕	uf yy
身家	uf jx
身手	uf uz
身教	uf jn
身水身汗	uf uv uf hj
身纪	uf ji
身长	uf ih
躯干	qu gj
躲躲闪闪	do do uj uj
车体	ie ti
车厘子	ie li zi
车厘子	ju li zi
车叶	ie xp
车叶	ie ye
车叶	ju xp
车叶	ju ye
车头相	ie tz xl
车头相	ju tz xl
车尾箱	ie ww xl
车尾箱	ju ww xl
车床	ie il
车房仔	ie fh zd
车房仔	ie fh zi
车房仔	ju fh zd
车房仔	ju fh zi
车皮	ie pi
车组	ie zu
车衫	ie uj
车衫	ju uj
车軚	ie td
车軚	ju td
车辘	ie lu
车辘	ju lu
车辙	ie ve
轧制	ya vi
轧辊	va gy
轩轾	xr vi
转下眼	vr xx yj
转业	vr ye
转会	vr hv
转体	vr ti
转卖	vr md
转向	vr xl
转呔	vr dd
转呔	vr td
转售	vr uz
转嫁	vr jx
转干	vr gj
转性	vr xk
转战南北	vr vj nj bw
转投	vr tz
转机	vr ji
转来转去	vr ld vr qu
转正	vr vg
转炉	vr lu
转用	vr ys
转瞬间	vr uy jm
转网	vr wh
转赠	vr zg
转车	vr ie
转轪	vr dd
转运站	vr yy vj
转述	vr uu
轮更	ly gg
轮渡	ly du
轮训	ly xy
软弱无力	rr ro wu li
软熟	rr uu
软熟	rr uz
软皮蛇	rr pi ue
软着陆	rr vo lu
软荏荏	rr rf rf
软银	rr yb
轰击	hs ji
轰动一时	hs ds yi ui
轰响	hs xl
轰炸机	hs va ji
轻信	qk xb
轻取	qk qu
轻型	qk xk
轻如鸿毛	qk ru hs mc
轻工业	qk gs ye
轻武器	qk wu qi
轻生	qk ug
轻纺	qk fh
轻视	qk ui
轻财好施	qk cd hc ui
轻音乐	qk yb yt
轻风	qk fg
轻骑	qk qi
载人	zd rf
载货	zd ho
载酒问字	zd jq wf zi
轿夫	jn fu
轿子	jn zi
较之	jn vi
较差	jn ia
辅导员	fu dc yr
辈出	bw iu
辈分	bw ff
辉映	hv yk
辑录	ji lu
输卵管	uu lr gr
输家	uu jx
输油管	uu yz gr
输液	uu ye
输电	uu dm
输电线	uu dm xm
输血	uu xt
输赌	uu du
辖区	xx qu
辘卡	lu ka
辘卡	lu qx
辘轳	lu lu
辛丑	xb iz
辛亥	xb hd
辛卯	xb mc
辛巳	xb si
辛未	xb ww
辛酉	xb yz
辞不达意	ci bu da yi
辞书	ci uu
辞典	ci dm
辞行	ci xk
辟易	bi yi
辟易	pi yi
辨析	bm xi
辨证	bm vg
辨识	bm ui
辩护人	bm hu rf
辩解	bm jp
辩证法	bm vg fa
边区	bm qu
边城	bm ig
边寨	bm vd
边民	bm mb
边界	bm jp
边界线	bm jp xm
边线	bm xm
边角料	bm jn ln
边远	bm yr
边际	bm ji
辽宁省	ln nk ug
辽远	ln yr
达卡	da ka
达卡	da qx
达观	da gr
迁册	qm ce
迁徙	qm xi
迂缓	yu hr
迅驰	xy ii
过五关	go wu gr
过人	go rf
过冬	go ds
过冷河	go lg he
过埠新娘	go bu xb nl
过境	go jk
过大	go da
过失	go ui
过底纸	go di vi
过往	go wh
过得硬	go de yk
过快	go kk
过敏	go mb
过时	go ui
过时黄花	go ui hl hx
过来人	go ld rf
过激	go ji
过火	go ho
过眼烟云	go yj yj yy
过硬	go yk
过秤	go ig
过细	go xi
过街老鼠	go jp lc uu
过路	go lu
过路人	go lu rf
过道	go dc
过钟	go vs
过长	go ih
过长	go vh
过骨	go gu
过龙	go ls
迈克	md ke
迈克尔	md ke er
迈拓	md ta
迈拓	md to
迈进	md jb
迍邅	vy vj
迎击	yk ji
迎头赶上	yk tz gj uh
迎宾曲	yk bb qu
迎宾馆	yk bb gr
迎送	yk ss
迎风招展	yk fg vc vj
运到	yy dc
运力	yy li
运动员	yy ds yr
运动场	yy ds ih
运动战	yy ds vj
运动衣	yy ds yi
运动量	yy ds ll
运动队	yy ds dv
运动鞋	yy ds xp
运城	yy ig
运斤成风	yy jb ig fg
运筹帷幄	yy iz ww wo
运营商	yy yk uh
运输机	yy uu ji
运输线	yy uu xm
运输费	yy uu fw
运销	yy xn
近些年	jb xp nm
近代史	jb dd ui
近住	jb vu
近在眉睫	jb zd mw jp
近处	jb iu
近年	jb nm
近日	jb ri
近来	jb ld
近海	jb hd
近程	jb ig
近视眼	jb ui yj
返乡	fj xl
返修	fj xq
返屋企	fj wu qi
返销	fj xn
返销粮	fj xn ll
返青	fj qk
还乡	hd xl
还乡	hr xl
还应	hd yk
还应	hr yk
还愿	hr yr
还手	hr uz
还清	hr qk
还神	hd uf
还神	hr uf
还须	hd xu
还须	hr xu
这一下	ve yi xx
这一来	ve yi ld
这就是说	ve jq ui uo
进一步	jb yi bu
进京	jb jk
进出口	jb iu kz
进化论	jb hx ly
进发	jb fa
进取	jb qu
进口税	jb kz uv
进口货	jb kz ho
进城	jb ig
进士	jb ui
进犯	jb fj
进行曲	jb xk qu
进言	jb yj
进贡	jb gs
进逼	jb bi
进项	jb xl
进食	jb ui
远亲近邻	yr qb jb lb
远亲近邻	yr qk jb lb
远古	yr gu
远望	yr wh
远洋	yr yh
远涉重洋	yr ue is yh
远游	yr yz
远离	yr li
远行	yr xk
远见	yr jm
远远	yr yr
远销	yr xn
违例	ww li
违宪	ww xm
违犯	ww fj
违禁品	ww jb pb
违纪	ww ji
违者	ww ve
连云港	lm yy gh
连任	lm rf
连作	lm zo
连同	lm ts
连埋	lm md
连埋	lm mj
连环	lm hr
连环画	lm hr hx
连用	lm ys
连续不断	lm xu bu dr
连绵	lm mm
连衣裙	lm yi qy
连轴转	lm vz vr
连连	lm lm
连通	lm ts
连部	lm bu
连锁反应	lm so fj yk
连队	lm dv
连阴雨	lm yb yu
迢递	tn di
迤逦	yi li
迥然不同	js rj bu ts
迪斯尼	di si ni
迪斯科	di si ke
迫击炮	pd ji pc
迫纽	pd nq
迫纽	po nq
迭埋心水	dp md xb uv
迭埋心水	dp mj xb uv
迭起	dp qi
述职	uu vi
述评	uu pk
迷彩服	mi cd fu
迷漫	mi mj
追击	vv ji
追悼会	vv dc hv
追肥	vv fw
追记	vv ji
追述	vv uu
退休金	tv xq jb
退位	tv ww
退守	tv uz
退居	tv ju
退换	tv hr
送人情	ss rf qk
适中	ui vs
适于	ui yu
适宜	ui yi
适应性	ui yk xk
适应症	ui yk vg
适时	ui ui
适用	ui ys
适用性	ui ys xk
适配	ui pw
适销	ui xn
适龄	ui lk
选举权	xr ju qr
选修课	xr xq ke
选区	xr qu
选择题	xr ze ti
选曲	xr qu
选本	xr bf
选段	xr dr
选矿	xr kl
选种	xr vs
选聘	xr pb
选育	xr yu
选读	xr du
选调	xr dn
选集	xr ji
逊志时敏	xy vi ui mb
透火	tz ho
透镜	tz jk
逐一	vu yi
逐个	vu ge
逐级	vu ji
递补	di bu
途经	tu jk
通例	ts li
通信员	ts xb yr
通史	ts ui
通商	ts uh
通明	ts mk
通晓	ts xn
通栏	ts lj
通气	ts qi
通渠	ts qu
通用性	ts ys xk
通畅	ts ih
通称	ts ig
通统	ts ts
通缉	ts ji
通航	ts hh
通衢	ts qu
通观	ts gr
通讯员	ts xy yr
通讯网	ts xy wh
通译	ts yi
通货	ts ho
通路	ts lu
通辽	ts ln
通通	ts ts
通邮	ts yz
通顶	ts dk
逝世	ui ui
逞凶	ig xs
速射	su ue
速成	su ig
速滑	su hx
速龙	su ls
造反	zc fj
造就	zc jq
造影	zc yk
造物主	zc wu vu
造纸厂	zc vi ih
造诣	zc yi
逡巡	qy xy
逢人说项	fg rf uo xl
逢人说项	fg rf uv xl
逢人说项	fg rf yt xl
逢年过节	fg nm go jp
逢系	fg ji
逢系	fg xi
逶迤	ww yi
逶随	ww sv
逸事	yi ui
逸闻	yi wf
逼人	bi rf
逼和	bi he
逼近	bi jb
逾期	yu qi
逾越	yu yt
遁词	dy ci
遇刺	yu ci
遇险	yu xm
遍及	bm ji
遍地	bm di
遏力	ee li
遏止	ee vi
道人	dc rf
道光	dc gl
道口	dc kz
道士	dc ui
道家	dc jx
道岔	dc ia
道班	dc bj
道琼斯	dc qs si
道道	dc dc
遗书	yi uu
遗传学	yi ir xt
遗传性	yi ir xk
遗体	yi ti
遗作	yi zo
遗像	yi xl
遗址	yi vi
遗失	yi ui
遗孤	yi gu
遗容	yi rs
遗弃	yi qi
遗志	yi vi
遗愿	yi yr
遗物	yi wu
遗训	yi xy
遗迹	yi ji
遗风	yi fg
遥感	yc gj
遥遥	yc yc
遭遇战	zc yu vj
遮羞布	ve xq bu
遮阳	ve yh
避孕药	bi yy yc
避实击虚	bi ui ji xu
避实就虚	bi ui jq xu
避暑	bi uu
避雷针	bi lw vf
避风塘	bi fg th
避风港	bi fg gh
邀集	yc ji
邅迴	vj hv
邓小平	dg xn pk
邓选	dg xr
邢台	xk td
那时快	na ui kk
那是	na ui
邪气	xp qi
邪说	xp uo
邪路	xp lu
邮展	yz vj
邮政局	yz vg ju
邮电	yz dm
邮电局	yz dm ju
邮筒	yz ts
邮编	yz bm
邮袋	yz dd
邮资	yz zi
邮路	yz lu
邮车	yz ie
邮递员	yz di yr
邻县	lb xm
邻近	lb jb
邻里	lb li
郁渥	yu wo
郊游	jn yz
郑州市	vg vz ui
部下	bu xx
部优	bu yz
部委	bu ww
部属	bu uu
部族	bu zu
部类	bu lw
部级	bu ji
郭沫若	go mo ro
都城	du ig
鄂西	ee xi
鄂豫皖	ee yu wj
鄙夷	bi yi
鄙薄	bi bo
鄙陋	bi lz
鄢郢	yj yk
酋长国	qq vh go
酌醴	vo li
配制	pw vi
酒会	jq hv
酒米	jq mi
酒精	jq jk
酒菜	jq cd
酒饼	jq bk
酣睡	hj uv
酥油	su yz
酥油茶	su yz ia
酥虾	su xx
酩酊	mk dk
酬金	iz jb
酴醾	tu mi
酸微微	sr ww ww
酸枝	sr vi
醉酒佬	zv jq lc
醍醐	ti hu
醒定	xk dk
醒目仔	xk mu zd
醒目仔	xk mu zi
醒胃	xk ww
采伐	cd fa
采掘	cd jt
采石	cd ui
采购员	cd gz yr
采风	cd fg
释义	ui yi
释文	ui wf
释疑	ui yi
里便	li bm
里便	li pm
里勾外连	li gz wd lm
里外	li wd
里手	li uz
里程	li ig
里程碑	li ig bw
里里外外	li li wd wd
里长	li ih
里长	li vh
重任	vs rf
重兵	vs bk
重利	vs li
重剑	vs jm
重印	is yb
重在	is zd
重在	vs zd
重地	vs di
重型	vs xk
重奖	vs jl
重工业	vs gs ye
重心	vs xb
重案组	is an zu
重案组	vs an zu
重武器	vs wu qi
重油	vs yz
重洋	is yh
重炮	vs pc
重物	vs wu
重秤	is ig
重秤	vs ig
重重叠叠	is is dp dp
重金属	vs jb uu
野史	ye ui
野战军	ye vj jy
野猪	ye vu
野茫茫	ye mh mh
野鸡	ye ji
量刑	ll xk
量力	ll li
量变	ll bm
金不换	jb bu hr
金丝猴	jb si hz
金价	jb jp
金价	jb jx
金光灿烂	jb gl cj lj
金光闪闪	jb gl uj uj
金刚石	jb gh ui
金华	jb hx
金发	jb fa
金咭	jb ji
金咭	jb ka
金庸	jb ys
金捞	jb lc
金文	jb wf
金星	jb xk
金桂飘香	jb gv pn xl
金沙	jb ua
金灿灿	jb cj cj
金盘洗手	jb pj xi uz
金石	jb ui
金矿	jb kl
金秋	jb qq
金笔	jb bi
金箔	jb bo
金花	jb hx
金蚕脱壳	jb cj to ke
金蚕脱壳	jb cj to qn
金质	jb vi
金门	jb mf
金陵	jb lk
金鱼佬	jb yu lc
金鸡	jb ji
鉴定会	jm dk hv
鉴戒	jm jp
鉴赏力	jm uh li
鎅刀	gd dc
针冇两头利	vf mc ll tz li
针剂	vf ji
针头	vf tz
针头线脑	vf tz xm nc
针对性	vf dv xk
针眼	vf yj
针线	vf xm
针织	vf vi
针织品	vf vi pb
钉盖	dk gd
钟声	vs ug
钟数	vs uu
钟点	vs dm
钟点女佣	vs dm nv ys
钢丝绳	gh si ug
钢厂	gh ih
钢材	gh cd
钢枪	gh ql
钢渣	gh va
钢笔	gh bi
钢筋铁骨	gh jb tp gu
钢花	gh hx
钦差大臣	qb id da if
钱七	qm qi
钱学森	qm xt sf
钱币	qm bi
钱庄	qm vl
钱罂	qm yk
钳制	qm vi
钳子	qm zi
钳工	qm gs
钵仔糕	bo zd gc
钵仔糕	bo zi gc
钵酒	bo jq
钻井队	zr jk dv
钻塔	zr ta
钻机	zr ji
钻石王老五	zr dj wh lc wu
钻石王老五	zr ui wh lc wu
钻空子	zr ks zi
铁丝网	tp si wh
铁中铮铮	tp vs vg vg
铁合金	tp he jb
铁心	tp xb
铁杵成针	tp iu ig vf
铁树开花	tp uu kd hx
铁桥	tp qn
铁水	tp uv
铁流	tp lq
铁矿石	tp kl dj
铁矿石	tp kl ui
铁索桥	tp so qn
铁路局	tp lu ju
铁路桥	tp lu qn
铁通	tp ts
铁道兵	tp dc bk
铁锨	tp xm
铁面御史	tp mm yu ui
铁骑	tp qi
铁骑士	tp qi ui
铅印	qm yb
铅字	qm zi
铅球	qm qq
铎叔	do uu
铓锣	mh lo
铜像	ts xl
铜器	ts qi
铜头铁额	ts tz tp ee
铜板	ts bj
铜管乐	ts gr le
铜管乐	ts gr yt
铜陵	ts lk
铠甲	kd jx
铭文	mk wf
铮铮	vg vg
铮铮铁骨	vg vg tp gu
铰剪	jn jm
铲泥车	ij ni ie
铲泥车	ij ni ju
铲车	ij ie
铲除	ij iu
铴锣	th lo
银仔	yb zd
银仔	yb zi
银元	yb yr
银发	yb fa
银团	yb tr
银奖	yb jl
银币	yb bi
银河系	yb he xi
银灰色	yb hv se
银芽	yb ya
银行业	yb hh ye
银行家	yb hh jx
银质奖	yb vi jl
铸件	vu jm
铸成	vu ig
铸成大错	vu ig da co
铺路石	pu lu ui
铺轨	pu gv
链冚	lm kj
链子	lm zi
链球菌	lm qq jy
销价	xn jx
销假	xn jx
销售一空	xn uz yi ks
销售额	xn uz ee
销货	xn ho
销路	xn lu
销铄	xn uo
锄大弟	iu da di
锄大弟	iu dd di
锄头	iu tz
锈蚀	xq ui
锌盆	xb pf
锒铛	lh dh
错事	co ui
错失	co ui
锟铻	ky wu
锡伯族	xi bo zu
锣鼓喧天	lo gu xr tm
锥处囊中	vv iu nh vs
锥形	vv xk
锦州	jb vz
锦旗	jb qi
锦标赛	jb bn sd
锦绣	jb xq
锦绣前程	jb xq qm ig
锦绣山河荒山野地	jb xq uj he hl uj ye de
锦绣山河荒山野地	jb xq uj he hl uj ye di
锦西	jb xi
锭子	dk zi
键入	jm ru
锯扒	ju ba
锯扒	ju pa
锻压	dr ya
镆铘	mo ye
镇痛	vf ts
镇纸	vf vi
镐头	gc tz
镜像	jk xl
镜框	jk kl
镬气	ho qi
长一智	vh yi vi
长假	ih jx
长剑	ih jm
长势	vh ui
长叹	ih tj
长官	vh gr
长年	ih nm
长成	vh ig
长拉拉	ih la la
长拉拉	vh la la
长方形	ih fh xk
长明灯	ih mk dg
长春市	ih iy ui
长春市	vh iy ui
长椅	ih yi
长沙市	ih ua ui
长沙市	vh ua ui
长河	ih he
长法	ih fa
长焦	ih jn
长焦	vh jn
长白山	ih bd uj
长眠	ih mm
长矛	ih mc
长短周	ih dr vz
长短周	vh dr vz
长笛	ih di
长衫	ih uj
长袍	ih pc
长话	ih hx
长长	ih ih
长长	ih vh
长长	vh ih
长长	vh vh
閪狗	hw gz
门口狗	mf kz gz
门外汉	mf wd hj
门将	mf jl
门市部	mf ui bu
门框	mf kl
门牌	mf pd
门联	mf lm
门脸	mf lm
门钟	mf vs
闪光灯	uj gl dg
闪动	uj ds
闪失	uj ui
闪存	uj cy
闪盘	uj pj
闪闪烁烁	uj uj uo uo
闭会	bi hv
闭幕式	bi mu ui
闭幕词	bi mu ci
闭目塞听	bi mu se tk
闭翳	bi yi
闭邪存诚	bi xp cy ig
闭邪存诚	bi ye cy ig
闭门羹	bi mf gg
问及	wf ji
问吊	wf dn
问好	wf hc
问讯	wf xy
问询	wf xy
问鼎	wf dk
闯劲	il jb
闲事	xm ui
闲科	xm ke
闲置	xm vi
闲话	xm hx
闲闲地	xm xm de
闲闲地	xm xm di
间不容发	jm bu rs fa
间作	jm zo
间断	jm dr
间架	jm jx
间距	jm ju
间隙	jm xi
闶阆	kh lh
闷气	mf qi
闸住	va vu
闹交	nc jn
闹市	nc ui
闹市区	nc ui qu
闻名	wf mk
阀阅	fa yt
阁仔	ge zd
阁仔	ge zi
阅世	yt ui
阅兵	yt bk
阅兵式	yt bk ui
阅览室	yt lj ui
阉割	yj ge
阊阖	ih he
阑尾炎	lj ww yj
阑干	lj gj
阒砾缂嘞	qu li ke le
阒砾缂嘞	qu li ke lw
阔佬懒理	ko lc lj li
阔咧啡	ko lp fw
阖府统请	he fu ts qk
阜新	fu xb
阜阳	fu yh
队旗	dv qi
队目	dv mu
队部	dv bu
队长	dv ih
队长	dv vh
阢陧	wu np
阢陧	ww np
防冻	fh ds
防务	fh wu
防化	fh hx
防化兵	fh hx bk
防卫	fh ww
防意如城	fh yi ru ig
防护林	fh hu lb
防旱	fh hj
防汛	fh xy
防治	fh vi
防波堤	fh bo di
防灾	fh zd
防盗	fh dc
防空洞	fh ks ds
防腐	fh fu
防腐剂	fh fu ji
防长	fh ih
防长	fh vh
防震	fh vf
防风林	fh fg lb
阳萎	yh ww
阴云	yb yy
阴凉	yb ll
阴声细气	yb ug xi qi
阴性	yb xk
阴道	yb dc
阴雨连绵	yb yu lm mm
阵势	vf ui
阵地战	vf di vj
阶下囚	jp xx qq
阶梯	jp ti
阶砖	jp vr
阶级性	jp ji xk
阶级斗争	jp ji dz vg
阻击	zu ji
阻击战	zu ji vj
阻头阻势	zu tz zu ui
阻截	zu jp
阻滞	zu vi
阿嫲	aa ma
阿嫲	ee ma
阿尔卑斯	aa er bw si
阿尔卑斯	ee er bw si
阿尔卡特	aa er ka te
阿尔卡特	aa er qx te
阿尔卡特	ee er ka te
阿尔卡特	ee er qx te
阿差	aa ci
阿差	aa ia
阿差	aa id
阿差	ee ci
阿差	ee ia
阿差	ee id
阿拉斯加	aa la si jx
阿拉斯加	ee la si jx
阿支阿左	aa vi aa zo
阿支阿左	aa vi ee zo
阿支阿左	ee vi aa zo
阿支阿左	ee vi ee zo
阿灿	aa cj
阿灿	ee cj
阿猪阿狗	aa vu aa gz
阿猪阿狗	aa vu ee gz
阿猪阿狗	ee vu aa gz
阿猪阿狗	ee vu ee gz
阿盟	aa mg
阿茂	aa mc
阿茂	ee mc
阿茂整饼	aa mc vg bk
阿茂整饼	ee mc vg bk
阿里	aa li
阿里	ee li
阿里巴巴	aa li ba ba
阿里巴巴	ee li ba ba
陀螺	to lo
陂陀	po to
附中	fu vs
附件	fu jm
附则	fu ze
附加税	fu jx uv
附和	fu he
附小	fu xn
附属物	fu uu wu
附庸	fu ys
附录	fu lu
附有	fu yz
附注	fu vu
附着物	fu vo wu
附言	fu yj
附设	fu ue
际遇	ji yu
陆上	lu uh
陆军装	lq jy vl
陆军装	lu jy vl
陆战队	lu vj dv
陆海空	lu hd ks
陆游	lq yz
陆游	lu yz
陆空	lq ks
陆空	lu ks
陆荣廷睇相唔衰罗嚟衰	lq rs tk di xl wu uk lo li uk
陆荣廷睇相唔衰罗嚟衰	lq rs tk di xl wu uk lo lw uk
陆荣廷睇相唔衰罗嚟衰	lu rs tk di xl wu uk lo li uk
陆荣廷睇相唔衰罗嚟衰	lu rs tk di xl wu uk lo lw uk
陆陆续续	lq lq xu xu
陆陆续续	lq lu xu xu
陆陆续续	lu lq xu xu
陆陆续续	lu lu xu xu
陈腐	if fu
陈迹	if ji
陋室	lz ui
陌生人	mo ug rf
降水量	jl uv ll
降生	jl ug
降职	jl vi
降落伞	jl lo sj
降龙伏虎	xl ls fu hu
限价	xm jx
限期	xm qi
限止	xm vi
限量版	xm ll bj
陕甘宁	uj gj nk
陕西省	uj xi ug
院墙	yr ql
院士	yr ui
院子	yr zi
院方	yr fh
院校	yr xn
院系	yr ji
院系	yr xi
除去	iu qu
除名	iu mk
除咗	iu zo
除夕	iu xi
除息	iu xi
除此以外	iu ci yi wd
除法	iu fa
除笨有精	iu bf yz jk
除衫	iu uj
陨星	yy xk
险境	xm jk
险峰	xm fg
险恶	xm ee
险滩	xm tj
险胜	xm ug
险象	xm xl
险过剃头	xm go ti tz
险阻	xm zu
陪审员	pw uf yr
陵云之志	lk yy vi vi
陶器	tc qi
陶渊明	tc yr mk
陷于	xm yu
随员	sv yr
随得	sv de
随得	sv dw
随机性	sv ji xk
随风飘洒	sv fg pn sa
隐匿	yb ni
隐忧	yb yz
隐晦	yb hv
隐现	yb xm
隐约	yb yt
隐约可见	yb yt ke jm
隐讳	yb hv
隶书	li uu
隶变	li bm
难事	nj ui
难以忘怀	nj yi wh hk
难友	nj yz
难堪	nj kj
雄关	xs gr
雄师	xs ui
雄赳赳	xs jq jq
雄鸡	xs ji
雄鸡报晓	xs ji bc xn
雅加达	ya jx da
集中制	ji vs vi
集中营	ji vs yk
集会	ji hv
集体化	ji ti hx
集体舞	ji ti wu
集团军	ji tr jy
集大成	ji da ig
集子	ji zi
集市	ji ui
集成度	ji ig du
集成电路	ji ig dm lu
集散	ji sj
集权	ji qr
集约	ji yt
集结	ji jp
集聚	ji ju
集装箱	ji vl xl
集训队	ji xy dv
集资	ji zi
集邮	ji yz
集锦	ji jb
集镇	ji vf
雇佣	gu ys
雇佣军	gu ys jy
雇工	gu gs
雨具	yu ju
雨季	yu ji
雨影	yu yk
雨果	yu go
雨溦	yu ww
雨滴	yu di
雨花石	yu hx ui
雨衣	yu yi
雨褛	yu lv
雨露	yu lu
雪原	xt yr
雪夜	xt ye
雪屐	xt ji
雪峰	xt fg
雪水	xt uv
雪泥鸿爪	xt ni hs vc
雪糕批	xt gc pi
雪糕筒	xt gc ts
雪褛	xt lv
雪铁龙	xt tp ls
零乱	lk lr
零售商	lk uz uh
零售店	lk uz dm
零售额	lk uz ee
零头	lk tz
零打碎敲	lk da sv qn
零时	lk ui
零星落索	lk xk la so
零星落索	lk xk lc so
零星落索	lk xk lo so
零舍	lk ue
零花钱	lk hx qm
零部件	lk bu jm
零配件	lk pw jm
雷击	lw ji
雷声大	lw ug da
雷曼	lw mj
雷电交加	lw dm jn jx
雷电大作	lw dm da zo
雷电大作	lw dm dd zo
雷达站	lw da vj
雷阵雨	lw vf yu
雾气	wu qi
需求量	xu qq ll
震中	vf vs
震天	vf tm
震天动地	vf tm ds di
震情	vf qk
震级	vf ji
霉变	mw bm
霉菌	mw jy
霉菜	mw cd
霎时	ua ui
霎气	ua qi
霏凡	fw fj
霏霏	fw fw
霜期	ul qi
露天矿	lu tm kl
露械	lu xp
露械	lz xp
霸位	ba ww
霸权主义	ba qr vu yi
霸王别姬	ba wh bp ji
青丝	qk si
青云	qk yy
青云直上	qk yy vi uh
青光眼	qk gl yj
青史	qk ui
青壮年	qk vl nm
青天	qk tm
青少年	qk uc nm
青山绿水	qk uj lv uv
青工	qk gs
青年人	qk nm rf
青年团	qk nm tr
青年宫	qk nm gs
青悲悲	qk bw bw
青春期	qk iy qi
青松	qk ss
青海湖	qk hd hu
青海省	qk hd ug
青灰	qk hv
青石	qk ui
青稞	qk ke
青翠	qk cv
青翠欲滴	qk cv yu di
青联	qk lm
青色	qk se
青苗	qk mn
青草	qk cc
青衣	qk yi
青霉素	qk mw su
青青	qk qk
青靓白净	qk jk bd jk
青靓白净	qk ll bd jk
青面獠牙	qk mm ln ya
靓爆镜	jk bc jk
靓爆镜	ll bc jk
静寂	jk ji
静思默想	jk si mo xl
静悄悄	jk qn qn
静止	jk vi
静物	jk wu
静电	jk dm
静穆	jk mu
静英英	jk yk yk
静静乐道	jk jk le dc
静静乐道	jk jk yt dc
静鸡鸡	jk ji ji
非人	fw rf
非典	fw dm
非异人任	fw yi rf rf
非暴力	fw bc li
非正式	fw vg ui
非法所得	fw fa so de
非金属	fw jb uu
靠山吃山	kc uj ii uj
靠水吃水	kc uv ii uv
靠背	kc bw
面世	mm ui
面交	mm jn
面口	mm kz
面左左	mm zo zo
面懵心精	mm mg xb jk
面授	mm uz
面无人色	mm wu rf se
面珠墩	mm vu dy
面皮厚	mm pi hz
面目一新	mm mu yi xb
面筋	mm jb
面议	mm yi
面豉	mm ii
面青口唇白	mm qk kz iy bd
面青青	mm qk qk
面面观	mm mm gr
面食	mm ui
革命军	ge mk jy
革命化	ge mk hx
革命家	ge mk jx
革命者	ge mk ve
革委会	ge ww hv
革委会	ge ww kk
革故鼎新	ge gu dk xb
革除	ge iu
靶子	ba zi
靶机	ba ji
鞋子	xp zi
鞋带	xp dd
鞋抽	xp iz
鞋踭	xp vg
鞠躬尽瘁死而后已	ju gs jb cv si er hz yi
鞠躬尽瘁死而后已一代风流	ju gs jb cv si er hz yi yi dd fg lq
鞭子	bm zi
鞭辟入里	bm pi ru li
鞲鞴	gz bw
韧性	rf xk
韩元	hj yr
韩语	hj yu
音乐会	yb yt hv
音乐厅	yb yt tk
音乐家	yb yt jx
音乐界	yb yt jp
音乐课	yb le ke
音乐课	yb yt ke
音像	yb xl
音响	yb xl
音域	yb yu
音容笑貌	yb rs xn mc
音箱	yb xl
音色	yb se
音质	yb vi
音速	yb su
音阶	yb jp
音韵	yb yy
页码	ye ma
顶住	dk vu
顶你个肺	dk ni ge fw
顶唔顺	dk wu uy
顶档	dk dh
顶点	dk dm
顶牛	dk nq
顶硬上	dk yk uh
顶笼	dk ls
顶肚	dk du
顶趾	dk vi
顶颈	dk gg
顶颈	dk jk
顶风	dk fg
顷刻	qk ke
顷刻之间	qk ke vi jm
项羽	xl yu
顺义	uy yi
顺口溜	uy kz lq
顺延	uy yj
顺摊	uy tj
顺治	uy vi
须眉茭白	xu mw jn bd
顽固派	wj gu pd
顽症	wj vg
顾住	gu vu
顾全	gu qr
顾及	gu ji
顾忌	gu ji
预付款	yu fu kr
预制	yu vi
预制板	yu vi bj
预备役	yu bw yi
预备队	yu bw dv
预委会	yu ww hv
预委会	yu ww kk
预审	yu uf
预展	yu vj
预应力	yu yk li
预支	yu vi
预演	yu yj
预热	yu re
预示	yu ui
预科	yu ke
预置	yu vi
预见	yu jm
预见性	yu jm xk
预言	yu yj
预订	yu dk
预购	yu gz
颅骨	lu gu
领事	lk ui
领事馆	lk ui gr
领养	lk yh
领到	lk dc
领受	lk uz
领嘢	lk ye
领太	lk td
领袖生	lk xq ug
领路	lk lu
颇为	po ww
颈渴	gg ke
颈渴	jk ke
颈都长	gg du ih
颈都长	gg du vh
颈都长	gg dz ih
颈都长	gg dz vh
颈都长	jk du ih
颈都长	jk du vh
颈都长	jk dz ih
颈都长	jk dz vh
颈链	gg lm
颈链	jk lm
颉颃	xp hh
颐和园	yi he yr
频带	pb dd
频频扑扑	pb pb pu pu
颓势	tv ui
题写	ti xp
题名	ti mk
题字	ti zi
题诗	ti ui
题跋	ti ba
题辞	ti ci
颙颙	ys ys
颜体	yj ti
颜真卿	yj vf qk
额定	ee dk
颞颥	np ru
颟顸	mj hj
颠簸	dm bo
颠覆	dm fu
颤巍巍	ij ww ww
风云	fg yy
风云人物	fg yy rf wu
风云变幻	fg yy bm hr
风俗画	fg su hx
风凉水冷	fg ll uv lg
风势	fg ui
风化	fg hx
风口	fg kz
风吹日晒	fg iv ri ud
风声	fg ug
风头火势	fg tz ho ui
风头趸	fg tz dy
风姿	fg zi
风帆	fg fj
风扫落叶	fg sc la xp
风扫落叶	fg sc la ye
风扫落叶	fg sc lc xp
风扫落叶	fg sc lc ye
风扫落叶	fg sc lo xp
风扫落叶	fg sc lo ye
风景区	fg jk qu
风景如画	fg jk ru hx
风景画	fg jk hx
风机	fg ji
风水佬	fg uv lc
风沙	fg ua
风油轪	fg yz dd
风洞	fg ds
风湿病	fg ui bk
风箱	fg xl
风蚀	fg ui
风行	fg xk
风速	fg su
风雪交加	fg xt jn jx
风风火火	fg fg ho ho
风风雨雨	fg fg yu yu
风驰电掣	fg ii dm ie
风骨峭峻	fg gu qn jy
飒爽英姿	sa ul yk zi
飘浮	pn fu
飘渺	pn mn
飞发	fw fa
飞向	fw xl
飞士	fw ui
飞擒大咬	fw qb da yc
飞擒大咬	fw qb dd yc
飞机场	fw ji ih
飞机师	fw ji ui
飞机恤	fw ji xu
飞机票	fw ji pn
飞来蜢	fw ld mg
飞毛腿	fw mc tv
飞水	fw uv
飞站	fw vj
飞腾	fw tg
飞舞	fw wu
飞蛾扑火	fw ee pu ho
飞行器	fw xk qi
飞象过河	fw xl go he
飞越	fw yt
食不重味	si bu is ww
食不重味	si bu vs ww
食不重味	ui bu is ww
食不重味	ui bu vs ww
食不重味	yi bu is ww
食不重味	yi bu vs ww
食价	si jp
食价	si jx
食价	ui jp
食价	ui jx
食价	yi jp
食价	yi jx
食品	ui pb
食塞米	si sd mi
食塞米	si se mi
食塞米	ui sd mi
食塞米	ui se mi
食塞米	yi sd mi
食塞米	yi se mi
食客	ui ke
食宿	ui su
食得咸鱼抵得渴	si de xm yu di de ke
食得咸鱼抵得渴	si de xm yu di dw ke
食得咸鱼抵得渴	si dw xm yu di de ke
食得咸鱼抵得渴	si dw xm yu di dw ke
食得咸鱼抵得渴	ui de xm yu di de ke
食得咸鱼抵得渴	ui de xm yu di dw ke
食得咸鱼抵得渴	ui dw xm yu di de ke
食得咸鱼抵得渴	ui dw xm yu di dw ke
食得咸鱼抵得渴	yi de xm yu di de ke
食得咸鱼抵得渴	yi de xm yu di dw ke
食得咸鱼抵得渴	yi dw xm yu di de ke
食得咸鱼抵得渴	yi dw xm yu di dw ke
食拖鞋饭	si to xp fj
食拖鞋饭	ui to xp fj
食拖鞋饭	yi to xp fj
食晏	si yj
食晏	ui yj
食晏	yi yj
食柠檬	si nk mg
食柠檬	ui nk mg
食柠檬	yi nk mg
食死猫	si si mc
食死猫	ui si mc
食死猫	yi si mc
食水深	si uv uf
食水深	ui uv uf
食水深	yi uv uf
食油	ui yz
食物链	ui wu lm
食猫面	si mc mm
食猫面	ui mc mm
食猫面	yi mc mm
食生菜	si ug cd
食生菜	ui ug cd
食生菜	yi ug cd
食用	ui ys
食白果	si bd go
食白果	ui bd go
食白果	yi bd go
食皇家饭	si hl jx fj
食皇家饭	ui hl jx fj
食皇家饭	yi hl jx fj
食盐	ui yj
食碗面反碗底	si wj mm fj wj di
食碗面反碗底	ui wj mm fj wj di
食碗面反碗底	yi wj mm fj wj di
食管	ui gr
食粮	ui ll
食糊	si hu
食糊	ui hu
食糊	yi hu
食糖	ui th
食经	si jk
食经	ui jk
食经	yi jk
食螺蛳	si lo si
食螺蛳	ui lo si
食螺蛳	yi lo si
食言	ui yj
食诈糊	si va hu
食诈糊	ui va hu
食诈糊	yi va hu
食谷种	si gu is
食谷种	si gu vs
食谷种	ui gu is
食谷种	ui gu vs
食谷种	yi gu is
食谷种	yi gu vs
食道	ui dc
食量	ui ll
餐馆	cj gr
饥民	ji mb
饥馑	ji jb
饭焦	fj jn
饭糗茹草	fj qq ru cc
饭钱	fj qm
饭铲头	fj ij tz
饭锅	fj go
饮冰茹檗	yb bk ru bo
饮品	yb pb
饮得杯落	yb de bw la
饮得杯落	yb de bw lc
饮得杯落	yb de bw lo
饮得杯落	yb dw bw la
饮得杯落	yb dw bw lc
饮得杯落	yb dw bw lo
饮片	yb pm
饮用	yb ys
饮用水	yb ys uv
饮胜	yb ug
饮衫	yb uj
饰演	ui yj
饰物	ui wu
饱死	bc si
饲养员	si yh yr
饲草	si cc
饸饹	he ge
饸饹	he le
饼印	bk yb
饼咭	bk ji
饼咭	bk ka
饼家	bk jx
饽饽	bo bo
饿过饥	ee go ji
馆内	gr nw
馉饳	gu do
首例	uz li
首倡	uz ih
首家	uz jx
首富	uz fu
首尾	uz ww
首府	uz fu
首张	uz vh
首日封	uz ri fg
首款	uz kr
首演	uz yj
首长	uz vh
香口胶	xl kz jn
香喷喷	xl pf pf
香椿	xl iy
香槟酒	xl bb jq
香气	xl qi
香油	xl yz
香炉趸	xl lu dy
香瓜	xl gx
香菜	xl cd
香蕉	xl jn
香车宝马	xl ie bc ma
香车宝马	xl ju bc ma
馨香	xb xl
马丁	ma dk
马克思	ma ke si
马刀	ma dc
马勒	ma le
马勒	ma lw
马匹	ma pi
马可尼	ma ke ni
马头琴	ma tz qb
马德里	ma de li
马放南山	ma fh nj uj
马死落地行	ma si la de hh
马死落地行	ma si la de xk
马死落地行	ma si la di hh
马死落地行	ma si la di xk
马死落地行	ma si lc de hh
马死落地行	ma si lc de xk
马死落地行	ma si lc di hh
马死落地行	ma si lc di xk
马死落地行	ma si lo de hh
马死落地行	ma si lo de xk
马死落地行	ma si lo di hh
马死落地行	ma si lo di xk
马灯	ma dg
马王堆	ma wh dv
马赛	ma sd
马赛克	ma sd ke
马蹄粉	ma ti ff
马里	ma li
马铃薯	ma lk uu
马革裹尸	ma ge go ui
驯养	xy yh
驯化	xy hx
驯品	xy pb
驰驱	ii qu
驱使	qu ui
驱逐舰	qu vu jm
驱除	qu iu
驳倒	bo dc
驳嘴	bo zv
驳骨	bo gu
驶入	ui ru
驻伊	vu yi
驻守	vu uz
驻沪	vu hu
驻防	vu fh
驾驶员	jx ui yr
驾驶室	jx ui ui
驾驶舱	jx ui ch
骁勇善战	xn ys uj vj
骁将	xn jl
骂名	ma mk
骄阳	jn yh
骄阳似火	jn yh si ho
骅骝	hx lq
骈体	pm ti
骋骛	ig wu
验光	yj gl
验方	yj fh
验货	yj ho
骎骎	qb qb
骐骝	qi lq
骐骥	qi ji
骑咧	qi lp
骑士	qi ui
骑手	qi uz
骑膊马	qi bo ma
骑车	qi ie
骑马	qi ma
骙骙	kv kv
骟鸡	uj ji
骡马	lo ma
骤变	vz bm
骤起	vz qi
骨刺	gu ci
骨朵	gu do
骨架	gu jx
骨灰盒	gu hv he
骨痹	gu bi
骨碌	gu lu
骨科	gu ke
骨骼	gu ge
髑髅	du lz
高个	gc ge
高个子	gc ge zi
高举	gc ju
高义薄云	gc yi bc yy
高义薄云	gc yi bo yy
高争鞋	gc vg xp
高产田	gc ij tm
高低杠	gc di gh
高出	gc iu
高分子	gc ff zi
高利	gc li
高利贷	gc li dd
高加索	gc jx so
高升	gc ug
高危	gc ww
高压	gc ya
高压电	gc ya dm
高压锅	gc ya go
高地	gc di
高坡	gc po
高墙	gc ql
高寒	gc hj
高寿	gc uz
高射炮	gc ue pc
高小	gc xn
高山族	gc uj zu
高山景行	gc uj jk hh
高山景行	gc uj jk xk
高山深涧悬崖峭壁	gc uj uf jm xr ya qn bi
高情远致	gc qk yr vi
高手如林	gc uz ru lb
高技术	gc ji uu
高效益	gc xn yi
高教	gc jn
高新	gc xb
高材生	gc cd ug
高校	gc xn
高楼大厦	gc lz da ua
高歌猛进	gc ge mg jb
高洁	gc jp
高清	gc qk
高炉	gc lu
高热	gc re
高盛	gc ig
高盛	gc ug
高祖	gc zu
高窦	gc dz
高等教育	gc dg jn yu
高管	gc gr
高纬度	gc ww du
高耸入云崇山峻岭	gc ss ru yy is uj jy lk
高见	gc jm
高超	gc ic
高足	gc zu
高踭鞋	gc vg xp
高达	gc da
高通	gc ts
高速	gc su
高高低低	gc gc di di
髢髢	di di
髽髻	vx ji
鬼五马六	gv wu ma lq
鬼五马六	gv wu ma lu
鬼咁	gv gj
鬼头仔	gv tz zd
鬼头仔	gv tz zi
鬼子	gv zi
鬼打鬼	gv da gv
鬼杀咁嘈	gv ua gj cc
鬼话	gv hx
鬼鬼鼠鼠	gv gv uu uu
鬼鼠	gv uu
魍魉	wh ll
魏碑	ww bw
魑魅	ii mw
魔兽	mo uz
魔戒	mo jp
鱼云	yu yy
鱼栏	yu lj
鱼水情	yu uv qk
鱼池	yu ii
鱼群	yu qy
鱼虾	yu xx
鱼跃鸟飞	yu yt dn fw
鱼跃鸟飞	yu yt nn fw
鱼雷	yu lw
鱼露	yu lu
鱼露	yu lz
鱼鳞	yu lb
鱿鱼	yz yu
鲍勃	bc bo
鲍勃	bc bw
鲍威尔	bc ww er
鲍肆	bc si
鲜卑	xm bw
鲜嫩水灵	xm nf uv lk
鲜果	xm go
鲜菜	xm cd
鲜鱼	xm yu
鲜鲍	xm bc
鲤鱼	li yu
鲩鱼	hr yu
鲫鱼	ji yu
鲯鳅	qi qq
鳝鱼	uj yu
鸟尽弓藏	nn jb gs ch
鸟语蝉鸣	dn yu ij mk
鸟语蝉鸣	nn yu ij mk
鸟飞兔走	dn fw tu zz
鸟飞兔走	nn fw tu zz
鸡乸	ji na
鸡仔	ji zd
鸡仔	ji zi
鸡仔媒人	ji zd mw rf
鸡仔媒人	ji zi mw rf
鸡啄唔断	ji vo wu dr
鸡手鸭脚	ji uz ya jn
鸡毛扫	ji mc sc
鸡毛鸭血	ji mc ya xp
鸡毛鸭血	ji mc ya xt
鸡泡鱼	ji pc yu
鸡犬不惊	ji qr bu jk
鸡皮纸	ji pi vi
鸡碎咁多	ji sv gj do
鸡红	ji hs
鸡肉	ji rz
鸡肠	ji ih
鸡脾	ji pi
鸡脾锤	ji pi iv
鸡舍	ji ue
鸡雏	ji iu
鸡项	ji xl
鸡食放光草心知肚明	ji si fh gl cc xb vi du mk
鸡食放光草心知肚明	ji ui fh gl cc xb vi du mk
鸡食放光草心知肚明	ji yi fh gl cc xb vi du mk
鸡鸣而起	ji mk er qi
鸣金收兵	mk jb uz bk
鸧鹒	ch gg
鸭仔团	ya zd tr
鸭仔团	ya zi tr
鸭梨	ya li
鸱鸺	ii xq
鸲鹆	qu yu
鸸鹋	li mn
鸺鹠	xq lq
鸽子	ge zi
鸿海	hs hd
鸿雁	hs yj
鸿鹄之志	hs hu vi vi
鹅卵石	ee lr ui
鹊局	qt ju
鹊巢鸠占	qt ic jq vj
鹍鹏	ky pg
鹘突	gu tu
鹘突	hu tu
鹘鸼	gu vz
鹘鸼	hu vz
鹣鲽	jm dp
鹤发鸡皮	he fa ji pi
鹤壁	he bi
鹤鸣之士	he mk vi ui
鹦鹉学舌	yk wu xt ue
鹪鹩	jn ln
麝香	ue xl
麦收	md uz
麦浪	md lh
麦田	md tm
麦秸	md jp
麦苗	md mn
麻利	ma li
麻布	ma bu
麻甩佬	ma uk lc
麻绳	ma ug
麻醉品	ma zv pb
麻雀脚	ma qt jn
麻雀虽小五脏俱全	ma qt sv xn wu zh ju qr
麻雀馆	ma qt gr
麻风	ma fg
麻鹰	ma yk
麻麻地	ma ma de
麻麻地	ma ma di
黄土地	hl tu di
黄埔	hl pu
黄帝	hl di
黄庭坚	hl tk jm
黄梅戏	hl mw xi
黄澄澄	hl dg dg
黄灿灿	hl cj cj
黄疸	hl dj
黄石	hl dj
黄石	hl ui
黄禽禽	hl qb qb
黄绿医生	hl lu yi ug
黄绿医生	hl lv yi ug
黄肿脚	hl vs jn
黄脚鸡	hl jn ji
黄花	hl hx
黄褐色	hl he se
黄酒	hl jq
黄金时代	hl jb ui dd
黄面婆	hl mm po
黄页	hl ye
黄鳝	hl uj
黎巴嫩	li ba nf
黎族	li zu
黎民	li mb
黐孖筋	ii ma jb
黐孖筋	ii zi jb
黐家	ii jx
黐牙	ii ya
黐线	ii xm
黐脷筋	ii li jb
黐黐地	ii ii de
黐黐地	ii ii di
黑乎乎	hw hu hu
黑匣子	hw xx zi
黑压压	hw ya ya
黑口黑面	hw kz hw mm
黑古勒特	hw gu le te
黑古勒特	hw gu lw te
黑土	hw tu
黑孖孖	hw ma ma
黑孖孖	hw ma zi
黑孖孖	hw zi ma
黑孖孖	hw zi zi
黑山	hw uj
黑手党	hw uz dh
黑斑	hw bj
黑板报	hw bj bc
黑洞洞	hw ds ds
黑猩猩	hw xk xk
黑瞇擝	hw mi mg
黑社会	hw ue hv
黑箱车	hw xl ie
黑箱车	hw xl ju
黑红	hw hs
黑色素	hw se su
黑豆	hw dz
黑过墨斗	hw go mo dz
黑霉	hw mw
黑麻麻	hw ma ma
黑黝黝	hw yz yz
黑龙江省	hw ls jl ug
黪黩	cj du
鼎立	dk li
鼓动	gu ds
鼓劲	gu jb
鼓手	gu uz
鼓掌	gu vh
鼓起	gu qi
鼓鼓囊囊	gu gu nh nh
鼠害	uu hd
鼠摸	uu mo
鼠窃狗盗	uu qp gz dc
鼻哥窿	bi ge ls
鼾声	hj ug
齐刷刷	qi ux ux
齐名	qi mk
齐国	qi go
齐头数	qi tz uu
齐步走	qi bu zz
齐白石	qi bd ui
齐缉缉	qi ji ji
齐葺葺	qi qi qi
齐集	qi ji
齐鲁	qi lu
齐鸣	qi mk
龂龂	kf kf
龂龂	kf yb
龂龂	yb kf
龂龂	yb yb
龃龆	ju tn
龋齿	qu ii
龙井茶	ls jk ia
龙卷风	ls jr fg
龙山	ls uj
龙文	ls wf
龙江	ls jl
龙腾虎跃	ls tg hu yt
龙芯	ls xb
龙跃凤鸣	ls yt fg mk
龙钟	ls vs
龙骧虎步	ls xl hu bu