啊	a
阿	aa
愛	ai
安	an
奧	ao
不	b
把	ba
濱	bb
報	bc
白	bd
本	bf
蹦	bg
幫	bh
比	bi
辦	bj
並	bk
邊	bm
表	bn
撥	bo
別	bp
部	bu
被	bw
才	c
擦	ca
草	cc
菜	cd
測	ce
傖	cf
曾	cg
藏	ch
次	ci
參	cj
錯	co
竄	cr
從	cs
粗	cu
催	cv
湊	cz
的	d
大	da
到	dc
代	dd
得	de
等	dg
當	dh
地	di
但	dj
定	dk
點	dm
調	dn
多	do
跌	dp
丟	dq
段	dr
動	ds
讀	du
對	dv
得	dw
都	dz
二	e
誒	ei
恩	en
非	f
法	fa
風	fg
反	fj
佛	fo
副	fu
費	fw
否	fz
個	g
嘎	ga
高	gc
該	gd
各	ge
跟	gf
更	gg
剛	gh
幹	gj
怪	gk
光	gl
過	go
關	gr
共	gs
古	gu
貴	gv
給	gw
夠	gz
和	h
哈	ha
好	hc
還	hd
何	he
很	hf
橫	hg
行	hh
含	hj
壞	hk
黃	hl
或	ho
換	hr
紅	hs
戶	hu
會	hv
黑	hw
後	hz
出	i
差	ia
超	ic
拆	id
車	ie
陳	if
成	ig
長	ih
吃	ii
產	ij
揣	ik
窗	il
戳	io
傳	ir
衝	is
處	iu
吹	iv
抽	iz
就	j
進	jb
幾	ji
經	jk
將	jl
間	jm
叫	jn
接	jp
窘	js
據	ju
加	jx
均	jy
可	k
卡	ka
靠	kc
開	kd
科	ke
肯	kf
坑	kg
抗	kh
看	kj
快	kk
況	kl
擴	ko
寬	kr
空	ks
酷	ku
虧	kv
尅	kw
口	kz
了	l
拉	la
林	lb
老	lc
來	ld
樂	le
冷	lg
浪	lh
裡	li
另	lk
兩	ll
連	lm
料	ln
落	lo
列	lp
劉	lq
亂	lr
龍	ls
路	lu
率	lv
類	lw
論	ly
樓	lz
沒	m
嗎	ma
民	mb
毛	mc
買	md
麼	me
們	mf
夢	mg
米	mi
慢	mj
明	mk
面	mm
末	mo
滅	mp
目	mu
每	mw
某	mz
你	n
那	na
您	nb
鬧	nc
呢	ne
嫩	nf
能	ng
囊	nh
泥	ni
難	nj
寧	nk
娘	nl
年	nm
鳥	nn
挪	no
捏	np
牛	nq
暖	nr
弄	ns
虐	nt
怒	nu
女	nv
內	nw
哦	o
嗯	og
嘸	om
喔	oo
歐	ou
平	p
怕	pa
品	pb
跑	pc
排	pd
盆	pf
碰	pg
旁	ph
批	pi
盤	pj
憑	pk
片	pm
票	pn
破	po
撇	pp
普	pu
配	pw
剖	pz
去	q
親	qb
其	qi
請	qk
強	ql
前	qm
橋	qn
且	qp
求	qq
全	qr
窮	qs
卻	qt
區	qu
恰	qx
群	qy
人	r
繞	rc
熱	re
任	rf
仍	rg
讓	rh
日	ri
然	rj
若	ro
軟	rr
容	rs
如	ru
肉	rz
三	s
撒	sa
掃	sc
賽	sd
色	se
森	sf
僧	sg
桑	sh
四	si
散	sj
所	so
算	sr
送	ss
蘇	su
歲	sv
搜	sz
他	t
她	ta
套	tc
太	td
特	te
騰	tg
湯	th
體	ti
談	tj
聽	tk
天	tm
調	tn
託	to
貼	tp
團	tr
同	ts
圖	tu
頭	tz
是	u
傻	ua
少	uc
曬	ud
設	ue
深	uf
生	ug
上	uh
時	ui
山	uj
帥	uk
雙	ul
說	uo
拴	ur
數	uu
水	uv
誰	uw
刷	ux
順	uy
受	uz
這	v
扎	va
找	vc
著	ve
真	vf
正	vg
長	vh
只	vi
佔	vj
拽	vk
裝	vl
桌	vo
轉	vr
中	vs
主	vu
追	vv
周	vz
我	w
挖	wa
外	wd
王	wh
完	wj
握	wo
無	wu
為	ww
小	x
新	xb
系	xi
行	xk
想	xl
先	xm
笑	xn
些	xp
修	xq
選	xr
凶	xs
學	xt
需	xu
下	xx
一	y
亞	ya
因	yb
要	yc
也	ye
樣	yh
以	yi
言	yj
應	yk
喲	yo
元	yr
用	ys
月	yt
與	yu
雲	yy
有	yz
在	z
雜	za
早	zc
再	zd
則	ze
怎	zf
增	zg
藏	zh
字	zi
做	zo
總	zs
組	zu
最	zv
賊	zw
走	zz

#简码词
安放	af
愛護	ah
安靜	aj
拗口	ak
案例	a;
澳門	am
安排	ap
安全	aq
愛人	ar
暗算	as
凹凸	at
暗示	au
安裝	av
安慰	aw
愛心	ax
安逸	ay
暗自	az
保留	b;
本來	bl
並且	bq
不然	br
比賽	bs
標準	bv
必須	bx
不要	by
參考	ck
從來	cl
層面	cm
才能	cn
存盤	cp
從前	cq
從頭	ct
此外	cw
錯誤	c;
才行	cx
採用	cy
代表	db
地方	df
到了	d;
帶來	dl
代替	dt
東西	dx
第一	dy
恩賜	ec
而非	ef
而且	e;
而已	ey
而言	ey
兒子	ez
分別	fb
服從	fc
諷刺	fc
反對	fd
反而	fe
方法	ff
返回	f;
非常	fi
分開	fk
法律	fl
方面	fm
煩惱	fn
分配	fp
放棄	fq
否認	fr
放鬆	fs
繁體	ft
反正	fv
發現	fx
反應	fy
根本	gb
過程	gi
幹嘛	gm
功能	gn
股票	gp
過去	gq
溝通	gt
更新	g;
關於	gy
何必	hb
好處	hi
號碼	h;
湖南	hn
害怕	hp
回去	hq
後天	ht
互相	hx
歡迎	hy
成本	ib
充滿	im
承諾	in
產品	i;
重啟	iq
衝突	it
成為	iw
出現	ix
成員	iy
驕傲	ja
精彩	jc
簡單	jd
金額	je
解放	jf
結果	jg
幾乎	jh
解決	j;
奇偶	jo
及其	jq
加入	jr
今天	jt
簡直	jv
幾位	jw
節奏	jz
恐怖	kb
看出	ki
科目	km
可能	kn
恐怕	kp
況且	kq
開通	kt
科學	kx
可以	k;
浪費	lf
瞭解	l;
論壇	lt
聯繫	lx
漫畫	mh
目錄	ml
默認	m;
貌似	ms
明天	mt
每天	mt
每週	mv
每年	mn
明顯	mx
難道	nd
那些	n;
偶爾	oe
歐陸	ol
偶然	o;
嘔吐	ot
偶像	ox
歐陽	oy
普洱	pe
配額	pe
脾氣	pq
騙人	pr
破碎	ps
平臺	pt
普通	pt
配置	pv
培訓	px
排序	p;
前後	qh
期間	qj
其中	q;
前往	qw
千萬	qw
認可	rk
人類	rl
人們	rm
熱鬧	rn
人品	rp
日期	r;
如同	rt
認為	rw
思考	sk
算了	sl
什麼	sm
隨你	sn
索賠	sp
所謂	sw
思想	sx
搜尋	sx
所以	sy
似乎	s;
討論	tl
天天	tt
統一	ty
順便	ub
事情	uq
神色	us
身體	ut
準備	v;
這麼	vm
指南	vn
照片	vp
中心	vx
這樣	vy
為此	wc
無法	wf
完成	wi
唯恐	wk
為了	wl
網絡	w;
我們	wm
無奈	wn
未能	wn
網盤	wp
完全	wq
無私	ws
問題	wt
唯一	wy
西安	xa
下次	xc
相當	xd
喜歡	xh
現金	xj
西歐	xo
協助	xv
現在	x;
一定	yd
月份	yf
應該	yg
要求	yq
一直	yv
因為	yw
一下	yx
應用	y;
總部	z;
自己	zj
走開	zk
走了	zl
怎麼	zm
怎能	zn
作品	zp
最新	zx

#算法不好處理的簡碼字
詞	ciy
