啊	a
阿	aa
安放	af
爱护	ah
爱	ai
安静	aj
拗口	ak
案例	al
澳门	am
安	an
奥	ao
安排	ap
安全	aq
爱人	ar
暗算	as
凹凸	at
暗示	au
安装	av
安慰	aw
爱心	ax
安逸	ay
暗自	az
不	b
把	ba
滨	bb
报	bc
白	bd
本	bf
蹦	bg
帮	bh
比	bi
办	bj
并	bk
保留	bl
本来	bl
边	bm
表	bn
拨	bo
别	bp
并且	bq
不然	br
比赛	bs
部	bu
标准	bv
被	bw
必须	bx
不要	by
才	c
擦	ca
草	cc
菜	cd
测	ce
伧	cf
曾	cg
藏	ch
次	ci
参	cj
参考	ck
从来	cl
层面	cm
才能	cn
错	co
存盘	cp
从前	cq
窜	cr
从	cs
从头	ct
粗	cu
催	cv
此外	cw
错误	cw
才行	cx
村	cy
采用	cy
凑	cz
的	d
大	da
代表	db
到	dc
代	dd
得	de
地方	df
等	dg
当	dh
地	di
但	dj
定	dk
到了	dl
带来	dl
点	dm
调	dn
多	do
跌	dp
丢	dq
段	dr
动	ds
代替	dt
读	du
对	dv
得	dw
东西	dx
第一	dy
都	dz
二	e
恩赐	ec
而非	ef
诶	ei
恩	en
而且	eq
而已	ey
而言	ey
儿子	ez
非	f
法	fa
分别	fb
服从	fc
讽刺	fc
反对	fd
反而	fe
方法	ff
风	fg
放	fh
返回	fh
非常	fi
反	fj
分开	fk
法律	fl
方面	fm
烦恼	fn
佛	fo
分配	fp
放弃	fq
否认	fr
放松	fs
繁体	ft
副	fu
反正	fv
费	fw
发现	fx
反应	fy
否	fz
个	g
嘎	ga
根本	gb
高	gc
该	gd
各	ge
跟	gf
更	gg
刚	gh
过程	gi
干	gj
怪	gk
光	gl
干嘛	gm
功能	gn
过	go
股票	gp
过去	gq
关	gr
共	gs
沟通	gt
古	gu
贵	gv
给	gw
更新	gx
关于	gy
滚	gy
够	gz
和	h
哈	ha
何必	hb
好	hc
还	hd
何	he
很	hf
横	hg
行	hh
好处	hi
含	hj
坏	hk
黄	hl
号码	hm
湖南	hn
或	ho
害怕	hp
回去	hq
换	hr
红	hs
后天	ht
户	hu
会	hv
黑	hw
互相	hx
欢迎	hy
后	hz
出	i
差	ia
成本	ib
超	ic
拆	id
车	ie
陈	if
成	ig
长	ih
吃	ii
产	ij
揣	ik
窗	il
充满	im
承诺	in
戳	io
产品	ip
重启	iq
传	ir
冲	is
冲突	it
处	iu
吹	iv
成为	iw
出现	ix
成员	iy
抽	iz
就	j
骄傲	ja
进	jb
精彩	jc
简单	jd
金额	je
解放	jf
结果	jg
几乎	jh
几	ji
解决	jj
经	jk
将	jl
间	jm
叫	jn
奇偶	jo
接	jp
久	jq
及其	jq
加入	jr
卷	jr
窘	js
今天	jt
据	ju
简直	jv
几位	jw
加	jx
均	jy
节奏	jz
可	k
卡	ka
恐怖	kb
靠	kc
开	kd
科	ke
肯	kf
坑	kg
抗	kh
看出	ki
看	kj
快	kk
况	kl
科目	km
可能	kn
扩	ko
恐怕	kp
况且	kq
宽	kr
空	ks
开通	kt
酷	ku
亏	kv
尅	kw
夸	kx
科学	kx
可以	ky
口	kz
了	l
拉	la
林	lb
老	lc
来	ld
乐	le
浪费	lf
冷	lg
浪	lh
里	li
了解	lj
另	lk
两	ll
连	lm
料	ln
落	lo
列	lp
刘	lq
乱	lr
龙	ls
论坛	lt
路	lu
率	lv
类	lw
联系	lx
论	ly
楼	lz
没	m
吗	ma
民	mb
毛	mc
买	md
么	me
们	mf
梦	mg
漫画	mh
米	mi
慢	mj
明	mk
目录	ml
面	mm
每年	mn
秒	mn
末	mo
灭	mp
默认	mr
貌似	ms
明天	mt
每天	mt
目	mu
每周	mv
每	mw
明显	mx
某	mz
你	n
那	na
您	nb
闹	nc
难道	nd
呢	ne
嫩	nf
能	ng
囊	nh
泥	ni
难	nj
宁	nk
娘	nl
年	nm
鸟	nn
挪	no
捏	np
牛	nq
暖	nr
弄	ns
虐	nt
怒	nu
女	nv
内	nw
那些	nx
哦	o
偶尔	oe
嗯	og
欧陆	ol
呒	om
喔	oo
偶然	or
呕吐	ot
欧	ou
偶像	ox
欧阳	oy
平	p
怕	pa
品	pb
跑	pc
排	pd
普洱	pe
配额	pe
盆	pf
碰	pg
旁	ph
批	pi
盘	pj
凭	pk
片	pm
票	pn
破	po
撇	pp
脾气	pq
骗人	pr
破碎	ps
平台	pt
普通	pt
普	pu
配置	pv
配	pw
培训	px
剖	pz
去	q
亲	qb
前后	qh
其	qi
期间	qj
请	qk
强	ql
前	qm
桥	qn
且	qp
求	qq
全	qr
穷	qs
却	qt
区	qu
其中	qv
前往	qw
千万	qw
恰	qx
群	qy
人	r
绕	rc
热	re
任	rf
仍	rg
让	rh
日	ri
然	rj
认可	rk
人类	rl
人们	rm
热闹	rn
若	ro
人品	rp
日期	rq
软	rr
容	rs
如同	rt
如	ru
认为	rw
肉	rz
三	s
撒	sa
扫	sc
赛	sd
色	se
森	sf
僧	sg
桑	sh
四	si
散	sj
思考	sk
算了	sl
什么	sm
随你	sn
所	so
索赔	sp
算	sr
送	ss
苏	su
岁	sv
所谓	sw
思想	sx
搜寻	sx
所以	sy
搜	sz
他	t
她	ta
套	tc
太	td
特	te
腾	tg
汤	th
体	ti
谈	tj
听	tk
讨论	tl
天	tm
调	tn
托	to
贴	tp
团	tr
同	ts
天天	tt
图	tu
统一	ty
头	tz
是	u
傻	ua
顺便	ub
少	uc
晒	ud
设	ue
深	uf
生	ug
上	uh
时	ui
山	uj
帅	uk
双	ul
说	uo
事情	uq
拴	ur
神色	us
身体	ut
数	uu
水	uv
谁	uw
刷	ux
顺	uy
受	uz
这	v
扎	va
准备	vb
找	vc
着	ve
真	vf
正	vg
长	vh
只	vi
占	vj
拽	vk
装	vl
这么	vm
指南	vn
桌	vo
照片	vp
转	vr
中	vs
主	vu
追	vv
中心	vx
这样	vy
周	vz
我	w
挖	wa
为此	wc
外	wd
无法	wf
王	wh
完成	wi
完	wj
唯恐	wk
为了	wl
网络	wl
我们	wm
无奈	wn
未能	wn
握	wo
网盘	wp
完全	wq
无私	ws
问题	wt
无	wu
为	ww
唯一	wy
小	x
西安	xa
新	xb
下次	xc
相当	xd
喜欢	xh
系	xi
现金	xj
行	xk
想	xl
先	xm
笑	xn
西欧	xo
些	xp
修	xq
选	xr
凶	xs
学	xt
需	xu
协助	xv
下	xx
现在	xz
一	y
亚	ya
因	yb
要	yc
一定	yd
也	ye
月份	yf
应该	yg
样	yh
以	yi
言	yj
应	yk
哟	yo
要求	yq
元	yr
用	ys
月	yt
与	yu
一直	yv
因为	yw
一下	yx
云	yy
有	yz
在	z
杂	za
总部	zb
早	zc
再	zd
则	ze
怎	zf
增	zg
藏	zh
字	zi
自己	zj
走开	zk
走了	zl
怎么	zm
怎能	zn
做	zo
作品	zp
总	zs
组	zu
最	zv
贼	zw
最新	zx
走	zz