安放	af
爱护	ah
安静	aj
拗口	ak
案例	a;
澳门	am
安排	ap
安全	aq
爱人	ar
暗算	as
凹凸	at
暗示	au
安装	av
安慰	aw
爱心	ax
安逸	ay
暗自	az
保留	b;
本来	bl
并且	bq
不然	br
比赛	bs
标准	bv
必须	bx
不要	by
参考	ck
从来	cl
层面	cm
才能	cn
存盘	cp
从前	cq
从头	ct
此外	cw
错误	c;
才行	cx
采用	cy
代表	db
地方	df
到了	d;
带来	dl
代替	dt
东西	dx
第一	dy
恩赐	ec
而非	ef
而且	e;
而已	ey
而言	ey
儿子	ez
分别	fb
服从	fc
讽刺	fc
反对	fd
反而	fe
方法	ff
返回	f;
非常	fi
分开	fk
法律	fl
方面	fm
烦恼	fn
分配	fp
放弃	fq
否认	fr
放松	fs
繁体	ft
反正	fv
发现	fx
反应	fy
根本	gb
过程	gi
干嘛	gm
功能	gn
股票	gp
过去	gq
沟通	gt
更新	g;
关于	gy
何必	hb
好处	hi
号码	h;
湖南	hn
害怕	hp
回去	hq
后天	ht
互相	hx
欢迎	hy
成本	ib
充满	im
承诺	in
产品	i;
重启	iq
冲突	it
成为	iw
出现	ix
成员	iy
骄傲	ja
精彩	jc
简单	jd
金额	je
解放	jf
结果	jg
几乎	jh
解决	j;
奇偶	jo
及其	jq
加入	jr
今天	jt
简直	jv
几位	jw
节奏	jz
恐怖	kb
看出	ki
科目	km
可能	kn
恐怕	kp
况且	kq
开通	kt
科学	kx
可以	k;
浪费	lf
了解	l;
论坛	lt
联系	lx
漫画	mh
目录	ml
默认	m;
貌似	ms
明天	mt
每天	mt
每周	mv
每年	mn
明显	mx
难道	nd
那些	n;
偶尔	oe
欧陆	ol
偶然	o;
呕吐	ot
偶像	ox
欧阳	oy
普洱	pe
配额	pe
脾气	pq
骗人	pr
破碎	ps
平台	pt
普通	pt
配置	pv
培训	px
排序	p;
前后	qh
期间	qj
其中	q;
前往	qw
千万	qw
认可	rk
人类	rl
人们	rm
热闹	rn
人品	rp
日期	r;
如同	rt
认为	rw
思考	sk
算了	sl
什么	sm
随你	sn
索赔	sp
所谓	sw
思想	sx
搜寻	sx
所以	sy
似乎	s;
讨论	tl
天天	tt
统一	ty
顺便	ub
事情	uq
神色	us
身体	ut
准备	v;
这么	vm
指南	vn
照片	vp
中心	vx
这样	vy
为此	wc
无法	wf
完成	wi
唯恐	wk
为了	wl
网络	w;
我们	wm
无奈	wn
未能	wn
网盘	wp
完全	wq
无私	ws
问题	wt
唯一	wy
西安	xa
下次	xc
相当	xd
喜欢	xh
现金	xj
西欧	xo
协助	xv
现在	x;
一定	yd
月份	yf
应该	yg
要求	yq
一直	yv
因为	yw
一下	yx
应用	y;
总部	z;
自己	zj
走开	zk
走了	zl
怎么	zm
怎能	zn
作品	zp
最新	zx
