的	bdde
的	bddi
一	aayi
了	vale
了	valn
是	orui
不	adbu
我	pdwo
人	pnrf
在	utzd
这	zwve
这	zwvw
他	rvta
有	uoyz
来	anld
道	zqdc
你	rxni
个	rage
大	anda
大	andd
到	dadc
上	aauh
说	yeuo
说	yeuv
说	yeyt
们	rmmf
着	yovc
着	yove
着	yovo
出	ekiu
中	aavs
地	tvde
地	tvdi
那	evna
就	wdjq
也	vvye
下	adxx
要	xnyc
么	psme
么	psmo
么	psyc
子	vazi
时	ocui
为	ldww
然	hprj
可	dkke
她	nvta
过	zcgo
之	dnvi
以	vryi
看	uokj
会	rshv
会	rskk
得	rcde
得	rcdw
天	adtm
去	tsqu
自	pozi
好	nzhc
心	ddxb
和	hkhe
和	hkho
和	hkhu
没	dymo
没	dymw
能	svng
对	ycdv
后	pkhz
还	zahd
还	zahr
里	aali
里	atli
小	adxn
手	pauz
而	aaer
起	zvqi
只	kbvi
身	ppuf
想	xmxl
都	etdu
都	etdz
头	ddtz
如	nkru
无	avmo
无	avwu
面	aamm
多	pddo
已	vvyi
发	vdfa
事	aaui
生	pfug
知	ukvi
家	bnjx
前	qdqm
声	upug
开	ackd
方	wpfh
经	sgjk
现	wjxm
笑	vdxn
什	ruuf
什	ruui
力	gpli
点	hadm
两	adll
法	dsfa
国	kwgo
样	myyh
所	pjso
成	gvig
意	xlyi
见	kvjm
但	radj
老	tvlc
用	pays
又	vnyz
情	xoqk
于	auyu
当	xedh
动	elds
己	vvji
些	evxp
行	rdhh
行	rdxk
此	vvci
眼	onyj
气	rvqi
把	fvba
回	kkhv
话	ykhx
将	dcjl
真	ubvf
长	pnih
长	pnvh
三	aesj
间	mojm
进	zajb
年	ranm
神	pauf
明	oomk
十	aaui
女	vanv
向	pkxl
定	brdk
正	avvg
实	bdui
本	aabf
很	rnhf
同	kkts
从	rrcs
高	wkgc
问	mkwf
才	apcd
全	rwqr
被	ppbw
被	pppi
主	dwvu
再	aazd
走	trzz
却	euqt
儿	pver
分	bdff
口	aakz
其	qbqi
作	razo
种	hais
种	havs
几	pgji
外	pdwd
打	fdda
最	oyzv
门	dgmf
与	aayu
给	skgw
给	skji
光	xegl
白	pobd
等	vcdg
听	kjtk
因	kdyb
重	pais
重	pavs
少	xpuc
风	jxfg
相	moxl
住	rwvu
次	drci
何	rkhe
让	yarh
色	dvse
色	dvud
二	aaer
公	bsgs
日	kari
怎	xrzf
名	pkmk
死	dvsi
便	rnbm
便	rnpm
位	rlww
部	elbu
果	ango
应	gayk
体	rati
感	xggj
太	ddtd
内	adnw
觉	xjjn
觉	xjjt
水	anuv
先	nexm
难	yfnj
王	atwh
比	avbi
别	dkbp
入	pnru
边	zlbm
第	vpdi
直	uqvi
机	mjji
理	wali
快	xnkk
更	angg
做	rwzo
处	wdiu
者	tove
并	qcbk
接	fnjp
西	aaxi
马	vama
轻	igqk
四	kesi
关	qdgr
山	kauj
月	peyt
放	wffh
连	zilm
加	lkjx
目	kamu
脸	oalm
飞	vdfw
使	rnui
龙	udls
强	gijl
强	giql
张	gnvh
由	aayz
金	rbjb
立	lali
叫	kajn
安	bnan
师	ajui
吧	kvba
剑	drjm
信	rkxb
学	xzxt
军	bijy
望	wwwh
算	vcsr
原	ixyr
美	ydmw
像	rnxl
平	aupk
东	adds
场	tpih
吗	kmma
战	agvj
特	ncte
万	apwj
数	wmuu
云	esyy
清	doqk
今	rvjb
变	wybm
任	rurf
空	bgks
表	fybn
完	bewj
合	rkge
合	rkhe
带	fjdd
常	xjih
量	oall
海	ddhd
受	vyuz
解	jnjp
解	jnxp
文	wxwf
命	remk
转	idvr
斯	qjsi
通	zsts
冷	dslg
思	xtsi
黑	hahw
世	cvui
该	yrgd
双	yyul
利	dhli
至	tavi
非	aafw
林	mmlb
呢	kvne
呢	kvni
新	ljxb
步	vpbu
候	ruhz
五	aawu
李	mzli
度	gydo
度	gydu
虽	kisv
路	zklu
惊	xxjk
微	rwww
跟	zngf
似	rrui
物	npwu
许	yuxu
化	rvhx
制	dpvi
火	drho
性	xfxk
反	pyfj
武	vdwu
总	xbzs
指	fovi
系	psji
系	psxi
结	skjp
花	cvhx
亲	lmqb
亲	lmqk
教	wtjn
功	glgs
刚	dkgh
提	frdi
提	frti
杀	xmua
竟	lejk
士	uaui
远	zeyr
百	abbd
红	sghs
它	bvta
离	wdli
满	ddmj
找	fgvc
落	ckla
落	cklc
落	cklo
容	bkrs
必	dpbi
深	dmuf
城	tvig
拉	flla
奇	dkji
奇	dkqi
若	ckro
各	wkge
失	pnui
尔	dxer
言	wkyj
传	rdir
传	rdvr
且	aaqp
形	apxk
青	foqk
石	akdj
石	akui
干	augj
半	babj
近	zjjb
认	yrrf
怕	xbpa
队	erdv
电	avdm
夫	anfu
往	rwwh
突	bqtu
吃	kgii
啊	kkaa
倒	rddc
活	dkho
件	rnjm
随	ezsv
绝	svjt
刻	dwke
息	xpxi
即	evji
工	aags
早	ouzc
极	mnji
乎	puhu
界	tajp
记	yvji
紧	asjb
怪	xtgk
流	dvlq
报	fybc
车	aaie
车	aaju
管	vkgr
音	loyb
衣	wyyi
保	rmbc
暗	ooan
弟	bpdi
及	pnji
交	wfjn
影	opyk
华	urhx
爱	vyai
精	mojk
伤	rluh
势	lfui
民	vqmb
令	rslk
计	yuji
决	dnjt
玉	wdyu
服	oyfu
条	wmtn
众	rrvs
领	ralk
哥	dkge
南	uunj
般	vybj
元	eeyr
罗	sdlo
收	wvuz
未	anww
始	nkui
办	ldbj
题	oati
星	ofxk
克	ueke
根	mngf
谁	yfuv
谁	yfuw
阵	eivf
则	dbze
象	dnxl
男	tlnj
达	zdda
告	nkgc
展	unvj
击	akji
坐	trzo
灵	ehlk
血	pmxp
血	pmxt
整	avvg
员	bkyr
兵	pbbk
急	xdji
千	puqm
切	qdqp
越	zvyt
喜	ukxi
语	ykyu
站	lkvj
请	yoqk
德	rxde
帮	jfbh
敢	wvgj
消	doxn
业	aaye
姐	nqjp
周	pkvz
视	pjui
字	bzzi
八	pnba
每	rdmw
苦	ckku
房	hffh
忙	xvmh
雷	ytlw
团	kptr
片	pvpm
哪	kena
尽	udjb
书	vduu
备	wtbw
求	adqq
司	gksi
北	avbw
静	fajk
错	joco
断	mjdr
准	dfvy
江	dgjl
刀	gpdc
建	zvjm
兄	kexs
终	sdvs
足	krzu
兴	xbxk
冲	dais
阳	eoyh
代	rddd
或	gaho
楚	mriu
底	gddi
夜	wdye
术	mduu
格	mkge
识	ybui
识	ybvi
持	fcii
答	vkda
哈	kkha
留	tplq
确	ujqt
易	opyi
七	avqi
论	yvly
父	bxfu
拿	runa
程	hwig
阿	ekaa
阿	ekee
害	bkhd
族	fuzu
破	uppo
孩	zrhd
魔	ggmo
官	bkgr
沉	djif
显	oaxm
够	gdgz
宝	bwbc
取	eyqu
单	badj
单	baij
单	bauj
掌	xuvh
务	wlwu
低	rddi
雪	yext
响	kkxl
布	ujbu
市	wjui
摇	ffyc
依	ryyi
久	pnjq
级	snji
首	qouz
运	zeyy
朝	uoic
朝	uovc
待	rcdd
娘	nnnl
客	bkke
统	sets
忽	xghu
速	zasu
复	rwfu
修	rpxq
欢	yqhr
异	vcyi
式	qdui
护	fhhu
爷	feye
况	dekl
脚	oejn
招	fkvc
九	pgjq
集	mrji
区	kxou
区	kxqu
晚	ovwj
铁	jntp
黄	cbhl
友	uyyz
亚	aaya
除	ehiu
钱	jgqm
送	zqss
兰	qelj
联	edlm
政	wavg
义	xdyi
丝	avsi
古	ukgu
六	wblq
六	wblu
器	kkqi
甚	qvuf
照	hovc
基	tqji
闪	mruj
院	eeyr
装	ydvl
居	ukju
产	lpij
呼	kuhu
杨	mpyh
露	yklu
露	yklz
句	gkgz
句	gkju
乱	pvlr
举	xaju
敌	wpdi
斗	dudz
香	hoxl
停	rdtk
台	sktd
群	vyqy
嘴	kjzv
希	xjxi
酒	dyjq
巴	vvba
怀	xdhk
议	ydyi
类	mdlw
支	uyvi
慢	xymj
陈	edif
仙	rexm
段	pydr
调	ykdn
调	yktn
顿	aady
派	dnpd
英	cnyk
喝	kvhe
期	qoqi
威	gnww
另	kllk
府	gcfu
改	wvgd
旁	lfph
资	bdzi
续	sdxu
造	znzc
乐	pdle
乐	pdyt
攻	wggs
左	ugzo
愿	ixyr
围	kaww
疑	pryi
念	xrnm
引	gayb
热	hfre
怒	xnnu
退	zvtv
缓	syhr
线	sgxm
注	dwvu
细	stxi
图	kdtu
背	oabw
需	yaxu
痛	bats
观	yjgr
组	sqzu
雨	adyu
曾	bocg
曾	bozg
约	sdyt
包	gvbc
木	anmu
技	fyji
示	exui
皇	bwhl
据	fkju
差	ygci
差	ygia
差	ygid
设	yyue
密	bemi
谢	ycxp
鬼	psgv
穿	bpir
脑	oknc
赶	zugj
莫	cdmo
丽	adli
品	kkpb
叶	kuxp
叶	kuye
既	vvji
存	uzcy
睛	oojk
宫	bkgs
烈	hdlp
诉	ydsu
追	zpvv
推	fftv
您	xrnb
右	ukyz
商	lkuh
争	davg
角	dajn
角	dajt
淡	dhdj
止	aavi
谈	yhtj
严	aiyj
恶	xaee
恶	xawu
狂	qwkl
挥	fihv
亮	wjll
卫	eaww
闻	mewf
忍	xdrf
态	xdtd
汉	dyhj
继	svji
模	mdmo
模	mdmu
银	jnyb
仍	rprg
跑	zvpc
否	akfz
君	vkjy
妹	nnmw
隐	exyb
母	vdmu
科	huke
凌	dwlk
选	znxr
梦	mdmg
刘	dwlq
寒	bdhj
局	ukju
冰	ddbk
禁	mxjb
境	tejk
掉	fudn
究	bjjq
余	rhyu
查	maia
激	dwji
号	kghc
防	effh
费	bvfw
恐	xgks
楼	mnlz
导	vcdc
肯	vokf
故	wugu
游	dzyz
球	wdqq
树	mcuu
叹	kytj
救	wajq
施	fvui
帝	ljdi
佛	rafo
佛	rafu
简	vojm
料	muln
际	exji
顾	iagu
齐	waqi
抓	fvvx
玩	wewj
猛	qmmg
份	rdff
米	bmmi
仅	ryjb
具	qbju
胜	ofug
治	dkvi
章	luvh
巨	kaju
险	eaxm
守	bcuz
散	wcsj
须	paxu
眉	vomw
抱	fvbc
权	myqr
试	ydui
独	qidu
震	ynvf
索	usso
证	yvvg
礼	pvli
助	qlvu
圣	tyug
股	oygu
跳	zdtn
波	dpbo
负	bdfu
虎	hjhu
练	sdlm
姑	nkgu
唐	gkth
室	tbui
伙	rhho
沙	dpua
妈	nmma
阴	eoyb
称	hxif
称	hxig
投	fytz
柔	smrz
扬	fpyh
规	ajgv
毫	wmhc
温	dmwf
较	ifjn
毒	fddu
耳	aaer
座	gtzo
座	trzo
射	ucue
厉	ipli
层	uscg
副	dafu
担	fadj
参	spcj
参	spuf
置	sqvi
历	illi
初	pdiu
卡	adka
卡	adqx
承	vnig
质	pbvi
属	uduu
属	udvu
渐	djjm
蓝	cmlj
船	vkir
逃	zptc
皮	vypi
药	cdyc
呀	kpya
靠	nakc
充	weis
标	mxbn
坚	tajm
贵	bagv
共	cbgs
赵	zxvc
维	sfww
陆	eklq
陆	eklu
块	tnkk
吸	knxi
刺	daci
堂	txth
醒	yfxk
考	tgkc
松	msss
排	fapd
划	dghx
换	fnhr
河	dkhe
环	wdhr
土	uatu
志	xuvi
责	bfze
致	wavi
压	idya
素	fssu
湖	dohu
睡	oauv
苏	cdsu
京	wxjk
效	wwxn
朋	oopg
宇	buyu
顺	pauy
紫	svzi
伸	rauf
赛	bbsd
超	zkic
忘	xwwh
幸	tuxk
遇	zayu
孙	zxsy
顶	dadk
拍	fbpd
警	ycjk
按	fnan
察	bxia
广	digl
藏	cach
藏	cazh
胡	uohu
秘	hpbi
秘	hpmi
凡	jdfj
型	taxk
尚	xkuh
恩	xken
脱	oeto
营	ckyk
增	tozg
价	rajx
史	anui
节	cejp
秋	hhqq
翻	pyfj
迷	zmmi
州	davz
付	rcfu
项	gaxl
萧	caxn
状	dqvl
尼	uvni
雅	afya
凤	jyfg
秦	fhqb
草	cucc
败	wbbd
著	covc
著	yovc
著	cove
著	yove
著	covo
著	yovo
著	covu
著	yovu
咱	kozj
朱	pnvu
呆	kmdd
封	tcfg
普	qopu
景	oxjk
专	advr
味	knww
舞	rawu
弄	wcns
虚	haxu
毕	uabi
讲	yajl
福	ptfu
纪	svji
握	ftwo
习	gaxi
社	ptue
永	dnys
寻	ecxy
默	hqmo
洞	dkds
控	fgks
骑	mkqi
钟	javs
徐	rhxu
辈	iabw
假	ryjx
病	bnbk
胸	okxs
欲	bqyu
伯	rbbd
伯	rbbo
峰	effg
肉	arrz
岁	edsv
医	kuyi
野	aaye
值	rqvi
职	ebvi
尊	qczy
恨	xnhf
狠	qnhf
田	kutm
魂	eghy
毛	pvmc
免	dvmm
短	uddr
秀	hpxq
麻	gmma
坏	tdhk
印	epyb
良	dnll
迎	zpyk
枪	mvql
弹	gadj
弹	gatj
骨	kogu
探	fmtj
啦	klla
研	ucyj
妖	ndyc
劲	vljb
劲	vljk
临	aalb
宁	bdnk
屋	utwu
案	bman
杰	hmjp
欧	kqou
饭	uyfj
村	mccy
升	pcug
抬	fktd
蒙	cnmg
略	tklt
丹	padj
源	dxyr
纷	sdff
雄	ufxs
烟	hdyj
危	dvww
优	rdyz
写	baxp
床	gmil
罪	sszv
网	kxwh
食	rnsi
食	rnui
食	rnyi
板	mybj
校	mfjn
校	mfxn
某	cmmz
妙	npmn
休	rmxq
珠	wnvu
列	ddlp
盘	mvpj
透	zhtz
春	foiy
委	hnww
移	hdyi
呵	kkhe
偷	rdtz
奥	pdao
吴	kdwu
验	mayj
牙	apya
泪	dolw
宗	bxzs
摆	fsbd
善	ykuj
浪	dnlh
羽	gayu
肩	hojm
智	ouvi
拥	fays
弱	gdro
柳	melq
硬	unyk
纳	sdna
洛	dklo
范	cvfj
混	dvhy
玄	wsxr
买	vdmd
济	daji
徒	rrtu
烦	hafj
配	yvpw
适	zpui
端	ladr
娜	nena
娜	neno
哭	qkku
凝	drnk
镇	jbvf
率	wulv
率	wuuk
避	zubi
拳	buqr
创	dril
采	vmcd
晓	oexn
托	fqto
森	mmsf
哼	kahg
惜	xoxi
束	anuu
熟	hwuu
熟	hwuz
归	aegv
抗	fjkh
邪	eaxp
邪	eaye
庄	gtvl
喊	kkhj
梅	mdmw
韩	uahj
罢	ssba
罢	sspi
仇	rjiz
仇	rjqq
奔	dcbf
亡	wvwh
富	btfu
限	enxm
吓	kdhe
吓	kdxx
养	yayh
厅	idtk
贝	krbw
娇	najn
省	xoug
省	xoxk
占	akvj
横	mbhg
飘	xfpn
戏	ygxi
画	akhx
暴	odbc
灭	ahmp
域	tkyu
瞧	ohqn
软	iqrr
摸	fdmo
席	gjxi
稳	hxwf
绿	sdlu
绿	sdlv
伊	rpyi
讨	yctc
释	paui
获	cqho
店	gkdm
敬	wcjk
谷	bkgu
仿	rffh
借	rojp
丈	anvh
姓	nfxk
挑	fdtn
祖	pqzu
套	dstc
困	kmky
墙	tkql
冒	oomc
夏	awxx
叔	ayuu
架	mljx
鱼	dayu
织	sbvi
尖	xdjm
丁	aadk
牛	panq
旧	aojq
扑	fdpu
彩	vpcd
降	eajl
降	eaxl
燕	hcyj
卷	bvjr
臂	oubi
臂	oubw
桌	amvo
卖	udmd
嘿	khhw
骂	mkma
鲜	ayxm
幽	evyz
训	yaxy
演	dbyj
闭	mpbi
巧	ggqn
奋	dtff
杂	jmza
亦	wdyi
预	sayu
尤	udyz
偏	rcpm
替	oati
箭	vdjm
残	dgcj
拜	ufbd
腿	oztv
婆	ndpo
唯	kfww
迹	zwji
班	dwbj
诸	yovu
吉	ukji
诺	ykno
狼	qnlh
洋	dyyh
虑	hxlv
杯	mdbw
袋	yrdd
策	vnce
腰	onyc
殿	uydm
番	ptfj
番	ptpj
测	ddce
输	iduu
杜	mtdu
惨	xpcj
盟	momg
鲁	aolu
豪	wnhc
积	hbji
趣	zyqu
圆	kbyr
午	ruwu
户	duhu
执	fdvi
妇	nefu
沈	dvuf
登	dvdg
懂	xads
含	rkhj
犹	qdyz
互	aahu
律	ralv
锋	jffg
抢	fvig
抢	fvql
厚	izhz
聚	enju
尸	vpui
闹	mjnc
纵	srzs
凭	jrpk
迅	zvxy
财	bpcd
搞	fkgc
嘛	kmma
侧	rdce
侧	rdvd
侧	rdzd
农	dnns
稍	houc
介	rajp
宣	baxr
抽	faiz
颜	layj
躲	umdo
舒	rauu
供	rbgs
傲	rwao
勇	slys
阶	eajp
犯	qvfj
益	mqyi
尘	txif
甲	aajx
皱	dpvz
街	rdjp
孤	zggu
协	udxp
兽	bkuz
碰	uapg
伟	raww
塔	tkta
批	fvpi
盖	mygd
监	majm
劳	cllc
碎	uusv
撞	favl
阻	eqzu
操	fmcc
概	mvgd
曲	aaqu
胆	oadj
轮	ivly
婚	nohy
迟	zuii
凶	kxxs
党	xedh
爸	fvba
剧	duju
弃	wcqi
奈	dxnd
逐	zavu
疯	bffg
距	zaju
附	ecfu
谓	yoww
歌	dqge
哦	kdee
哦	kdoo
构	msgz
咬	kfyc
误	ydwu
塞	btsd
塞	btse
慕	cxmu
笔	vmbi
孔	zvks
牌	pupd
陪	ekpw
折	fjue
折	fjve
窗	bdil
逼	zabi
材	mpcd
挡	fedh
岛	nedc
择	favd
择	faze
袭	lyxi
挂	ftgx
伦	rvly
遍	zhbm
芒	cvmh
征	rvvg
触	jiiu
瞪	oddg
荡	cpdh
抵	fddi
郎	edlh
滚	dygy
怜	xslm
乃	gpnd
幻	vghr
臣	kaif
判	dbpj
烧	heuc
翼	ybyi
腾	omtg
欣	jqxb
灯	hddg
库	giku
妻	anqi
私	hssi
荣	cmrs
夺	dcdo
园	keyr
壁	tubi
贼	buzw
颗	aake
累	tslw
宋	bmss
狗	qkgz
悄	xoqn
颤	waij
颤	wavj
吟	kvyb
伏	rqfu
瞬	oauy
舍	rkue
补	pdbu
扫	fesc
跃	zdyt
艺	cgyi
挺	fztk
岳	peyt
悲	xabw
圈	kvjr
圈	kvqr
旋	frxr
瑞	warv
惑	xgho
竹	pavu
蛋	vidj
艾	cxai
艾	cxyi
扎	fvva
莉	cdli
损	fbsy
迫	zbpd
迫	zbpo
盛	mgig
盛	mgug
企	rvqi
缘	snyr
纯	sviy
俊	rwjy
努	lnnu
逸	zdyi
菲	cafw
抖	fudz
乌	pawu
油	dayz
炼	hdlm
唇	ikiy
幕	cjmu
康	gnkh
吐	kttu
汗	duhj
馆	ukgr
昨	oazo
赞	bnzj
茶	cmia
苍	cvch
恢	xhhv
裂	ydlp
育	woyu
央	anyh
闲	mmxm
吼	kvhz
爆	hdbc
鼓	uygu
乡	vpxl
陷	eaxm
曼	oymj
泰	fdtd
踪	zxzs
灰	uhhv
赤	tdii
萨	cisa
缺	fnqt
宽	bjkr
岂	evqi
伴	rabj
猜	qocd
额	baee
遗	zayi
谋	ymmz
浮	dzfu
昏	pohy
融	airs
妮	nvni
菜	cmcd
例	rdli
盯	oddk
涌	days
遭	zczc
洲	davz
潜	doqm
拼	fcpb
勒	glle
勒	gllw
博	ucbo
蛇	ivue
港	dvgh
貌	vemc
绍	skuc
拔	fdba
洗	dexi
彻	rdie
针	juvf
纸	sqvi
莱	cnld
县	qsxm
剩	dpug
扶	fnfu
愤	xbff
镜	jejk
爵	vcjt
晶	oojk
佩	rjpw
讯	yuxy
忧	xdyz
鼻	pabi
御	reyu
均	tdjy
枫	mffg
泽	daze
凯	ejkd
浩	dkhc
奶	npnd
怨	xpyr
毁	pyhv
壮	duvl
诚	yvig
忠	xavs
洪	dbhs
雾	ylwu
糊	mohu
固	kkgu
轰	iyhs
坦	tatj
睁	oavg
佳	rtjx
爹	fddp
蒂	cjdi
丢	psdq
庆	gdqk
亿	rgyi
词	ykci
辛	luxb
丰	aafg
缩	sbso
吹	kqiv
仰	reyh
迪	zadi
晃	oghl
庭	gztk
莲	czlm
梁	mdll
仔	rzzd
仔	rzzi
侠	rnxx
阁	mkge
检	majm
暂	oizj
读	yddu
读	yddz
郭	ewgo
绕	serc
插	faia
凉	dxll
净	dajk
召	dkuc
召	dkvc
减	dkjm
侍	rcui
慌	xvhl
敏	wrmb
伍	rwwu
鹰	gnyk
朗	dolh
讶	ypya
诗	ycui
货	brho
掩	fvyj
码	umma
浑	dihy
隔	eage
傅	rcfu
疾	buji
鸟	nadn
鸟	nann
赏	bxuh
摩	gumo
池	dvii
氏	pqui
振	fnvf
途	zrtu
闷	mxmf
童	lats
朵	jmdo
傻	rwua
粗	mqcu
旦	oadj
悉	xpxi
鸣	nkmk
径	rgjk
旅	fnlv
赫	tdhe
穴	bbxt
延	zpyj
惯	xbgr
唤	knhr
皆	bajp
盗	mddc
琴	wvqb
帐	jnvh
戴	tgdd
忆	xgyi
仁	rerf
宜	bqyi
甘	cagj
炸	hava
戒	gcjp
琳	wmlb
浓	dnns
吻	kpwf
季	hzji
疼	bdtg
桑	ymsh
侯	ruhz
堡	trbc
珍	wpvf
贴	bktp
符	vcfu
芳	cffh
嗯	kxen
嗯	kxog
羞	yaxq
典	abdm
劫	tljp
骗	mcpm
旗	fbqi
啸	kaxn
堆	tfdv
霸	yoba
廷	zptk
促	rzcu
惧	xbju
耐	acnd
庞	glph
荒	cvhl
序	gaxu
躺	ukth
粉	mdff
慧	xfhv
餐	uacj
喃	kunj
踏	zota
吕	kklv
孟	mzmg
抚	fvfu
匆	gdcs
漫	dymj
乘	pnig
乘	pnug
启	hkqi
脉	onmd
脉	onmo
仪	rdyi
络	sklc
络	sklo
拒	faju
洁	dkjp
郑	eqvg
奉	fafg
漂	dxpn
愈	xryu
倍	rkbw
拖	fvto
怔	xvvg
映	onyk
访	yffh
奴	nynu
乔	paqn
颇	papo
愣	xflg
献	uqxm
编	scbm
健	rzjm
扭	fanq
缠	saij
核	mrhe
核	mrhu
评	yupk
享	wzxl
尾	umww
碧	uwbi
瓦	adwa
尺	unii
票	xxpn
玛	wmma
川	pair
彼	rpbi
焰	hayj
醉	yuzv
述	zauu
痕	bnhf
晨	onif
薄	ccbc
薄	ccbo
胖	oaph
胖	oapj
恭	cxgs
辉	gihv
绪	soxu
倾	raqk
亏	egkv
躯	uxqu
磨	gumo
隆	efls
岸	euan
括	fkko
废	gdfw
狐	qghu
吞	akty
丫	baya
锁	jbso
忌	xvji
悟	xkwu
滑	dghx
椅	mkyi
赌	bodu
垂	paiv
粮	mnll
厂	apih
辰	inif
曹	aocc
霍	yfho
遥	zvyc
痴	bkii
款	uqkr
贫	bbpb
扩	fgko
督	oadu
乖	pvgk
欺	qqqi
聊	eeln
悠	xryz
艳	fvyj
奖	ddjl
帅	ajuk
估	rkgu
爬	vvpa
匹	kepi
录	vdlu
截	rgjp
牢	bnlc
锐	jerv
递	zbdi
唱	koih
唉	kuai
嘻	kkxi
董	cads
刹	dxia
刹	dxua
钢	jxgh
惹	cxre
焦	hrjn
穷	blqs
援	fyyr
慰	xuww
措	foco
悔	xdhv
革	cage
陵	ewlk
姿	ndzi
扯	fvie
泉	bdqr
予	sayu
予	snyu
筑	vdvu
勾	gsgz
授	fyuz
罩	suvc
埋	tamd
埋	tamj
熊	hsxs
潮	doic
漠	ddmo
轩	iuxr
殊	dnuu
哀	wyai
鸡	nyji
掠	fxlt
肚	otdu
聪	excs
斩	ijvj
狱	qqyu
俩	rdll
炮	hvbc
炮	hvpc
俱	rbju
挣	favg
邦	efbh
袖	paxq
泛	dnfj
沿	dkyj
辞	puci
卓	auvo
恼	xknc
航	vjhh
零	yslk
盈	mgyk
载	igzd
扰	fdrc
末	anmo
恋	xwlm
肃	vasu
鹏	onpg
姆	ndmu
屈	ukqu
眸	onmz
冥	bbmk
辆	idll
劝	ylqr
刃	ddrf
炎	hhyj
姬	naji
拦	fslj
堪	tvkj
劈	dupi
墨	thmo
培	tkpw
霜	youl
斜	ruxp
审	bauf
甜	pctm
撒	fwsa
驾	mljx
耀	gfyc
脆	ovcv
袍	pvpc
驻	mwvu
霞	yyxx
厌	iqyj
尝	xsih
弯	wgwj
宏	bshs
滴	dkdi
牧	wnmu
键	jzjm
耶	eeye
销	joxn
膀	ofbh
膀	ofph
寂	byji
媚	nomw
枝	myvi
牵	dnqm
丧	unsh
祝	pevu
趁	zpif
舌	pkue
课	ynke
麦	fwmd
抹	fnma
抹	fnmo
玲	wslk
喷	kbpf
染	mdrj
跪	zvgv
擦	fxca
翔	yyxl
币	pjbi
埃	tuai
钻	jkzr
贯	bvgr
盾	pody
灾	bhzd
溜	dtlq
询	yoxy
腹	owfu
渡	dydu
燃	hhrj
眨	onva
撤	fwie
敲	wyqn
侵	ryqb
喘	kair
柄	mnbk
悦	xeyt
嫁	nnjx
岩	euyj
赖	abld
烂	hslj
嘉	ukjx
拾	fkui
泥	dvni
夹	anga
夹	anjx
版	pybj
搜	fysz
汇	dkhv
冬	wdds
俗	rksu
僧	rosg
竞	lejk
喂	knww
骇	mrhd
搭	fkda
暖	oynr
茫	cvmh
返	zpfj
莎	cpua
挤	faji
宾	bbbb
冠	bcgr
析	mjxi
郁	euyu
允	seyy
疗	baln
繁	srfj
桥	maqn
葛	cvge
祥	pyxl
瘦	byuz
仲	ravs
耸	erss
仗	rnvh
弓	vggs
违	zaww
豫	snyu
幅	jtfu
胁	odxp
瓶	qwpk
愧	xgkv
晕	oiyy
柱	mwvu
饰	ujui
翠	yucv
勉	dlmm
矮	unai
宿	bbsu
宿	bbxq
偶	rdou
汤	dpth
刑	daxk
涛	dctc
黎	hdli
煞	hdua
贤	baxm
姊	npzi
衫	ppuj
锦	jjjb
抛	flpc
虫	adis
昂	oeah
恰	xkqx
咐	kcfu
铺	jdpu
琪	wbqi
衡	rdhg
饮	uryb
捉	fzvo
纤	suqm
纤	suxm
袁	tyyr
猎	qolp
赢	wdyk
购	bsgz
卢	aulu
础	ukiu
亭	wdtk
娃	ntwa
慈	xqci
晴	ooqk
咒	jkvz
羊	bayh
签	vaqm
猫	qtmc
薇	cwww
覆	xwfu
覆	rwfu
祸	pdho
罚	sdfa
舰	vjjm
魏	hgww
耗	lmhc
寸	adcy
跌	zndp
俄	rdee
蝶	imdp
详	yyxl
撑	fuig
闯	mmil
箱	voxl
弗	vafu
扮	fdbj
诱	ypyz
障	euvh
怖	xjbu
屁	uvpi
弥	gxmi
歉	qqqm
砍	uqkj
齿	vkii
踢	zpti
寺	tcsi
爪	pnvc
爪	pnvx
贸	bpmc
脏	otzh
棋	mbqi
贺	blhe
迈	zamd
捕	fdbu
笼	vlls
浅	dgqm
扣	fkkz
拨	fdbo
扇	hyuj
臭	pqiz
臭	pqxq
篇	vcpm
猪	qovu
邓	eydg
泄	dvxp
辱	icru
肤	onfu
懒	xblj
裁	ygcd
仆	rdpu
穆	hpmu
昆	ovky
丑	vaiz
愁	xhiz
渊	dayr
勤	clqb
悬	xqxr
铃	jslk
韦	aaww
崇	exis
井	aajk
帕	jbpa
昌	ooih
鞭	gnbm
叛	bypj
僵	rajl
纹	swwf
鸿	dnhs
瑶	wfyc
雕	pfdn
洒	dxsa
冯	dmfg
冯	dmpk
蛮	wimj
爽	dxul
跨	zgkx
饶	uerc
矛	spmc
缝	szfg
湾	dgwj
税	heuv
涉	dpue
铜	jkts
屠	uotu
麽	gsmo
乾	uggj
乾	augj
乾	ugqm
乾	auqm
莹	cwyk
涂	dhtu
奸	nujm
梯	mpti
邀	zbyc
誉	xyyu
诡	yvgv
慎	xbuf
夕	pdxi
婉	nvwj
吩	kdff
镖	jxbn
摔	fuuk
魄	bgpo
卧	kdwo
酷	ykku
丛	arcs
巡	zvxy
祭	pxji
崖	etya
誓	yfui
描	ftmn
奏	fdzz
肖	xoxn
碍	ucai
曰	kayt
霄	yoxn
糟	mozc
麟	lalb
枚	wmmw
肌	ojji
欠	drqm
欠	fnqm
欠	drqt
欠	fnqt
稀	hjxi
阔	mkko
液	dnye
笨	vabf
勃	ulbo
勃	ulbw
毅	lyyi
矿	ugkl
湿	daui
桃	mdtc
疲	bppi
荷	ckhe
汽	dqqi
姜	ynjl
摄	fynp
摄	fyue
哎	kxai
植	mqvi
艰	ynjm
脖	ozbo
催	rfcv
虹	ighs
巫	grwu
屏	ucpk
咽	kdye
咽	kdyj
驰	mvii
蓉	ckrs
凑	ddcz
愕	xgee
肥	ovfw
绩	sbji
坛	tstj
凄	dnqi
搬	fybj
扔	fprg
瑟	wdse
杖	mnvh
芙	cnfu
畏	tnww
频	vapb
润	dwry
酸	ywsr
割	dbge
绵	sjmm
披	fppi
滋	dszi
秒	hpmn
戈	adge
贪	brtj
捷	frjp
瞒	odmj
播	ftbo
逆	zqni
咳	krke
申	aauf
卑	pubw
搂	fnlz
寇	bykz
魅	gnmw
惠	xahv
宛	bvwj
宛	bvyr
喉	kuhz
幼	vlyz
卿	peqk
龄	islk
赐	bpci
驶	mnui
瓜	pngx
氛	qdff
腕	ovwj
污	dgwu
谅	yxll
筹	vciz
宠	blis
碗	uvwj
妃	nvfw
筋	vljb
甩	pvuk
驱	mxqu
寨	bmvd
蕾	ctlw
兼	qnjm
婷	ndtk
捏	ftnp
妥	vnto
拓	fkta
拓	fkto
斥	pdii
吵	kpic
订	yddk
纠	sajq
璃	wsli
届	uajp
饿	udee
夸	dgkx
倩	roqm
薛	cuxt
窜	bacr
崔	efcv
尉	ucww
尉	ucyu
恒	xahg
後	rwhz
宴	bnyj
晌	okuh
艘	vysz
辣	lnla
哇	ktwa
柜	magv
柜	maju
斤	pajb
储	roiu
挨	fuai
豹	vvbc
雁	ifyj
吾	wkwu
挖	fgwa
饱	uvbc
彭	upbh
彭	uppg
役	ryyi
琼	wxqs
遮	zgve
舟	pdvz
佣	rays
狮	qjui
寿	fcuz
陶	eftc
患	xahr
砸	ujza
颊	aajx
励	illi
愚	xayu
腐	grfu
牲	nfug
哑	kaya
恍	xghl
裤	piku
俏	roqn
鼠	pvuu
岚	eflj
狄	qhdi
妄	wnwh
丘	paqq
抑	feyi
呈	kwig
蓦	cmmo
尹	vpyb
坡	tppo
契	dfqi
契	dfxp
嫌	nnxm
津	dajb
售	kruz
棒	mabh
郡	evjy
撕	fjsi
骤	mnvz
疆	gajl
颈	vagg
颈	vajk
贾	bxgu
贾	bxjx
咕	kkgu
歇	oqxp
漏	ddlz
脾	oupi
窝	bdwo
嫣	nhyj
盼	odpj
耻	evii
蜜	bimi
姨	nnyi
厨	iciu
珊	wauj
链	jzlm
裹	wygo
汪	dwwh
靖	loqk
殷	pyyb
殷	pyyj
拟	frni
淫	duyb
呜	kawu
韵	layy
柯	mkke
巾	aajb
庙	gamn
纱	spua
娶	nequ
矩	uaju
棍	mvgy
晋	aojb
伐	rgfa
绳	svug
涨	dnvh
添	dxtm
陛	etbi
嘲	koic
嘲	kovc
捧	fapg
宅	bqvd
鼎	ovdk
谨	yajb
乏	pnfa
黛	hrdd
仓	rvch
岗	exgh
掏	fftc
削	dxxn
削	dxxt
诧	yqia
灌	dfgr
旨	povi
刷	duux
页	baye
泡	dvpc
辩	yubm
俞	rdyu
婴	nbyk
盒	mrhe
嚷	kyrh
沾	dkvj
漆	ddqi
蠢	fiiy
甫	adfu
膝	odxi
墓	ctmu
逢	zwfg
嫩	nwnf
坠	tevv
雀	xfqt
枯	mkku
偿	rsih
陌	ebmo
屑	uoxp
畅	apih
陡	erdz
挽	fvwj
鹤	ndhe
涵	dkhj
署	souu
沃	ddwo
叉	ydia
搏	fcbo
逝	zfui
趟	zkth
鞋	gtxp
赴	zdfu
谦	ynqm
砰	uupg
骄	majn
遂	zqsv
泣	dlqi
档	medh
摊	fftj
慨	xvkd
籍	voji
擒	fsqb
苗	ctmn
浴	dkyu
鉴	jajm
尴	jmgj
迁	zpqm
疏	vvuu
尬	jaga
赚	bnvr
赚	bnzj
逗	zadz
豆	aqdz
孝	tzxn
芬	cdff
湘	doxl
诀	ynjt
晰	ojxi
廉	gnlm
馨	uoxb
辽	zvln
械	mcxp
吊	kjdn
炉	hhlu
串	aair
裸	pnlo
哲	kfve
凛	dxlb
渴	dvke
柏	mbbd
柏	mbbo
芸	csyi
芸	cgyi
芸	csyy
芸	cgyy
拱	fbgs
妨	nffh
揉	fmrz
樱	mnyk
寄	bkji
宙	bavz
宰	buzd
媒	nmmw
眯	ommi
贡	bggs
崩	eobg
绑	sebh
斧	fjfu
惶	xwhl
嘶	kjsi
沟	dsgz
禅	paij
禅	pauj
骚	misc
荆	dcjk
歪	avwd
涯	dtya
耍	anux
遵	zqzy
伪	rdww
冤	bdyr
悍	xuhj
耿	ehgg
翅	uyii
循	roxy
聂	eynp
猴	quhz
拂	fafu
裙	pkqy
蓬	czpg
芝	cnvi
昭	okvc
倏	rquu
舱	vvch
肆	aasi
帽	jomc
岭	eslk
叮	kddk
拐	flgk
儒	raru
嫂	nysc
瞥	oxpp
廊	gelh
赔	bkpw
辨	dubm
鄙	ekbi
哩	kali
逊	zzxy
愉	xdyu
摘	fkvd
淋	dmlb
牺	nxxi
俯	rcfu
谭	yutj
蒋	ccjl
劣	xllp
玫	wwmw
吁	kuxu
吁	kuyu
肠	opih
押	faya
昔	coxi
攀	mupj
乳	vvru
鹿	gvlu
潘	dtpj
娅	naya
藤	cdtg
躬	uggs
蔡	cxcd
粒	mlli
涩	dvse
揭	fvjp
揭	fvqi
嗓	kmsh
啪	kbpa
翎	rylk
撼	fxhj
竖	lauu
遣	zaqm
囊	aynh
眠	oqmm
掀	fqxm
旺	owwh
弘	gshs
戚	gxqi
烁	hduo
逍	zxxn
坤	taky
憾	xxhj
仑	rvly
租	hqzu
咯	kkge
咯	kkka
咯	kklo
卜	adbo
卜	adbu
凰	jwhl
哄	kbhs
匪	kafw
膛	otth
淑	dyuu
忖	xccy
堵	todu
夷	anyi
柴	mvid
撇	fwpp
歹	addd
辜	uugu
沐	dmmu
绽	srvj
辅	idfu
萍	cupk
敖	wfao
拆	fdid
磊	uulw
罕	buhj
冻	ddds
赋	bdfu
趋	zequ
瞳	oats
杆	mugj
灿	hecj
葬	cczh
篮	vmlj
胞	ovbc
颠	uadm
黯	hoan
峡	enxx
顽	eawj
朕	odvf
兆	pdvc
擅	fauj
陀	evto
龟	dvgv
龟	dvjy
龟	dvqq
蜂	iffg
贞	bavf
阎	mayj
咦	knyi
惟	xfww
竭	lvjp
厢	ioxl
惩	xrig
谎	yvhl
腔	ogql
裴	yapw
玻	wpbo
璇	wrxr
溪	ddxi
铭	jkmk
邻	erlb
朴	mdpn
朴	mdpo
朴	mdpu
衷	wyvs
帘	bjlm
拢	flls
魁	gukv
哗	kuhx
侄	rtvi
茵	cdyb
盆	mbpf
阅	meyt
弦	gsxm
兮	bgxi
翁	bywg
贱	bgjm
债	rbvd
斌	wdbb
坑	tjkg
逻	zslo
踩	zmcd
瞎	okxx
躁	zmzc
讽	yffg
钉	jddk
蓄	ctxu
丸	gdwj
丐	aggd
矣	suyi
册	pace
兔	ddtu
溃	dbkv
隙	exxi
叠	yqdp
瞄	otmn
倚	rkyi
轿	iajn
舅	pljq
钦	jqqb
祈	pjqi
烛	hivu
怡	xkyi
兹	qsci
兹	qszi
肢	oyvi
综	sxzs
禀	wxbk
於	fdwu
於	fdyu
壶	uahu
雯	ywwf
栏	mslj
览	jalj
斑	wwbj
蹲	zcdy
纽	sanq
践	zgjm
棠	xmth
汹	dkxs
胎	oktd
妾	lnqp
篷	vzpg
腥	oaxk
厮	ijsi
锅	jdgo
楞	mflg
澳	ddao
窃	bdqp
霆	yztk
桂	mtgv
艇	vztk
轨	ijgv
哨	kouc
寡	bdgx
挪	feno
翰	uyhj
尧	aeyc
咧	kdlp
怯	xsqp
瑰	wggv
沧	dvch
寞	bdmo
叙	ryxu
彷	rffh
彷	rfph
佐	rgzo
呐	kdna
呐	kdne
卒	wucu
卒	wuzu
栽	mgzd
焕	hnhr
塌	tyta
绣	spxq
骆	mklo
敛	wrlm
携	fpxp
蹄	zjti
颖	payk
棵	mnke
廖	gpln
呻	kauf
痒	byyh
驳	mxbo
裳	xyih
裳	xyuh
睹	oodu
泼	ddpo
溢	dmyi
狡	qfjn
倘	rkth
胳	okga
胳	okge
羡	yrxm
婢	nubi
枕	mvvf
妒	nudu
绮	skqi
噬	krui
呃	kvee
喔	ktoo
喔	ktwo
狸	qali
缕	snlv
译	yayi
泊	dbbo
芷	cvvi
咪	kmmi
刮	dpgx
咖	kkga
咖	kkka
恕	xnuu
煌	hwhl
嘱	kdvu
蚩	eiii
栋	mdds
锤	jaiv
逛	zqgl
暇	oyxx
栈	mgvj
溅	dgjm
巷	cvhh
巷	cvxl
填	tbtm
膊	ocbo
诈	yava
昧	onmw
乞	rgqi
叱	kqii
姚	ndyc
渔	dayu
摧	ffcv
遁	zpdy
焚	hmff
糕	mhgc
衬	pcif
倦	rvjr
辕	iyyr
啡	kafw
啥	kkua
乙	ggyi
彦	lpyj
郝	ethc
履	uwlv
匕	avbi
潇	daxn
茜	cxqm
茜	cxxi
嘟	kedu
汝	dnru
耽	evdj
旭	joxu
浸	dyjb
畜	wtiu
畜	wtxu
硕	uauo
蕴	cmyy
侦	rbvf
佑	rkyz
灼	hdvo
嗤	kiii
峻	ewjy
菊	cmju
彤	ppts
焉	ahyj
敦	wwdy
哟	kdyo
筒	vkts
棉	mjmm
霉	ydmw
衰	wyuk
烤	hgkc
麒	lbqi
钩	jsgz
犬	ddqr
庸	gays
滩	dftj
姥	nvlc
桶	mats
榜	mfbh
茅	cpmc
狭	qnxx
剥	debc
剥	debo
症	bvvg
诞	yvdj
乍	rava
翩	hypm
辑	ieji
棺	mkgr
潭	dutj
歆	lqxb
滞	djvi
抄	fpic
谱	yopu
枉	mwwh
趴	zbpa
狞	qdnk
隶	vnli
嗔	kbif
毙	avbi
谊	yqyi
淮	dfhk
笛	vadi
缚	scfu
剪	qdjm
囚	krqq
蔽	cwbi
辟	uubi
辟	uupi
碌	udlu
塑	tqsu
刊	dakj
澜	ddlj
捂	fkwu
秃	hjtu
掷	fevi
桐	mkts
霎	ynua
搁	fkge
帆	jdfj
矢	rdui
腻	odni
函	vkhj
址	tvvi
弩	gnnu
邱	epqq
孽	cznp
藉	coji
藉	roji
藉	cojp
藉	rojp
胀	onvh
兀	aewu
嚣	kkxn
雍	wfys
巍	egww
匠	kjjl
冉	aarj
窥	bjkv
蛛	invu
狈	qbbw
瑜	wdyu
妍	ncyj
衍	rdyj
邵	educ
朽	mgxq
噗	knpu
苟	ckgz
鲍	avbc
胃	toww
壳	ujke
壳	ujqn
暮	comu
萝	cdlo
恳	xvkf
渠	mdqu
挟	fnjx
挟	fnxp
琉	wvlq
熙	hkxi
噢	kdoo
雇	hfgu
碑	uubw
驼	mvto
俺	rvan
绘	sshv
喀	kkka
捡	fajm
斐	wafw
阮	eerr
嘎	kgga
吱	kyvi
炽	hbii
钥	joyc
钥	joyt
妆	dnvl
杏	mkxk
桓	mahr
昊	odhc
擎	ucqk
贷	brdd
磁	usci
宪	bexm
沸	dafw
衙	rdya
匙	ovii
匙	ovui
鞘	goqn
鞘	gouc
剂	dwji
搅	fjjn
猿	qyyr
赠	bozg
徽	rwhv
裕	pkyu
祷	pcdc
株	mnvu
蜀	siuu
桩	mtvl
账	bnvh
巢	vnic
堕	tedo
堕	tehv
梭	mwso
兜	epdz
敞	wxih
肿	oavs
骷	gkku
髅	gnlz
娟	nojr
茂	cpmc
窄	bavd
菱	cwlk
吨	kvdy
絮	snxu
坎	tqkj
琦	wkqi
芦	chlu
渗	dpuf
拘	fkju
梵	mdfj
脊	doji
澡	dmzc
窟	bkku
姻	ndyb
捐	fojr
盏	mgvj
孕	gzyy
滔	datc
挫	ftco
伺	rkci
伺	rksi
贩	byfj
扁	hcbm
扁	hcpm
墅	tauu
寝	byqb
侮	rdwu
垃	tlla
郊	ewjn
眶	owkl
莽	ccmh
俘	rzfu
蝉	iaij
卦	tdgx
喧	kaxr
圾	tnji
诛	ynvu
澄	dddg
澄	ddig
妞	nanq
彪	hpbn
淳	dziy
淳	dzvy
唔	kkm
唔	kkwu
揽	fjlj
厦	iwua
厦	iwxx
嗡	kywg
勋	klxy
歧	vyqi
鸦	naya
聘	egpb
珑	wlls
哮	kzxn
嗦	ksso
虞	hdyu
惭	xjcj
熬	hfao
迭	zpdp
盐	mtyj
啧	kbze
捣	fedc
梳	mvuu
浆	ddjl
烫	hdth
虐	hant
钧	jdjy
掘	fkjt
忿	xbff
畔	tapj
樊	dmfj
倪	reni
亩	wtmu
咙	klls
邮	eayz
襄	wyxl
禽	rdqb
鳞	aalb
勿	gpwu
炀	hpyh
嫉	nuji
杭	mjhh
嚎	knhc
衔	rdxm
菁	cojk
眩	osxr
栗	xmli
蹦	zobg
喻	kdyu
盲	womh
虏	hllu
茹	ckru
觑	hjqu
佘	rxue
蔓	cymj
蔓	cywj
陋	evlz
苹	cupg
苹	cupk
娱	ndyu
堤	trdi
彬	mpbb
绷	sobg
铸	jcvu
酬	yaiz
绞	sfjn
渺	dpmn
淘	dftc
卸	erxp
蛟	ifjn
朦	onmg
帖	jktp
菩	ckpu
坊	tffh
旷	ogkl
襟	pxjb
汁	duvi
僻	rupi
翘	ayqn
盔	mukv
嘘	kaui
嘘	kaxu
峨	edee
疚	bnjq
慑	xyue
粹	mucv
醋	yocu
饥	ujji
秩	hnvi
沫	dnmo
肺	ojfw
咆	kvpc
砖	udvr
嘀	kkdi
弧	gghu
锡	jpxi
顷	aaqk
迦	zljx
拚	fcpb
胧	olls
妓	nyji
捞	fllc
蹈	zadc
坟	twff
幢	jail
幢	javl
湛	dvvj
亨	wahg
媳	nxxi
荐	czjm
奕	wdyi
吏	anli
磕	umke
皓	bkhc
婿	noxu
跋	zdba
钰	jwyu
罡	svgh
扳	fybj
屡	unlv
犀	unxi
稿	hkgc
蚁	idyi
咚	kdds
耕	lagg
锻	jydr
奢	doue
诊	ypvf
祺	pbqi
泳	dnys
拭	fdui
蚀	uiui
垒	tslw
冈	kxgh
窍	bgqn
龚	lbgs
戟	ugji
萱	caxr
绰	suic
绰	suio
脂	oovi
宵	boxn
钓	jddn
蔑	cdmp
嵌	eqqm
戮	yglu
叩	ekkz
迸	zqbg
淹	dvyj
丞	vaig
喇	kdla
哧	kdii
叨	kddc
叨	kdtc
瓷	wdci
炯	hkjs
蝎	ivxp
揪	fhjq
沛	djpw
斋	wavd
侣	rklv
挠	fenc
蝠	itfu
逞	zkig
疫	byyi
眷	bojr
姗	nauj
懈	xnxp
瘫	bftj
饼	ucbk
嗅	kqxq
豁	bkho
棚	mopg
煤	hmmw
框	mwkl
绸	skiz
殖	dqvi
券	bdqr
券	bdxr
蒸	chvg
熄	hxxi
疤	bvba
蒲	cdpu
稚	hfvi
莺	cnyk
冀	abji
稻	hadc
葡	cdpu
侃	rvkj
捆	fmky
澈	dwie
毯	mhtj
傍	rfbh
旬	goxy
呕	kxou
梧	mkwu
寓	bdyu
粘	mknm
粘	mkvj
滨	dbbb
薪	cjxb
阱	eajk
撩	fxln
舔	pxtm
辖	ikxx
舜	vauy
梨	mhli
猾	qghx
抿	fqmb
禹	pdyu
啼	kjti
炭	ehtj
砚	ujyj
玑	wjji
掐	faqx
夭	pdyc
榻	myta
哉	kgzd
逮	zvdd
旱	ouhj
驴	mhlv
甄	xwvf
煮	htvu
憋	xxbp
缴	swjn
缴	swvo
蕊	cxrv
稽	hoji
绯	safw
喽	knlz
涡	drgo
涡	drwo
滥	dmlj
搓	fgco
颓	hatv
瞅	ohiz
铮	javg
纲	sxgh
揍	fdzz
鹅	npee
氓	wqmg
氓	wqmh
瑾	wajb
肝	ougj
踉	znll
讪	yeuj
箫	vaxn
腊	oola
腊	ooxi
霓	yeni
惫	xwbw
淌	dkih
淌	dkth
霹	yupi
垫	tfdm
跄	zvql
茨	crci
刁	gadn
禄	pdlu
膜	odmo
诅	yqzu
擂	ftlw
轴	iavz
厥	iqjt
讥	yjji
厄	ivee
胶	ofjn
扛	fggh
扛	fgkh
惕	xpti
瞟	oxpn
凸	aatu
肘	ocvz
媛	nyyr
拧	fdnk
浙	djve
奎	dtkv
熏	hpxy
沁	dxqb
骏	mwjy
笙	vfug
岔	beia
沮	dqju
颅	aalu
酥	yhsu
冶	dkye
嗽	kqsz
舵	vvdo
燥	hmzc
拙	fkvo
蛊	migu
瓣	gubj
吭	kjhh
吭	kjkg
绫	swlk
蝴	iohu
罐	ffgr
糖	mkth
蹙	gzcu
琢	wnvo
漾	dnyh
绅	sauf
怠	xsdd
嗷	kwao
沦	dvly
鸭	naya
涅	dtnp
驭	myyu
咏	knys
窒	btvi
槐	mghk
凳	vjdg
臀	outy
伞	rusj
懊	xdao
雳	ylli
逾	zryu
唬	khhu
葫	cohu
闺	mtgv
咸	gkxm
镶	jyxl
萄	cftc
梢	mouc
嗜	koui
戳	ygio
铲	jiij
缪	spmn
缪	spmq
缪	spmz
猩	qfxk
跺	zmdo
蟒	icmg
蟒	icmh
詹	dyvj
晒	oxud
浦	ddpu
邹	edzz
黝	hlyz
筷	vnkk
狰	qavg
霖	ymlb
炫	hsxr
凹	aaao
凹	aawa
伶	rslk
揣	faik
揣	fatr
揣	favv
窘	bkjs
悸	xzji
垮	tgkx
噜	kolu
颔	rahj
嚼	kcjn
嚼	kcjt
尿	udnn
沼	dkvc
塘	tkth
肋	olle
肋	ollw
簇	vucu
哆	kddo
兢	uejk
琐	wbso
颁	babj
泻	daxp
鞠	gmju
匿	kkni
膨	oppg
酿	ynnl
颂	bass
瘾	bxyb
栖	mxqi
栖	mxxi
蔚	ccww
楠	munj
帜	jbvi
剔	doti
靴	gvxt
萌	comg
棘	anji
娥	ndee
沌	dvdy
谜	yzmi
觅	vjmi
砂	upua
脯	odfu
脯	odpu
讳	yahv
螺	islo
晖	oihv
韧	adrf
瞻	oyvj
蜡	iola
瀑	ddpu
璧	wubi
蚕	aicj
聋	lels
漓	dsli
踱	zydo
谣	yfyc
敷	wafu
偎	rnww
绢	sojr
噩	wkee
搔	fisc
晏	onyj
匣	kaxx
倔	rkjt
蹬	zddg
苑	cvyr
婶	nasf
歼	dujm
缉	seji
彰	lpvh
拇	fdmu
寥	bpln
昼	uavz
弊	cxbi
坪	tupk
敝	wxbi
裘	ayqq
呸	kapw
憎	xozg
镔	jbbb
悯	xwmb
舆	pbyu
诵	yass
拎	fslb
唾	kato
瑛	wnyk
枢	mxuu
叭	kbba
挚	ufvi
揖	feyi
兑	bedv
蜘	ikvi
秉	pnbk
荫	coyb
衅	xaxb
壤	tyrh
匀	gayy
驯	maxy
浊	divo
惚	xxhu
牟	snmu
牟	snmz
呛	kvql
祁	epqi
娴	nmxm
蜥	ijxi
炒	hpic
婕	nrjp
甸	gtdm
惮	xada
惮	xadj
碟	umdp
谐	ybxp
叟	pysz
猝	qucu
侥	rejn
侥	reyc
斟	quvf
啤	kupi
髓	gzsv
寰	byhr
峙	ecui
峙	ecvi
赦	wtue
噪	kmzc
枭	nmxn
浇	dejn
腮	oxsd
遏	zoee
哽	kngg
芽	cpya
婪	nmlj
倭	rnwo
卵	pdlr
暧	oyai
阙	mqqt
诏	ykvc
炙	phvi
祟	exsv
拣	fdjm
邸	epdi
骸	grhd
谬	ypmq
磋	ugco
涕	dpti
瀚	dyhj
邢	eaxk
捶	faiv
袱	pqfu
洽	dkqx
峭	eoqn
巩	gdgs
檀	matj
赎	bduu
祀	pvsi
滕	odtg
柬	anjm
嵩	ekss
嬉	nkxi
僚	rxln
睬	omcd
葱	cxcs
嬷	nsmo
缸	fggh
杉	mpua
杉	mpuj
虔	hwqm
娲	nrwa
拽	fpvk
廓	geko
玮	waww
蔷	ckql
恃	xcui
竿	vugj
恙	xyyh
绒	surs
瑚	wohu
漪	dkyi
鹃	nkjr
睫	orjp
鸽	nrge
陕	enuj
钞	jpic
蝙	icbm
搀	fdij
袅	nynn
蝇	ivyk
佬	rvlc
蚂	imma
蚊	iwwf
翡	yafw
朔	qouo
踹	zaik
嗖	kysz
芊	cuqm
崎	ekqi
啃	kokf
璋	wuvh
慷	xnkh
咋	kava
咋	kaza
咋	kaze
檐	myyj
鞍	gnan
剿	dvic
剿	dvjn
腑	ocfu
悚	xnss
缎	sydr
匈	gkxs
厕	idce
厕	idsi
鹫	nwjq
涟	dzlm
虾	idxx
漩	drxr
聆	eslk
栅	mace
栅	mauj
栅	mava
搐	ftiu
鸾	wnlr
蓓	ckbw
扒	fbba
扒	fbpa
穹	bgqs
瑕	wyxx
珀	wbpo
锥	jfvv
矫	uajn
庐	ghlu
暑	oouu
溶	dkrs
靡	gami
晦	odhv
喳	kaia
喳	kava
咄	kkdo
巅	eadm
墟	taxu
煎	hqjm
芯	cxxb
亢	wjkh
掳	fllu
屯	avty
屯	avvy
叽	kjji
曦	ogxi
獠	qxln
厘	iali
懦	xano
渣	dava
桀	mpjp
恬	xktm
缀	syvv
褪	pztv
褪	pzty
嵋	eomw
筝	vavg
秽	hdhv
庇	gvbi
绊	sabj
褚	poiu
褚	pove
褚	povu
拯	favg
衲	pdna
眺	odtn
悴	xucv
驹	mkju
钝	jvdy
酋	qaqq
珂	wkke
祢	pxmi
狙	qqju
汰	ddtd
镯	jivo
贿	bohv
铠	jvkd
粥	mgvz
佟	rdts
芮	crrv
奄	dvyj
怅	xnih
剖	dlpz
伽	rkga
伽	rkjx
伽	rkqp
忡	xais
萎	cnww
凿	auzc
鬟	ayhr
奠	qddm
熠	hbyi
憔	xhqn
钮	janq
妩	nvwu
抡	fvly
崆	egks
弛	gvii
褐	pvhe
勘	qlkj
妲	nada
唰	kdux
惺	xaxk
膏	wogc
筠	vajy
贬	bnbm
绚	soxr
嗨	kdhd
怦	xupg
晤	okwu
俐	rdli
窦	bddz
驿	mayi
棱	mwlg
棱	mwlk
竺	vevu
烙	hklc
烙	hklo
睿	aorv
锣	jdlo
溺	ddni
溺	ddnn
恺	xvkd
缔	sjdi
牡	ntmu
鬓	abbb
藩	ctfj
谕	ydyu
庵	gvan
憨	xvhj
瘟	bmwf
钗	jdid
昕	ojxb
徊	rkhk
偌	rkro
髯	aarj
缰	sajl
庶	ghuu
札	mvva
缭	sxln
徘	rapd
曙	oouu
阀	mgfa
殆	dkdd
巳	vvsi
纬	saww
缄	skjm
澎	dppg
掣	upie
惘	xvwh
槽	mocc
诣	yoyi
曳	apye
娄	mnlz
胤	pvyb
惋	xvwj
虬	ivqq
倡	roih
芭	cvba
琛	wmif
肴	xoyc
蹭	zocg
庚	gngg
飙	qfbn
仕	ruui
貂	vkdn
嚓	kxia
蜴	ipyi
募	clmu
昱	olyu
圳	tavf
氧	qyyh
悻	xuxk
佯	ryyh
锵	jcql
隋	eodo
隋	eosv
笃	vmdu
筱	vwxn
忑	xate
捅	fats
捺	fxna
茉	cnmo
萤	ciyk
佗	rvto
睨	oeni
邃	zbsv
谴	yzqm
霏	yafw
屎	umui
乒	pppk
谍	ymdp
缅	samm
忐	xatj
暄	oaxr
簌	vqsu
鲸	axjk
涎	dvxm
瞩	odvu
攒	fbcr
攒	fbzj
蟹	ijxp
茄	ckjx
茄	ckqp
漱	dquu
饲	uksi
嗣	kksi
诫	ydjp
阐	maij
瑭	wkth
熔	hkrs
冽	ddlp
棕	mxzs
酱	ydjl
辫	subm
辙	iwve
闵	mwmb
殴	kyou
蛙	itwa
滢	dwyk
晁	odic
删	dpuj
裔	ykyi
膳	okuj
殃	dnyh
蔼	cvai
茱	cnvu
苛	ckke
跷	zeqn
痊	bwqr
樵	mhqn
烘	hbhs
癫	badm
懿	uxyi
扼	fvee
吆	ksyc
鸠	njjq
茧	cijm
孜	wzzi
侨	raqn
幡	jtfj
咎	wkjq
蔬	cvuu
酣	ychj
亵	wyxp
哝	knns
隧	ezsv
禾	pmhe
纺	sffh
黏	hknm
湃	dfpd
绛	sajl
崛	ekjt
嘈	kocc
眈	ovdj
皙	bmxi
礁	uhjn
琅	wnlh
睦	otmu
薰	chxy
璐	wklu
蹿	zacr
邑	kvyi
躇	zoiu
菌	chjy
枣	adzc
踌	zciz
迢	zdtn
赃	btzh
臻	ahvf
苇	caww
篝	vagz
袜	pnwa
崭	ejvj
屿	eayu
娆	nerc
靳	gjjb
咨	kdzi
煜	hlyu
聿	vayu
陨	ebyy
鸳	npyr
榴	mtlq
帷	jfww
钵	jabo
毋	vpwu
橙	mdig
雌	vfci
丙	anbk
琥	whhu
匡	kwkl
狩	qcuz
芜	cvwu
羿	ycyi
璀	wfcv
鲨	adua
冕	ovmm
讷	ydne
蠕	iaru
砌	udqi
戾	hqli
掺	fpij
掺	fpuj
掺	fpxm
拈	fknm
酌	ydvo
殇	dpuh
忒	qdte
忒	qdtv
铅	jkqm
戎	gurs
蹑	zynp
唠	kllc
苔	cktd
栩	myxu
烨	huye
吝	wklb
啜	kyik
啜	kyio
涣	dnhr
甬	says
莞	cegr
莞	cewj
恻	xdce
雏	dfiu
窖	bkjn
傀	rggv
傀	rgkv
蜷	ivqr
岱	erdd
疙	bgge
飒	lfsa
衮	wygy
谑	yaxt
乓	pdph
棣	mndd
棣	mndi
棣	mnti
磅	ufbh
磅	ufph
焱	hhyj
猖	qoih
簿	vcbu
譬	yupi
羁	smji
戬	agjm
拗	flao
拗	flnq
煦	hoxu
烬	hdjb
伫	ravu
葵	cdkv
镰	jnlm
瘩	bkda
笠	vlli
趾	zvvi
攸	rwyz
剌	dala
唧	keji
睽	odkv
坝	tbba
紊	wswf
渍	dbzi
迳	zvjk
靶	gvba
糙	mzcc
宦	bahr
吮	keuy
勺	gduc
祯	pbvf
邯	echj
鄂	ekee
窑	bfyc
圭	ttgv
侈	rdii
粪	mbff
杠	mggh
鸯	anyh
炬	haju
浏	ddlq
橡	mnxl
孰	wduu
琶	wvpa
俨	riyj
泓	dshs
涧	dojm
呗	kbbd
呗	kbbw
麾	gmhv
昵	ovni
屹	egyi
恤	xxxu
寐	bnmw
婧	nojk
闸	mava
韶	lkuc
菇	ckgu
靓	fjjk
靓	fjll
椒	myjn
荀	coxy
癸	vdgv
饕	uktc
啐	kucv
啐	kuqi
疮	bvil
岑	evcf
辎	itzi
攘	fyrh
琵	wvpi
稷	hwji
肮	ojah
矜	svgr
矜	svjb
矜	svqb
楣	momw
渎	dddu
荧	chyk
噎	kdye
呱	kngx
崽	xezd
饵	ueer
拷	fgkc
锭	jrdk
缥	sxpn
瘪	bvbp
瞠	otig
沪	dhhu
沪	dxhu
沪	dhlv
沪	dxlv
奚	vdxi
籁	vbld
湮	dtyj
萦	csyk
劭	dluc
铛	jedh
铛	jeig
茗	ckmk
弑	xdui
痹	babi
飕	fysz
铿	jtkg
璨	wmcj
赘	bfvv
缨	snyk
畴	tciz
儡	rtlw
冢	bnvs
辐	itfu
蜈	idwu
珞	wklo
鞑	gzda
咻	kmxq
笈	vnji
扈	hvhu
壑	tahe
骰	gytz
撰	fbvr
鲲	avky
噤	kxjb
煽	hyuj
玺	dwxi
炳	hnbk
捻	fxnm
诶	yuei
嗒	kkda
嗒	kkta
锯	jkju
浣	dehr
窿	bfls
坞	tawu
鑫	jjxb
磷	ualb
蜒	ivyj
噔	kddg
绎	sayi
咔	kdka
扉	hafw
阖	mmhe
穗	hxsv
叁	sssj
茸	cers
踞	zkju
皂	bqzc
璞	wnpu
垢	tkgz
枷	mkjx
珏	wwjt
骋	mgig
矗	uaiu
缇	srti
蹊	zdqi
蹊	zdxi
粟	xmsu
呦	klyz
驸	mcfu
唆	kwso
馒	uymj
寅	bbyb
撮	fyco
撮	fyzo
羹	ydgg
楮	moiu
峦	welr
灶	htzc
餮	udtp
靥	iaye
嬴	wdyk
遐	zvxx
胭	odyj
顼	waxu
榕	mkrs
胯	ogkx
迂	zayu
惦	xkdm
伎	ryji
诬	yrwu
癌	beai
桨	mdjl
黠	hkxx
逵	ztkv
韬	aatc
嫡	nkdi
悼	xudc
喏	kkno
喏	kkre
帛	bjbo
俭	rajm
啄	knvo
咣	kegl
铐	jgkc
咫	ubvi
钳	jcqm
骼	gkge
舷	vsxm
祠	pkci
箍	vjgu
橱	mciu
鳄	agee
袂	pnmw
溟	dbmk
锈	jpxq
篱	vsli
缈	spmn
淤	ddyu
铎	jado
囔	kynh
蚣	isgs
痞	bkpi
吒	kqva
迄	zrqi
稼	hnjx
汀	ddtk
槛	mmjm
槛	mmkj
漉	dllu
椎	mfiv
椎	mfvv
辗	innm
辗	invj
辗	inzj
滤	dxlv
洼	dtwa
醇	yziy
瘤	btlq
桅	mvww
喵	ktmn
亥	wrhd
渝	ddyu
惬	xnqp
淼	ddmn
咛	kdnk
蛾	idee
筛	vjud
髻	akji
幌	jghl
笺	vgjm
憧	xais
梗	mngg
颍	payk
瓢	xgpn
馀	uhyu
殉	doxy
翟	yfdi
翟	yfvd
翟	yfzd
盎	maah
濒	dabb
簧	vbhl
馈	ubkv
孺	zaru
伢	rpya
闽	mimb
楷	mbjp
楷	mbkd
亘	aagf
惴	xavv
瓒	wbzj
笋	vpsy
咀	kqju
幺	vsyc
蒜	cxsr
掂	fkdm
杵	muiu
瞑	obmk
兖	weyj
峒	ekds
峒	ekts
颐	kayi
曜	ofyc
螂	ielh
毗	tvpi
飓	fbju
缆	sjlj
芥	cajp
缤	sbbb
蜿	ivwj
翊	lyyi
卉	uchv
屉	uvti
翱	byao
拴	fwur
湄	domw
稠	hkiz
桦	muhx
鹊	ncqt
咂	kjza
燎	hxln
谏	ynjm
贮	bavu
猥	qnww
峥	eavg
溯	dosu
佼	rfjn
喋	kmdp
喋	kmva
诩	yyxu
渥	dtwo
曝	odbc
剃	dbti
邺	eaye
羔	hygc
匾	kcbm
汲	dnji
邬	epwu
赂	bklu
炜	haww
锢	jkgu
吠	kqfw
锄	jliu
蛤	ikge
蛤	ikha
藻	cmzc
烹	hwpg
蹋	zyta
垦	tvkf
迥	zkjs
岐	eyqi
耷	deda
隘	emai
淬	ducv
嚅	karu
慵	xays
烽	hffg
诲	ydhv
橘	mkju
翌	ylyi
濮	dnpu
蟾	iyij
垣	tayr
锺	javs
抉	fnjt
茬	ctia
啷	kelh
淇	dbqi
硝	uoxn
沥	dlli
褥	pcru
踝	znhk
矶	ujji
骁	mexn
酝	ysyy
梓	muzi
唷	koyo
玎	wddk
憬	xxjk
霭	yvai
蕉	chjn
眦	ovzi
墩	twdy
毡	mkvj
蕃	ctbo
蕃	ctfj
弼	agbi
肇	havc
阑	mdlj
垄	tlls
晟	ovig
晟	ovug
呲	kvci
呲	kvzi
毓	rvyu
痪	bnhr
陇	ells
鳌	afao
袒	patj
谛	yjdi
忏	xuij
拌	fabj
拌	fapj
臾	pnyu
瀛	ddyk
簪	vozj
懵	xomg
纶	svgr
纶	svly
跤	zfjn
胴	okds
浚	dwjy
唏	kjxi
筏	vgfa
甥	nlug
蝗	iwhl
癞	bbld
瓮	bwwg
驮	mddo
驮	mdto
涤	dmdi
捍	fuhj
膺	goyk
铳	jeis
芹	cjqb
嘭	kppg
骥	mbji
炕	hjkh
匐	gtfu
羌	yvql
娓	nmww
壕	tnhc
宓	bdfu
宓	bdmi
隼	ursy
泌	dpbi
泌	dpmi
嗫	kynp
桔	mkjp
桔	mkju
圃	kdpu
抒	fauu
稣	ahsu
瓯	kwou
鲤	aali
磐	uvpj
萃	cucv
魃	gdba
侬	rnns
讼	ysss
萼	cgee
皎	bfjn
簸	vybo
姒	nrsi
叼	kpdn
茎	cgjk
瞿	ofju
瞿	ofqu
剁	djdo
篆	vnvr
羲	ygxi
骡	mslo
鹦	nbyk
蕙	cxhv
隅	edyu
瘸	brqt
炊	hqiv
饷	ukxl
辄	ivve
嘤	knyk
颌	rage
颌	rahe
腆	obtm
嫖	nxpn
惆	xkiz
媲	nvpi
馁	unnw
娉	ngpk
褒	wybc
旖	fkyi
馋	udij
噘	kqjt
呤	kslk
缜	sbvf
荃	cwqr
捋	fclo
捋	fclv
胥	voxu
潺	dzij
卯	epmc
婵	naij
撅	fqjt
涔	dvcf
舫	vffh
柿	mjui
偕	rbxp
汩	dogu
汩	doyu
榨	mava
苞	cvbc
胄	aovz
坍	twtj
麓	lmlu
鸥	nkou
掬	fmju
礴	ucbo
轧	ivga
轧	ivva
轧	ivya
纣	scvz
淀	drdm
糜	gmmw
昙	ostj
壹	udyi
埔	tdbu
埔	tdpu
诃	ykhe
魇	igyj
凋	dkdn
蹂	zmrz
荼	chtu
镑	jfbh
鹉	nawu
臧	gazh
褂	pdgx
筐	vwkl
纨	sdwj
筵	vvyj
轼	idui
蘑	cumo
潞	dklu
榆	mdyu
沣	dffg
黔	hvqm
玟	wwmb
玟	wwwf
婊	nybn
旌	fajk
痉	bgjk
魑	gdii
嫦	njih
卞	ddbm
瘴	buvh
丕	aapi
贽	bfvi
袄	pdao
砾	udli
挛	wulr
麴	umqu
麴	aaqu
腋	odye
隽	rpjr
隽	rpjy
躏	zflb
撂	fkln
偃	rnyj
馅	uaxm
醺	yhxy
嗥	kuhc
渭	doww
阉	mvyj
蟆	idma
盅	mavs
沓	doda
沓	dota
榭	mcxp
睐	onld
婀	nkee
哒	kzda
啬	ukse
郢	ekyk
噼	kupi
琬	wvwj
栓	mwur
冗	bjrs
睚	otya
硫	uvlq
癖	bupi
霈	yjpw
甭	aabg
侏	rnvu
皑	bvai
拄	fwvu
夙	jdsu
渲	daxr
秤	huig
攫	fyjt
岌	enji
遽	zhju
蛆	iqqu
赧	tynj
踵	zavs
汴	ddbm
鸨	npbc
剐	dkgx
窈	blyc
潼	dats
靼	gada
睑	oajm
霁	yaji
沅	deyr
卤	axlu
掰	bubd
攥	fszr
鹭	nzlu
藕	cdou
颚	kaee
蛰	ifve
幔	jymj
腼	oamm
篡	vscr
恣	xdzi
蟠	itpj
噌	kocg
嫔	nbpb
裆	pedh
哺	kdbu
跚	zauj
馥	hwfu
孚	zvfu
僖	rkxi
窕	bdtn
盂	mayu
钊	djvc
囤	kvdy
囤	kvty
喟	kokv
跛	zpbo
刨	dgbc
刨	dgpc
槌	mziv
臊	omsc
苜	comu
渤	dlbo
螳	itth
肾	oauf
荤	cihy
捎	fouc
镭	jtlw
糗	mqqq
薯	couu
徨	rwhl
蜕	ietv
瑙	wxnc
噫	kxyi
鳖	axbp
妤	nayu
谪	ykve
贲	bubf
贲	bubi
隗	egkv
隗	egww
裟	ydua
擞	fwsz
濑	dbld
绔	sgku
鳅	ahqq
戍	gduu
摹	cumo
堑	tiqm
绾	skwj
捱	ftai
捱	fuai
旎	fvni
谄	yaij
谒	yvye
谧	ymmi
嚏	krti
苋	cjxm
恸	xlts
粤	pgyt
姣	nfjn
姣	nfxn
碳	uhtj
殒	dbyy
哂	kxuf
龌	itwo
啾	khjq
蹒	zdpj
蝼	inlz
龊	izio
娼	noih
揩	fbkd
沂	djyi
舶	vbbo
泞	ddnk
啻	lkii
阜	pufu
弋	qdyi
恪	xkke
蜃	iiuf
搪	fkth
辘	illu
挲	udua
娑	ndso
嗝	kage
饺	ufjn
桉	mnan
岖	exqu
杳	moyc
碾	unnm
妪	nxyu
袈	yljx
赈	bnvf
摒	fcbk
孵	pzfu
菡	ckhj
哐	kwkl
羚	yslk
撬	fmqn
颉	uajp
颉	uajx
颉	uaxp
晔	ouye
罔	kvwh
倜	rkti
倌	rkgr
藐	cemn
髦	mamc
猊	qeni
汐	ddxi
颦	vupb
臌	oygu
獒	qfao
粼	mvlb
杞	mvqi
蚌	ifbg
蚌	ifbh
郸	ebdj
揄	fdyu
竣	lwjy
嗲	kddx
瞌	omke
胚	oapw
愠	xmyy
谙	yoan
恁	xrnf
龇	ivzi
啵	kpbo
匍	gdpu
脓	onns
撵	finm
痰	bhtj
蛹	iays
觎	rjyu
畿	vtji
殛	daji
泯	dqmb
讹	yvee
潦	dxln
犁	nhli
苓	cslk
犷	qggl
俟	ruqi
俟	rusi
邝	egkl
弈	wcyi
呓	kgyi
汛	duxy
螓	ihqb
觊	ejji
玷	wkdm
瞰	owkj
槟	mbbb
槟	mbbk
椰	meye
垠	tnyb
邕	vvys
臆	oxyi
钛	jdtd
挎	fgkx
粱	mdll
涸	dkhe
糯	mano
霾	yamd
禧	pkxi
俸	rafg
箕	vbji
坷	tkke
祗	pdvi
熹	huxi
俑	rays
怂	xrss
噙	ksqb
湍	datr
赣	lbgj
芋	cuyu
咝	kasi
潋	dwlm
噶	kvga
巽	vbxy
汕	deuj
仞	rdrf
釜	fafu
鬃	axzs
嗵	kzts
颀	jaqi
锚	jtmc
螭	idii
洵	doxy
犸	qmma
珈	wkjx
魍	gvwh
摁	fxen
疵	bvci
忤	xuwu
汾	ddff
汜	dvsi
琰	whyj
褛	pnlv
惰	xodo
蚯	iaqq
斓	wdlj
觐	cjjb
梆	mebh
漳	duvh
镣	jxln
贻	bkyi
粲	macj
恿	xsys
谲	ykjt
咿	kpyi
咤	kqva
篓	vnlz
飚	fhbn
篑	vbkv
憩	xpqi
椭	moto
睥	oubi
睥	oupi
沽	dkgu
犄	nkji
怏	xnyh
魉	gdll
鼾	puhj
堰	tnyj
齑	waji
帚	ejvz
亟	vaji
镀	jydu
骠	mxbn
骠	mxpn
苯	cabf
宸	bnif
僮	rats
僮	ravl
阗	mbtm
榄	mjlj
辇	ianm
豺	vpid
翦	qyjm
纰	svbi
纰	svpi
阂	mrhe
旃	fwvj
荦	cnlo
蚓	iayb
趄	zqju
趄	zqqp
猬	qoww
劾	wlhe
趔	zdlp
蜻	ioqk
嵘	emrs
铝	jklv
滇	dbdm
呷	kaxx
暹	zoxm
蠡	vili
淄	dtzi
囵	kvly
掸	fadj
掸	fauj
溉	dvgd
坳	tlao
轲	ikke
皋	bugc
骜	mfao
螃	ifph
帧	jbvf
蘅	cdhg
剽	dxpn
坂	tybj
涓	dojr
魈	goxn
怆	xvil
袤	wymc
嗳	kyai
踊	zays
锏	jojm
濡	daru
昀	odyy
鹞	nvyc
氲	qmyy
厩	ivjq
徙	rrxi
瑁	womc
箩	vdlo
斡	uuwo
抠	fxkz
褶	pbve
痣	bxvi
晾	oxll
廿	aanm
揶	feye
炖	hvdy
氤	qdyb
蹩	zxbp
芍	cduc
愫	xssu
玳	wddd
嗬	kkhe
臼	pajq
淅	djxi
嘣	kobg
桧	msgv
桧	mshv
腺	odxm
壬	purf
瘁	bucv
堇	cajb
侗	rkds
侗	rkts
赁	brlb
匝	kjza
孱	uzij
灸	phjq
褴	pmlj
镂	jnlz
畸	tkji
碴	uaia
羯	yvjp
暨	vaji
谤	yfbh
彝	vcyi
嘹	kxln
雹	yvbc
忱	xvif
蔫	chnm
荔	clli
鲛	afjn
硅	utgv
刽	drgv
悖	xzbw
脐	oaqi
骧	myxl
夥	adho
盹	ovdy
孪	wzlr
谆	yzvy
殡	dbbb
诌	yevz
琊	weya
敕	waii
禺	adyu
罂	fbyk
犊	nddu
滟	dvyj
藜	cdli
蟑	iuvh
郦	eali
郦	eavi
绥	snsv
讧	yghs
潢	dbgl
潢	dbhl
夔	qwkv
橄	mwgj
桢	mbvf
酆	eefg
淆	doxn
涮	ddur
蜗	idwo
垛	tmdo
啕	kftc
孬	aznc
臃	ofys
澹	dydj
澹	dytj
耘	lsyy
徵	rwvg
徵	rwvi
銮	wjlr
豚	onty
蓟	cdji
汶	dwmf
汶	dwwf
皿	kamb
遑	zbhl
倨	rkju
燧	hzsv
佻	rdtn
诘	ykji
诘	ykjp
碉	ukdn
摞	fslo
镐	jkgc
镐	jkhc
诽	yafw
掖	fnye
峋	eoxy
戛	agga
戛	agjx
蒯	dckk
叵	kkpo
泗	dssi
鄢	eayj
鏖	ljao
邋	zvla
舐	pqui
獗	qqjt
酉	xayz
煊	haxr
嗟	kgjp
忻	xjxb
泱	dnyh
蔻	cykz
蓁	chvf
琮	wxcs
遢	zota
庖	gvpc
帼	jwgo
琏	wzlm
诋	yddi
骊	mdli
荻	chdi
遨	zfao
俪	rdli
秧	hnyh
怵	xdiu
瘠	boji
诠	ywqr
忪	xsss
忪	xsvs
鹄	nnhu
卟	kdbu
腴	onyu
嶙	ealb
犒	nkkc
挞	fzta
焊	huhj
碱	ukjm
傥	reth
迩	zder
馊	uysz
摺	fbue
摺	fjue
摺	fbve
摺	fjve
珩	wdhg
葳	cnww
绉	sevz
斫	ujvo
跆	zktd
珉	wqmb
泠	dslk
忸	xanq
闩	maur
鸵	nvto
彗	efhv
麝	lcue
耙	lvba
耙	lvpa
岷	eqmb
鸶	vnsi
粽	mxzs
蝈	iwgo
闳	mshs
骛	mswu
佝	rkgz
蜓	iutk
笆	vvba
怩	xvni
奂	dnhr
掇	fydo
艮	vngf
舀	vayc
膘	oxbn
踮	zkdm
匮	kbgv
匮	kbkv
濠	dnhc
狒	qafw
宕	budh
皖	bewj
燮	yhxp
邙	ewmh
喙	knhv
莓	cdmw
颛	eavr
椿	moiy
陲	eaiv
恫	xkds
钹	jdbo
檄	mwxi
绡	soxn
鳍	aoqi
椁	mzgo
偻	rnlv
偻	rnlz
纾	sauu
鹧	ngve
弭	gemi
漕	docc
荑	cnti
荑	cnyi
贰	qber
槿	majb
牒	pmdp
鸢	nqyr
砺	upli
雉	ufvi
鸪	nugu
绺	sklq
橇	mmqn
跻	zaji
轶	inyi
戊	gpwu
猷	qqyz
锹	jhqn
衾	ryqb
钺	jdyt
祚	pazo
闾	mklv
涝	dllc
荥	cdxk
荥	cdyk
逅	zphz
肪	offh
囱	pdcs
洱	deer
峪	ekyu
鄱	eppo
箬	vkro
嫒	nyai
繇	vsyc
繇	vsyz
莆	cdpu
阪	eybj
镳	jhbn
浃	dnjx
佞	rnnk
麋	lmmi
搡	fmsh
蘸	chvj
挝	fzvx
挝	fzwo
岈	epya
唳	kqli
娣	npdi
忾	xqkd
忾	xqxi
戌	gaxu
幄	jtwo
氢	qgqk
霰	ywxm
蔺	cflb
骅	muhx
蚱	iava
谀	ynyu
俦	rciz
昶	doih
撸	folu
狻	qwsr
荏	curf
磬	uuqk
昴	oemc
杈	mdia
闰	mwry
缮	skuj
谚	ypyj
龛	rlkj
鸩	ndvf
谗	ydij
砥	uddi
俎	rqzu
瘀	bdyu
邂	zjxp
沏	ddqi
邈	zvmn
埠	tubu
坯	tapi
咭	kkji
咭	kkka
缙	sojb
蹇	bzjm
俾	rubi
蜚	iafw
箐	vojk
箐	voqk
籽	mzzi
阚	mwhj
阚	mwkj
嗄	kwaa
嗄	kwua
钠	jdna
泾	dgjk
腓	oafw
驽	mnnu
辍	iyio
鞅	gnyh
蹶	zqjt
迤	zryi
诮	yoqn
哔	kubi
赳	zajq
刎	dgwf
聒	ekgo
抨	fupg
腌	ovaa
腌	ovyj
佥	raqm
炷	hwvu
淙	dxcs
饯	ugjm
垩	taee
磺	ubhl
鳗	aymj
钏	jair
氅	mxih
胛	oajx
遛	zplq
涿	dnvo
酪	yklc
糠	mnkh
翕	ryxi
姝	nnuu
佶	rkji
茴	ckhv
呔	kddd
呔	kdtd
檬	mnmg
衩	pdia
柩	mnjq
恹	xqyj
翳	kyyi
纂	vszr
姹	nqia
浒	duhu
浒	duxu
跖	zkvi
琨	wvky
铄	jduo
镌	jpjr
佃	rtdm
佃	rttm
钜	jaju
莅	clli
嗑	kmke
沱	dvto
膻	oadj
膻	oauj
楔	mdxp
徇	roxy
懑	xdmf
豸	vpvi
儆	rwjk
貉	vkhc
貉	vkhe
貉	vkmo
潸	douj
仨	rssa
讫	ygqi
圜	kyhr
圜	kyyr
孀	noul
秣	hnmo
蜍	ihiu
汨	domi
柠	mdnk
唁	kkyj
舄	phxi
呶	kync
戗	rgql
璎	wnyk
莜	cwyz
泸	dulu
谟	ydmo
椋	mxll
扪	fmmf
聃	eadj
辔	kspw
逖	zqti
猡	qdlo
剜	dbwj
佰	rbbd
掴	fwgo
绶	syuz
茁	ckvo
罄	fuqk
町	tddk
町	tdtk
龅	ivbc
蛀	iwvu
诳	ywkl
颧	caqr
嵇	heji
谩	yymj
砝	usfa
殓	dalm
胫	ogjk
螟	ibmk
玖	wnjq
蛭	itvi
祛	psqu
裨	pubi
裨	pupi
赝	ibyj
氐	pddi
湫	dhqq
葆	cmbc
蒺	cuji
睇	opdi
樽	mczy
绦	smtc
涪	dkfu
啮	kknp
锲	jdqp
懔	xxlb
囡	knnj
蹴	zdcu
篙	vkgc
葩	cvpa
濯	dfvo
矍	oyjt
溥	dcpu
藓	cyxm
铨	jwqr
盥	mpgr
黜	hkiu
覃	xuqb
覃	xutj
煅	hydr
谡	ywsu
坨	tvto
淞	dsss
铤	jzdk
铤	jztk
犟	ngjl
璜	wbhl
铀	jayz
驷	mssi
樟	muvh
猕	qxmi
菠	cybo
鱿	adyz
瘌	bdla
诰	ykgc
滂	dfph
葭	cyjx
槁	mkgc
獐	quvh
栾	wmlr
饪	uurf
殄	dptm
栉	mevi
酵	yzjn
噱	knjt
噱	knxt
醐	yohu
锉	jtco
崧	esss
砧	ukvf
蔗	chve
牦	nmmc
榷	mfqt
泵	udbg
嫱	nkql
槊	mquo
醍	yrti
逡	zwqy
赡	byuj
鎏	jdlq
鸷	nfvi
灞	doba
荪	cxsy
骓	mfvv
酗	yxxu
咩	kymp
箴	vkvf
哓	kexn
蚤	yizc
罹	sfli
馍	udmo
滓	duzi
鹗	nkee
釉	payz
棂	mhlk
赊	bxue
熨	huyu
熨	huyy
塾	twuu
瑗	wyyr
锟	jvky
挹	fvyi
夯	dlhh
囫	kphu
诙	yhhv
酡	yvto
痍	bnyi
痿	bnww
绌	skiu
莘	cuuf
莘	cuxb
殁	dymo
兕	aesi
刍	deiu
奘	davl
獬	qnxp
箸	vovu
锷	jgee
崴	enwd
崴	enww
纭	ssyy
骞	bmqm
锃	jwzg
蝮	iwfu
柑	mcgj
秆	hugj
圉	kuyu
馗	jokv
嶂	euvh
莒	ckju
膑	obbb
荟	cshv
豢	bnhr
灏	dahc
脶	odlo
衢	rdqu
仄	irze
鹘	nggu
鹘	nghu
痘	bqdz
嚯	kfho
碇	urdk
晷	okgv
渚	dovu
碜	upif
蛎	ipli
隍	ewhl
砣	uvto
谔	ygee
泅	drqq
骈	mcpm
懋	xmmc
仝	rgts
稔	hxrf
泫	dsxr
哞	knmz
乜	gvmp
乜	gvnp
诓	ywkl
蓿	cbxu
桠	maya
耒	anlw
糅	mmrz
烯	hjxi
镫	jddg
貅	vmxq
猱	qmnc
犴	quan
犴	quhj
纫	sdrf
褓	pmbc
蕲	cjqi
偈	rvji
偈	rvjp
溧	dmli
訇	gyhs
媾	nagz
榛	mhvf
郏	eajx
葺	ceqi
铩	jmua
蚨	infu
掾	fnyr
靛	frdm
螯	ifao
耦	ldou
萋	cnqi
侩	rskk
恽	xiyy
徉	ryyh
枰	mupk
鹜	nswu
褫	phii
琚	wkju
蜮	ikyu
抻	faif
襁	piql
遴	zmlb
蓑	cyso
皈	bygv
娩	nvmm
虱	giui
菟	cdtu
阈	mayu
觞	jpuh
呖	klli
箝	vcqm
狎	qaxx
邳	eapi
轾	itvi
幂	bjmi
阡	euqm
忝	axtm
窳	bgyu
貔	vvpi
炅	ohgv
炅	ohjs
舢	veuj
铢	jmvu
糨	mijl
髭	avzi
抟	fdtr
沆	djhh
铣	jexi
铣	jexm
腩	ounj
烩	hshv
锴	jbkd
殚	dadj
秸	hkjp
砀	updh
氮	qhdj
孑	vajp
愎	xwbi
睢	ofsv
逦	zali
薜	cubi
嘞	klle
嘞	kllw
狴	qtbi
悌	xpti
猢	qohu
爻	xxyc
牍	pddu
羸	wdlw
囗	aaww
撺	facr
鹑	nwiy
缃	soxl
饽	uzbo
嶷	eryi
蒿	ckhc
蝾	imrs
稹	hbvf
雒	wflo
仃	rddk
俅	rdqq
狍	qvpc
梏	mkgu
橐	amto
韪	oaww
橹	molu
鳕	aext
轸	ipvf
黢	hwqu
徜	rkih
桎	mtvi
鬣	aalp
擢	ffvo
肓	wohl
泷	dlls
泷	dlul
镏	jtlq
呙	kdgo
呙	kdgx
呙	kdhe
呙	kdwa
呙	kdwd
呙	kdwo
璺	pwwf
铡	jdva
碘	ubdm
镁	jdmw
伥	rnih
珐	wsfa
辂	iklu
崂	ellc
炝	hvql
祉	pvvi
狲	qxsy
榔	melh
钙	jggd
媪	nmao
珲	wihv
珲	wihy
肛	oggh
濂	dnlm
芩	cvqb
诿	ynww
镞	juzu
鼬	uayz
臬	pmnp
岫	eaxq
氯	qdlv
阆	mnlh
箔	vbbo
貊	vbmo
澧	ddli
饨	uvty
蜇	ifve
馄	uvhy
蜢	immg
镛	jays
寮	bxln
蛔	ikhv
诨	yihy
酊	yddk
璁	wxcs
骢	mxcs
砒	uvpi
纛	fsdc
楸	mhqq
蟊	simc
煲	hrbc
爿	appj
谌	yvif
谌	yvuf
狷	qojr
聩	ebkv
媸	niii
掼	fbgr
蛐	iaqu
莠	cpyz
钨	jawu
镝	jkdi
怼	xydv
旮	joga
酩	ykmk
韫	amwf
韫	amyy
诟	ykgz
硭	uvmh
摈	fbbb
蚋	idrv
赭	tove
絷	sfvi
歃	pqua
黩	hddu
耆	toqi
闱	maww
嘬	kyzo
飨	vuxl
茯	cqfu
邴	eabk
缛	scru
驺	mezz
訾	yvzi
轱	ikgu
卅	aasa
祆	pdxm
鲧	asgy
甯	bank
甯	bdnk
蹉	zgco
氨	qnan
遒	zqqq
僭	rojm
谯	yhqn
倥	rgks
孢	zvbc
嵬	egww
誊	bytg
旯	ojla
妁	nduo
岬	eajx
孛	uzbw
泖	demc
裾	pkju
榈	mklv
荚	cnjx
跎	zvto
囿	koyz
悒	xvyi
檑	mtlw
谥	ymui
谶	ygif
蚺	iarj
痂	bkjx
虺	aihv
牯	nkgu
镗	jtth
煨	hnww
饴	ukyi
獾	qfhr
眇	opmn
闫	msyj
伉	rjkh
祧	pdtn
胪	oulu
啖	khdj
钴	jkgu
揆	fdkv
苻	ccfu
錾	jizj
鼹	unyj
阒	mqqu
笞	vkii
豕	anui
耄	tmmc
撷	faxp
椤	mdlo
痔	bcvi
菀	cvwj
菀	cvyy
嫫	ndmo
蟋	ixxi
拮	fkjp
拮	fkjx
暝	obmk
岿	eekv
阕	mdqt
滁	dhiu
弁	scbm
弁	yubm
荇	cdxk
逶	zhww
蚪	iudz
喑	koyb
蟀	iuuk
嘁	kxqi
糸	vxmi
糸	avmi
糸	vxsi
糸	avsi
茕	cuqs
埙	tbxy
獭	qbta
觥	jegs
晗	okhj
蝌	iuke
俚	rali
磔	umve
墒	tkuh
搽	fmia
滦	dmlr
姘	ncpb
湎	damm
螫	itui
螫	itve
畹	tvwj
笮	vaze
笮	vazo
饬	ulii
菅	ckjm
肱	osgs
徕	rnld
傈	rmli
汞	gdgs
蓐	ccru
徭	rfyc
鳝	akuj
巯	vvqq
鲽	amdp
铆	jemc
剡	dhuj
剡	dhyj
猁	qdli
柚	mayz
逑	zaqq
捭	fubd
脔	wrlr
鬈	avqr
哙	kskk
铂	jbbo
挈	ufqp
绻	svqr
跹	zzxm
瑷	wyai
铖	jvig
炻	huui
癣	byxr
颢	oahc
裱	pybn
蕤	carv
悱	xafw
猞	qkue
赅	brgd
楹	mmyk
恚	xthv
潍	dfww
衽	purf
貘	vdmo
钎	juqm
凼	kddh
蜉	izfu
粕	mbpo
钿	jtdm
钿	jttm
涞	dnld
雩	ygyu
鲫	aeji
傩	rfno
莳	ccui
斛	juhu
珙	wbgs
纥	sgge
纥	sghe
筅	vexm
胰	onyi
荜	cubi
焘	hfdc
焘	hftc
怄	xxou
栎	mdli
栎	mdyt
讴	yxou
洌	ddlp
觜	jvzi
觜	jvzv
瘙	bisc
唿	kxhu
缳	syhr
戕	vgql
锝	jcde
埂	tngg
拊	fcfu
讦	yujp
螈	ixyr
锌	juxb
郗	exxi
仵	ruwu
烊	hyyh
篁	vwhl
搴	buqm
獍	qejk
杷	mvpa
脍	oskk
醴	ydli
鹂	nali
邰	estd
郜	engc
纩	sgkl
堞	tmdp
鹬	nsyu
牝	nvpb
湟	dwhl
酃	eylk
冼	dexm
氦	qrhd
锒	jnlh
篾	vdmp
缦	symj
杌	mewu
硌	ukge
硌	uklo
骝	mtlq
碣	uvjp
碣	uvya
鏊	jfao
虻	ivmg
膂	oflv
咴	khhv
缟	skgc
荞	caqn
偬	rxzs
暾	owty
窨	boxy
窨	boyb
鼐	gvnd
帏	jaww
洮	ddtc
胱	oegl
铉	jdxr
鲟	acxy
竦	lnss
虢	vhgo
椽	mnir
韭	aajq
佤	rwwa
蕨	cqjt
狯	qskk
屐	uyji
癯	bfqu
鳃	axsd
苌	cnih
侔	rnmz
腚	ordk
腱	ozjm
圻	tjqi
圻	tjyb
痨	bllc
眙	okii
眙	okyi
竽	vuyu
缢	smyi
辚	ialb
尜	xxga
趺	znfu
茔	ctyk
蝰	itkv
囹	kslk
洇	ddyb
鼋	evyr
芫	ceyj
芫	ceyr
赍	buji
宥	boyz
樘	mtth
酶	ydmw
墉	tays
嘌	kxpn
恂	xoxy
罅	fuxx
镊	jynp
椴	mydr
彀	uygz
洹	dahr
盱	ouxu
噻	ktsd
旄	fmmc
犍	nzjm
犍	nzqm
庹	gnto
欹	dqqi
珥	weer
吡	kvbi
吡	kvpi
撄	fnyk
狃	qanq
裢	pzlm
镙	jslo
圩	tuww
圩	tuxu
铬	jkge
馐	uaxq
峄	eayi
馏	utlq
搠	fouo
炔	hnqt
踟	zkii
鼍	kvto
仟	ruqm
鹌	ndan
戡	qgkj
苫	ckuj
襦	paru
擀	fugj
娈	wnlr
昃	orze
荛	cerc
龈	inkf
龈	inyb
焖	hxmf
诤	yavg
峤	eajn
峤	eaqn
犰	qjqq
蟥	ibhl
蹼	znpu
殳	jyuu
妣	nvbi
楫	meji
燹	haxm
缱	szqm
厣	iayj
傣	rddd
狁	qeyy
帔	jppw
锰	jmmg
圄	kkyu
痢	bdli
嵯	egco
樨	mnxi
纡	suyu
畲	rtue
瘐	bnyu
腭	ogee
瓴	rwlk
蠹	aidu
裣	palm
郓	ebyy
柞	mava
砦	vuvd
杼	mavu
闼	mzta
鞒	gaqn
芨	cnji
蛉	islk
骐	mbqi
吖	kaaa
吖	kaya
瘿	bnyk
笳	vkjx
郧	ekyy
黟	hdyi
舛	pair
钾	jajx
憷	xriu
稞	hnke
颏	wake
佚	rndp
佚	rnyi
苡	cryi
勐	zlmg
淖	duio
淖	dunc
淖	duvo
澍	dcuu
澍	dcvu
勖	klxu
铰	jfjn
褡	pkda
诜	yeuf
薨	cvhs
濉	dfsv
檫	mxia
郇	eghr
郇	egxy
骘	mevi
凫	njfu
垭	taya
罨	svyj
邗	eahj
钯	jvba
搦	fdno
荠	caji
荠	caqi
喁	kdys
枋	mffh
浔	dcxy
煸	hcbm
矽	udxi
苕	cktn
苕	ckuc
謇	byjm
垓	trgd
沔	dvmm
粑	mvba
蝓	idyu
躅	zivu
锨	jqxm
瀣	daxp
迓	zaya
杓	mdbn
杓	mduc
喈	kbjp
烷	hewj
矾	udfj
缁	stzi
蜊	idli
陉	egxk
堠	tuhz
鄯	eyuj
幛	juvh
愀	xhqn
瓤	wgrh
蕈	cuxy
踯	zevi
鲵	aeni
刭	dvjk
怫	xafu
罴	hspi
坩	tcgj
焙	hkbw
氰	qoqk
渑	dvmm
渑	dvug
疥	bajp
肜	oprs
厶	vdsi
氟	qafu
鲰	ayzz
疟	bant
疟	bayc
笫	vpzi
褰	byqm
痼	bkgu
鲑	atgv
鲑	atxp
黍	hduu
沭	dduu
缗	somb
菸	cdyj
菸	hdyj
悭	xtqm
疱	bvpc
衿	pvjb
艏	vouz
裎	pwig
孳	qzzi
庠	gyxl
旒	fvlq
栳	mvlc
茏	clls
阄	mvjq
亳	wqbo
艨	vnmg
邛	egqs
麂	ljji
尻	ujkc
樯	mkql
豌	dvwj
踽	zdju
鲈	aulu
艄	vouc
鲶	axnm
眭	otgv
眭	otsv
陂	epbw
陂	eppi
陂	eppo
榉	maju
氖	qpnd
笏	vphu
廪	gxlb
怛	xada
蚍	ivpi
铙	jenc
殍	dzpn
泶	xdxt
淝	dvfw
菘	csss
蒹	cnjm
忉	xddc
桁	mdhg
桁	mdhh
疹	bpvf
蝣	izyz
喱	kali
妊	nurf
萑	cfhr
擘	uubo
逋	zabu
埚	tdgo
苒	carj
锗	jove
唢	kbso
谰	ydlj
歙	rque
歙	rqxi
焯	huic
焯	huvo
矬	utco
疽	bqju
艟	vais
趸	azdy
蹰	zciu
荩	cdjb
縻	gsmi
亍	eaiu
佧	rdka
叻	klle
趿	znta
勰	lxxp
嘏	uygu
桫	mpso
侪	raid
疴	bkke
翥	tyvu
蚝	imhc
鲠	angg
雎	qfju
毂	uygu
茑	cnnn
觚	jggu
阋	mexi
洄	dkhv
焓	hkhj
跗	zcfu
猗	qkyi
胺	onan
鹕	unhu
笤	vktn
跸	zubi
钬	jhho
镪	jiql
馕	uynh
疡	bpyh
篦	vvbi
鹈	nbti
踅	zfxt
棼	mdff
睾	pugc
鹳	ncgr
漭	dcmh
烃	hgtk
瞽	ougu
逄	zwph
锍	jvlq
哚	kmdo
砬	ulla
砬	ulli
蝥	ismc
钲	jvvg
陟	epvi
耋	ttdp
酮	ykts
塄	tflg
痫	bmxm
蚧	iajp
埘	tcui
枸	mkgz
枸	mkju
柢	mddi
柢	mdii
潆	dsyk
笄	vcji
醮	yhjn
彖	vntr
稗	hubd
窠	bnke
萘	cxnd
郯	ehtj
掮	foqm
尢	uvyz
鲇	aknm
鼙	uupi
畦	ttqi
舸	vkge
帑	jnnu
帑	jnth
睃	owso
蚜	ipya
溘	dmke
蠃	wdlo
岢	ekke
矸	uugj
鸱	npii
狳	qhyu
祜	pkhu
囟	pxxb
扦	fuqm
枥	mlli
庾	gnyu
菔	cyfu
蟛	ippg
嗉	kssu
擤	faxk
莪	cdee
觋	pjxi
醪	yplc
倬	ruvo
爰	vyyr
蚰	iayz
轳	iulu
锱	jtzi
鬻	gayu
鳏	adgr
栲	mgkc
渌	ddlu
蛄	ikgu
嬗	nauj
谘	ykzi
鋈	jdwu
阍	mohy
杲	omgc
柘	muve
毖	adbi
禳	pyrh
馔	ubvr
鳐	afyc
鳟	aczy
耔	lzzi
辊	ivgy
镍	jmnp
侑	royz
娠	nnuf
槎	mgia
芾	cjfu
芾	cjfw
豳	eabb
钤	jvqm
锕	jkaa
孥	znnu
綦	qsqi
锑	jpti
洙	dnvu
榫	musy
疣	bdyz
砭	unbm
筮	vrui
酽	yiyj
愆	xrqm
栀	mvvi
耪	lfph
薅	cchc
蜞	ibqi
崤	eoxn
椟	mddu
糁	mpuf
茇	cdba
啁	kktn
啁	kkvc
啁	kkvz
氪	qeke
萁	cbqi
龃	iqju
墀	tnii
芪	cqqi
莰	cqkj
菏	ckhe
嵊	enug
蛩	igqs
鞯	gzjm
楂	maia
楂	mava
缒	szvv
乩	avji
捌	fdba
毽	mzjm
愍	xvmb
瘢	bybj
铋	jpbi
铧	juhx
髋	gjkr
鹚	nqci
儋	rydj
奁	dxlm
樾	mvyt
滹	dahu
穑	hkse
茌	cuii
骶	gddi
刖	doyt
嫜	nuvh
溏	dkth
螽	wivs
囝	kzjm
戽	huhu
橛	mqjt
舂	fais
遄	zeir
坭	tvni
澶	daij
熵	hkuh
镬	jyho
飧	pusy
枞	mrcs
枞	mrzs
柙	maxx
硎	udxk
缯	sozg
蔌	cqsu
鲂	affh
冱	dahu
岙	peao
殂	dqcu
艉	vmww
蠼	iyqu
匏	dvpc
痈	bays
鹾	agco
尕	gxga
攮	fynh
樗	mgiu
皲	bpjy
髡	aeky
坻	tddi
坻	tdii
伧	rvcf
伧	rvif
剀	dekd
椐	mkju
瓠	dghu
讣	ydfu
髁	gnke
龉	ikyu
彘	vvvi
棹	muvc
棹	muvo
疠	bpli
薮	cwsz
隈	enww
龋	idqu
朐	okiy
朐	okqu
橼	mnyr
芰	cyji
圹	tgkl
敉	wmmi
暌	odkv
饧	upxk
泔	dcgj
赜	kbze
黧	hhli
筚	vubi
蓖	cvbi
鸬	nalu
蚬	ijxm
醯	ymxi
钪	jjkh
餍	iuyj
鸹	npgx
哏	kngf
哏	knhf
甑	bwzg
疋	vrpi
膣	otvi
螅	ixxi
锞	jnke
髫	aktn
宄	bjgv
摭	fhvi
檠	mcqk
盍	mthe
绂	sdfu
骟	myuj
棰	maiv
缡	ssli
苷	ccgj
蹁	zcpm
铗	jnjx
鞣	gmrz
圯	tvyi
涑	dnsu
箜	vgks
芎	cgxs
蔟	cucu
觯	javi
鍪	jsmz
镟	jrxr
夤	pbyb
妫	ndgv
熘	htlq
硼	uopg
秫	hduu
阏	mdee
飑	fvbn
啭	kdvr
枳	mbvi
礅	uwdy
耨	lcnz
茭	cfjn
钡	jbbw
捩	fqlp
柁	mvdo
柁	mvto
苴	cqia
苴	cqju
铊	jvta
铊	jvto
寤	bkwu
牖	pdyz
赀	bvzi
醚	yzmi
柽	mtig
栌	milu
肄	payi
脘	oewj
酎	ycvz
鲳	aoih
柒	mdqi
浠	djxi
蛳	ijsi
壅	twys
枇	mvpi
楱	mdzz
焐	hkwu
秭	hpzi
笥	vksi
茈	cvci
茈	cvzi
蒌	cnlz
谵	yyvj
跏	zkjx
镆	jdmo
怙	xkhu
枵	mgxn
痱	bafw
膈	oage
卮	pvvi
圊	koqk
圮	tvpi
堀	teku
氚	qair
皴	spcy
绐	skdd
蟮	ikuj
邡	effh
庑	gvwu
廨	gnxp
钭	judz
觳	uyhu
闶	mjkh
檗	mubo
漯	dslo
漯	dslw
漯	dsta
瓿	lwbu
眚	noug
芴	cphu
芴	cpwu
诂	ykgu
郴	meif
鳓	alle
俣	rdyu
徼	rwjn
桡	menc
桡	merc
楗	mzjm
莨	cnlh
莨	cnll
酰	yexm
雠	yfiz
喾	xkku
揿	fqqb
笊	vvvc
苎	cavu
黥	hxqk
僳	rmsu
芏	ctdu
菖	coih
蓊	cywg
袢	papj
馑	uajb
卺	vvjb
垆	tulu
旆	fjpw
曛	ohxy
汊	ddia
硒	uxxi
穰	hyrh
粳	mnjk
酾	ydud
酾	ydui
鲷	akdn
鹣	nqjm
塬	txyr
曩	oynh
莴	cdwo
蕞	cyzv
蘖	cmnp
怃	xvwu
欤	aqyu
玢	wdbb
玢	wdff
蕖	cmqu
镒	jmyi
厝	ioco
坶	tdmu
屣	urxi
揎	faxr
榧	mafw
芑	cvqi
蓥	cjyk
钣	jybj
鬲	aage
鳔	axbn
鼗	eytc
仂	rlle
婺	nswu
嫠	anli
愦	xbkv
癍	bwbj
癔	bxyi
碓	ufdv
箧	vnqp
缶	rkfz
缶	fffz
缶	rkgr
缶	ffgr
蘧	czqu
妗	nvjb
幞	jnfu
沤	dxou
痦	bkwu
蛑	inmz
詈	syli
钚	jdbu
铴	jpth
锆	jkgc
丌	aaji
岘	ejxm
枧	mjjm
柰	mxnd
浜	dbbb
浜	dbbh
蓼	cpln
蓼	cplu
蛞	ikko
鄣	elvh
偾	rbff
藿	cfho
酢	yacu
酢	yazo
铟	jdyb
锛	jcbf
阊	moih
骖	mpcj
鲆	aupk
檩	mxlb
燔	htfj
猓	qmgo
蘼	cami
趵	zdbc
酲	ywig
鹩	nuln
乇	pvto
乇	pvve
屙	ukee
揸	fava
碛	ubqi
笸	vkpo
赓	gbgg
鄄	exjr
铱	jyyi
黻	adfu
伲	rvni
缂	sgke
蜣	ivql
蜩	iktn
谝	ycpm
铍	jppi
伛	rxyu
傧	rbbb
揠	fnya
昝	wozj
溽	dcru
胙	oazo
萏	cadj
隹	rfvv
麈	lwvu
妯	navz
孓	vnjt
溱	dhqb
溱	dhvf
碚	ukbw
蕺	caji
锊	jclt
镧	jdlj
髀	gubi
坫	tkdm
崃	enld
戢	kgji
糌	mozj
缬	saxp
邶	eabw
坼	tdie
梃	mztk
瞢	comg
缧	sslw
菽	cyuu
豉	dyii
仳	rvpi
堙	ttyb
忭	xdbm
砷	uauf
筌	vwqr
箪	vadj
艿	cpnd
郅	eavi
鲢	azlm
鳎	ayta
厍	iiue
哕	kdhv
哕	kdyt
廑	gajb
廑	gaqb
敫	wbjn
栊	mlls
癜	bydm
碹	uaxr
磙	uygy
笾	vzbm
篪	vhii
缌	sxsi
苣	caju
苣	caqu
荨	ccqm
荨	ccxy
诹	yyzz
诼	ynvo
钒	jdfj
嗍	koso
槠	movu
欷	xqxi
淦	djgj
甏	wubg
胝	odvi
蓍	coui
蛱	injx
裉	pnkf
辏	idcz
颞	eanp
麸	fnfu
娌	nali
椹	mvuf
椹	mvvf
缫	snsc
翮	ayhe
诒	ykdd
诒	ykyi
郾	ekyj
铯	jvse
锂	jali
鞫	gyju
卣	aayz
圬	tgwu
尥	jdln
槲	muhu
氘	qadc
瘘	bnlz
耩	lajl
轫	idrf
迨	zsdd
馓	uwsj
啉	kmlb
啉	kmlj
圪	tgge
泺	ddlo
熳	hymj
璩	wnqu
胗	opvf
苁	crcs
薹	cttd
薹	cktd
锘	jkno
阌	mywf
鳊	acbm
唑	ktzo
溻	dyta
瘰	bslo
砗	uiie
砩	uafu
砩	uafw
羝	yddi
茺	ceis
蓠	csli
俳	rapd
刳	ddku
唣	kqzc
悝	xakv
悝	xali
慊	xnqm
慊	xnqp
瘳	bpiz
茼	ckts
麇	lhjy
麇	lhqy
黾	kvmb
黾	kvmg
黾	kvmm
嗾	kusz
嵛	edyu
杩	mmma
狨	qurs
狺	qkyb
痧	bpua
砜	uffg
缍	sado
芡	cqqm
蓣	cayu
顸	aahj
槭	mxqi
槭	mxse
溲	dysz
痤	btco
眄	ovmm
糍	msci
葚	cvuf
郐	ergv
郐	erkk
酹	yclw
镢	jqjt
隳	exdo
隳	exhv
鹋	ncmn
唛	kwma
唛	kwmd
嬖	nubi
怍	xava
朊	oerr
涫	dkgr
绲	svgy
胼	ocpm
腧	oduu
葑	ccfg
蠓	inmg
踬	zbvi
鞲	gagz
饫	udyu
刈	dxyi
垲	tvkd
嵴	eoji
帻	jbze
旰	ougj
旰	ouhj
畚	stbf
荭	cghs
萸	cnyu
蘩	csfj
颃	wahh
颟	camj
鸲	ngqu
龠	rcyt
呒	kvom
嗌	kmai
嗌	kmyi
疸	badj
硖	unxx
绁	svxp
耧	lnlz
蚴	ilyz
蛸	ioxn
裰	pydo
謦	yuqi
跣	zpxm
踺	zzjm
逯	zvlu
陔	ergd
凇	dsss
堋	tobg
堋	topg
屦	unju
峁	eemc
廛	gtij
栝	mkgx
栝	mkko
栝	mktm
磴	uddg
篌	vuhz
芘	cvbi
芘	cvpi
葸	cxxi
薏	cxyi
踔	zuio
鄞	ecyb
醢	ymhd
铒	jeer
镲	jxia
鲮	awlk
仉	rjvh
侉	rgkx
桄	megl
泮	dapj
燠	hnyu
皤	btpo
粝	mpli
蹀	zmdp
颡	yash
鲞	baxl
唪	kafg
嗪	khqb
掭	fxtm
畈	tyfj
簦	vddg
绨	spti
胍	oggx
胲	orhd
舻	vilu
铘	jeye
锩	jvjr
鲋	acfu
崮	ekgu
庋	gygv
毳	mmcv
箅	vabi
缣	snjm
菹	cqzu
虿	aiid
谇	yusv
贶	bekl
陧	etnp
隰	ehxi
僬	rhjn
匦	kjgv
垧	tkuh
疔	bddk
肭	odna
蝤	iyqq
谖	yyxr
趑	zqzi
轭	ivee
酐	yugj
醅	ykpw
醑	yoxu
醛	ywqr
锬	jhtj
劂	dijt
垅	tlls
悛	xwqr
戥	ogdg
拶	fdza
拶	fdzj
硷	uajm
笕	vjjm
簟	vudm
莼	cviy
蒴	couo
藁	cmgc
诖	ytgx
谠	yedh
谳	yqyj
邾	epvu
陴	eupi
鬏	ahjq
龀	ivif
剞	ddji
劬	glqu
埸	tpyi
嬲	nlnn
嵝	enlz
搿	ruge
柝	mdto
桴	mzfu
洧	doww
浯	dkwu
疝	beuj
笱	vkgz
肽	odtd
舯	vavs
艋	vmmg
芤	cvkz
葙	coxl
鲔	aoww
鸸	naer
佾	royi
墁	tymj
嫘	nslw
榇	mmif
煳	hohu
硪	udwo
礞	unmg
菰	cggu
蚵	ikee
趱	zbzj
躜	zbzr
钼	jomu
鲱	aafw
匚	avkl
呋	knfu
媵	onyk
崦	evyj
楝	mnlm
潲	douc
獯	qhxy
瘵	bxvd
绀	scgj
绋	safu
莩	czfu
觫	jnsu
辋	ivwh
镡	juij
镡	jutj
镡	juxb
髂	gkqx
鬯	kvih
鹨	nylq
亓	eaqi
劓	dpyi
埕	twig
曷	ovhe
洚	dajl
碲	ujdi
磲	umqu
粜	emtn
绱	skuh
芄	cdwj
酚	ydff
铪	jkha
铪	jkke
髌	gbbb
鲥	acui
俜	rgpk
刿	degv
吣	kxqb
垤	ttdp
枘	mdrv
氽	rdty
溷	dnhy
甍	cwmg
笪	vada
胬	rnnu
舨	vybj
芟	cyuj
蒽	cxen
銎	jgqs
铵	jnan
锶	jxsi
骱	gajp
鹆	nbyu
岣	ekgz
岵	ekhu
怿	xayi
慝	xkte
挢	fajn
掎	fkji
毹	rmuu
汆	rdcr
沲	dvdo
湔	ddjm
甙	cqdd
罟	skgu
羼	uyij
菝	cdba
讵	yaju
诎	ykqu
谮	yozf
赉	bald
郄	exqp
郄	exxi
鐾	jubw
鲎	xahz
啶	krdk
塍	otig
屺	evqi
庥	gmxq
掊	fkpz
撙	fczy
柃	mslk
檎	mdqb
毵	smsj
渖	dauf
砘	uvdy
窭	bnju
肟	ogwo
蔸	cedz
蚶	ichj
蛏	itig
躞	zyxp
酯	yovi
锾	jyhr
饩	uqxi
劢	almd
嘧	kemi
嵫	eszi
擐	fyhr
湓	dmpf
蝻	iunj
蠖	iyho
觖	jnjt
跬	ztkv
鳜	aqgv
鳜	aqjt
仡	rgge
仡	rgyi
垌	tkds
垌	tkts
氆	mopu
氇	molu
汔	dgqi
篼	vedz
缑	sugz
舾	vxxi
莸	cdyz
蛲	ienc
蠛	icmp
蠲	qijr
褊	pcbm
醣	ykth
骀	mktd
倮	rnlo
僦	rdjq
崾	enyc
渫	dmxp
瘗	btyi
箦	vbze
肼	oajk
腽	omwa
臁	onlm
舳	vavu
芈	aami
荽	cnsv
蒉	cbkk
蒉	cbkv
蛴	iaqi
袼	pkge
跫	zgqs
遘	zagz
儇	ryxr
埽	tjsc
庀	gvpi
戆	xlgh
戆	xlvl
扃	hkjs
搛	fnjm
杪	mpmn
浼	dvmw
滏	dafu
瓞	gndp
疃	tatr
砟	uava
硗	ueqn
禊	pdxi
篥	vmli
簋	vmgv
綮	shqi
綮	shqk
苤	capp
踣	zkbo
躐	zvlp
酴	yhtu
钽	jatj
锸	jaia
锼	jysz
阃	mmky
鞔	gvmf
鞔	gvmj
鲭	aoqk
鹪	nrjn
黪	hpcj
黼	adfu
榀	mkpb
榘	muju
榘	uaju
浍	dshv
浍	dskk
炱	shtd
煺	hztv
犋	nbju
砻	luls
秕	hvbi
籼	mexm
耜	lksi
肀	vayi
肫	oviy
肫	ovvy
肷	oqqm
胂	oauf
莛	cutk
裥	pojm
逭	zbhr
钋	jdpo
钌	jaln
钸	jjbu
髑	gidu
鳆	awfu
鼯	ukwu
佴	reer
佴	rend
吲	kayb
帱	jccz
帱	jcdc
帱	jciz
搌	fnvj
擗	fupi
桷	mjjt
氡	qdds
氩	qaya
溴	dqxq
畋	wttm
硐	ukds
糇	muhz
腠	odcz
葶	cdtk
袷	pkqx
陬	eyzz
黉	xbhs
龆	iktn
哜	kaji
埴	tqvi
岜	evba
徂	racu
惝	xkih
惝	xkth
烀	hahu
眢	opyr
瞵	oalb
筇	veqs
簏	vllu
芗	cpxl
蝽	ioiy
蟪	ixhv
郫	eppi
钕	jnnv
钫	jffh
镉	jage
镘	jymj
颥	yaru
黹	advi
坜	tlli
埤	tupi
廾	aags
彳	paii
楦	maxr
氙	qexm
澌	djsi
畛	tpvf
疳	bcgj
瘅	badj
砉	fuhx
砉	fuxu
砹	uxai
碡	udvz
穸	bdxi
缵	sbzr
羟	ygql
膦	oalb
菪	cudh
虼	igge
蛘	iyyh
螨	idmj
裼	ppti
裼	ppxi
迕	zrwu
铈	jjui
锇	jdee
锔	jkju
锪	jxho
镓	jnjx
镦	jwdv
镱	jxyi
霪	yuyb
骒	mnke
鹁	nubo
冁	bnij
哿	lkge
噍	khjn
埝	txnm
弪	ggjk
攉	ffho
浞	dzvo
潴	dovu
畀	tabi
籴	rmdi
罱	sulj
羰	yhth
胨	odds
胩	odka
舴	vaze
苊	cvee
茆	cemc
茛	cngf
蒇	cbij
虮	ijji
蠊	inlm
裒	wypz
襞	yubi
觇	ajij
轺	ikyc
锿	jyai
髹	amxq
鸫	nads
哌	knpd
垸	tehr
垸	teyr
埏	tvuj
埏	tvyj
墼	taji
帙	jnvi
悃	xmky
揲	fmue
晡	odbu
榍	moxp
榱	mycv
殪	ddyi
淠	dapi
淠	dapw
漤	dnlj
疬	blli
砑	upya
缲	smqn
缲	smsc
罘	sdfu
苈	clli
萆	cubi
谂	yxuf
鄹	eezz
酞	ydtd
钔	jmmf
铥	jsdq
镅	jomw
髟	apbn
鲡	adli
鲦	amtn
鳇	awhl
鹇	nmxm
鹱	nyhu
埒	tclp
岽	edds
悫	xuqt
攵	pxwf
桊	bmjr
桕	majq
槔	mugc
溆	dyxu
漶	dxhr
牾	nkwu
畎	tqqr
疖	bejp
矧	uauf
稂	hnlh
窀	bvvy
籀	vtvz
腈	oojk
苄	cdbm
薷	caru
褙	pobw
赙	bcfu
跽	zxji
钐	jpuj
锖	joql
镎	juna
饔	wuys
骣	mzij
鳙	aays
坌	tbbf
氍	omqu
沩	ddww
洫	dxxu
澉	dwgj
瀹	dcyt
爨	phcr
珧	wdyc
瘊	buhz
瞍	oysz
硇	uxnc
筘	vkkz
粢	mdci
粢	mdzi
聍	ednk
舁	pcyu
艚	vocc
荸	czbi
蜱	iupi
钍	jttu
铞	jjdn
铫	jddn
铫	jdtn
铫	jdyc
骺	gkhz
鲼	abff
劐	dcho
哳	kjva
唼	knua
忮	xyvi
恝	xfjx
戋	adjm
椠	miqm
瘕	byjx
瘕	byxx
瘛	bxii
瘼	bdmo
祓	pdfu
窆	bnbm
窬	bdyu
篚	vafw
粞	mxxi
羧	ywso
脬	ozpc
艽	cjjn
艽	cjqq
葜	cdqx
蓰	crxi
觌	ujdi
豇	dgjl
轵	ibvi
醵	ynju
铌	jvni
镄	jbfw
阼	eazo
鞴	gabw
鲅	adba
鲒	akjp
埯	tvan
恧	xanv
憝	xwdv
搋	fhik
氕	qppp
洳	dkru
浈	dbvf
濞	dabi
濞	dapi
礤	uxca
聱	efao
艹	aacc
蟓	inxl
襻	pupj
趼	zcjm
迮	zrze
钆	jvga
铷	jkru
镨	jopu
驵	mqzh
鲣	atjm
鳘	armb
鸺	rnxq
嚆	kkhc
堍	tvtu
嶝	eddg
巛	vvve
廒	gwao
桤	mvqi
橥	mqvu
爝	hcjt
甾	vtzd
痄	bava
癀	bbhl
筲	vouc
箨	vato
罾	sozg
耵	eddk
舣	vdyi
荬	cdmd
蕹	cfwg
诔	ynlw
赆	bdjb
蹯	ztfj
钇	jgyi
钶	jkke
铕	joyz
镤	jnpu
鲚	aaji
鲻	atzi
鳢	adli
鹛	nvmw
塥	tage
庳	gubw
怊	xkic
捃	fkjy
揞	foan
揞	foye
揞	foyj
洎	doji
涠	daww
滠	dyue
猸	qomw
甓	wupi
瘃	bnvu
瞀	osmc
砼	ugts
礓	uajl
绠	sngg
耱	lumo
脎	omsa
脒	ommi
脞	otco
萜	cktp
蕻	cbhs
薤	caxp
跞	zdli
跞	zdlo
轹	idli
锎	jckd
锓	jyqb
馇	uaia
鲐	aktd
鲩	aehr
仫	rsmu
垡	trfa
垴	tknc
岍	ecqm
崞	ezgo
枨	mnig
毪	mnmu
牮	nrjm
癃	bals
眍	oxkz
眵	odii
稃	hzfu
筢	vvpa
腙	oxzs
舭	vvbi
菥	cjxi
蜾	ingo
螬	iocc
螵	ixpn
衄	xanv
谫	ydjm
躔	ztij
郛	evfu
酤	ykgu
钷	jkpo
锫	jkpw
镩	jacr
阢	eewu
阢	eeww
鼷	udxi
劁	drqn
埭	tndd
墚	tmll
摅	fxuu
撖	fwhj
泐	dlle
滗	dmbi
牿	nkgu
犏	ncpm
猹	qaia
猹	qava
疰	bwvu
痃	bsxr
痖	baya
瘥	bgcd
瘥	bgid
磉	umsh
箢	vvyr
簖	vjdr
缋	sbhv
缏	snbm
耥	lkth
脲	odnn
膪	olik
膪	olva
膪	olvd
苠	cqmb
茳	cgjl
莶	calm
莶	caxm
蒎	cnpd
蒡	cfbh
虍	aqhu
螗	ikth
贳	bcui
醌	yvky
醭	ynbu
铹	jllc
铼	jnld
镥	jolu
阽	ekdm
馘	qkgo
鲺	aiui
鹎	npbw
鼽	pjqq
傺	rxii
勹	pvbc
喹	ktkv
戤	gggd
瀵	dbff
醃	yvaa
錒	jkaa
卬	epah
骯	kjah
藹	cvai
鎄	jyai
叆	eyai
鑀	jwai
噯	kwai
靄	yvai
靉	ywai
堨	trai
嬡	nwai
愛	vwai
曖	owai
欸	sqai
毐	upai
璦	wwai
皚	bdai
礙	urai
菴	cvan
諳	yoan
銨	jnan
咹	knan
唵	kvan
闇	moan
垵	tnan
鮟	anan
鵪	ndan
盦	mran
襖	pdao
隩	edao
奡	aaao
奧	pdao
驁	mfao
媼	nmao
鰲	afao
嶅	feao
嶴	peao
璈	wwao
胈	oyba
蚆	ivba
覇	xoba
釟	jbba
鈀	jvba
哱	kzba
壩	toba
妭	ndba
鮁	adba
鮊	abba
鲌	abba
抜	fyba
朳	mbba
粃	mpba
罷	spba
羓	yvba
臏	obbb
賓	bbbb
邠	ebbb
儐	rbbb
鑌	jbbb
髕	gbbb
鬢	abbb
擯	fbbb
檳	mbbb
殯	dbbb
濱	dbbb
瀕	dabb
繽	sbbb
鉋	jvbc
剝	dvbc
報	tybc
飽	uvbc
嫑	anbc
鮑	avbc
寶	bbbc
鴇	npbc
齙	ivbc
枹	mvbc
襬	yvbd
唄	kbbd
拝	ffbd
擺	fvbd
敗	wbbd
賁	bubf
倴	rcbf
錛	jcbf
喯	kcbf
坋	tdbf
掤	fobf
栟	mcbf
犇	nnbf
祊	pfbg
綳	sobg
繃	sobg
蚄	ifbh
謗	yfbh
鎊	jfbh
塝	tfbh
幫	tjbh
搒	ffbh
棓	mkbh
綁	sebh
肶	opbi
苾	cpbi
蓽	cabi
賁	bubi
赑	bbbi
蹕	zabi
佖	rpbi
鉍	jpbi
咇	kxbi
閉	mpbi
闢	uubi
嗶	kabi
坒	atbi
屄	ubbi
幣	jxbi
斃	xvbi
沘	dpbi
潷	dabi
畢	tabi
痺	bubi
皕	abbi
祕	ppbi
筆	vabi
篳	vabi
紕	svbi
辦	llbj
鈑	jybj
闆	mkbj
頒	babj
姅	nabj
攽	bwbj
昄	oybj
柈	mabj
絆	sabj
蛃	irbk
並	qabk
併	rcbk
餅	ucbk
抦	frbk
昺	orbk
梹	mbbk
檳	mbbk
稟	whbk
萹	ccbm
變	wsbm
貶	bnbm
辮	subm
辯	yubm
辺	zdbm
邊	zpbm
変	wwbm
鯿	acbm
抃	fdbm
昪	ocbm
碥	ucbm
籩	vzbm
編	sabm
緶	snbm
脿	oybn
蔈	cxbn
藨	chbn
俵	rybn
儦	rhbn
錶	jybn
鏢	jxbn
鑣	jhbn
颮	fvbn
飆	qfbn
飈	fhbn
驃	mxbn
驫	mmbn
骉	mmbn
鰾	axbn
幖	jxbn
摽	fxbn
標	mxbn
瘭	bxbn
葧	clbo
蔔	ctbo
袯	pybo
襏	pybo
僰	rabo
鈸	jdbo
鉑	jbbo
剝	dvbo
鉢	jabo
哱	kzbo
噃	ktbo
餑	uzbo
駁	mxbo
鮊	abbo
鲌	abbo
鵓	nubo
嶓	etbo
抜	fybo
撥	fybo
桲	mzbo
榑	mcbo
欂	mcbo
砵	iabo
別	dkbp
鱉	axbp
彆	gxbp
癟	bcbp
蔀	cebu
蔔	ctbu
補	pdbu
佈	rjbu
鈈	jdbu
鈽	jjbu
埗	tpbu
餔	udbu
鯆	adbu
歩	vpbu
貝	obbw
踎	zkbw
輩	iabw
備	rabw
鋇	jbbw
唄	kbbw
鵯	npbw
憊	xrbw
揹	fobw
棓	mkbw
椑	mubw
狽	qbbw
痺	bubw
盃	mabw
肏	rrcc
巣	dncc
財	bpcd
啋	kmcd
寀	bmcd
採	fmcd
綵	smcd
纔	sdcd
側	rdce
冊	aace
廁	gdce
惻	xdce
柵	mace
測	ddce
傖	rkcf
層	uocg
嶒	eocg
曽	bocg
艙	vkch
蒼	ckch
蔵	cach
倉	rkch
鶬	nrch
鸧	nrch
滄	dkch
玱	wvch
瑲	wkch
罉	ruch
茲	csci
莿	cdci
詞	ykci
賜	bpci
佽	rqci
辭	vuci
勅	alci
餈	udci
餈	sdci
鶿	nqci
枱	mkci
䅟	hpcj
蔘	cpcj
蠶	aicj
參	spcj
驂	mpcj
黲	hpcj
慘	xpcj
慚	xjcj
	hpcj
殘	dgcj
燦	hmcj
穇	hpcj
莝	ctco
剒	dcco
銼	jtco
錯	joco
唶	koco
鹺	agco
躥	zucr
鑹	jucr
攛	fucr
攢	fbcr
竄	bucr
聰	excs
蓯	crcs
蔥	cxcs
叢	aycs
囪	pxcs
驄	mxcs
従	rrcs
從	rrcs
悰	xxcs
樅	mrcs
崒	eicv
焠	hucv
粋	mucv
邨	uacy
吋	kvcy
輳	idcz
幬	jccz
湊	ddcz
荙	czda
薘	czda
跶	zzda
躂	zzda
達	zyda
咑	kdda
噠	kzda
垯	tzda
韃	gzda
墶	tzda
憚	xada
	dzda
澾	dzda
㳠	dzda
舠	vddc
導	cvdc
島	nedc
幬	jcdc
捯	fddc
搗	fedc
擣	fcdc
梼	mcdc
檮	mcdc
燾	hudc
盜	mddc
禱	pcdc
稲	hodc
詒	ykdd
貸	brdd
叇	ezdd
靆	yzdd
垈	trdd
帶	fjdd
紿	skdd
鍀	jcde
嘚	kcde
徳	rxde
扽	fvdf
僜	radg
鄧	evdg
鐙	jddg
憕	xadg
櫈	mjdg
燈	hddg
蕩	cpdh
襠	ptdh
讜	yhdh
儅	rtdh
鐺	jtdh
噹	ktdh
垱	tedh
壋	ttdh
黨	xhdh
擋	ftdh
檔	mtdh
氹	dgdh
珰	wedh
璫	wtdh
當	xtdh
盪	mddh
碭	updh
䃅	uudi
菂	cddi
䗖	ijdi
螮	ijdi
覿	ujdi
詆	yddi
諦	yjdi
逓	zpdi
遞	zpdi
鏑	jkdi
哋	kxdi
啲	kddi
埞	trdi
墑	tkdi
媂	njdi
尐	xndi
敵	wldi
杕	mddi
滌	dmdi
牴	nddi
磾	uadi
禘	pjdi
糴	rfdi
締	sjdi
膽	okdj
誕	yvdj
賧	bhdj
赕	bhdj
亶	wadj
鄲	ekdj
単	xadj
啗	kadj
單	kadj
噉	kwdj
彈	gadj
惔	xhdj
憚	xadj
憺	xkdj
揼	fddj
撢	fudj
撣	fadj
擔	fkdj
殫	dadj
沊	dddj
癉	badj
簞	vadj
羶	yadj
萣	crdk
訂	yddk
釘	jddk
鋌	jzdk
錠	jrdk
頂	dadk
飣	uddk
饤	uddk
鈿	jtdm
電	yvdm
顛	uadm
墊	tudm
巔	eadm
點	hkdm
扂	hkdm
捵	fbdm
澱	dydm
癲	badm
誂	yddn
調	ykdn
釣	jddn
銚	jddn
銱	jjdn
鯛	akdn
屌	ujdn
鳥	nhdn
鵰	nkdn
弔	gadn
弔	vadn
椆	mkdn
汈	dadn
亸	wado
剟	dydo
鐸	judo
嚲	wado
埵	tado
墮	tedo
奪	dcdo
馱	mddo
杕	mddo
㙍	tydo
綞	sado
䏲	opdp
諜	ymdp
咥	ktdp
鰈	amdp
昳	ondp
楪	mmdp
畳	tqdp
疊	tqdp
絰	stdp
绖	stdp
丟	psdq
銩	jsdq
耑	eadr
鍛	jydr
塅	tydr
斷	sjdr
籪	vjdr
緞	sydr
腖	onds
苳	cdds
丼	adds
凍	ddds
動	plds
崬	ends
鶇	nads
鼕	udds
戙	kgds
東	ands
棟	mdds
読	yedu
讀	ybdu
賭	bodu
鍍	jydu
厾	gsdu
闍	modu
姤	nkdu
黷	hbdu
櫝	mbdu
瀆	dbdu
牘	pbdu
犢	nbdu
獨	qidu
篤	vmdu
兌	bedv
鐓	jwdv
隊	endv
対	dcdv
對	acdv
懟	xadv
躉	czdy
鈍	jvdy
噸	kady
坉	tvdy
頓	aady
忳	xvdy
惇	xzdy
揼	fddy
楯	mody
燉	hwdy
脰	oadz
読	yedz
讀	ybdz
鈄	judz
哣	kadz
唞	kudz
鬥	aadz
枓	mudz
竇	bbdz
訛	yvee
諤	ygee
軛	ivee
鋨	jdee
鍔	jgee
咹	knee
閼	mdee
噁	kxee
堊	taee
堨	tree
額	baee
顎	kaee
餓	udee
姶	nkee
鱷	akee
崿	evee
鵝	npee
鶚	nkee
齶	vgee
悪	xaee
惡	xaee
痾	bkee
誒	yuei
欸	sqei
奀	aden
耏	aper
貳	qber
邇	zaer
児	aeer
兒	peer
鉺	jeer
咡	keer
餌	ueer
鮞	aaer
鲕	aaer
鴯	naer
弍	eder
弐	ader
爾	axer
閥	mgfa
髪	vyfa
琺	wsfa
発	vvfa
發	vyfa
罰	sdfa
僨	rbff
坋	tdff
墳	tbff
奮	dtff
鱝	abff
鼢	udff
憤	xbff
棻	cmff
濆	dbff
瞓	oaff
糞	mbff
紛	sdff
諷	yffg
豊	adfg
豐	adfg
鋒	jffg
堼	ttfg
風	jifg
馮	dmfg
峯	effg
鳳	jhfg
崶	ecfg
楓	mffg
沨	dxfg
渢	dffg
灃	ddfg
瘋	bffg
碸	uffg
縫	szfg
蚄	iffh
訪	yffh
倣	rwfh
鈁	jffh
鍅	jsfh
魴	affh
昉	offh
紡	sffh
販	byfj
釩	jdfj
鐇	jtfj
墦	ttfj
飯	uyfj
氾	dvfj
汎	ddfj
煩	hafj
璠	wtfj
礬	umfj
範	vvfj
仏	rsfo
彿	pafo
彿	rafo
膚	hofu
艴	vvfu
芣	cxfu
茀	cafu
䓛	cefu
複	pwfu
襆	jnfu
訃	ydfu
負	bdfu
賦	bdfu
賻	bcfu
仏	rsfu
輔	idfu
伕	rdfu
伕	anfu
輻	itfu
咈	kafu
垺	tzfu
駙	mcfu
婦	njfu
鮒	acfu
鰒	awfu
鳧	njfu
麩	anfu
彿	pafu
彿	rafu
復	rwfu
払	fsfu
撫	fhfu
榑	mcfu
洑	dqfu
㕮	kxfu
砆	unfu
㳇	dxfu
紱	sdfu
紼	safu
縛	scfu
誹	yafw
費	bvfw
剕	dafw
鐨	jbfw
飛	vdfw
鯡	aafw
屝	uafw
廃	gvfw
廢	gyfw
朏	oefw
棐	amfw
緋	safw
缹	hffz
軋	ivga
釓	jvga
夾	anga
曱	kaga
㗎	kmga
誥	ykgc
鋯	jkgc
鎬	jkgc
睪	sugc
縞	skgc
荄	crgd
蓋	cmgd
該	yrgd
賅	brgd
鈣	jggd
鎅	jagd
晐	orgd
個	rkge
鉻	jkge
鎘	jage
閣	mkge
閤	mkge
嗰	kkge
嘅	kege
頜	rage
餎	ukge
饹	ukge
鴿	nrge
擱	fkge
箇	vkge
紇	sgge
亙	aagf
賡	gbgg
頸	vagg
鯁	angg
鶊	nggg
鹒	nggg
綆	sngg
舡	vggh
冮	dggh
剛	dkgh
堽	tvgh
岡	kkgh
崗	ekgh
戇	xlgh
棡	mkgh
槓	mbgh
㭎	mxgh
筻	vngh
綱	skgh
贛	lbgj
趕	zugj
咁	kagj
尷	umgj
幹	uugj
桿	mugj
玕	wugj
稈	hugj
紺	scgj
㽏	dcgj
夬	vngk
柺	mlgk
鉱	jsgl
垙	tggl
広	gsgl
廣	gbgl
洸	degl
獷	qbgl
腘	owgo
膕	oago
蟈	iago
過	zkgo
鍋	jkgo
咼	kkgo
啯	kwgo
嘓	kago
國	kago
堝	tkgo
幗	jago
摑	fago
槨	mego
渦	dkgo
蒄	ccgr
観	rjgr
觀	yjgr
貫	bvgr
咲	kdgr
関	mdgr
關	magr
館	ukgr
鰥	adgr
鸛	ncgr
慣	xbgr
摜	fbgr
毌	vugr
爟	hfgr
綸	scgr
䢼	ecgs
貢	bggs
唝	kbgs
嗊	kbgs
鞏	gggs
宮	bkgs
龔	lbgs
蓇	cogu
䓛	cegu
蠱	migu
詁	ykgu
賈	bxgu
軲	ikgu
轂	uygu
僱	rfgu
鈷	jkgu
錮	jkgu
堌	tkgu
顧	hagu
鯝	akgu
鲴	akgu
鴣	nugu
鶻	nggu
榖	uygu
穀	uygu
規	ajgv
詭	yvgv
貴	bagv
軌	ijgv
鄶	ergv
劊	drgv
劌	dvgv
匭	kjgv
匱	kbgv
閨	mtgv
闠	mbgv
阓	mbgv
姽	nvgv
媯	nhgv
嬀	nhgv
鮭	atgv
鱖	aqgv
嶲	eggv
帰	ajgv
廆	gggv
龜	pxgv
攰	ulgv
檜	mogv
櫃	mbgv
歸	pegv
氿	djgv
給	skgw
詿	ytgx
剮	dkgx
銛	jkgx
咼	kkgx
铦	jkgx
啩	kdgx
坬	tggx
颳	fkgx
鴰	npgx
掛	fdgx
袞	wygy
輥	ivgy
鯀	asgy
滾	dygy
緄	svgy
耇	tkgz
覯	ajgz
觏	cjgz
詬	ykgz
購	bagz
鉤	jkgz
韝	aagz
夠	dkgz
姤	nkgz
搆	fagz
構	magz
溝	dagz
緱	sugz
鉿	jkha
噏	kyha
#jp	njhaihanji
號	kjhc
蠔	inhc
侴	rdhc
鎬	jkhc
顥	oahc
灝	dahc
還	zyhd
咍	kkhd
嗐	kkhd
駭	mrhd
覈	xwhe
訶	ykhe
賀	blhe
郃	erhe
咼	kkhe
閡	mrhe
閤	mkhe
闔	mmhe
嚇	kvhe
嚇	kdhe
垎	tkhe
頜	rahe
鶴	ndhe
齕	ighe
龁	ighe
暍	ovhe
盉	mhhe
紇	sghe
姮	nahg
恆	xahg
橫	mbhg
頏	wahh
絎	sdhh
绗	sdhh
蔊	cuhj
虷	iuhj
闞	mwhj
垾	tuhj
韓	uahj
頇	aahj
頷	rahj
駻	muhj
崡	ekhj
嵅	eghj
扞	fuhj
暵	odhj
浛	dkhj
漢	dnhj
㘎	kwhj
㘚	kwhj
耲	lyhk
壊	tyhk
壞	tyhk
懐	xyhk
懷	xyhk
㷫	hhhk
艎	vwhl
謊	yvhl
鍠	jwhl
锽	jwhl
喤	kwhl
塃	tvhl
媓	nwhl
鰉	awhl
黃	cbhl
滉	dghl
㿠	bghl
耠	lkho
貨	brho
佸	rkho
鈥	jhho
鍃	jxho
鑊	jyho
嚄	kyho
彟	eyho
彠	eyho
擭	fyho
獲	qyho
禍	pkho
穫	hyho
㸌	haho
荁	cahr
䴉	nshr
還	zyhr
鍰	jyhr
鐶	jyhr
镮	jyhr
喚	knhr
奐	dnhr
嬛	nyhr
鯇	aehr
峘	eahr
鹮	nshr
換	fnhr
歓	rqhr
歡	cqhr
渙	dnhr
煥	hnhr
環	wyhr
瘓	bnhr
㬊	oyhr
緩	syhr
繯	syhr
葒	cghs
葓	cbhs
訌	yghs
轟	iihs
吽	knhs
唝	kbhs
閎	mshs
嗊	kbhs
鬨	abhs
鴻	dnhs
黌	dbhs
竑	lshs
紅	sghs
紘	sshs
衚	rdhu
覈	xwhu
護	ychu
軤	iahu
轷	iahu
壺	uahu
餬	uohu
姱	nvhu
嫭	nuhu
鬍	aohu
鯱	yjhu
鵠	nnhu
鶘	nuhu
鶻	nghu
鸌	nyhu
戶	puhu
昈	ohhu
昒	ophu
楛	mkhu
沍	dahu
淴	dxhu
滸	duhu
薈	cohv
袆	pahv
褘	pahv
詼	yhhv
誨	ydhv
諱	yahv
譭	yyhv
賄	bohv
輝	gihv
迴	zkhv
匯	kdhv
噦	kphv
墮	tehv
廆	gghv
彙	vnhv
恵	xahv
揮	fihv
暉	oihv
會	rohv
槥	mehv
橞	mxhv
檜	mohv
毀	pyhv
澮	dohv
燬	hyhv
燴	hohv
琿	wihv
穢	hdhv
絵	sshv
繢	sbhv
繪	sohv
翚	yihv
翬	yihv
閪	mxhw
黒	hhhw
華	cahx
話	ykhx
譁	kahx
劃	dvhx
鏵	jahx
嘩	kuhx
驊	mahx
婳	nkhx
嫿	nahx
樺	mahx
畫	aahx
葷	cihy
諢	yihy
閽	mohy
餛	uvhy
婫	nvhy
惛	xohy
渾	dihy
琿	wihy
垕	pthz
餱	muhz
鱟	pahz
睺	ouhz
詑	yvia
詫	yqia
侘	rqia
剎	dxia
鍤	jaia
鑔	jxia
垞	tqia
餷	uaia
奼	nqia
嵖	eaia
挿	faia
梌	mhia
耖	lpic
鈔	jpic
勦	vlic
巣	dnic
弨	gkic
槱	mhic
綽	suic
茝	ckid
蠆	ciid
儕	raid
釵	jdid
車	aaie
俥	riie
唓	kiie
屮	vaie
徹	wrie
硨	uiie
㬚	owie
襯	pjif
諶	yvif
讖	ygif
偁	raif
傖	rkif
陳	edif
塵	ltif
齔	ivif
梣	mgif
棽	mgif
櫬	mjif
磣	upif
稱	haif
蟶	iwig
誠	yvig
乗	pnig
偁	raig
鋮	jvig
鐺	jtig
騁	mgig
宬	bvig
庱	gwig
憕	xaig
懲	xrig
搶	fkig
撐	fpig
棖	mnig
檉	mwig
琤	waig
稱	haig
腸	opih
萇	cnih
倀	rnih
償	rbih
錩	joih
锠	joih
長	anih
閶	moih
嘗	xoih
嚐	koih
場	tpih
鯧	aoih
廠	iwih
悵	xnih
暢	apih
胣	oyii
佁	rkii
遅	zyii
遲	zuii
勅	alii
呎	knii
喫	kdii
飭	ulii
奓	ddii
馳	mvii
鴟	npii
黐	psii
齒	vkii
恥	exii
摛	fsii
歯	vkii
熾	hbii
蕆	cbij
蟬	iaij
覘	ajij
諂	yaij
讒	ydij
儳	rdij
刬	dgij
剗	dgij
剷	dlij
単	xaij
鏟	jfij
鐔	juij
啴	kaij
單	kaij
闡	maij
嘽	kaij
囅	knij
顫	waij
饞	udij
驏	mzij
嬋	naij
巉	evij
懺	xdij
摻	fpij
攙	fdij
旵	oeij
梴	mzij
毚	ddij
浐	diij
滻	dfij
瀍	dtij
產	wfij
禪	paij
纏	stij
創	dril
闖	mmil
噇	kail
愴	xkil
橦	mail
牀	dmil
瘡	bkil
輟	iyio
婥	nuio
齪	izio
惙	xyio
綽	suio
伝	rsir
傳	rcir
釧	jair
圌	kair
堾	toir
蟲	iiis
衝	rdis
銃	jeis
埫	tkis
寵	blis
摏	fais
沖	dais
種	hais
㳘	deis
翀	yais
芻	geiu
蒭	ceiu
處	hjiu
䝙	vkiu
䢺	eeiu
觸	jiiu
貙	vkiu
躕	zciu
俶	ryiu
儲	roiu
処	wjiu
鋤	jliu
闘	mciu
雛	gfiu
廚	gciu
齣	vkiu
摴	fviu
斶	jiiu
柷	meiu
歜	sqiu
礎	uriu
絀	skiu
倕	raiv
錘	jaiv
圌	kaiv
惙	xyiv
欻	hqix
脣	ioiy
蓴	cciy
䲠	yoiy
鰆	yoiy
鶉	nwiy
純	sviy
裯	pkiz
讎	yfiz
躊	zciz
儔	rciz
醜	vgiz
婤	nkiz
幬	jciz
搊	feiz
杻	maiz
梼	mciz
椆	mkiz
檮	mciz
疇	tciz
籌	vciz
綢	skiz
藎	cmjb
覲	cjjb
謹	yajb
贐	bmjb
進	zfjb
僅	rfjb
儘	rmjb
勁	aljb
錦	jjjb
墐	tajb
壗	tmjb
饉	ufjb
巹	vvjb
慬	xajb
晉	aojb
殣	dfjb
燼	hmjb
盡	mvjb
緊	ksjb
縉	sojb
耤	loji
薊	cdji
薺	caji
蟣	idji
覬	ejji
計	yuji
記	yvji
詰	ykji
譏	ydji
跡	zdji
蹟	zbji
躋	zaji
伋	rnji
輯	ieji
係	rxji
係	psji
剤	dwji
劑	dwji
勣	flji
嚌	kaji
際	exji
雞	nvji
霽	yaji
垍	toji
堲	tvji
塈	tvji
飢	ujji
饑	udji
姞	nkji
驥	mbji
鯽	aeji
鱭	aaji
鶏	nvji
鶺	ndji
幾	sgji
齎	waji
齏	waji
徛	rkji
惎	qxji
撃	uiji
擊	uiji
擠	faji
枅	mcji
極	maji
機	mjji
檵	mvji
済	daji
濟	daji
璣	wdji
㓤	duji
磯	udji
積	hbji
紀	svji
級	snji
給	skji
継	svji
緝	seji
績	sbji
繫	saji
繼	svji
羈	smji
脛	ogjk
荊	cdjk
莖	cgjk
䴖	nfjk
逕	zajk
倞	rxjk
剄	dajk
勁	aljk
鎌	jnjk
鏡	jejk
靚	fjjk
靜	fajk
頸	vajk
驚	cmjk
鯨	axjk
鶄	nfjk
弳	ggjk
徑	rgjk
汫	dajk
浄	dajk
涇	dgjk
淨	dajk
璟	wxjk
痙	bgjk
競	lejk
経	stjk
經	sgjk
膙	oijl
蔣	ccjl
薑	yajl
講	yajl
醤	ydjl
醬	ydjl
奨	ddjl
將	dcjl
弶	gxjl
強	gijl
彊	gajl
槳	mdjl
殭	dajl
漿	ddjl
烱	hkjl
獎	dqjl
絳	sajl
繮	sajl
艦	vmjm
艱	cnjm
薦	chjm
襇	pojm
襉	pojm
見	oejm
諫	ynjm
譾	yyjm
賤	bgjm
踐	zgjm
倹	rnjm
儉	rrjm
剣	ddjm
劍	drjm
鍵	jzjm
鐗	jojm
鐧	jojm
鑑	jmjm
鑒	jkjm
間	mojm
鞬	gzjm
韉	ghjm
堅	tkjm
餞	ugjm
姦	nnjm
鰹	atjm
鶼	nqjm
鹸	anjm
鹼	arjm
戔	ggjm
戩	agjm
揀	fdjm
撿	frjm
暕	onjm
梘	mjjm
検	mnjm
樫	mtjm
檢	mrjm
檻	mmjm
殲	ddjm
減	dkjm
漸	djjm
澗	dojm
濺	dgjm
監	mkjm
瞼	orjm
礆	uajm
筧	vjjm
箋	vgjm
簡	vojm
緘	skjm
縑	snjm
繭	cijm
腳	oejn
膠	opjn
藠	cbjn
覚	xjjn
覺	pjjn
䴔	nwjn
較	ifjn
轎	ikjn
僥	rejn
鉸	jfjn
勦	vljn
餃	ufjn
驕	mkjn
嬌	nkjn
鮫	afjn
峧	efjn
鵁	nwjn
嶠	ekjn
鷦	nrjn
恔	xfjn
撟	fkjn
撹	fjjn
攪	fjjn
斠	cujn
澆	dejn
矯	ukjn
筊	vxjn
絞	sfjn
繳	swjn
耤	lojp
蜐	iljp
訐	yujp
詰	ykjp
誡	ydjp
𠝹	dtjp
価	rxjp
傑	rmjp
價	rbjp
劼	uljp
階	ebjp
頡	uajp
鮚	akjp
屆	uajp
岊	vejp
悈	xgjp
掲	fvjp
桝	majp
檞	mnjp
潔	dsjp
玠	wajp
癤	bejp
㛃	nfjp
節	vejp
結	skjp
舊	cajq
鬮	avjq
鳩	njjq
鷲	nwjq
廄	gyjq
氿	djjq
㠇	edjq
糺	svjq
糾	sajq
錈	jvjr
鐫	jgjr
雋	rgjr
圏	kvjr
婘	nvjr
鵑	nkjr
嶲	egjr
巻	bvjr
捲	fvjr
捲	bvjr
朘	owjr
棬	mvjr
絹	sojr
䌹	skjs
䐃	okjs
䢛	zkjs
冏	kkjs
囧	kkjs
坰	tkjs
泂	dkjs
烱	hkjs
絅	skjs
覚	xjjt
覺	pjjt
訣	ynjt
譎	ykjt
傕	rfjt
叕	yyjt
鐝	jqjt
钁	jyjt
埆	tjjt
鱖	aqjt
鴃	nnjt
決	dnjt
玦	wnjt
㵐	dqjt
絕	svjt
腒	okju
舉	paju
蒟	ckju
詎	yaju
䴗	noju
跼	zkju
車	aaju
侷	rkju
鉅	jkju
鉅	jaju
劇	dhju
鋦	jkju
鋸	jkju
颶	fbju
駒	mkju
娵	nyju
屨	unju
岠	ekju
岨	eqju
崌	ekju
鶪	noju
弆	tcju
齟	iqju
懼	xfju
拠	fjju
挙	xuju
據	fnju
櫃	mbju
櫸	maju
泃	dkju
焗	hkju
窶	bnju
莢	cnjx
蛺	injx
賈	bxjx
仮	ryjx
価	rxjx
傢	rnjx
郟	eajx
價	rbjx
鉀	jajx
鋏	jnjx
鎵	jnjx
叚	vyjx
頡	uajx
頰	aajx
夾	anjx
駕	mljx
挾	fnjx
斝	kujx
槚	mbjx
檟	mbjx
泇	dkjx
浹	dnjx
㗎	kmjx
筴	vnjx
莙	ckjy
葰	cwjy
軍	bijy
儁	rgjy
鈞	jdjy
雋	rgjy
駿	mwjy
龜	pxjy
晙	owjy
濬	dojy
焌	hwjy
珺	wkjy
皸	bpjy
銬	jgkc
㸆	hakc
蒈	cbkd
凱	ejkd
剴	dekd
鍇	jbkd
鎧	jdkd
鐦	jckd
開	mkkd
塏	tdkd
愒	xvkd
愷	xdkd
愾	xmkd
課	ynke
趷	zvke
軻	ikke
鈳	jkke
剋	duke
剋	udke
鉿	jkke
錁	jnke
匼	kkke
頦	wake
顆	aake
騍	mnke
悈	xgke
殻	uyke
殼	uyke
渇	dvke
痾	bkke
㞹	ekke
緙	sgke
墾	tvkf
齦	inkf
懇	xvkf
珢	wykf
鏗	jtkg
鈧	jjkh
閌	mjkh
鱇	yxkh
犺	qjkh
衎	rdkj
轗	ixkj
冚	bekj
闞	mwkj
墈	tlkj
崁	eqkj
嵁	evkj
龕	rlkj
檻	mmkj
磡	ulkj
膾	ookk
蕢	cbkk
儈	rokk
鄶	erkk
噲	kokk
塊	tgkk
鱠	aokk
擓	fkkk
會	rokk
澮	dokk
獪	qokk
㧟	fkkk
誆	ywkl
誑	ywkl
貺	bekl
鄺	egkl
劻	klkl
壙	tbkl
夼	dakl
拡	fskl
曠	obkl
況	dekl
礦	ubkl
纊	sbkl
啹	kkko
闊	mkko
拡	fsko
擴	fbko
髖	gdkr
寛	bjkr
寬	bdkr
梡	mekr
埪	tgks
褲	piku
嚳	pkku
圐	kfku
庫	giku
朏	oeku
楛	mkku
矻	ugku
絝	sgku
聵	ebkv
蕢	cbkv
虧	hgkv
匱	kbkv
饋	ubkv
巋	ejkv
憒	xbkv
戣	vgkv
櫆	mukv
潰	dbkv
瞶	obkv
窺	bjkv
簣	vbkv
剋	dukw
剋	udkw
誇	ygkx
姱	nvkx
骻	ggkx
裈	piky
褌	piky
錕	jvky
閫	mmky
堃	tfky
壸	uaky
壼	uaky
婫	nvky
鯤	avky
崑	evky
梱	mmky
焜	hvky
睏	okky
睏	omky
釦	jkkz
摳	fkkz
瞘	okkz
臘	ovla
蝋	iala
蝲	idla
蠟	ivla
鑞	jvla
臨	kklb
藺	cflb
賃	brlb
躪	zflb
轔	ialb
鄰	emlb
凜	dhlb
鱗	aalb
廩	ghlb
懍	xhlb
檁	mhlb
粦	malb
耢	lllc
耮	lllc
荖	cplc
銠	jvlc
労	xllc
勞	hllc
鐒	jllc
铑	jvlc
嘮	kllc
嫪	nplc
嶗	ellc
撈	fllc
澇	dllc
癆	bllc
絡	sklc
萊	cnld
賚	bald
賴	abld
來	anld
俫	rnld
倈	rnld
錸	jnld
頼	abld
崍	enld
徠	rnld
梾	mnld
棶	mnld
淶	dnld
瀨	dbld
瀬	dald
癩	bbld
睞	onld
籟	vbld
餎	ukle
饹	ukle
鰳	alle
擽	fmle
楽	mdle
樂	mvle
瞭	oxle
冧	bmlf
堎	twlg
崚	ewlg
稜	mwlg
蒗	cnlh
蓢	colh
鋃	jnlh
唥	kslh
閬	mnlh
埌	tnlh
塱	tdlh
崀	enlh
桹	mnlh
㫰	onlh
㮾	mdlh
脷	odli
蒞	clli
藶	cvli
蘺	cfli
蠣	idli
裏	wyli
裡	ptli
貍	ptli
躒	zmli
轢	imli
轣	ivli
邐	zali
儷	rlli
酈	eali
釐	aali
凓	dmli
鋰	jali
勵	illi
厲	idli
叕	yyli
唎	kdli
嚟	kdli
嚦	kvli
隷	unli
隸	mnli
離	wfli
靂	yvli
壢	tvli
驪	mlli
鯉	aali
鱧	adli
鱺	alli
峛	edli
鸝	nali
麗	alli
慄	xmli
戻	hdli
暦	ioli
曆	ioli
朸	mlli
櫟	mmli
櫪	mvli
欐	mlli
歴	ivli
歷	ivli
浬	dtli
瀝	dvli
灕	dfli
犛	anli
琍	wdli
癘	bdli
癧	bvli
礪	udli
礫	umli
禮	pdli
㰀	mdli
籬	vfli
糲	mdli
綟	sqli
縭	ssli
藍	cmlj
蘭	cnlj
襤	pmlj
襴	pnlj
覧	jklj
覽	jklj
讕	ydlj
躝	zjlj
躝	znlj
𨅬	znlj
鑭	jdlj
闌	mdlj
嵐	eflj
懶	xblj
攔	fnlj
攬	fjlj
斕	wdlj
暕	onlj
欄	mdlj
欖	mjlj
濫	dmlj
瀾	ddlj
灠	djlj
爛	hslj
籃	vmlj
繿	smlj
纜	sjlj
舲	vslk
蔆	cwlk
鈴	jslk
霊	yalk
靈	yalk
坽	tslk
領	ralk
姈	nslk
鯪	awlk
鴒	nrlk
崚	ewlk
嶺	ealk
鸰	nrlk
齡	islk
齢	islk
○	vvlk
昤	oslk
櫺	mklk
欞	mrlk
淩	dwlk
〇	oolk
㥄	xwlk
稜	mwlk
綾	swlk
諒	yxll
両	akll
輛	irll
俍	rnll
倆	rrll
倞	rxll
兩	arll
鍄	jxll
唡	krll
啢	krll
喨	kjll
靚	fjll
魎	grll
悢	xnll
樑	mmll
涼	dxll
糧	mall
聯	ealm
臉	orlm
蓮	czlm
蔹	cwlm
薟	crlm
蘞	cwlm
褳	pzlm
襝	prlm
連	zilm
錬	jnlm
鍊	jnlm
鎌	jnlm
鏈	jzlm
鐮	jnlm
嗹	kzlm
奩	dklm
鰱	azlm
憐	xalm
戀	xslm
斂	wrlm
梿	mzlm
槤	mzlm
殮	drlm
漣	dzlm
瀲	dwlm
煉	hdlm
璉	wzlm
簾	vnlm
練	snlm
縺	szlm
遼	zxln
釕	jaln
鐐	jxln
嫽	nxln
鷯	naln
憭	xxln
暸	oxln
橑	mxln
療	bxln
瞭	oxln
繚	sxln
腡	oklo
蓏	cglo
蘿	cflo
躒	zmlo
邏	zslo
儸	rflo
鏍	jslo
鑼	jflo
啰	kdlo
囉	kflo
駱	mklo
騾	mslo
欏	mflo
濼	dmlo
犖	hnlo
玀	qflo
㑩	rdlo
砢	uklo
籮	vflo
絡	sklo
羅	sflo
脟	oclp
䴕	ndlp
哷	kclp
鴷	ndlp
猟	qalp
獵	qvlp
蹓	ztlq
劉	dplq
鋶	jvlq
鎦	jtlq
鏐	jplq
陸	etlq
餾	utlq
騮	mtlq
鶹	nplq
鷚	nylq
鹠	nplq
瀏	ddlq
綹	sklq
臠	wrlr
亂	vvlr
鑾	jslr
孌	nslr
孿	jslr
巒	eslr
鸞	wslr
攣	uslr
欒	mslr
灤	dmlr
聾	lels
蘢	clls
哢	kcls
嚨	klls
隴	ells
壟	tlls
壠	tlls
尨	udls
龍	lals
攏	flls
昽	olls
曨	olls
朧	olls
櫳	mlls
滝	dvls
瀧	dlls
瓏	wlls
礱	luls
竜	lvls
籠	vlls
䂮	fult
鋝	jclt
圙	kalt
臚	omlu
艫	vmlu
菉	cdlu
蕗	cklu
蘆	cmlu
虜	hllu
賂	bklu
輅	iklu
轆	illu
轤	imlu
僇	rplu
勠	yllu
錄	vdlu
録	jdlu
鑥	jolu
陸	etlu
嚕	kolu
顱	halu
壚	tmlu
魯	aolu
鱸	amlu
鷺	nzlu
鸕	nhlu
鹵	axlu
廬	gmlu
彔	vdlu
擄	fllu
擼	folu
櫓	molu
櫨	mmlu
氌	molu
淥	ddlu
滷	axlu
瀘	dmlu
爐	hmlu
琭	wdlu
盧	hmlu
硵	uxlu
磠	uxlu
祿	pdlu
箓	vdlu
籙	vdlu
綠	sdlu
緑	sdlu
葎	calv
褸	pnlv
侶	rklv
僂	rnlv
鋁	jklv
呂	kklv
哷	kclv
閭	mklv
垏	talv
驢	mmlv
屢	unlv
慮	hxlv
梠	mklv
櫚	mklv
濾	dxlv
稆	hklv
穭	holv
綠	sdlv
緑	sdlv
縷	snlv
藟	ctlw
誄	ynlw
鐳	jtlw
嚟	kdlw
塁	ttlw
類	malw
壘	ttlw
戻	hdlw
攰	ullw
楽	mdlw
涙	ddlw
淚	dqlw
礌	utlw
縲	sslw
論	yaly
輪	icly
侖	rcly
倫	rcly
圇	kcly
崙	rcly
掄	fcly
淪	dcly
綸	scly
耬	lnlz
䁖	onlz
蔞	cnlz
螻	inlz
僂	rnlz
剅	dalz
鏤	jnlz
嘍	knlz
婁	anlz
髏	gnlz
嶁	enlz
摟	fnlz
樓	mnlz
瘻	bnlz
瞜	onlz
簍	vnlz
螞	imma
嗎	kmma
嘜	kdma
馬	ahma
媽	nmma
嫲	ngma
嬤	ndma
嬤	nsma
孖	zzma
榪	mmma
獁	qmma
瑪	wmma
碼	umma
祃	pmma
禡	pmma
罵	msma
閔	mwmb
閩	mimb
鰵	armb
黽	avmb
忞	wxmb
憫	xwmb
旻	owmb
緡	somb
芼	cmmc
貓	vtmc
貿	bpmc
冇	ukmc
鉚	jemc
錨	jtmc
楙	mmmc
犛	anmc
脈	onmd
蕒	cbmd
買	bsmd
賣	bumd
邁	zcmd
勱	clmd
嘜	kdmd
売	uemd
麥	admd
麼	gsme
亹	wqmf
們	rmmf
鍆	jmmf
門	aamf
悶	mxmf
惛	xomf
懣	xdmf
抆	fwmf
捫	fmmf
燜	hxmf
錳	jmmg
夢	cdmg
尨	udmg
幪	jnmg
黽	avmg
懞	xxmg
懞	xnmg
掹	fmmg
擝	fmmg
曚	onmg
濛	dnmg
獴	qnmg
矇	onmg
㠓	enmg
鋩	jvmh
厖	ipmh
铓	jvmh
尨	udmh
杗	wmmh
杧	mwmh
牤	nvmh
覓	vjmi
謎	yzmi
謐	ymmi
冪	bjmi
屘	uzmi
彌	gxmi
搣	fami
瀰	dxmi
獼	qxmi
瞇	ozmi
祕	ppmi
禰	pxmi
羋	aami
蟎	irmj
蠻	ismj
謾	yymj
鏝	jymj
顢	camj
饅	uymj
嫚	nymj
鰻	aymj
屘	uzmj
悗	xvmj
満	dkmj
滿	drmj
瞞	ormj
縵	symj
蓂	cbmk
銘	jkmk
鳴	nkmk
丏	agmm
偭	ramm
勔	almm
靦	ajmm
麪	agmm
麺	famm
黽	avmm
愐	xamm
澠	dvmm
綿	sjmm
緬	samm
鶓	ncmn
廟	gomn
緲	spmn
繆	spmn
脈	onmo
藦	cumo
謨	ydmo
鏌	jdmo
饃	udmo
驀	cmmo
嬤	ndmo
嬤	nsmo
麼	gsmo
黙	hamo
歿	dymo
沒	dymo
無	rhmo
衊	xdmp
搣	famp
滅	damp
謬	ypmq
嫑	anmq
繆	spmq
鉬	jomu
霂	ymmu
畝	wnmu
郿	evmw
鋂	jdmw
鎂	jdmw
鎇	jomw
媄	ndmw
鶥	nvmw
黴	ywmw
毎	ramw
沒	dymw
沬	dnmw
眛	onmw
謀	ymmz
鉾	jnmz
呣	kdmz
繆	spmz
乸	xdna
鈉	jdna
錼	jxna
鎿	juna
吶	krna
嗱	kuna
妠	nrna
拏	unna
納	sdna
囜	ksnb
脳	oknc
腦	oxnc
臑	oanc
蟯	ienc
鐃	jenc
堖	txnc
嫐	nnnc
鬧	ajnc
峱	qenc
悩	xknc
惱	xxnc
撓	fenc
橈	menc
耏	apnd
迺	zxnd
訥	ydne
吶	krne
奀	adnf
媆	ndnf
啱	oung
饢	uynh
膩	odni
薿	crni
鈮	jvni
妳	nxni
鯢	aeni
擬	frni
暱	okni
暱	ovni
萳	cunj
啱	ounj
難	cfnj
妠	nrnj
婻	nunj
聹	ednk
苧	cdnk
苧	cank
薴	cdnk
嚀	kdnk
寧	bdnk
擰	fdnk
檸	mdnk
濘	ddnk
獰	qdnk
醸	yynl
釀	ynnl
嬢	nynl
孃	nynl
輦	ianm
輾	innm
唸	kxnm
鮎	aknm
鯰	axnm
捵	fbnm
撚	fhnm
攆	finm
蔦	cnnn
裊	nynn
嫋	ndnn
嬝	nynn
鳥	nhnn
諾	ykno
儺	rfno
鍩	jkno
聶	eenp
菍	cxnp
蘗	cmnp
躡	zenp
鎳	jmnp
鑷	jenp
噛	kknp
隉	egnp
嚙	kvnp
囁	kenp
顳	eanp
嵲	emnp
齧	finp
惗	xxnp
摂	fdnp
攝	fenp
櫱	emnp
鈕	janq
鈕	sanq
杻	manq
紐	sanq
膿	onns
農	anns
儂	rnns
噥	knns
濃	dnns
燶	hnns
秾	hnns
穠	hnns
㶶	hnns
瘧	bant
傉	rcnu
駑	mnnu
釹	jnnv
內	adnw
餒	unnw
呣	kdom
嘸	kvom
嚄	kyoo
痾	bkoo
謳	ykou
區	kkou
嘔	kkou
鴎	nkou
鷗	nkou
慪	xkou
歐	kqou
毆	kyou
漚	dkou
甌	kwou
舥	vbpa
粃	mppa
貧	bbpb
頻	vapb
塀	tcpb
顰	vupb
嬪	nbpb
藨	chpc
鉋	jvpc
奅	depc
拋	flpc
皰	pvpc
砲	ivpc
拝	ffpd
噴	kbpf
芃	cdpg
蘋	cbpg
鵬	onpg
弸	gopg
搒	ffpg
椪	mapg
泙	dupg
尨	udph
徬	rfph
苉	cepi
䴙	nupi
伾	rapi
鈹	jppi
闢	uupi
嚭	ukpi
鷿	nupi
鸊	nupi
狉	qapi
痺	bupi
紕	svpi
罷	sppi
羆	hhpi
蹣	zrpj
柈	mapj
槃	mvpj
盤	mvpj
荓	ccpk
蘋	cbpk
蚲	iupk
評	yupk
呯	kupk
馮	dmpk
鮃	aupk
帡	jcpk
憑	xdpk
泙	dupk
洴	dcpk
諞	ycpm
駢	mcpm
騙	mcpm
楩	mnpm
㛹	nnpm
薸	cxpn
飄	xfpn
驃	mxpn
慓	xxpn
樸	mdpn
縹	sxpn
䥽	jdpo
釙	jdpo
鉕	jkpo
鏺	jypo
哱	kzpo
頗	papo
樸	mdpo
潑	dypo
蒱	cfpu
蜅	zdpu
譜	yopu
僕	rdpu
鋪	jdpu
鏷	jnpu
鐠	jopu
墣	tnpu
鯆	adpu
撲	fdpu
樸	mdpu
衃	xapw
賠	bkpw
轡	kspw
鉳	jvpw
錇	jkpw
珮	wjpw
哣	kapz
垺	tzpz
抔	fxpz
棓	mkpz
親	ljqb
鋟	jyqb
唚	kyqb
駸	myqb
寢	byqb
嵚	eqqb
嶔	eqqb
慬	xaqb
撳	fqqb
欽	jqqb
臍	oaqi
䓫	ckqi
薺	caqi
蘄	cjqi
蠐	iaqi
訖	ygqi
豈	edqi
跂	zyqi
踦	zkqi
鏚	jxqi
呇	dkqi
啓	khqi
啟	whqi
埼	tkqi
頎	jaqi
騎	mkqi
騏	mbqi
婍	nkqi
鰭	aoqi
齊	waqi
恓	xxqi
悽	xnqi
愭	xoqi
慼	xpqi
掲	fvqi
斉	waqi
棄	wmqi
棨	hmqi
棲	mnqi
榿	mdqi
気	qxqi
氣	qmqi
淒	dnqi
玘	wvqi
碁	quqi
磧	ubqi
祇	pqqi
綺	skqi
苘	ckqk
親	ljqk
請	yoqk
軽	itqk
輕	igqk
傾	raqk
勍	wlqk
頃	aaqk
鯖	aoqk
庼	gaqk
廎	gaqk
慶	gwqk
檾	hmqk
氫	qgqk
蔃	ciql
薔	ckql
蹌	zkql
錆	joql
鏘	jcql
鏹	jiql
嗆	kkql
嬙	nkql
強	giql
戧	rgql
搶	fkql
槍	mkql
檣	mkql
熗	hkql
牆	pkql
玱	wvql
瑲	wkql
羥	ygql
蒨	coqm
蕁	ccqm
謙	ynqm
譴	yzqm
伣	rjqm
俔	rjqm
遷	zxqm
僉	rrqm
釺	juqm
鈐	jvqm
鉗	jcqm
鉛	jkqm
銭	jgqm
錢	jgqm
圲	tuqm
韆	gzqm
塹	tiqm
墘	tgqm
騫	bmqm
孅	igqm
慳	xtqm
拑	fcqm
杄	muqm
槧	miqm
汧	dcqm
淺	dgqm
潛	doqm
牽	wnqm
簽	vrqm
籤	vgqm
縴	snqm
繊	saqm
繾	szqm
纖	sgqm
蕎	ckqn
誚	yoqn
譙	yhqn
蹺	zeqn
僑	rkqn
鍬	jhqn
喬	pkqn
鞽	gkqn
嶠	ekqn
橋	mkqn
橾	mmqn
殻	uyqn
殼	uyqn
硚	uaqn
磽	ueqn
礄	ukqn
竅	bwqn
繰	smqn
翹	tyqn
鍥	jdqp
愜	xnqp
掲	fvqp
竊	bsqp
篋	vnqp
萩	chqq
虯	iaqq
讎	yfqq
賕	bdqq
赇	bdqq
鞦	ghqq
鰌	ayqq
鰍	ahqq
鶖	nhqq
巰	avqq
鹙	nhqq
龜	pxqq
梂	mdqq
毬	mdqq
詮	ywqr
踡	zvqr
輇	iwqr
佺	rwqr
辁	iwqr
銓	jwqr
勧	rlqr
勸	clqr
圏	kvqr
顴	caqr
婘	nvqr
惓	xvqr
棬	mvqr
槫	mcqr
権	mfqr
權	mfqr
綣	svqr
䓖	clqs
藭	cgqs
嬛	nyqs
煢	huqs
瓊	wwqs
窮	bgqs
傕	rfqt
卻	ekqt
闋	mdqt
闕	mqqt
埆	tjqt
鵲	ncqt
愨	xuqt
棤	moqt
汋	ddqt
確	ufqt
胠	osqu
䓛	cequ
袪	psqu
覷	hjqu
詘	ykqu
趨	zequ
軀	ukqu
佢	raqu
區	kkqu
闃	mqqu
坥	tqqu
駆	mxqu
驅	mkqu
鴝	ngqu
嶇	ekqu
麹	fmqu
齲	idqu
焌	hwqu
㭕	msqu
匼	kkqx
拤	fdqx
囷	khqy
羣	vyqy
蕘	cerc
饒	uerc
嬈	nerc
擾	fwrc
橈	merc
繞	serc
熱	htre
腍	oxrf
菍	cxrf
認	yxrf
軔	idrf
韌	adrf
飪	uurf
紉	sdrf
紝	surf
纴	surf
蘘	cyrh
譲	yyrh
讓	yyrh
儴	ryrh
壌	tyrh
穣	hyrh
囸	kvri
馹	mori
驲	mori
䎃	ayrj
譲	yyrj
蒻	cdro
婼	nkro
軟	iqrr
堧	tdrr
媆	ndrr
蠑	imrs
鎔	jkrs
镕	jkrs
嶸	emrs
栄	xmrs
榮	hmrs
絨	surs
銣	jkru
顬	yaru
嬬	naru
縟	scru
銳	jerv
汭	ddrv
閏	mwry
潤	dwry
薩	cfsa
颯	lfsa
灑	dlsa
騒	misc
騷	misc
鰠	aisc
鳋	aisc
掃	fjsc
掻	fisc
繅	smsc
繰	smsc
賽	bbsd
嗮	kysd
嘥	krsd
鰓	axsd
銫	jvse
嗇	akse
渋	ddse
澀	dvse
穡	hkse
㴔	dxse
嬸	ntsf
喪	unsh
顙	yash
虒	pjsi
螄	ijsi
俬	rssi
偲	rxsi
凘	djsi
鍶	jxsi
噝	kssi
飼	uksi
駟	mssi
鷥	nssi
廁	gdsi
廝	gjsi
枱	mksi
楒	mxsi
㟃	eksi
絲	sssi
緦	sxsi
傘	rusj
叄	sssj
饊	uwsj
毿	smsj
鎖	jbso
嗩	kbso
愬	xbso
瑣	wbso
縮	sbso
痠	bwsr
聳	erss
訟	ysss
誦	yass
𩠌	uzss
吅	kkss
頌	bass
餸	izss
餸	uzss
娀	ngss
鬆	asss
慫	xrss
㧐	fyss
㩳	fyss
肅	vasu
蘇	chsu
訴	ydsu
謖	ywsu
傃	rxsu
囌	khsu
甦	aasu
甦	afsu
穌	ahsu
窣	busu
粛	vasu
裇	pxsv
誶	yusv
隨	ezsv
雖	kfsv
髄	gzsv
旞	fzsv
歲	vpsv
砕	uusv
穂	hxsv
綏	snsv
繐	hxsv
蓀	cssy
孫	zssy
損	fbsy
猻	qssy
筍	vosy
蒐	cssz
蒐	cgsz
藪	cwsz
螋	iysz
鎪	jysz
颼	fysz
餿	uysz
廋	gysz
捜	fysz
擻	fwsz
褟	pyta
鉈	jvta
闥	mzta
鰨	ayta
撻	fzta
牠	nxta
獺	qbta
祂	pxta
討	yctc
唞	kutc
鞀	gktc
韜	aatc
弢	gytc
慆	xatc
梼	mctc
檮	mctc
濤	dctc
燾	hutc
絛	rstc
綯	sftc
臺	tutd
軚	idtd
鈦	jdtd
颱	fktd
駘	mktd
鮐	aktd
態	xstd
擡	fttd
枱	mktd
檯	mttd
鋱	jxte
铽	jxte
氹	dgtf
螣	oitg
謄	bytg
䲢	oytg
騰	omtg
鰧	oytg
䣘	exth
蹚	ztth
儻	rhth
劏	dxth
鎲	jeth
鏜	jtth
鐋	jpth
钂	jhth
镋	jeth
嘡	ktth
湯	dpth
燙	hdth
㓥	dxth
㓥	deth
䏲	opti
䴘	npti
俶	ryti
銻	jpti
題	oati
媂	njti
媞	nrti
體	gdti
鯷	arti
屜	uvti
鳀	arti
鵜	nbti
鷈	npti
鷉	npti
擿	fzti
綈	spti
緹	srti
菼	chtj
談	yhtj
譚	yutj
貪	brtj
倓	rhtj
鉭	jatj
錟	jhtj
鐔	jutj
啴	katj
嘆	kntj
嘽	katj
壇	tatj
弾	gatj
彈	gatj
惔	xhtj
攤	fftj
曇	ostj
榃	mttj
歎	cqtj
灘	dftj
癱	bftj
罈	futj
聤	edtk
聴	extk
聽	extk
䗴	iztk
侹	rztk
鋌	jztk
圢	tdtk
庁	gdtk
廳	gxtk
桯	mwtk
烴	hgtk
兲	wbtm
鈿	jttm
銛	jktm
铦	jktm
闐	mbtm
晪	obtm
沺	dttm
湉	dktm
畑	httm
誂	ydtn
調	yktn
銚	jdtn
嬥	nftn
鰷	amtn
齠	iktn
朓	odtn
條	rmtn
㕮	kxtn
糶	eftn
脫	oeto
萚	cato
蘀	cuto
託	yvto
讬	yvto
侂	rqto
迆	zxto
鉈	jvto
啴	kato
嘽	kato
馱	mdto
駝	mvto
鴕	nvto
鼉	kvto
橢	moto
籜	vuto
貼	bktp
鉄	jntp
鐵	jgtp
怗	xktp
畳	tqtp
団	kctr
團	kctr
摶	fctr
槫	mctr
糰	mctr
衕	rdts
銅	jkts
劏	dxts
哃	kkts
峂	edts
慟	xlts
曈	oats
橦	mats
㛚	nats
統	sets
腯	ootu
葖	cqtu
釷	jttu
図	kxtu
圖	kktu
塗	tdtu
従	rrtu
梌	mhtu
禿	hetu
㻬	wvtu
蛻	ietv
頹	hatv
粋	mutv
坉	tvty
飩	uvty
忳	xvty
鍮	jdtz
頭	dbtz
剎	dxua
鎩	jyua
唦	kpua
鯊	adua
廈	gwua
殺	xyua
紗	spua
卲	educ
柖	mkuc
焼	heuc
燒	heuc
紹	skuc
釃	ylud
曬	olud
篩	vjud
設	yyue
賒	bxue
踄	zpue
厙	iiue
闍	moue
奓	ddue
懾	xyue
捨	fkue
摂	fdue
攝	feue
渉	dpue
灄	deue
畬	rtue
脤	oyuf
腎	okuf
蔘	cpuf
詵	yeuf
諗	yxuf
諶	yvuf
侁	reuf
參	spuf
審	btuf
鰺	apuf
屾	eeuf
棽	mguf
滲	dpuf
瀋	dtuf
燊	hmuf
珅	wauf
糝	mpuf
紳	sauf
聖	weug
聲	ueug
乗	pnug
剰	dpug
勝	olug
昇	ocug
昇	oaug
澠	dvug
縄	svug
繩	svug
觴	jpuh
賞	bxuh
傷	rpuh
鞝	skuh
埫	tkuh
殤	dpuh
緔	skuh
䏡	oxui
蒔	ccui
蝕	uiui
蝨	viui
視	pjui
試	ydui
詩	ycui
諡	ymui
謚	ymui
識	ygui
貰	bcui
䴓	naui
軾	idui
適	zkui
釃	ylui
釈	pnui
釋	puui
鈰	jjui
勢	ltui
啫	koui
噓	kaui
塒	tcui
飾	ujui
奭	dbui
駛	mnui
実	bnui
實	bbui
鯴	aiui
鰣	acui
鰤	ajui
屍	upui
鳾	naui
師	pjui
弒	xdui
時	ocui
栻	mdui
浉	djui
湜	drui
溮	djui
溼	dtui
獅	qjui
訕	yeuj
贍	byuj
釤	jpuj
刪	dauj
単	xauj
閃	mruj
單	kauj
陝	enuj
墡	tluj
姍	nauj
騸	myuj
鱔	akuj
嶦	ekuj
掞	fhuj
摻	fpuj
撣	fauj
晱	ohuj
柵	mauj
睒	ojuj
禪	pauj
繕	skuj
羶	yauj
帥	pjuk
雙	ryul
塽	txul
滝	dvul
瀧	dlul
礵	ioul
說	yeuo
鑠	jmuo
爍	hmuo
碩	uauo
腨	oaur
閂	maur
槫	mcur
藷	couu
術	rduu
豎	dkuu
贖	bbuu
輸	iduu
婌	nyuu
屬	uiuu
悆	rxuu
攄	fxuu
數	wauu
書	vouu
朮	mduu
樞	mkuu
樹	mcuu
橾	mmuu
籔	vwuu
紓	sauu
說	yeuv
誰	yfuv
帨	jeuv
稅	heuv
誰	yfuw
順	pauy
揗	fouy
楯	mouy
収	vyuz
壽	ucuz
獣	xquz
獸	kquz
痩	byuz
綬	syuz
䃎	udva
詐	yava
軋	ivva
劄	dvva
鍘	jdva
閘	mava
奓	ddva
鮓	aava
齄	phva
齇	pqva
拃	fava
挓	fqva
搾	fava
柤	mqva
柵	mava
紮	smva
詔	ykvc
趙	zovc
釗	djvc
旐	fdvc
曌	ogvc
櫂	mfvc
側	rdvd
債	rbvd
堨	trvd
齋	wavd
択	fnvd
擇	fuvd
擿	fzvd
斎	wavd
欸	sqvd
䗪	give
蟄	itve
謫	ykve
輒	ivve
轍	iwve
這	zyve
鍺	jove
啫	kove
喆	ukve
嗻	khve
鷓	ngve
晢	ofve
痾	bkve
葴	cgvf
䟴	zyvf
袗	ppvf
診	ypvf
貞	bavf
賑	bnvf
軫	ipvf
偵	rbvf
針	juvf
鍼	jkvf
鎮	jbvf
陣	eivf
鴆	ndvf
幀	jbvf
抌	fevf
揕	fvvf
昣	opvf
楨	mbvf
湞	dbvf
禎	pbvf
縝	sbvf
証	yvvg
諍	yavg
證	ydvg
鄭	eqvg
鉦	jvvg
錚	javg
崢	eavg
徴	rwvg
憕	xavg
掙	favg
烝	hvvg
爭	vavg
猙	qavg
癥	bwvg
睜	oavg
箏	vavg
脹	onvh
賬	bnvh
長	anvh
鱆	auvh
帳	jnvh
張	gnvh
暲	ouvh
漲	dnvh
職	egvi
茋	cdvi
衹	pqvi
製	ypvi
觶	javi
誌	yxvi
識	ygvi
質	bjvi
贄	btvi
躑	zevi
躓	zbvi
軹	ibvi
輊	itvi
値	rvvi
酈	eavi
隻	ryvi
執	tdvi
姪	ntvi
騭	mevi
鷙	ntvi
幟	jgvi
庤	gcvi
扺	fqvi
摯	utvi
擲	fevi
擿	fzvi
晊	otvi
梔	mvvi
梽	mxvi
榰	movi
櫛	mevi
沚	dvvi
滯	djvi
祇	pqvi
紙	sqvi
緻	swvi
縶	stvi
繊	savi
織	sgvi
譫	yyvj
輾	invj
佔	rkvj
偡	rvvj
邅	zavj
咹	knvj
顫	wavj
嵁	evvj
嶄	ejvj
嶦	ekvj
戦	dgvj
戰	kgvj
斬	ijvj
栴	mdvj
桟	mdvj
棧	mgvj
氈	wmvj
盞	gmvj
綻	srvj
荘	cuvl
莊	cuvl
衆	xnvl
裝	ydvl
壯	duvl
妝	dnvl
戇	xlvl
樁	mavl
狀	dqvl
呣	kdvm
䓬	cuvo
䦃	jovo
諑	ynvo
叕	yyvo
鐯	jovo
鐲	jivo
晫	ouvo
柮	mevo
梲	mevo
棁	mevo
椓	mnvo
汋	ddvo
濁	divo
禚	phvo
繳	swvo
膞	ocvr
䏝	odvr
賺	bnvr
転	isvr
伝	rsvr
轉	icvr
傳	rcvr
僎	rcvr
囀	kcvr
顓	eavr
饌	ubvr
専	acvr
專	acvr
磚	ucvr
腫	oavs
茽	cavs
衆	xnvs
鈡	javs
鍾	javs
鐘	javs
塚	tnvs
柊	mdvs
眾	srvs
種	havs
終	sdvs
苧	cdvu
苧	cavu
薴	cdvu
藷	covu
蠋	iivu
註	ywvu
誅	ynvu
諸	yovu
豬	aovu
貯	bdvu
佇	rdvu
銖	jnvu
鋳	jcvu
鑄	jcvu
嗻	khvu
囑	kivu
駐	mwvu
屬	uivu
柷	mevu
櫧	movu
櫫	mavu
瀦	dovu
燭	hivu
矚	oivu
硃	unvu
竚	ldvu
築	vmvu
紵	savu
纻	savu
贅	bfvv
錐	jfvv
墜	tevv
騅	mfvv
綴	syvv
縋	szvv
這	zyvw
撾	fkvx
衠	rdvy
諄	yzvy
迍	zvvy
圫	tqvy
忳	xvvy
準	ufvy
荮	ccvz
葤	ccvz
謅	yevz
賙	bkvz
赒	bkvz
軸	iavz
週	zkvz
冑	yovz
冑	aovz
呪	kevz
驟	mnvz
婤	nkvz
晝	vavz
椆	mkvz
㑇	revz
㑳	revz
皺	gpvz
㤘	xevz
㥮	xevz
紂	scvz
縐	sevz
膃	omwa
襪	pnwa
咼	kkwa
婠	nkwa
媧	nkwa
搲	fgwa
窪	dtwa
咼	kkwd
喎	kkwd
聞	mewf
芠	cwwf
問	mkwf
閿	mywf
韞	amwf
塭	tmwf
馼	mwwf
鰛	amwf
鰮	amwf
忞	wxwf
抆	fwwf
揾	fmwf
搵	fmwf
榅	mmwf
榲	mmwf
溫	dmwf
炆	hwwf
穏	hxwf
穩	hxwf
紋	swwf
縕	smwf
缊	smwf
鶲	nbwg
甕	wwwg
輞	ivwh
尪	uwwh
網	svwh
萬	cdwj
輓	ivwj
卍	xxwj
卐	xxwj
頑	eawj
塆	tgwj
壪	tgwj
妧	newj
婠	nkwj
彎	sgwj
晩	ovwj
椀	mvwj
毌	vuwj
汍	ddwj
灣	dgwj
紈	sdwj
綰	skwj
臥	kdwo
萵	ckwo
蝸	ikwo
偓	rtwo
咼	kkwo
喎	kkwo
齷	itwo
撾	fkwo
	knwo
渦	dkwo
㖞	knwo
窩	bkwo
蕪	chwu
誣	yrwu
誤	ydwu
鄔	epwu
務	slwu
鎢	jhwu
吳	kdwu
嗚	khwu
噁	kxwu
霧	ylwu
塢	thwu
騖	mswu
嫵	nhwu
屼	eewu
峿	ekwu
鵐	nrwu
鵡	nqwu
鶩	nswu
廡	ghwu
悪	xawu
惡	xawu
憮	xhwu
旿	ouwu
樢	nmwu
汙	duwu
烏	phwu
無	rhwu
碔	udwu
葦	caww
薳	czww
蝟	ioww
螱	uiww
衛	rdww
諉	ynww
謂	yoww
亹	wqww
偉	raww
違	zaww
偽	rhww
闈	maww
囲	kaww
圍	kaww
韋	aaww
韙	oaww
餵	unww
鮪	aoww
峗	evww
幃	jaww
廆	ggww
撝	fhww
溈	dhww
潙	dhww
潿	daww
濰	dfww
為	dhww
煒	haww
瑋	waww
磑	udww
㧑	fdww
維	sfww
緯	saww
䜣	ijxb
訢	ijxb
伈	rxxb
釁	pdxb
鋅	juxb
鐔	juxb
肸	ouxi
臘	ovxi
蓆	cjxi
䜣	ijxi
襲	lyxi
覡	gjxi
訢	ijxi
係	rxxi
係	psxi
俙	rjxi
傒	rdxi
釐	aaxi
銑	jexi
錫	jpxi
卌	aaxi
喺	oxxi
噏	kyxi
囍	ukxi
餼	umxi
鬩	aexi
屃	buxi
屓	buxi
嶍	ebxi
嶲	egxi
巇	egxi
恓	xxxi
愾	xmxi
憙	uxxi
戯	hgxi
戱	hgxi
戲	hgxi
扱	fnxi
晞	ojxi
暿	okxi
枲	smxi
棲	mnxi
渓	dnxi
犠	ndxi
犧	ndxi
璽	awxi
窸	xbxi
細	stxi
繫	saxi
習	ybxi
興	pbxk
倖	ruxk
陘	egxk
餳	upxk
婞	nuxk
滎	dhxk
薌	cexl
詳	yyxl
郷	evxl
鄉	evxl
儴	ryxl
鑲	jyxl
嚮	vkxl
響	soxl
項	gaxl
餉	ukxl
饗	uvxl
驤	myxl
鯗	ayxl
廂	goxl
曏	oexl
緗	soxl
莧	cjxm
薟	crxm
蘚	cyxm
蜆	ijxm
賢	bkxm
躚	zzxm
伭	rdxm
僩	roxm
銑	jexm
銛	jkxm
銜	rdxm
鍁	jqxm
铦	jkxm
啣	kexm
閑	mmxm
閒	moxm
陥	eoxm
険	enxm
險	erxm
顕	oaxm
顯	oaxm
餡	uaxm
嫺	noxm
嫻	nmxm
孅	igxm
鮮	ayxm
峴	ejxm
崄	eaxm
嶮	erxm
鷳	nmxm
鷴	nmxm
鹹	akxm
忺	xqxm
憲	bxxm
挦	fcxm
摻	fpxm
撏	fcxm
杴	mqxm
狝	qxxm
猃	qaxm
獫	qrxm
獮	qxxm
獻	hqxm
現	wjxm
癇	boxm
県	oxxm
秈	mexm
㬎	hoxm
絃	ssxm
線	sdxm
縣	qsxm
縴	snxm
繊	saxm
纖	sgxm
羨	yrxm
蕭	caxn
虓	jjxn
蟏	iaxn
蠨	iaxn
傚	rwxn
銷	joxn
効	wlxn
嘐	kpxn
嘯	kaxn
嘵	kexn
囂	kkxn
驍	mexn
鴞	nkxn
鸮	nkxn
恔	xfxn
敩	xwxn
斆	wpxn
暁	oexn
曉	oexn
梟	nmxn
瀟	daxn
篠	vmxn
簫	vaxn
綃	soxn
脅	loxp
葉	cmxp
薢	cnxp
蠍	iqxp
褻	wyxp
諧	ybxp
謝	ycxp
偰	rdxp
協	ulxp
頡	uaxp
塮	tcxp
鮭	atxp
寫	bhxp
挾	fnxp
揳	fdxp
擷	faxp
攜	fkxp
洩	dpxp
瀉	dhxp
㙦	trxp
紲	svxp
緤	smxp
纈	saxp
脩	roxq
䗛	ijxq
鏥	jbxq
鏽	jaxq
饈	uaxq
鵂	rnxq
琇	wpxq
繍	saxq
繡	saxq
衒	rdxr
諼	yyxr
軒	iuxr
伭	rdxr
𣈶	oaxr
選	zbxr
鉉	jdxr
鏇	jrxr
吅	kkxr
咺	kaxr
嬛	nyxr
愃	xaxr
懸	xqxr
昡	odxr
晅	oaxr
暅	oaxr
暶	orxr
烜	haxr
瑄	waxr
璿	woxr
癬	byxr
絢	soxr
兇	xexs
夐	dwxs
洶	dkxs
茓	cbxt
謔	yaxt
學	zpxt
鱈	aext
峃	xext
嶨	epxt
鷽	npxt
敩	xwxt
斆	wpxt
澩	dpxt
虛	haxu
許	yuxu
詡	yyxu
諝	yoxu
谞	yoxu
冔	oaxu
勗	olxu
卹	xexu
噓	kaxu
垿	taxu
須	paxu
頊	waxu
媭	npxu
嬃	npxu
鬚	aaxu
魆	ggxu
敘	wrxu
旴	oaxu
昫	okxu
欻	hqxu
歔	hqxu
滸	duxu
漵	dwxu
籲	vaxu
粛	vaxu
糈	moxu
続	sdxu
緒	soxu
繻	saxu
續	sbxu
蝦	iyxx
轄	ikxx
俠	rnxx
叚	vyxx
嚇	kvxx
嚇	kdxx
鰕	ayxx
峽	enxx
廈	gwxx
烚	hkxx
煆	hyxx
狹	qnxx
硤	unxx
祫	pkxx
蕁	ccxy
薫	chxy
蟫	iuxy
訊	yuxy
訓	yaxy
詢	yoxy
遜	zzxy
勛	klxy
勲	hpxy
勳	plxy
噀	kcxy
塤	tbxy
壎	thxy
馴	maxy
尋	ecxy
鱘	acxy
栒	moxy
潯	dcxy
燻	hhxy
珣	woxy
瞓	oaxy
䥺	jpya
訝	ypya
亜	aaya
亞	aaya
軋	ivya
釾	jpya
錏	yaya
唖	kaya
啞	kaya
圧	itya
埡	taya
堐	ttya
壓	itya
姶	nkya
婭	naya
鴉	naya
鴨	naya
	jpya
椏	maya
氬	qaya
瘂	baya
茚	ceyb
蔭	csyb
䜣	ijyb
蟫	iuyb
訢	ijyb
䲟	aeyb
銀	jnyb
銦	jdyb
陰	esyb
嚚	kkyb
隠	exyb
隱	exyb
飲	uryb
鮣	aeyb
崟	ejyb
廕	gsyb
齦	inyb
愔	xoyb
慇	pxyb
慭	axyb
憖	xayb
歅	xqyb
珢	wyyb
癮	bxyb
葯	cdyc
薬	cmyc
藥	cmyc
謠	yfyc
謡	yfyc
軺	ikyc
遙	zdyc
僥	reyc
鈅	joyc
銚	jdyc
鑰	jcyc
垚	ttyc
堯	aeyc
餚	uoyc
媱	nfyc
鰩	afyc
峣	eeyc
嶢	eeyc
鷂	nvyc
麼	gsyc
揺	ffyc
搖	ffyc
榣	mfyc
焼	heyc
瑤	wfyc
瘧	bayc
㙘	tnyc
窯	bhyc
約	sdyc
葉	cmye
謁	yvye
倻	reye
鄴	eaye
円	aaye
鋣	jeye
吔	kxye
嘢	kaye
嚥	khye
靨	iaye
頁	baye
堨	trye
曄	oaye
楪	mmye
業	anye
燁	haye
爺	feye
緤	smye
卬	epyh
咉	knyh
钖	jpyh
陽	epyh
垟	tyyh
颺	fpyh
飏	fpyh
養	ynyh
鴦	nayh
揚	fpyh
旸	opyh
暘	opyh
楊	mpyh
様	mdyh
樣	mnyh
煬	hpyh
瘍	bpyh
癢	buyh
艤	vdyi
藝	csyi
螠	imyi
蟻	idyi
裛	wyyi
訳	ynyi
詒	ykyi
詣	yoyi
誼	yqyi
譯	yuyi
議	ydyi
貽	bkyi
乂	pnyi
軼	inyi
佁	rkyi
迆	zxyi
偯	ryyi
遺	zayi
儀	rdyi
億	rxyi
酏	yvyi
醫	ykyi
釔	jgyi
銥	jyyi
勚	clyi
勩	clyi
匜	kyyi
鎰	jmyi
叕	yyyi
鐿	jxyi
囈	ksyi
頤	kayi
壱	uvyi
飴	ukyi
駅	mnyi
驛	muyi
嫕	nxyi
宧	bayi
嶧	euyi
鷁	nqyi
帟	wjyi
廙	gcyi
憶	xxyi
懌	xuyi
扅	hdyi
扆	hyyi
昳	onyi
杙	mdyi
枍	mvyi
栘	mdyi
椸	mvyi
櫂	mfyi
浥	dvyi
㑊	rdyi
異	tbyi
瘞	btyi
礒	udyi
祎	payi
禕	payi
㴔	dxyi
縊	smyi
繹	suyi
義	ydyi
艷	fvyj
虤	hjyj
蝘	ikyj
諺	ypyj
讌	yhyj
讞	yqyj
豔	fmyj
贋	ibyj
贗	ibyj
䶮	ldyj
儼	rwyj
兗	weyj
醃	yvyj
釅	ywyj
剦	ddyj
匽	knyj
厭	iqyj
厳	xwyj
厴	iayj
啱	ouyj
閆	msyj
閹	mvyj
閻	mayj
嚥	khyj
嚴	kwyj
顏	wayj
顔	layj
塩	tmyj
墕	thyj
饜	iuyj
験	mnyj
驗	mryj
嬿	nhyj
魘	igyj
巌	ewyj
巖	ewyj
鹽	mkyj
黡	viyj
黶	ihyj
弇	rcyj
鼴	unyj
彥	wpyj
龑	ldyj
懨	xqyj
戭	bgyj
扊	hhyj
掞	fhyj
梴	mzyj
棪	mhyj
歅	xqyj
沇	deyj
灧	dvyj
灩	dmyj
煙	htyj
硯	ujyj
䓨	cfyk
蛍	xiyk
螢	hiyk
蠅	ivyk
贏	wbyk
鎣	jhyk
営	xkyk
嚶	knyk
頴	payk
塋	htyk
媖	nnyk
嬰	nbyk
鶯	hnyk
鷹	gnyk
鸚	nbyk
応	gxyk
應	gxyk
攖	fnyk
桜	mnyk
桯	mwyk
櫻	mnyk
滎	dhyk
潁	payk
瀅	dwyk
瀠	dsyk
熒	hhyk
營	hkyk
瑩	hwyk
瓔	wnyk
癭	bnyk
穎	payk
縈	hsyk
纓	snyk
罃	fhyk
罌	fbyk
喲	kdyo
薳	czyr
蜎	ioyr
轅	iyyr
遠	ztyr
円	aayr
員	bkyr
園	kyyr
圓	kbyr
願	iayr
妧	neyr
嫄	nxyr
鳶	nqyr
鴛	ndyr
黿	evyr
櫞	mnyr
淵	dayr
緣	snyr
縁	snyr
詠	knys
踴	zlys
傭	rays
鏞	jays
埇	tays
鯒	aays
鱅	aays
擁	ffys
栐	mnys
湧	dlys
癰	bfys
㶲	hays
說	yeyt
躍	zfyt
鈅	joyt
鉞	jdyt
鑰	jcyt
閱	meyt
噦	kpyt
嶽	eqyt
悅	xeyt
楽	mdyt
樂	mvyt
櫟	mmyt
玥	woyt
粵	pgyt
約	sdyt
與	pbyu
艅	vhyu
蕷	cayu
薁	cdyu
褕	pdyu
覦	rjyu
語	ykyu
諛	ynyu
諭	ydyu
譽	pyyu
輿	pbyu
俁	rdyu
傴	rkyu
鈺	jwyu
喐	ekyu
閾	mayu
隩	edyu
圫	tqyu
堉	toyu
預	sayu
飫	udyu
餘	uhyu
馭	myyu
娛	ndyu
嫗	nkyu
鬱	mpyu
魚	dhyu
嵎	edyu
鵒	nbyu
嶼	eayu
鷸	nsyu
彧	kdyu
齬	ikyu
悆	rxyu
慾	xbyu
敔	wwyu
棫	mgyu
歟	pqyu
滪	dbyu
漁	dayu
澦	dayu
獄	qqyu
玙	wayu
璵	wbyu
畬	rtyu
癒	bxyu
禦	xryu
籲	vayu
㳚	ddyu
紆	suyu
㺄	qdyu
蕓	csyy
蕰	cmyy
薀	cmyy
蘊	cmyy
贇	bwyy
運	zbyy
鄆	ebyy
鄖	ekyy
醞	ymyy
勻	gayy
隕	ebyy
雲	ysyy
韞	amyy
韻	lbyy
妘	nsyy
惲	xiyy
慍	xmyy
暈	oiyy
殞	dbyy
氳	qmyy
沄	dsyy
涢	dbyy
溳	dbyy
紜	ssyy
縕	smyy
缊	smyy
耰	myyz
蕕	cqyz
誘	ypyz
遊	zfyz
郵	epyz
優	rwyz
鈾	jayz
銪	joyz
魷	adyz
憂	wayz
槱	mhyz
猶	qyyz
祐	pkyz
紬	sayz
臜	obza
臢	obza
囃	kfza
雑	jfza
雜	wfza
甴	kaza
譟	ymzc
蹧	zozc
鑿	ajzc
慥	xzzc
棗	anzc
皁	buzc
竈	bezc
載	igzd
側	rdzd
災	vhzd
責	bfze
賾	kbze
則	dbze
嘖	kbze
幘	jbze
択	fnze
擇	fuze
沢	dnze
澤	duze
簀	vbze
譖	yozf
䎖	byzg
贈	bozg
鋥	jwzg
増	tozg
曽	bozg
繒	sozg
臓	oazh
蔵	cazh
贓	bdzh
駔	mqzh
髒	gczh
茲	cszi
虸	izzi
諮	kdzi
諮	ykzi
貲	bvzi
資	bdzi
輜	itzi
錙	jtzi
嗞	kdzi
孖	zzzi
鯔	atzi
齜	ivzi
漬	dbzi
眥	ovzi
緇	stzi
讚	ybzj
賛	bazj
賺	bnzj
贊	bnzj
趲	zbzj
輾	inzj
偺	rozj
鏨	jizj
寁	brzj
攢	fbzj
暫	oizj
瓚	wbzj
咗	kgzo
岞	eazo
捽	fuzo
躦	zbzr
鉆	jkzr
鑽	jbzr
纘	sbzr
蹤	zrzs
倧	rxzs
傯	rxzs
樅	mrzs
糉	mwzs
綜	sxzs
総	xxzs
縦	srzs
縱	srzs
總	sxzs
詛	yqzu
鏃	juzu
崒	eizu
組	sqzu
酔	yuzv
槜	mgzv
賊	buzw
僔	rczy
噂	kczy
鱒	aczy
嶟	eczy
諏	yyzz
鄒	gdzz
騶	mezz
鯫	ayzz
