的	debd
的	dibd
一	yiaa
是	uior
了	leva
了	lnva
不	buad
在	zdut
有	yzuo
個	gerk
人	rfpn
這	vezy
這	vwzy
上	uhaa
中	vsaa
大	daan
大	ddan
為	wwdh
來	ldan
我	wopd
到	dcda
出	iuek
要	ycxn
以	yivr
時	uioc
和	hehk
和	hohk
和	huhk
地	detv
地	ditv
們	mfrm
得	derc
得	dwrc
可	kedk
下	xxad
對	dvac
生	ugpf
也	yevv
子	ziva
就	jqwd
過	gozk
能	ngsv
他	tarv
會	hvro
會	kkro
多	dopd
發	favy
而	eraa
於	wufd
於	yufd
自	zipo
之	vidn
用	yspa
年	nmra
行	hhrd
行	xkrd
家	jxbn
方	fhwp
後	hzrw
作	zora
成	iggv
開	kdmk
面	mmaa
事	uiaa
好	hcnz
小	xnad
心	xbdd
前	qmqd
所	sopj
道	dczq
法	fads
如	runk
進	jbzf
着	vcyo
着	veyo
着	voyo
同	tskk
經	jksg
分	ffbd
定	dkbr
都	duet
都	dzet
然	rjhp
與	yupb
本	bfaa
還	hdzy
還	hrzy
其	qiqb
當	dhxt
起	qizv
動	dspl
已	yivv
兩	llar
點	dmhk
從	csrr
問	wfmk
裏	liwy
主	vudw
實	uibb
天	tmad
高	gcwk
去	quts
現	xmwj
長	ihan
長	vhan
此	civv
三	sjae
將	jldc
無	morh
無	wurh
國	goka
全	qrrw
文	wfwx
理	liwa
明	mkoo
日	rika
些	xpev
看	kjuo
只	vikb
公	gsbs
等	dgvc
十	uiaa
意	yixl
正	vgav
外	wdpd
想	xlxm
間	jmmo
把	bafv
情	qkxo
者	veto
沒	mody
沒	mwdy
重	ispa
重	vspa
相	xlmo
那	naev
向	xlpk
知	viuk
因	ybkd
樣	yhmn
學	xtzp
應	ykgx
又	yzvn
手	uzpa
但	djra
信	xbrk
關	grma
使	uirn
種	isha
種	vsha
見	jmoe
力	ligp
名	mkpk
二	eraa
處	iuhj
門	mfaa
並	bkqa
口	kzaa
麼	megs
麼	mogs
麼	ycgs
先	xmne
位	wwrl
頭	tzdb
回	hvkk
話	hxyk
很	hfrn
再	zdaa
由	yzaa
身	ufpp
入	rupn
內	nwad
第	divp
平	pkau
被	bwpp
被	pipp
給	gwsk
給	jisk
次	cidr
別	bpdk
幾	jisg
月	ytpe
真	vfub
立	lila
新	xblj
通	tszs
少	ucxp
機	jimj
打	dafd
水	uvan
果	goan
最	zvoy
部	buel
何	herk
安	anbn
接	jpfn
報	bcty
聲	ugue
才	cdap
體	tigd
今	jbrv
合	gerk
合	herk
性	xkxf
西	xiaa
你	nirx
放	fhwf
表	bnfy
目	muka
加	jxlk
常	ihxj
做	zorw
己	jivv
老	lctv
四	sike
件	jmrn
解	jpjn
解	xpjn
路	luzk
更	ggan
走	zztr
比	biav
總	zssx
金	jbrb
管	grvk
光	glxe
工	gsaa
結	jpsk
提	difr
提	tifr
任	rfru
東	dsan
原	yrix
便	bmrn
便	pmrn
美	mwyd
及	jipn
教	jnwt
難	njcf
世	uicv
至	vita
氣	qiqm
神	ufpa
山	ujka
數	uuwa
利	lidh
書	uuvo
代	ddrd
直	viuq
色	sedv
色	uddv
場	ihtp
變	bmws
記	jiyv
張	vhgn
必	bidp
受	uzvy
交	jnwf
非	fwaa
服	fuoy
化	hxrv
求	qqad
風	fgji
度	dogy
度	dugy
太	tddd
萬	wjcd
各	gewk
算	srvc
邊	bmzp
王	what
什	ufru
什	uiru
快	kkxn
許	xuyu
連	lmzi
五	wuaa
活	hodk
思	sixt
該	gdyr
步	buvp
海	hddd
指	vifo
物	wunp
則	zedb
女	nvva
或	hoga
完	wjbe
馬	maah
強	jlgi
強	qlgi
言	yjwk
條	tnrm
特	tenc
命	mkre
感	gjxg
清	qkdo
帶	ddfj
認	rfyx
保	bcrm
望	whww
轉	vric
傳	irrc
傳	vrrc
兒	erpe
制	vidp
幹	gjuu
計	jiyu
民	mbvq
白	bdpo
住	vurw
字	zibz
它	tabv
義	yiyd
車	ieaa
車	juaa
像	xlrn
反	fjpy
象	xldn
題	tioa
卻	qtek
流	lqdv
且	qpaa
即	jiev
深	ufdm
近	jbzj
形	xkap
取	quey
往	whrw
系	jips
系	xips
量	lloa
論	lyya
告	gcnk
息	xixp
讓	rhyy
決	jtdn
未	wwan
花	hxcv
收	uzwv
滿	mjdr
每	mwrd
華	hxca
業	yean
南	njuu
覺	jnpj
覺	jtpj
電	dmyv
空	ksbg
眼	yjon
聽	tkex
遠	yrzt
師	uipj
元	yree
請	qkyo
容	rsbk
她	tanv
軍	jybi
士	uiua
百	bdab
辦	bjll
語	yuyk
期	qiqo
北	bwav
林	lbmm
識	uiyg
識	viyg
半	bjba
夫	fuan
客	kebk
戰	vjkg
院	yree
城	igtv
候	hzru
單	djka
單	ijka
單	ujka
音	yblo
台	tdsk
死	sidv
視	uipj
領	lkra
失	uipn
司	sigk
親	qblj
親	qklj
始	uink
極	jima
雙	ulry
令	lkrs
改	gdwv
功	gsgl
程	ighw
愛	aivw
德	derx
復	furw
切	qpqd
隨	svez
李	limz
員	yrbk
離	liwf
輕	qkig
觀	gryj
青	qkfo
足	zukr
落	lack
落	lcck
落	lock
叫	jnka
根	gfmn
怎	zfxr
持	iifc
精	jkmo
送	sszq
眾	vssr
影	ykop
八	bapn
首	uzqo
包	bcgv
準	vyuf
興	xkpb
紅	hssg
達	dazy
早	zcou
盡	jbmv
故	guwu
房	fhhf
引	ybga
火	hodr
站	vjlk
似	uirr
找	vcfg
備	bwra
調	dnyk
調	tnyk
斷	drsj
設	ueyy
格	gemk
消	xndo
拉	lafl
照	vcho
布	buuj
友	yzuy
整	vgav
術	uurd
石	djak
石	uiak
展	vjun
緊	jbks
據	jufn
終	vssd
周	vzpk
式	uiqd
舉	jupa
飛	fwvd
片	pmpv
雖	svkf
易	yiop
運	yyzb
笑	xnvd
雲	yyys
建	jmzv
談	tjyh
界	jpta
務	wusl
寫	xpbh
錢	qmjg
商	uhlk
樂	lemv
樂	ytmv
推	tvff
注	vudw
越	ytzv
千	qmpu
微	wwrw
若	rock
約	ycsd
約	ytsd
英	ykcn
集	jimr
示	uiex
呢	nekv
呢	nikv
待	ddrc
坐	zotr
議	yiyd
乎	hupu
留	lqtp
稱	ifha
稱	igha
品	pbkk
志	vixu
黑	hwha
存	cyuz
六	lqwb
六	luwb
造	zczn
低	dird
江	jldg
念	nmxr
產	ijwf
刻	kedw
節	jpve
爾	erax
吃	iikg
勢	uilt
依	yiry
圖	tukk
共	gscb
曾	cgbo
曾	zgbo
響	xlso
底	digd
裝	vlyd
具	juqb
喜	xiuk
嚴	yjkw
九	jqpg
況	klde
跟	gfzn
羅	losf
須	xupa
顯	xmoa
熱	reht
病	bkbn
證	vgyd
剛	ghdk
治	vidk
絕	jtsv
羣	qyvy
市	uiwj
陽	yhep
確	qtuf
究	jqbj
久	jqpn
除	iueh
聞	wfme
答	davk
段	drpy
官	grbk
政	vgwa
類	lwma
黃	hlcb
武	wuvd
七	qiav
支	viuy
費	fwbv
父	fubx
統	tsse
府	fugc
查	iama
般	bjvy
斯	siqj
倒	dcrd
突	tubq
號	hckj
樹	uumc
拿	naru
克	keue
初	iupd
廣	glgb
奇	jidk
奇	qidk
願	yria
歡	hrcq
希	xixj
母	muvd
香	xlho
破	poup
誰	uvyf
誰	uwyf
致	viwa
線	xmsd
急	jixd
古	guuk
既	jivv
句	gzgk
句	jugk
京	jkwx
甚	ufqv
仍	rgrp
晚	wjov
爭	vgva
遊	yzzf
龍	lsla
餘	yuuh
護	huyc
另	lkkl
器	qikk
細	xist
木	muan
權	qrmf
星	xkof
哪	nake
苦	kuck
孩	hdzr
試	uiyd
朝	icuo
朝	vcuo
阿	aaek
阿	eeek
隊	dven
居	juuk
害	hdbk
獨	duqi
講	jlya
錯	cojo
局	juuk
男	njtl
差	ciyg
差	iayg
差	idyg
參	cjsp
參	ufsp
社	uept
換	hrfn
選	xrzb
止	viaa
際	jiex
假	jxry
漢	hjdn
夠	gzdk
訴	suyd
資	zibd
密	mibe
案	anbm
史	uian
較	jnif
環	hrwy
投	tzfy
靜	jkfa
寶	bcbb
專	vrac
修	xqrp
室	uitb
區	oukk
區	qukk
料	lnmu
幫	bhtj
衣	yiwy
竟	jkle
模	momd
模	mumd
臉	lmor
善	ujyk
兵	bkpb
考	kctg
規	gvaj
聯	lmea
團	trkc
冷	lgds
玉	yuwd
施	uifv
派	pddn
紀	jisv
採	cdfm
歷	liiv
顧	guha
春	iyfo
責	zebf
夜	yewd
畫	hxaa
驚	jkcm
銀	ybjn
負	fubd
續	xusb
嗎	makm
簡	jmvo
章	vhlu
左	zoug
塊	kktg
索	sous
酒	jqdy
值	virq
態	tdxs
按	anfn
陳	ifed
河	hedk
巴	bavv
衝	isrd
陣	vfei
境	jkte
助	vuql
角	jnda
角	jtda
户	hudu
亂	lrvv
呼	huku
靈	lkya
腳	jnoe
繼	jisv
樓	lzmn
景	jkox
怕	paxb
停	tkrd
鐵	tpjg
異	yitb
謝	xpyc
否	fzak
傷	uhrp
蘭	ljcn
置	visq
醫	yiyk
良	lldn
承	igvn
福	fupt
科	kehu
屬	uuui
屬	vuui
圍	wwka
需	xuya
退	tvzv
基	jitq
右	yzuk
速	suza
適	uizk
藥	yccm
懷	hkxy
擊	jiui
買	mdbs
素	sufs
背	bwoa
歲	svvp
土	tuua
忙	mhxv
充	iswe
排	pdfa
價	jprb
價	jxrb
質	vibj
遇	yuza
端	drla
列	lpdd
印	ybep
貴	gvba
疑	yipr
露	luyk
露	lzyk
哥	gedk
殺	uaxy
標	bnmx
招	vcfk
血	xppm
血	xtpm
禮	lipd
弟	dibp
亮	llwj
齊	qiwa
穿	irbp
腦	ncox
委	wwhn
州	vzda
某	mzcm
順	uypa
省	ugxo
省	xkxo
討	tcyc
尚	uhxk
維	wwsf
板	bjmy
散	sjwc
項	xlga
狀	vldq
追	vvzp
筆	biva
副	fuda
層	cguo
沙	uadp
養	yhyn
讀	duyb
讀	dzyb
習	xiyb
永	ysdn
草	cccu
胡	huuo
濟	jida
執	vitd
察	iabx
歸	gvpe
富	fubt
座	zogt
座	zotr
雨	yuad
堂	thtx
威	wwgn
忽	huxg
蘇	such
船	irvk
罪	zvss
敢	gjwv
婦	funj
村	cymc
著	vcco
著	vcyo
著	veco
著	veyo
著	voco
著	voyo
著	vuco
著	vuyo
食	sirn
食	uirn
食	yirn
導	dccv
免	mmdv
温	wfdm
莫	mocd
掌	vhxu
激	jidw
慢	mjxy
託	toyv
勝	ugol
險	xmer
尋	xyec
守	uzbc
波	bodp
雷	lwyt
沉	ifdj
秀	xqhp
職	vieg
驗	yjmr
靠	kcna
楚	iumr
略	lttk
族	zufu
藏	chca
藏	zhca
麗	lial
漸	jmdj
劉	lqdp
僅	jbrf
肯	kfvo
擔	djfk
揚	yhfp
盤	pjmv
唐	thgk
鍾	vsja
級	jisn
毛	mcpv
營	ykhk
堅	jmtk
鬆	ssas
皮	pivy
供	gsrb
店	dmgk
飯	fjuy
範	fjvv
哈	hakk
趕	gjzu
吧	bakv
雪	xtye
鬥	dzaa
效	xnww
臨	lbkk
農	nsan
味	wwkn
惡	eexa
惡	wuxa
煙	yjht
園	yrky
烈	lphd
配	pwyv
雜	zawf
短	drud
跳	tnzd
孫	syzs
曲	quaa
封	fgtc
抓	vxfv
移	yihd
頓	dyaa
律	lvra
賣	mdbu
藝	yics
舊	jqca
朋	pgoo
救	jqwa
防	fhef
脱	tooe
翻	fjpy
劃	hxdv
迎	ykzp
痛	tsba
校	jnmf
校	xnmf
窗	ilbd
宣	xrba
鄉	xlev
楊	yhmp
葉	xpcm
葉	yecm
警	jkyc
限	xmen
湖	hudo
軟	rriq
掉	dnfu
財	cdbp
詞	ciyk
壓	yait
揮	hvfi
超	iczk
屋	wuut
秋	qqhh
跑	pczv
忘	whxw
館	gruk
暗	anoo
班	bjdw
黨	dhxh
宗	zsbx
壞	hkty
技	jify
困	kykm
登	dgdv
姐	jpnq
預	yusa
耳	eraa
席	xigj
夢	mgcd
朱	vupn
組	zusq
旁	phlf
份	ffrd
禁	jbmx
套	tcds
亞	yaaa
益	yimq
探	tjfm
康	khgn
增	zgto
詩	uiyc
戲	xihg
伯	bdrb
伯	borb
曉	xnoe
含	hjrk
勞	lchl
恩	enxk
頂	dkda
君	jyvk
莊	vlcu
謂	wwyo
付	furc
田	tmku
畢	bita
紙	visq
研	yjuc
虛	xuha
怪	gkxt
寧	nkbd
替	tioa
犯	fjqv
燈	dghd
優	yzrw
您	nbxr
姓	xknf
例	lird
絲	siss
蓋	gdcm
誤	wuyd
架	jxml
幸	xktu
隱	ybex
股	guoy
毒	dufd
娘	nlnn
佔	vjrk
智	viou
佛	fora
佛	fura
牀	ildm
米	mibm
凡	fjjd
介	jpra
徵	vgrw
徵	virw
彩	cdvp
演	yjdb
射	ueuc
祖	zupq
欲	yubq
束	uuan
獲	hoqy
舞	wura
聖	ugwe
夥	hoad
梅	mwmd
普	puqo
借	jpro
私	sihs
源	yrdx
鎮	vfjb
睡	uvoa
緩	hrsy
升	ugpc
納	nasd
織	visg
歌	gedq
宮	gsbk
概	gdmv
野	yeaa
醒	xkyf
夏	xxaw
互	huaa
積	jihb
街	jprd
牌	pdpu
休	xqrm
搖	ycff
洋	yhdy
敗	bdwb
監	jmmk
骨	guko
批	pifv
兄	xske
刀	dcgp
網	whsv
率	lvwu
率	ukwu
庭	tkgz
熟	uuhw
熟	uzhw
創	ildr
訪	fhyf
硬	ykun
仁	rfre
菜	cdcm
丁	dkaa
綠	lusd
綠	lvsd
牛	nqpa
避	bizu
陰	ybes
拍	pdfb
雄	xsuf
祕	bipp
祕	mipp
缺	qtfn
卷	jrbv
姑	gunk
尼	niuv
油	yzda
恐	ksxg
玩	wjwe
釋	uipu
遍	bmzh
握	woft
球	qqwd
降	jlea
降	xlea
慮	lvhx
榮	rshm
策	cevn
肉	rzar
媽	manm
迷	mizm
檢	jmmr
伸	ufra
歐	oukq
攻	gswg
練	lmsn
育	yuwo
危	wwdv
廳	tkgx
啊	aakk
睛	jkoo
擺	bdfv
茶	iacm
勇	yssl
判	pjdb
材	cdmp
抱	bcfv
亦	yiwd
妻	qian
吸	xikn
喝	hekv
趣	quzy
嘴	zvkj
逐	vuza
操	ccfm
午	wuru
吉	jiuk
浪	lhdn
輪	lyic
默	mohq
毫	hcwm
冰	bkdd
珠	vuwn
鼓	guuy
階	jpeb
孔	kszv
徐	xurh
固	gukk
偏	pmrc
陸	lqet
陸	luet
諸	vuyo
遺	yiza
爺	yefe
述	uuza
帝	dilj
閉	bimp
補	bupd
編	bmsa
巨	juka
透	tzzh
弄	nswc
尤	yzud
魯	luao
擁	ysff
錄	luvd
吳	wukd
牆	qlpk
貨	hobr
弱	rogd
敵	diwl
挑	tnfd
寬	krbd
跡	jizd
抽	izfa
忍	rfxd
折	uefj
折	vefj
輸	uuid
穩	wfhx
皇	hlbw
桌	voam
獻	xmhq
蒙	mgcn
紛	ffsd
麻	magm
洗	xide
評	pkyu
掛	gxfd
童	tsla
尊	zyqc
舍	uerk
唯	wwkf
博	bouc
劇	judh
乃	ndgp
混	hydv
彈	djga
彈	tjga
附	fuec
遲	iizu
敬	jkwc
杯	bwmd
魚	yudh
控	ksfg
塞	sdbt
塞	sebt
劍	jmdr
厚	hziz
佳	jxrt
測	cedd
訓	xyya
牙	yaap
洞	dsdk
淡	djdh
盛	igmg
盛	ugmg
縣	xmqs
芳	fhcf
雅	yaaf
革	geca
款	kruq
橫	hgmb
累	lwts
擇	vdfu
擇	zefu
乘	igpn
乘	ugpn
刺	cida
載	zdig
猛	mgqm
逃	tczp
構	gzma
趙	vczo
杜	dumt
慶	qkgw
途	tuzr
奔	bfdc
虎	huhj
巧	qngg
抗	khfj
針	vfju
徒	turr
圓	yrkb
閃	ujmr
谷	gubk
紹	ucsk
聚	juen
額	eeba
健	jmrz
誠	igyv
鮮	xmay
淚	lwdq
閒	xmmo
均	jytd
序	xuga
震	vfyn
仿	fhrf
緣	yrsn
戴	ddtg
婚	hyno
篇	pmvc
亡	whwv
奶	ndnp
忠	vsxa
煩	fjha
賽	sdbb
鬧	ncaj
協	xpul
傑	jprm
殘	cjdg
懂	dsxa
丹	djpa
柳	lqme
妹	mwnn
映	ykon
橋	qnmk
歎	tjcq
愈	yuxr
旅	lvfn
授	uzfy
享	xlwz
暴	bcod
偷	tzrd
藍	ljcm
氏	uipq
寒	hjbd
宜	yibq
棄	qiwm
豐	fgad
延	yjzp
輩	bwia
搶	igfk
搶	qlfk
顏	yjwa
贊	zjbn
典	dmab
冒	mcoo
眉	mwvo
燒	uche
廠	ihiw
唱	ihko
徑	jkrg
庫	kugi
川	irpa
辭	civu
伴	bjra
怒	nuxn
型	xkta
純	iysv
貝	bwob
票	pnxx
隔	geea
窮	qsbg
拜	bduf
審	ufbt
倫	lyrc
悲	bwxa
柔	rzsm
啟	qiwh
減	jmdk
頁	yeba
縱	zssr
掃	scfj
偉	wwra
迫	pdzb
迫	pozb
振	vffn
瑞	rvwa
丈	vhan
樑	llmm
洲	vzda
槍	qlmk
央	yhan
觸	iuji
予	yusa
予	yusn
孤	guzg
縮	sosb
洛	lodk
損	syfb
促	curz
番	fjpt
番	pjpt
罷	basp
罷	pisp
宋	ssbm
奮	ffdt
銷	xnjo
幕	mucj
猶	yzqy
鎖	sojb
珍	vfwp
抬	tdfk
陪	pwek
妙	mnnp
摸	mofd
峯	fgef
勁	jbal
勁	jkal
鏡	jkje
沈	ufdv
奪	dodc
昨	zooa
哭	kuqk
訊	xyyu
貌	mcve
謀	mzym
泰	tdfd
側	cerd
側	vdrd
側	zdrd
貧	pbbb
扶	fufn
阻	zueq
貼	tpbk
申	ufaa
岸	aneu
彼	birp
賞	uhbx
版	bjpy
抵	difd
澤	zedu
插	iafa
迅	xyzv
憑	pkxd
伊	yirp
潮	icdo
咱	zjko
仙	xmre
符	fuvc
宇	yubu
肩	jmho
嘗	ihxo
遞	dizp
燕	yjhc
潔	jpds
拒	jufa
郎	lhed
凝	nkdr
淨	jkda
遭	zczc
儀	yird
薄	bccc
薄	bocc
卡	kaad
卡	qxad
末	moan
勒	legl
勒	lwgl
烏	wuph
森	sfmm
諾	noyk
呀	yakp
壯	vldu
憂	yzwa
沿	yjdk
慣	grxb
丟	dqps
季	jihz
企	qirv
壁	bitu
惜	xixo
婆	pond
袋	ddyr
朗	lhdo
零	lkys
辛	xblu
憶	yixx
努	nuln
舒	uura
枝	vimy
鳳	fgjh
滅	mpda
韓	hjua
膽	djok
灰	hvuh
旦	djoa
孟	mgmz
陷	xmea
俗	surk
繞	rcse
疾	jibu
瞧	qnoh
洪	hsdb
甲	jxaa
帳	vhjn
糊	humo
泛	fjdn
皆	jpba
碰	pgua
吹	ivkq
碼	maum
奉	fgfa
箱	xlvo
傾	qkra
胸	xsok
堆	dvtf
狂	klqw
仲	vsra
圈	jrkv
圈	qrkv
冬	dswd
餐	cjua
厲	liid
腿	tvoz
尖	jmxd
括	kofk
佩	pwrj
鬼	gvps
欣	xbjq
垂	ivpa
躍	ytzf
港	ghdv
騙	pmmc
融	rsai
撞	vlfa
塔	tatk
紫	zisv
蕩	dhcp
敏	mbwr
鄭	vgeq
賴	ldab
滑	hxdg
允	yyse
鳥	dnnh
鳥	nnnh
課	keyn
暫	zjoi
瓦	waad
祥	xlpy
染	rjmd
滾	gydy
浮	fudz
粗	cumq
刑	xkda
輛	llir
狗	gzqk
撲	pufd
稍	ucho
秦	qbfh
扎	vafv
魂	hyeg
島	dcne
騰	tgom
臣	ifka
琴	qbwv
悉	xixp
絡	lcsk
絡	losk
摩	mogu
措	cofo
域	yutk
冠	grbc
竹	vupa
殊	uudn
豪	hcwn
呆	ddkm
薩	sacf
旋	xrfr
喊	hjkk
寄	jibk
悄	qnxo
倍	bwrk
祝	vupe
剩	ugdp
督	duoa
旗	qifb
返	fjzp
召	ucdk
召	vcdk
徹	iewr
賓	bbbb
甘	gjca
吐	tukt
喬	qnpk
腰	ycon
拔	bafd
幅	fujt
違	wwza
詳	xlyy
臂	biou
臂	bwou
尺	iiun
飲	ybur
顆	keaa
涉	uedp
逼	biza
競	jkle
培	pwtk
惠	hvxa
虧	kvhg
叔	uuay
伏	furq
喚	hrkn
雞	jinv
鄰	lbem
池	iidv
怨	yrxp
奧	aopd
侯	hzru
騎	qimk
漫	mjdy
拖	tofv
俊	jyrw
尾	wwum
恨	hfxn
貫	grbv
凌	lkdw
兼	jmqn
詢	xyyo
碎	svuu
晨	ifon
罰	fasd
鋪	pujd
濃	nsdn
伍	wurw
宿	subb
宿	xqbb
泉	qrbd
井	jkaa
繁	fjsr
粉	ffmd
緒	xuso
築	vuvm
恢	hvxh
匹	pike
塵	iflt
輝	hvgi
魔	mogg
仰	yhre
董	dsca
描	mnft
距	juza
盜	dcmd
渡	dudy
勤	qbcl
勸	qrcl
蓮	lmcz
坦	tjta
搭	dafk
挺	tkfz
蹤	zszr
幽	yzev
截	jprg
荒	hlcv
恰	qxxk
慧	hvxf
邦	bhef
頗	popa
焦	jnhr
醉	zvyu
廢	fwgy
掩	yjfv
籤	qmvg
喪	shun
災	zdvh
鼻	bipa
侵	qbry
陶	tcef
肅	suva
裁	cdyg
俱	jurb
磨	mogu
析	ximj
獎	jldq
匆	csgd
瓶	pkqw
泥	nidv
拾	uifk
涼	lldx
麥	mdad
湧	ysdl
潛	qmdo
隆	lsef
津	jbda
搞	gcfk
蛋	djvi
奈	nddx
擾	rcfw
耐	ndac
傅	furc
錦	jbjj
播	boft
墨	moth
偶	ourd
捕	bufd
惑	hoxg
飄	pnxf
屈	quuk
鳴	mknk
擠	jifa
毀	hvpy
斜	xpru
啦	lakl
污	wudg
赤	iitd
慰	wwxu
飾	uiuj
鋒	fgjf
覆	fuxw
覆	furw
湯	thdp
壽	uzuc
跨	kxzg
羊	yhba
航	hhvj
拳	qrbu
盟	mgmo
廷	tkzp
盧	luhm
嚇	hekv
嚇	hekd
嚇	xxkv
嚇	xxkd
寂	jiby
荷	heck
亭	tkwd
曼	mjoy
呂	lvkk
寸	cyad
衡	hgrd
狠	hfqn
郭	goew
奏	zzfd
割	gedb
閣	gemk
汗	hjdu
箭	jmvd
埋	mdta
埋	mjta
撥	bofy
頻	pbva
屏	pkuc
坡	potp
宏	hsbs
黎	lihd
猜	cdqo
萊	ldcn
障	vheu
患	hrxa
牢	lcbn
搜	szfy
賢	xmbk
賀	hebl
遷	qmzx
欺	qiqq
裂	lpyd
鞋	xpgt
撫	fufh
罵	mams
乏	fapn
拼	pbfc
俄	eerd
闊	komk
礙	aiur
搬	bjfy
夾	gaan
夾	jxan
遙	yczd
牽	qmwn
駕	jxml
爸	bafv
踏	tazo
添	tmdx
襲	xily
扣	kzfk
艾	aicx
艾	yicx
鄧	dgev
兇	xsxe
殿	dmuy
訂	dkyd
昏	hypo
肚	duot
匯	hvkd
驅	qumk
核	hemr
核	humr
桑	shym
孝	xntz
棋	qimb
咬	yckf
疏	uuvv
邀	yczb
仔	zdrz
仔	zirz
巡	xyzv
嘉	jxuk
冊	ceaa
仇	izrj
仇	qqrj
串	iraa
糧	llma
齡	lkis
宅	vdbq
扭	nqfa
嫁	jxnn
蒼	chck
戒	jpgc
賈	gubx
賈	jxbx
崇	isex
翠	cvyu
嶽	yteq
蟲	isii
椅	yimk
暖	nroy
曹	ccao
慕	mucx
灣	wjdg
彎	wjsg
捉	vofz
濤	tcdc
柱	vumw
糾	jqsa
邪	xpea
邪	yeea
譯	yiyu
刊	kjda
朵	dojm
浩	hcdk
翼	yiyb
吟	ybkv
悶	mfmx
幼	yzvl
昌	ihoo
羽	yuga
吾	wuwk
柏	bdmb
柏	bomb
植	vimq
哀	aiwy
慘	cjxp
辯	bmyu
肥	fwov
憐	lmxa
傲	aorw
潤	rydw
扇	ujhy
聰	csex
聊	lnee
纖	qmsg
纖	xmsg
鑑	jmjm
吞	tyak
估	gurk
赫	hetd
堪	kjtv
陵	lkew
趨	quze
牧	muwn
漂	pndx
盈	ykmg
攝	npfe
攝	uefe
欠	qmdr
欠	qmfn
欠	qtdr
欠	qtfn
擴	kofb
覽	ljjk
譽	yupy
姿	zind
霞	xxyy
豔	yjfm
豈	qied
屍	uiup
幻	hrvg
稀	xihj
勃	boul
勃	bwul
抖	dzfu
瘋	fgbf
御	yure
療	lnbx
爬	pavv
籍	jivo
敲	qnwy
愁	izxh
淺	qmdg
憤	ffxb
魏	wwhg
鑽	zrjb
馮	fgdm
馮	pkdm
袖	xqpa
悦	ytxe
欄	ljmd
櫃	gvmb
櫃	jumb
塗	tutd
飽	bcuv
揭	jpfv
揭	qifv
邁	mdzc
卿	qkpe
倆	llrr
躲	doum
壇	tjta
巖	yjew
勾	gzgs
偽	wwrh
購	gzba
汪	whdw
韋	wwaa
霧	wuyl
曰	ytka
廟	mngo
貢	gsbg
租	zuhq
呈	igkw
媒	mwnm
艱	jmcn
嫌	xmnn
窩	wobk
矛	mcsp
葛	gecv
循	xyro
旨	vipo
忌	jixv
燃	rjhh
豆	dzaq
呵	hekk
挖	wafg
戀	lmxs
娜	nane
娜	none
駐	vumw
跌	dpzn
捷	jpfr
桃	tcmd
赴	fuzd
誘	yzyp
僕	purd
昂	ahoe
夕	xipd
甜	tmpc
昭	vcok
厭	yjiq
摘	vdfk
耶	yeee
脣	iyio
劫	jptl
爆	bchd
援	yrfy
姜	jlyn
稿	gchk
蒂	dicj
辨	bmdu
醜	izvg
擦	cafx
桂	gvmt
梯	timp
炮	bchv
炮	pchv
瓜	gxpn
腐	fugr
銅	tsjk
瘦	uzby
惟	wwxf
遵	zyzq
慌	hlxv
賭	dubo
叢	csay
擋	dhft
税	uvhe
爛	ljhs
盒	hemr
霸	bayo
逢	fgzw
牲	ugnf
悟	wuxk
撐	igfp
擬	nifr
扮	bjfd
酸	sryw
卓	voau
漠	modd
凱	kdej
羞	xqya
署	uuso
刷	uxdu
廉	lmgn
炸	vaha
熊	xshs
償	ihrb
汽	qidq
彌	migx
績	jisb
蕭	xnca
剪	jmqd
盾	dypo
宴	yjbn
售	uzkr
億	yirx
帽	mcjo
痴	iibk
溝	gzda
惱	ncxx
斤	jbpa
寺	sitc
輯	jiie
倉	chrk
貪	tjbr
滴	didk
贏	ykwb
疼	tgbd
痕	hfbn
縫	fgsz
慈	cixq
役	yiry
悔	hvxd
殷	ybpy
殷	yjpy
賦	fubd
噴	pfkb
伐	farg
漏	lzdd
蛇	ueiv
堡	bctr
鼠	uupv
脈	mdon
脈	moon
撤	iefw
慎	ufxb
妨	fhnf
玄	xrws
債	vdrb
扯	iefv
耀	ycgf
禍	hopk
逸	yizd
穆	muhp
煉	lmhd
爐	luhm
腹	fuow
戈	gead
液	yedn
抑	yife
掙	vgfa
舟	vzpd
懸	xrxq
勵	liil
籌	izvc
晶	jkoo
迪	diza
卧	wokd
鍵	jmjz
碗	wjuv
鴻	hsdn
芝	vicn
渾	hydi
攔	ljfn
纏	ijst
鈴	lkjs
拆	idfd
恆	hgxa
昆	kyov
爹	dpfd
卜	boad
卜	buad
嘛	makm
耗	hclm
碧	biuw
髒	zhgc
貓	mcvt
悠	yzxr
霍	hoyf
霜	ulyo
拋	pcfl
謹	jbya
轟	hsii
苗	mnct
轎	jnik
奴	nuny
嶺	lkea
郵	yzep
繩	ugsv
逆	nizq
茫	mhcv
躺	thuk
翁	wgby
撒	safw
鷹	ykgn
暢	ihap
紋	wfsw
崔	cvef
抹	mafn
抹	mofn
晴	qkoo
嬌	jnnk
吻	wfkp
繪	hvso
披	pifp
吊	dnkj
獄	yuqq
芬	ffcd
敦	dyww
劣	lpxl
溪	xidd
懼	juxf
辱	ruic
昔	xico
踐	jmzg
辰	ifin
填	tmtb
晉	jbao
雕	dnpf
鬱	yump
賜	cibp
矩	juua
冤	yrbd
豬	vuao
狼	lhqn
菲	fwca
勉	mmdl
叉	iayd
跪	gvzv
矣	yisu
滋	zids
礎	iuur
姆	mund
兆	vcpd
頸	ggva
頸	jkva
衫	ujpp
捧	pgfa
賊	zwbu
睜	vgoa
闖	ilmm
驟	vzmn
毅	yily
籠	lsvl
丘	qqpa
妥	tovn
衰	ukwy
歇	xpoq
湊	czdd
棉	mmmj
柴	idmv
韻	yylb
胞	bcov
墓	muct
巾	jbaa
遂	svzq
恭	gscx
炎	yjhh
貞	vfba
誓	uiyf
催	cvrf
脅	xplo
檔	dhmt
甫	fuad
玲	lkws
虹	hsig
棒	bhma
馳	iimv
哲	vekf
疊	dptq
傻	uarw
璃	liws
鞭	bmgn
鵬	pgon
押	yafa
翔	xlyy
址	vitv
貿	mcbp
崗	ghek
腸	ihop
廊	lhge
胖	phoa
胖	pjoa
盼	pjod
疲	pibp
駛	uimn
舌	uepk
泄	xpdv
齒	iivk
戚	qigx
湘	xldo
臭	izpq
臭	xqpq
仗	vhrn
晃	hlog
蝶	dpim
蓬	pgcz
謙	qmyn
餓	eeud
衷	vswy
萍	pkcu
漲	vhdn
葬	zhcc
幣	bijx
吵	ickp
潘	pjdt
遮	vezg
拓	tafk
拓	tofk
獵	lpqv
儲	iuro
渴	kedv
逝	uizf
彭	bhup
彭	pgup
惹	recx
袁	yrty
顫	ijwa
顫	vjwa
脆	cvov
娃	want
瞬	uyoa
膚	fuho
嫂	scny
灑	sadl
侍	uirc
履	lvuw
挨	aifu
淑	uudy
廚	iugc
獸	uzkq
薛	xtcu
旺	whow
欽	qbjq
鶴	hend
婉	wjnv
械	xpmc
削	xndx
削	xtdx
喘	irka
竊	qpbs
愧	kvxg
銘	mkjk
裕	yupk
帥	ukpj
宰	zdbu
杭	hhmj
紗	uasp
埃	aitu
樸	pnmd
樸	pomd
樸	pumd
酷	kuyk
繡	xqsa
遣	qmza
贈	zgbo
誼	yiyq
耕	ggla
函	hjvk
掘	jtfk
鏈	lmjz
豫	yusn
賠	pwbk
灌	grdf
斥	iipd
診	vfyp
皺	vzgp
畏	wwtn
溜	lqdt
誇	kxyg
攜	xpfk
琳	lbwm
粒	liml
愚	yuxa
屆	jpua
穴	xtbb
玻	bowp
淵	yrda
筋	jbvl
輔	fuid
遼	lnzx
帕	pajb
攤	tjff
裹	gowy
喂	wwkn
籲	xuva
籲	yuva
屠	tuuo
疆	jlga
盆	pfmb
氛	ffqd
瑪	mawm
綜	zssx
症	vgbv
弗	fuva
闢	biuu
闢	piuu
峽	xxen
郊	jnew
蔡	cdcx
拐	gkfl
筒	tsvk
挽	wjfv
棵	kemn
糟	zcmo
攀	pjmu
菊	jucm
砍	kjuq
褲	kupi
眠	mmoq
杆	gjmu
蓄	xuct
綁	bhse
涵	hjdk
綿	mmsj
啞	yaka
漁	yuda
鑰	ycjc
鑰	ytjc
寡	gxbd
諒	llyx
慨	kdxv
凍	dsdd
狐	huqg
軌	gvij
爵	jtvc
拘	jufk
懶	ljxb
枚	mwwm
犧	xind
煌	hlhw
奸	jmnu
碑	bwuu
祭	jipx
媚	mwno
剝	bcdv
剝	bodv
鍋	gojk
潑	pody
腔	qlog
妖	ycnd
乞	qirg
姚	ycnd
歪	wdav
乙	yigg
芒	mhcv
舅	jqpl
扔	rgfp
枯	kumk
饒	rcue
哩	lika
爽	uldx
柯	kemk
趁	ifzp
譜	puyo
契	qidf
契	xpdf
弦	xmgs
掠	ltfx
汝	rudn
寨	vdbm
鹽	yjmk
簾	lmvn
翰	hjuy
焰	yjha
儒	rura
愉	yuxd
肖	xnxo
尉	wwuc
尉	yuuc
裙	qypk
桶	tsma
俠	xxrn
盯	dkod
訝	yayp
誕	djyv
隸	limn
勿	wugp
抄	icfp
姊	zinp
礦	klub
袍	pcpv
泡	pcdv
踢	tizp
倚	yirk
泊	bodb
咽	yekd
咽	yjkd
罩	vcsu
哦	eekd
哦	ookd
瓊	qsww
乳	ruvv
倘	thrk
膀	bhof
膀	phof
堵	duto
嚷	rhky
尹	ybvp
薦	jmch
囊	nhay
竭	jplv
矢	uird
酬	izya
瞪	dgod
焉	yjah
淮	hkdf
塑	sutq
乾	gjug
乾	gjau
乾	qmug
乾	qmau
畜	iuwt
畜	xuwt
剎	iadx
剎	uadx
頑	wjea
磁	cius
蔽	bicw
穎	ykpa
卑	bwpu
驕	jnmk
茲	cics
茲	zics
泣	qidl
脊	jido
淫	ybdu
聘	pbeg
蜜	mibi
懲	igxr
堤	ditr
駱	lomk
茂	mccp
肌	jioj
錫	xijp
僧	sgro
恥	iiex
徽	hvrw
煤	mwhm
姻	ybnd
蔣	jlcc
顛	dmua
暈	yyoi
陌	moeb
軀	quuk
鼎	dkov
邏	lozs
賺	vrbn
賺	zjbn
蜂	fgif
膝	xiod
釘	dkjd
衍	yjrd
寓	yubd
豎	uudk
蓉	rsck
蠻	mjis
溢	yidm
沾	vjdk
盲	mhwo
僱	gurf
哼	hgka
摔	ukfu
濱	bbdb
駁	bomx
遜	xyzz
燭	vuhi
歉	qmqq
襯	ifpj
晰	xioj
妮	ninv
夷	yian
嫩	nfnw
憲	xmbx
燦	cjhm
糖	thmk
瑰	gvwg
腫	vsoa
灘	tjdf
峻	jyew
哄	hskb
咐	fukc
籃	ljvm
囑	vuki
嘲	icko
嘲	vcko
瑟	sewd
獅	uiqj
栽	zdmg
軒	xriu
詐	vaya
聳	sser
狹	xxqn
姨	yinn
茅	mccp
蘋	pgcb
蘋	pkcb
雁	yjif
趟	thzk
譚	tjyu
浙	vedj
巷	hhcv
巷	xlcv
磚	vruc
啼	tikj
弓	gsvg
棺	grmk
餅	bkuc
佐	zorg
斑	bjww
掏	tcff
掀	xmfq
魅	mwgn
臘	laov
臘	xiov
浴	yudk
僵	jlra
娶	qune
紐	nqsa
俯	furc
浦	pudd
偵	vfrb
庸	ysga
販	fjby
捐	jrfo
挪	nofe
胎	tdok
丫	yaba
歹	ddad
帆	fjjd
畝	muwn
飢	jiuj
漆	qidd
鹿	lugv
碩	uoua
秒	mnhp
渠	qumd
滯	vidj
榜	bhmf
拂	fufa
嘿	hwkh
倦	jrrv
咳	kekr
悽	qixn
釣	dnjd
艙	chvk
株	vumn
擱	gefk
賤	jmbg
哉	zdkg
喉	hzku
稽	jiho
喻	yukd
坊	fhtf
券	qrbd
券	xrbd
藤	tgcd
澄	dgdd
澄	igdd
媳	xinx
柄	bkmn
秩	vihn
憾	hjxx
矮	aiun
殼	keuy
殼	qnuy
窄	vdba
脾	piou
銜	xmrd
暮	muco
框	klmw
熙	xihk
肝	gjou
鈞	jyjd
貸	ddbr
乖	gkpv
躬	gsug
壺	huua
珊	ujwa
淋	lbdm
匙	iiov
匙	uiov
荊	jkcd
隙	xiex
旬	xygo
樁	vlma
搏	bofc
宛	wjbv
宛	yrbv
瞞	mjor
狄	diqh
魄	pobg
琪	qiwb
枕	vfmv
吼	hzkv
刮	gxdp
晌	uhok
叛	pjby
崖	yaet
卸	xper
梳	uumv
歧	qivy
嘻	xikk
娛	yund
拱	gsfb
伺	cirk
伺	sirk
旭	xujo
猴	hzqu
杏	xkmk
賬	vhbn
崩	bgeo
寵	isbl
怔	vgxv
嘯	xnka
脹	vhon
睹	duoo
妄	whwn
祿	lupd
怖	buxj
辣	laln
擅	ujfa
辜	guuu
邵	uced
汁	vidu
齋	vdwa
嬰	yknb
蔭	ybcs
膠	jnop
淘	tcdf
芙	fucn
罕	hjbu
肆	siaa
浸	jbdy
鮑	bcav
坑	kgtj
莉	licd
岡	ghkk
腕	wjov
佑	yzrk
墳	fftb
棍	gymv
棚	pgmo
迭	dpzp
莎	uacp
捆	kyfm
兮	xibg
喧	xrka
塌	taty
惶	hlxw
脖	booz
墜	vvte
堯	ycae
斂	lmwr
綢	izsk
棟	dsmd
頃	qkaa
耍	uxan
廂	xlgo
殖	vidq
嵌	qmeq
寞	mobd
騷	scmi
雀	qtxf
哨	ucko
濫	ljdm
蘆	lucm
姬	jina
孕	yygz
劈	pidu
懇	kfxv
斬	vjij
靖	qklo
愣	lgxf
鹹	xmak
廈	uagw
廈	xxgw
簇	cuvu
刃	rfdd
卒	cuwu
卒	zuwu
笨	bfva
眸	mzon
匪	fwka
捏	npft
逗	dzza
涯	yadt
枉	whmw
裸	lopn
邱	qqep
炭	tjeh
笛	diva
弊	bicx
噪	zckm
耿	ggeh
劑	jidw
喲	yokd
敞	ihwx
彬	bbmp
裴	pwya
彥	yjwp
屢	lvun
弘	hsgs
兔	tudd
匠	jlkj
麟	lbla
恍	hlxg
墊	dmtu
耽	djev
玫	mwww
魁	kvgu
薪	xbcj
粘	nmmk
粘	vjmk
輿	yupb
誦	ssya
潰	kvdb
巫	wugr
冶	yedk
簿	buvc
蹈	dcza
綱	ghsk
爍	uohm
躁	zczm
咖	gakk
咖	kakk
杖	vhmn
慄	lixm
喃	njku
塘	thtk
糕	gcmh
啡	fwka
蹲	dyzc
鴨	yana
旱	hjou
頌	ssba
禪	ijpa
禪	ujpa
俺	anrv
擎	qkuc
脂	vioo
犬	qrdd
桐	tsmk
頰	jxaa
叮	dkkd
剖	pzdl
謊	hlyv
胃	wwto
阮	rree
祈	qipj
勛	xykl
侄	virt
稚	vihf
楓	fgmf
煞	uahd
聶	npee
禽	qbrd
諷	fgyf
譁	hxka
攏	lsfl
縛	fusc
挫	coft
眷	jrbo
丸	wjgd
棧	vjmg
俏	qnro
宙	vzba
斌	bbwd
襟	jbpx
寇	kzby
畔	pjta
陡	dzer
肢	vioy
坎	kjtq
恕	uuxn
唉	aiku
倡	ihro
蝕	uiui
傍	bhrf
罐	grff
稻	dcha
薇	wwcw
砸	zauj
諧	xpyb
郝	hcet
暑	uuoo
羨	xmyr
豹	bcvv
潭	tjdu
桓	hrma
蒸	vgch
閻	yjma
竄	crbu
瑩	ykhw
樊	fjdm
瑣	sowb
碌	luud
奠	dmqd
泳	ysdn
擲	vife
甩	ukpv
澳	aodd
撕	sifj
轄	xxik
虞	yuhd
妓	jiny
鈔	icjp
嗚	wukh
肺	fwoj
繳	jnsw
繳	vosw
暇	xxoy
疫	yiby
鴉	yana
滄	chdk
篷	pgvz
倪	nire
昧	mwon
滲	ufdp
妒	dunu
坤	kyta
謠	ycyf
禿	tuhe
僻	piru
瞎	xxok
苑	yrcv
淹	yjdv
朽	xqmg
曠	klob
哇	wakt
瓣	bjgu
瑤	ycwf
禱	dcpc
粹	cvmu
黛	ddhr
溶	rsdk
縷	lvsn
鄒	zzgd
烤	kchg
俞	yurd
晝	vzva
翅	iiuy
蕾	lwct
屁	piuv
冥	mkbb
鈕	nqja
鈕	nqsa
茵	ybcd
帖	tpjk
乍	vara
撈	lcfl
煥	hrhn
逾	yuzr
頒	bjba
瓷	ciwd
凜	lbdh
幢	ilja
幢	vlja
咒	vzjk
綴	vvsy
晤	wuok
郡	jyev
勻	yyga
鑄	vujc
苟	gzck
扁	bmhc
扁	pmhc
壘	lwtt
兜	dzep
撰	vrfb
廓	koge
敷	fuwa
爪	vcpn
爪	vxpn
譬	piyu
懈	xpxn
窟	kubk
吩	ffkd
沃	wodd
菱	lkcw
窺	kvbj
逛	glzq
斧	fufj
逮	ddzv
瀟	xnda
馨	xbuo
娟	jrno
梨	limh
沛	pwdj
焚	ffhm
怡	yixk
陋	lzev
啥	uakk
龜	gvpx
龜	jypx
龜	qqpx
蠢	iyfi
棠	thxm
刪	ujda
絨	rssu
漿	jldd
叩	kzek
沸	fwda
緬	mmsa
厄	eeiv
甸	dmgt
攬	ljfj
妃	fwnv
詠	yskn
駝	tomv
猿	yrqy
葡	pucd
絞	jnsf
巢	icvn
瞻	vjoy
踩	cdzm
侖	lyrc
陝	ujen
嗓	shkm
陀	toev
咕	gukk
裳	ihxy
裳	uhxy
鄙	biek
圾	jitn
膜	mood
灼	vohd
婿	xuno
巍	wweg
龔	gslb
怯	qpxs
瞥	ppox
穢	hvhd
囚	qqkr
霄	xnyo
紳	ufsa
袱	fupq
舜	uyva
膩	niod
拚	pbfc
蠟	laiv
屑	xpuo
盞	vjgm
撇	ppfw
軸	vzia
鵝	eenp
侮	wurd
磊	lwuu
嵐	ljef
曬	udol
駭	hdmr
摧	cvff
煮	vuht
櫻	ykmn
綺	qisk
艇	tkvz
吶	nakr
吶	nekr
翩	pmhy
禹	yupd
挾	jxfn
挾	xpfn
蘿	locf
澀	sedv
傘	sjru
牟	musn
牟	mzsn
滔	tcda
沫	modn
兑	dvbe
匿	nikk
紡	fhsf
萄	tccf
廖	lngp
艦	jmvm
揉	rzfm
喇	lakd
蹄	tizj
攪	jnfj
炒	ichp
膏	gcwo
芽	yacp
寢	qbby
吏	lian
燙	thhd
彰	vhlp
冀	jiab
洽	qxdk
侶	lvrk
鞍	angn
夭	ycpd
廝	sigj
藉	jico
藉	jiro
藉	jpco
藉	jpro
詭	gvyv
雍	yswf
鑲	xljy
撿	jmfr
蔬	uucv
訣	jtyn
磕	keum
蒲	pucd
凳	dgvj
俘	furz
襄	xlwy
驢	lvmm
傭	ysra
勘	kjql
冉	rjaa
兢	jkue
尿	nnud
搗	dcfe
嘶	sikj
亨	hgwa
曙	uuoo
哎	aikx
詫	iayq
暉	hvoi
岔	iabe
釀	nlyn
嫉	jinu
僑	qnrk
剔	tido
湛	vjdv
宵	xnbo
蟻	yiid
熬	aohf
燥	zchm
擒	qbfs
毯	tjmh
噸	dyka
膊	booc
摟	lzfn
斐	fwwa
胳	gaok
胳	geok
槽	ccmo
碟	dpum
榻	tamy
眨	vaon
賄	hvbo
奢	uedo
垃	latl
訟	ssys
閨	gvmt
砂	uaup
灶	zcht
棲	qimn
棲	ximn
壤	rhty
狡	jnqf
仕	uiru
姥	lcnv
螺	lois
撓	ncfe
絮	xusn
纜	ljsj
豁	hobk
邢	xkea
叭	bakb
拙	vofk
淳	iydz
淳	vydz
凸	tuaa
廁	cegd
廁	sigd
緞	drsy
鉛	qmjk
寥	lnbp
摯	viut
倩	qmro
愕	eexg
奎	kvdt
瀾	ljdd
墮	dote
墮	hvte
澆	jnde
艘	szvy
斟	vfqu
棗	zcan
覓	mivj
蜀	uusi
虐	ntha
嬸	sfnt
諮	zikd
諮	ziyk
揀	jmfd
貶	bmbn
屯	tyav
屯	vyav
戳	ioyg
秉	bkpn
鞠	jugm
悼	dcxu
樞	uumk
鶯	ykhn
蔓	mjcy
蔓	wjcy
娥	eend
毋	wuvp
儉	jmrr
萌	mgco
莽	mhcc
沁	qbdx
梧	wumk
沐	mudm
朔	uoqo
膛	thot
醬	jlyd
薰	xych
狸	liqa
慚	cjxj
丙	bkan
濁	vodi
琢	vown
揪	jqfh
凹	aoaa
凹	waaa
叨	dckd
叨	tckd
嚼	jnkc
嚼	jtkc
霖	lbym
扳	bjfy
刁	dnga
凰	hljw
闡	ijma
伶	lkrs
棘	jian
憎	zgxo
諱	hvya
祁	qiep
聾	lsle
蔚	wwcc
雯	wfyw
遏	eezo
鞏	gsgg
尬	gaja
芸	yics
芸	yicg
芸	yycs
芸	yycg
砌	qiud
尷	gjum
鏢	bnjx
扛	ghfg
扛	khfg
澡	zcdm
驀	mocm
綽	icsu
綽	iosu
廬	lugm
竅	qnbw
琦	qiwk
癱	tjbf
牡	munt
梭	somw
滕	tgod
幟	vijg
囂	xnkk
癢	yhbu
菩	puck
彤	tspp
孜	ziwz
弧	hugg
蟬	ijia
黯	anho
矯	jnuk
瞄	mnot
謬	mqyp
抒	uufa
徊	hkrk
饋	kvub
嘔	oukk
梢	ucmo
丐	gdag
絹	jrso
喀	kakk
稼	jxhn
揣	ikfa
揣	trfa
揣	vvfa
卵	lrpd
駿	jymw
錘	ivja
衙	yard
坪	pktu
鍛	drjy
緝	jise
菌	jych
淪	lydc
裔	yiyk
斃	bixv
炯	jshk
瀏	lqdd
肘	vzoc
芯	xbcx
晏	yjon
緯	wwsa
醋	cuyo
鑼	lojf
梗	ggmn
謎	miyz
黴	mwyw
邑	yikv
糞	ffmb
迄	qizr
慷	khxn
貯	vubd
槐	hkmg
壩	bato
殆	dddk
孰	uuwd
庶	uugh
蚊	wfiw
拷	kcfg
鴿	genr
琛	ifwm
缸	ghfg
渺	mndp
竿	gjvu
咧	lpkd
詹	vjdy
瀑	pudd
徘	pdra
洶	xsdk
撼	hjfx
漓	lids
噓	uika
噓	xuka
翹	qnty
楞	lgmf
呻	ufka
柵	cema
柵	ujma
柵	vama
蠶	cjai
兀	wuae
瑜	yuwd
腥	xkoa
烘	hshb
膨	pgop
裘	qqay
窘	jsbk
葱	cscx
彪	bnhp
馭	yumy
綻	vjsr
奕	yiwd
侃	kjrv
妾	qpln
嘎	gakg
酌	voyd
閥	famg
孽	npcz
篤	duvm
庚	gggn
襪	wapn
炕	khhj
嗯	enkx
嗯	ogkx
鏟	ijjf
瀉	xpdh
陛	biet
柬	jman
皓	hcbk
朦	mgon
韶	uclk
攢	crfb
攢	zjfb
竇	dzbb
赦	uewt
檻	jmmm
檻	kjmm
槓	ghmb
熾	iihb
轍	veiw
奚	xivd
繆	mnsp
繆	mqsp
繆	mzsp
稟	bkwh
憋	bpxx
箏	vgva
贓	zhbd
肇	vcha
溯	sudo
萎	wwcn
煎	jmhq
窯	ycbh
汲	jidn
匣	xxka
咎	jqwk
茨	cicr
藩	fjct
叱	iikq
忿	ffxb
頹	tvha
眶	klow
跋	bazd
誡	jpyd
僚	lnrx
譏	jiyd
鑿	zcaj
粥	vzmg
朧	lsol
趴	pazb
葫	huco
熄	xihx
蝴	huio
檐	yjmy
蔑	mpcd
辮	bmsu
嶄	vjej
炳	bkhn
帷	wwjf
絆	bjsa
逞	igzk
飼	siuk
拭	uifd
敖	aowf
璇	xrwr
匡	klkw
婷	tknd
啤	piku
悍	hjxu
蝦	xxiy
蠅	ykiv
圭	gvtt
繹	yisu
閘	vama
虔	qmhw
蛛	vuin
杉	uamp
杉	ujmp
蛙	wait
濺	jmdg
倏	uurq
瞅	izoh
靡	miga
螞	maim
懊	aoxd
樵	qnmh
墅	uuta
咯	gekk
咯	kakk
咯	lokk
擰	nkfd
篩	udvj
芭	bacv
眯	miom
炬	juha
皂	zcbq
募	mucl
橡	xlmn
戎	rsgu
嗣	sikk
筷	kkvn
釐	liaa
釐	xiaa
璧	biwu
忖	cyxc
婪	ljnm
唬	hukh
嗽	szkq
嗅	xqkq
稜	lgmw
稜	lkmw
楷	jpmb
楷	kdmb
迸	bgzq
軋	gaiv
軋	vaiv
軋	yaiv
睦	muot
涕	tidp
蟹	xpij
卦	gxtd
拯	vgfa
癮	ybbx
矚	vuoi
瘡	ilbk
惕	tixp
扒	bafb
扒	pafb
汰	tddd
蒜	srcx
椒	jnmy
婁	lzan
庵	angv
峨	eeed
札	vamv
祠	cipk
錠	dkjr
淌	ihdk
淌	thdk
繃	bgso
髓	svgz
怠	ddxs
霓	niye
擂	lwft
漾	yhdn
雛	iugf
禾	hepm
骸	hdgr
苛	keck
靴	xtgv
煒	wwha
哺	bukd
澗	jmdo
渝	yudd
蕊	rvcx
亟	jiva
鱗	lbaa
匈	xsgk
眺	tnod
輻	fuit
贖	uubb
錐	vvjf
餚	ycuo
鋸	jujk
疇	iztc
恬	tmxk
誣	wuyr
窒	vibt
蕪	wuch
粟	suxm
棕	zsmx
蹦	bgzo
沼	vcdk
硯	yjuj
嘟	duke
虜	luhl
睫	jpor
糙	ccmz
茄	jxck
茄	qpck
乒	pkpp
茹	ruck
扼	eefv
溺	nidd
溺	nndd
驛	yimu
隋	doeo
隋	sveo
頤	yika
乓	phpd
桔	jpmk
桔	jumk
葦	wwca
庇	bigv
褐	hepv
氓	mgwq
氓	mhwq
澈	iedw
瓏	lswl
渦	godk
渦	wodk
鬢	bbab
眩	xros
瘤	lqbt
拴	urfw
撩	lnfx
孺	ruza
隧	svez
懾	uexy
拈	nmfk
膳	ujok
佟	tsrd
狽	bwqb
譴	qmyz
噢	ookd
沮	judq
曳	yeap
磋	coug
褥	rupc
漬	zidb
贅	vvbf
咚	dskd
敝	biwx
崎	qiek
憫	mbxw
霎	uayn
錚	vgja
逍	xnzx
誅	vuyn
轅	yriy
茜	qmcx
茜	xicx
駒	jumk
閩	mbmi
紊	wfws
冕	mmov
苔	tdck
峙	uiec
峙	viec
闕	qtmq
涅	npdt
詣	yiyo
悵	ihxn
籬	livf
哆	dokd
霆	tkyz
盔	kvmu
踱	dozy
昊	hcod
吭	hhkj
吭	kgkj
寅	ybbb
垢	gztk
丞	igva
媛	yrny
薔	qlck
弛	iigv
琉	lqwv
攙	ijfd
靶	bagv
捂	wufk
遁	dyzp
晦	hvod
嗜	uiko
嘍	lzkn
噬	uikr
臻	vfah
咄	dokk
嚨	lskl
阱	jkea
唾	toka
隴	lsel
榆	yumd
恃	uixc
吱	viky
汀	tkdd
躊	izzc
脯	fuod
脯	puod
賂	lubk
筍	syvo
雌	civf
酣	hjyc
遐	xxzv
芷	vicv
恤	xuxx
鈍	dyjv
酥	suyh
滌	didm
藻	zccm
巳	sivv
瞳	tsoa
萃	cvcu
楠	njmu
蹬	dgzd
摻	ijfp
摻	ujfp
摻	xmfp
瞿	juof
瞿	quof
酉	yzxa
祀	sipv
躇	iuzo
聆	lkes
腑	fuoc
卉	hvuc
憊	bwxr
奄	yjdv
締	disj
肋	leol
肋	lwol
彷	fhrf
彷	phrf
簧	hlvb
髦	mcma
嫣	yjnh
賃	lbbr
羈	jism
侈	iird
醇	iyyz
琵	piwv
琅	lhwn
羹	ggyd
迢	tnzd
疚	jqbn
厥	jtiq
馴	xyma
搓	cofg
迦	jxzl
褪	tvpz
褪	typz
娼	ihno
熒	ykhh
鐸	doju
秤	ighu
惚	huxx
勺	ucgd
烹	pghw
岑	cfev
掣	ieup
琶	pawv
疤	babv
啪	pakb
嫻	xmnm
翎	lkry
箋	jmvg
寰	hrby
俐	lird
圃	pukd
殃	yhdn
嘖	zekb
穗	svhx
睿	rvao
窖	jnbk
宦	hrba
輒	veiv
妞	nqna
顱	luha
絳	jlsa
隅	yued
儼	yjrw
峭	qneo
檀	tjma
啃	kfko
蕉	jnch
闌	ljmd
曦	xiog
舵	dovv
毆	ouky
瑚	huwo
梵	fjmd
嗤	iiki
摹	mocu
墾	kftv
椎	ivmf
椎	vvmf
悖	bwxz
韌	rfad
腮	sdox
妍	yjnc
鎔	rsjk
栩	xumy
犀	xiun
垮	kxtg
埠	butu
橙	igmd
炙	viph
葵	kvcd
睬	cdom
砰	pguu
殲	jmdd
婢	binu
柿	uimj
吆	ycks
亥	hdwr
岱	dder
捺	nafx
鄂	eeek
濾	lvdx
屜	tiuv
榴	lqmt
簫	xnva
壟	lstl
閔	mbmw
凋	dndk
粵	ytpg
咋	vaka
咋	zaka
咋	zeka
詔	vcyk
舶	bovb
迂	yuza
渭	wwdo
釵	idjd
邸	diep
哮	xnkz
繭	jmci
炫	xrhs
瑾	jbwa
哽	ggkn
氈	vjwm
啄	vokn
藹	aicv
匕	biav
祟	svex
襖	aopd
瑛	ykwn
拇	mufd
攘	rhfy
瀝	lidv
覷	quhj
靳	jbgj
饅	mjuy
鴛	yrnd
偕	xprb
綸	grsc
綸	lysc
沌	dydv
筐	klvw
裊	nnny
笙	ugvf
嬉	xink
悴	cvxu
拽	vkfp
鵑	jrnk
亢	khwj
窪	wadt
惘	whxv
霹	piyu
猖	ihqo
戟	jiug
僥	jnre
僥	ycre
猾	hxqg
撮	cofy
撮	zofy
幀	vfjb
悸	jixz
皋	gcbu
楣	mwmo
剿	icdv
剿	jndv
忡	isxa
輾	nmin
輾	vjin
輾	zjin
芹	qbcj
墟	xuta
翟	diyf
翟	vdyf
翟	zdyf
芮	rvcr
渣	vada
喔	ookt
喔	wokt
趾	vizv
掐	qxfa
綾	lksw
磷	lbua
竺	vuve
幌	hljg
烙	lchk
烙	lohk
酋	qqqa
蠍	xpiq
訕	ujye
捻	nmfx
鴦	yhna
猩	xkqf
繚	lnsx
壑	heta
嗡	wgky
瓢	pnxg
熔	rshk
鉗	qmjc
寐	mwbn
鵲	qtnc
阜	fupu
苞	bccv
嗦	soks
癌	aibe
愷	kdxd
浚	jydw
簸	bovy
曝	bcod
甄	vfxw
嘈	ccko
翌	yiyl
惰	doxo
捶	ivfa
黔	qmhv
綏	svsn
釁	xbpd
憔	qnxh
吝	lbwk
珀	powb
殯	bbdb
褂	gxpd
螢	ykhi
墩	dytw
褚	iupo
褚	vepo
褚	vupo
炊	ivhq
戮	luyg
韜	tcaa
莞	grce
莞	wjce
蜘	viik
嚕	luko
婭	yana
姍	ujna
稠	izhk
殉	xydo
拗	aofl
拗	nqfl
拎	lbfs
矗	iuua
瘩	dabk
憚	daxa
憚	djxa
猝	cuqu
偎	wwrn
瀆	dudb
溉	gddv
甥	ugnl
鷗	ounk
冢	vsbn
迥	jszk
縈	ykhs
絢	xrso
獰	nkqd
惺	xkxa
璋	vhwu
鏽	xqja
倔	jtrk
蓓	bwck
磅	bhuf
磅	phuf
孚	fuzv
垣	yrta
屎	uium
璞	puwn
伽	gark
伽	jxrk
伽	qprk
惋	wjxv
氧	yhqy
犁	linh
淤	yudd
瀕	bbda
揖	yife
淇	qidb
匾	bmkc
蕙	hvcx
雹	bcyv
搔	scfi
咦	yikn
嫖	pnnx
扉	fwha
惦	dmxk
隘	aiem
橘	jumk
栓	urmw
忱	ifxv
誨	hvyd
潦	lndx
岐	qiey
沂	yidj
篡	crvs
麒	qilb
貽	yibk
鋤	iujl
疙	gebg
憨	hjxv
蕃	boct
蕃	fjct
漱	uudq
黝	yzhl
謁	yeyv
拌	bjfa
拌	pjfa
蹊	qizd
蹊	xizd
袒	tjpa
矜	grsv
矜	jbsv
矜	qbsv
沓	dado
沓	tado
嗆	qlkk
蹌	qlzk
屹	yieg
訥	neyd
瀛	ykdd
磯	jiud
沅	yrde
箍	guvj
驥	jimb
鏘	qljc
釗	vcdj
噩	eewk
嵩	ssek
瘟	wfbm
恙	yhxy
珂	kewk
荔	licl
棣	ddmn
棣	dimn
棣	timn
泌	bidp
泌	midp
踴	yszl
瘓	hrbn
踉	llzn
翡	fwya
麓	lulm
穹	qsbg
咪	mikm
笠	livl
筵	yjvv
莖	jkcg
懦	noxa
捎	ucfo
騾	loms
褒	bcwy
諫	jmyn
嘮	lckl
澱	dmdy
礁	jnuh
璽	xiaw
渲	xrda
嚎	hckn
詛	zuyq
暨	jiva
喳	iaka
喳	vaka
崛	jtek
憧	isxa
痊	qrbw
諄	vyyz
佇	vurd
槳	jlmd
蓀	sycs
弩	nugn
骯	ahkj
弼	biag
筠	jyva
圳	vfta
瀚	hjdy
毓	yurv
煽	ujhy
卯	mcep
掄	lyfc
薯	uuco
梓	zimu
騁	igmg
懺	ijxd
汕	ujde
畸	jitk
卞	bmdd
瘸	qtbr
藕	oucd
蹙	cugz
萱	xrca
戍	uugd
澎	pgdp
筱	xnvw
汛	xydu
嗔	ifkb
胥	xuvo
佯	yhry
跤	jnzf
掖	yefn
毗	pitv
菁	jkco
椿	iymo
篆	vrvn
馱	domd
馱	tomd
錨	mcjt
汾	ffdd
潺	ijdz
雋	jrrg
雋	jyrg
嘀	dikk
睞	ldon
鯨	jkax
鸞	lrws
烽	fghf
諦	diyj
攫	jtfy
揍	zzfd
唆	sokw
剃	tidb
淆	xndo
颯	salf
蛾	eeid
膺	ykgo
臀	tyou
跺	dozm
闔	hemm
帛	bobj
滇	dmdb
盎	ahma
腎	ufok
踞	juzk
怦	pgxu
夙	sujd
褻	xpwy
諜	dpym
頷	hjra
餌	erue
瑕	xxwy
嶼	yuea
恣	zixd
浣	hrde
巔	dmea
纓	yksn
佼	jnrf
叟	szpy
邃	svzb
楨	vfmb
餒	nwun
沽	gudk
蹭	cgzo
臾	yupn
燎	lnhx
呱	gxkn
亙	gfaa
踵	vsza
漣	lmdz
蹺	qnze
廿	nmaa
戌	xuga
禎	vfpb
荀	xyco
癲	dmba
滷	luax
芥	jpca
嵇	jihe
粱	llmd
諭	yuyd
枷	jxmk
霏	fwya
痰	tjbh
咀	jukq
佬	lcrv
竣	jylw
鯉	liaa
皎	jnbf
繽	bbsb
靂	liyv
朕	vfod
蛟	jnif
伎	jiry
涎	xmdv
咆	pckv
湍	trda
鏗	kgjt
昕	xboj
煦	xuho
巒	lres
摳	kzfk
憬	jkxx
悻	xkxu
謗	bhyf
緋	fwsa
鸚	yknb
稷	jihw
鞘	qngo
鞘	ucgo
璐	luwk
塢	wuth
哧	iikd
俟	qiru
俟	siru
攸	yzrw
恪	kexk
吠	fwkq
撂	lnfk
蜒	yjiv
餡	xmua
籟	ldvb
拄	vufw
蔗	vech
茸	rsce
盅	vsma
蹋	tazy
輟	ioiy
埔	butd
埔	putd
薊	jicd
蠕	ruia
簌	suvq
秧	yhhn
硫	lquv
硝	xnuo
惻	cexd
鎊	bhjf
抉	jtfn
耘	yyls
罔	whkv
旌	jkfa
吮	uyke
鑫	xbjj
蠱	gumi
礫	lium
鈺	yujw
鄔	wuep
榕	rsmk
胭	yjod
悚	ssxn
幺	ycvs
懿	yiux
暄	xroa
鰲	aoaf
梟	xnnm
汶	mfdw
汶	wfdw
纂	zrvs
諺	yjyp
躋	jiza
唔	mkk
唔	wukk
泓	hsds
靄	aiyv
狩	uzqc
掬	jufm
賑	vfbn
蛤	geik
蛤	haik
漪	yidk
捍	hjfu
袂	mwpn
惆	izxk
樺	hxma
揩	kdfb
葆	bccm
幡	fjjt
菇	guck
椰	yeme
臧	zhga
弨	icgk
貳	erqb
銬	kcjg
皿	mbka
簍	lzvn
偌	rork
啜	ikky
啜	ioky
湃	pddf
謔	xtya
冽	lpdd
嫵	wunh
羔	gchy
髻	jiak
胚	pwoa
氮	djqh
噗	pukn
嫡	dink
閏	rymw
抿	mbfq
渥	wodt
訛	eeyv
窿	lsbf
苓	lkcs
噎	yekd
訶	heyk
甬	yssa
邯	hjec
蜕	tvie
舔	tmpx
腆	tmob
鐲	voji
刨	bcdg
刨	pcdg
茉	mocn
碾	nmun
鷺	lunz
忒	teqd
忒	tvqd
叁	sjss
匱	gvkb
匱	kvkb
坯	pita
饞	ijud
甭	bgaa
痺	bibu
痺	bwbu
痺	pibu
丕	piaa
彝	yivc
嗟	jpkg
鋁	lvjk
唧	jike
珏	jtww
杳	ycmo
鳩	jqnj
帚	vzej
坍	tjtw
祺	qipb
噥	nskn
甕	wgww
遽	juzh
箕	jivb
鵡	wunq
暱	niok
暱	niov
癖	pibu
琨	kywv
嬤	mand
嬤	mans
嬤	mond
嬤	mons
貂	dnvk
蚌	bgif
蚌	bhif
濮	pudn
忻	xbxj
晁	icod
覃	qbxu
覃	tjxu
嗒	dakk
嗒	takk
樟	vhmu
橢	tomo
娣	dinp
琥	huwh
熠	yihb
渙	hrdn
嗨	hdkd
磐	pjuv
擄	lufl
瑋	wwwa
茗	mkck
贍	ujby
猙	vgqa
紂	vzsc
燼	jbhm
盂	yuma
躡	npze
榭	xpmc
徙	xirr
坷	ketk
曖	aiow
摒	bkfc
剌	lada
晾	llox
蘑	mocu
憩	qixp
璀	cvwf
蜿	wjiv
翊	yily
呃	eekv
鍍	dujy
惴	vvxa
桀	jpmp
偃	yjrn
舷	xmvs
舫	fhvf
餃	jnuf
葷	hyci
筏	favg
匝	zakj
攆	nmfi
茬	iact
濡	ruda
瞟	pnox
崽	zdxe
犢	dunb
熹	xihu
簪	zjvo
囗	wwaa
餞	jmug
皖	wjbe
荼	tuch
臍	qioa
閡	hemr
玷	dmwk
蝠	fuit
禧	xipk
羲	xiyg
涸	hedk
諳	anyo
飆	bnqf
咫	viub
撬	qnfm
愜	qpxn
檳	bbmb
檳	bkmb
泵	bgud
氟	fuqa
羌	qlyv
媲	pinv
檬	mgmn
跛	bozp
桅	wwmv
臆	yiox
豚	tyon
杞	qimv
癟	bpbc
肪	fhof
緘	jmsk
瘴	vhbu
饗	xluv
蜷	qriv
俎	zurq
鬟	hray
渤	bodl
腋	yeod
柑	gjmc
馥	fuhw
衢	qurd
醃	aayv
醃	yjyv
瑙	ncwx
弈	yiwc
銓	qrjw
喋	dpkm
喋	vakm
慟	tsxl
喏	nokk
喏	rekk
徇	xyro
晟	igov
晟	ugov
叼	dnkp
堰	yjtn
掂	dmfk
嚀	nkkd
鐫	jrjg
扈	huhv
詮	qryw
詰	jiyk
詰	jpyk
濘	nkdd
鹼	jmar
沏	qidd
唁	yjkk
攣	lrus
瞰	kjow
螃	phif
娓	wwnm
阪	bjey
焊	hjhu
聿	yuva
垛	dotm
涓	jrdo
梆	bhme
漳	vhdu
榨	vama
漉	ludl
膿	nson
嶇	quek
儂	nsrn
獗	jtqq
蝗	hliw
謐	miym
芋	yucu
噯	aikw
捅	tsfa
邇	erza
愴	ilxk
嚓	iakx
睽	kvod
蟠	pjit
硅	gvut
徨	hlrw
臼	jqpa
靚	jkfj
靚	llfj
縹	pnsx
璨	cjwm
騫	qmbm
蘸	vjch
撾	vxfk
撾	wofk
戊	wugp
氨	anqn
誹	fwya
瘠	jibo
鱷	eeak
笆	bavv
驊	hxma
碳	tjuh
姣	jnnf
姣	xnnf
蝨	uivi
璜	hlwb
髏	lzgn
颼	szfy
逵	kvzt
轆	luil
蛀	vuiw
胄	vzao
欖	ljmj
曜	ycof
蝸	woik
痞	pibk
疵	cibv
烯	xihj
藜	licd
搪	thfk
橄	gjmw
骼	gegk
癩	ldbb
㗎	gakm
㗎	jxkm
㓤	jidu
㷫	hkhh
㞹	keek
劏	thdx
劏	tsdx
躝	ljzj
躝	ljzn
燶	nshn
䟴	vfzy
䢛	jszk
餸	ssiz
餸	ssuz
曇	tjos
踹	ikza
薈	hvco
謨	moyd
釜	fufa
蟒	mgic
蟒	mhic
藐	mnce
宕	dhbu
壕	hctn
盹	dyov
麾	hvgm
痘	dzbq
珞	lowk
鏤	lzjn
翱	aoby
汩	gudo
汩	yudo
嗇	seak
糜	mwgm
鋅	xbju
鵠	hunn
瞑	mkob
幔	mjjy
槌	ivmz
嶸	rsem
玖	jqwn
瞠	igot
泗	sids
璉	lmwz
臊	scom
潢	gldb
潢	hldb
詼	hvyh
漩	xrdr
啻	iilk
軼	yiin
鐮	lmjn
睨	nioe
搐	iuft
莘	ufcu
莘	xbcu
猷	yzqq
澇	lcdl
攥	zrfs
黏	nmhk
呷	xxka
霽	jiya
賒	uebx
潼	tsda
腺	xmod
氫	qkqg
茁	vock
俸	fgra
楔	xpmd
籽	zimz
蝙	bmic
蹴	cuzd
忑	texa
踝	hkzn
婕	jpnr
饃	moud
芻	iuge
峪	yuek
杵	iumu
璣	jiwd
紉	rfsd
蟄	veit
噙	qbks
贛	gjlb
鍬	qnjh
廄	jqgy
啾	jqkh
褶	vepb
囿	yzko
靦	mmaj
瘁	cvbu
跚	ujza
舀	ycva
壹	yiud
掇	dofy
醺	xyyh
碘	dmub
擯	bbfb
髯	rjaa
懋	mcxm
苯	bfca
禺	yuad
鼾	hjpu
蜓	tkiu
紈	wjsd
紜	yyss
榷	qtmf
緲	mnsp
忐	tjxa
欒	lrms
昱	yuol
骷	kugk
酵	jnyz
擻	szfw
訖	qiyg
捱	aift
捱	aifu
隼	syur
淄	zidt
崢	vgea
湄	mwdo
荻	dich
泠	lkds
煜	yuhl
斡	wouu
敕	iiwa
瞌	keom
荃	qrcw
斕	ljwd
韞	wfam
韞	yyam
隕	yyeb
懵	mgxo
眈	djov
皙	xibm
牒	dppm
囱	cspd
嫗	yunk
鄲	djek
鈸	bojd
櫛	vime
呸	pwka
喟	kvko
檸	nkmd
祚	zopa
蹣	pjzr
驍	xnme
顰	pbvu
酪	lcyk
掰	bdbu
幗	goja
蒿	hcck
妲	dana
黍	uuhd
撣	djfa
撣	ujfa
臃	ysof
迤	yizr
痙	jkbg
泯	mbdq
灸	jqph
戛	gaag
戛	jxag
褸	lvpn
餉	xluk
柩	jqmn
裨	bipu
裨	pipu
鐺	dhjt
鐺	igjt
頎	qija
繕	ujsk
湮	yjdt
嫦	ihnj
箴	vfvk
瘧	ntba
瘧	ycba
垠	ybtn
膘	bnox
羚	lkys
仄	zeir
猥	wwqn
颶	jufb
燁	yeha
咂	zakj
躥	crzu
怵	iuxd
箔	bovb
飩	tyuv
剁	dodj
皚	aibd
黠	xxhk
萼	eecg
蟾	ijiy
賁	bfbu
賁	bibu
陲	ivea
襤	ljpm
仞	rfrd
佃	dmrt
佃	tmrt
麝	uelc
螂	lhie
脛	jkog
噤	jbkx
沱	todv
婊	bnny
塾	uutw
鐐	lnjx
恿	ysxs
壬	rfpu
剽	pndx
熨	yuhu
熨	yyhu
鎬	gcjk
鎬	hcjk
氯	lvqd
錮	gujk
骰	tzgy
佚	dprn
佚	yirn
蜚	fwia
燉	dyhw
椽	irmn
縝	vfsb
孀	ulno
謳	ouyk
啐	cvku
啐	qiku
隍	hlew
弋	yiqd
淖	iodu
淖	ncdu
淖	vodu
稈	gjhu
縐	vzse
齧	npfi
胯	kxog
儡	lwrt
虯	qqia
吒	vakq
龕	kjrl
撻	tafz
劾	hewl
孵	fupz
嚏	tikr
蜻	qkio
罹	lisf
訃	fuyd
戾	lihq
祐	yzpk
淅	xidj
佞	nkrn
慵	ysxa
鄱	poep
劊	gvdr
蹶	jtzq
穌	suah
濯	vodf
獺	taqb
涇	jkdg
俑	ysra
羿	yiyc
雉	viuf
瀘	ludm
涔	cfdv
倭	worn
岌	jien
遨	aozf
洱	erde
唄	bdkb
唄	bwkb
痢	libd
焱	yjhh
耦	ould
夯	hhdl
挎	kxfg
郢	ykek
殮	lmdr
逕	jkza
泱	yhdn
畹	wjtv
顴	qrca
祛	qups
彗	hvef
砷	ufua
嬋	ijna
罡	ghsv
閂	urma
胤	ybpv
倌	grrk
蟆	maid
閹	yjmv
滸	hudu
滸	xudu
唏	xikj
劭	ucdl
磬	qkuu
娑	sond
銑	xije
銑	xmje
疹	vfbp
耆	qito
豺	idvp
粼	lbmv
秸	jphk
飈	bnfh
赳	jqza
蚣	gsis
儷	lirl
抨	pgfu
籮	lovf
渚	vudo
溥	pudc
謫	veyk
驪	liml
櫓	lumo
町	dktd
町	tktd
溟	mkdb
檜	gvmo
檜	hvmo
諂	ijya
鬃	zsax
綬	uzsy
滓	zidu
槁	gcmk
嘹	lnkx
擷	xpfa
莓	mwcd
咿	yikp
叵	pokk
鑾	lrjs
匍	pugd
孿	lrjs
婀	eenk
旖	yifk
閭	lvmk
瞼	jmor
翦	jmqy
蚓	ybia
僮	tsra
僮	vlra
囉	lokf
倜	tirk
幄	wojt
珩	hgwd
獷	glqb
捋	lofc
捋	lvfc
飪	rfuu
狙	juqq
嗖	szky
芍	uccd
窈	ycbl
軾	uiid
愫	suxs
俾	biru
慫	ssxr
銖	vujn
駟	sims
岫	xqea
罄	qkfu
韭	jqaa
諛	yuyn
蹂	rzzm
宸	ifbn
噶	gakv
謾	mjyy
酗	xuyx
泅	qqdr
諉	wwyn
瀅	ykdw
嚅	ruka
鯊	uaad
卅	saaa
礬	fjum
仃	dkrd
涿	vodn
裱	bnpy
爿	pjap
囁	npke
傀	gvrg
傀	kvrg
鍥	qpjd
榛	vfmh
樽	zymc
膾	kkoo
澹	djdy
澹	tjdy
噠	dakz
曄	yeoa
唷	yoko
洵	xydo
揄	yufd
粲	cjma
詡	xuyy
鉻	gejk
鄺	kleg
撅	jtfq
糯	noma
挹	yifv
峋	xyeo
逅	hzzp
礪	liud
坳	aotl
蟀	ukiu
咔	kakd
釉	yzpa
儺	norf
匐	fugt
琮	cswx
蜈	wuid
躪	lbzf
侗	dsrk
侗	tsrk
艮	gfvn
囔	nhky
砧	vfuk
蜃	ufii
滂	phdf
灝	hcda
囡	njkn
鈉	najd
囤	dykv
囤	tykv
蚤	zcyi
鰻	mjay
礴	bouc
謅	vzye
埂	ggtn
箸	vuvo
啕	tckf
菠	bocy
莆	pucd
笈	jivn
舐	uipq
鴇	bcnp
潞	ludk
宓	fubd
宓	mibd
蒞	licl
邂	xpzj
塹	qmti
譎	jtyk
巽	xyvb
嚶	ykkn
涪	fudk
衾	qbry
霾	mdya
潁	ykpa
侏	vurn
茱	vucn
潯	xydc
鯽	jiae
恫	dsxk
頡	jpua
頡	jxua
頡	xpua
窕	tnbd
柚	yzma
砥	diud
糠	khmn
怏	yhxn
峒	dsek
峒	tsek
噫	yikx
蟋	xiix
蚯	qqia
衲	napd
佰	bdrb
嬪	pbnb
蛆	quiq
拮	jpfk
拮	jxfk
佘	uerx
藺	lbcf
汴	bmdd
胺	anon
靨	yeia
嗑	kekm
讒	ijyd
翳	yiky
綹	lqsk
裟	uayd
遑	hlzb
恁	nfxr
淬	cvdu
窠	kebn
觴	uhjp
頜	gera
頜	hera
牘	dupb
娩	mmnv
腴	yuon
胰	yion
郴	ifme
嬴	ykwd
覬	jiej
粽	zsmx
搽	iafm
琬	wjwv
僂	lvrn
僂	lzrn
聒	goek
嗷	aokw
濰	wwdf
碴	iaua
鷲	jqnw
瘀	yubd
齷	woit
蛔	hvik
媧	wank
昶	ihdo
愠	yyxm
邕	ysvv
齪	ioiz
揆	kvfd
婠	wank
婠	wjnk
瀨	lddb
覲	jbcj
鈾	yzja
袈	jxyl
罌	ykfb
夔	kvqw
祗	vipd
鴕	tonv
嗥	hcku
鉀	jxja
盥	grmp
恂	xyxo
稔	rfhx
鯤	kyav
絀	iusk
斫	vouj
闋	qtmd
鐗	jmjo
囹	lkks
鉞	ytjd
旎	nifv
庖	pcgv
畦	qitt
鈣	gdjg
蹩	bpzx
啷	lhke
瑁	mcwo
癸	gvvd
嵋	mweo
詆	diyd
嶙	lbea
淞	ssds
歆	xblq
庾	yugn
皈	gvby
縉	jbso
覦	yurj
驤	xlmy
燮	xpyh
楫	jime
鸝	lina
淼	mndd
駙	fumc
荏	rfcu
桎	vimt
仝	tsrg
魘	yjig
襠	dhpt
耙	balv
耙	palv
潸	ujdo
梏	gumk
烷	wjhe
珉	mbwq
氲	yyqm
剮	gxdk
檄	ximw
浹	jxdn
輦	nmia
淙	csdx
焙	bwhk
榔	lhme
煊	xrha
誥	gcyk
楹	ykmm
囈	yiks
葩	pacv
鎧	kdjd
咻	xqkm
尕	gagx
灩	yjdm
圻	qitj
圻	ybtj
赧	njty
捫	mffm
摺	uefb
摺	uefj
摺	vefb
摺	vefj
邈	mnzv
蠡	livi
舸	gevk
斛	huju
閾	yuma
仟	qmru
痣	vibx
耄	mctm
磺	hlub
鄴	yeea
鴣	gunu
豢	hrbn
黜	iuhk
睢	svof
萋	qicn
騖	wums
悌	tixp
櫺	lkmk
鑣	bnjh
饌	vrub
粕	pomb
徠	ldrn
濂	lmdn
餛	hyuv
氤	ybqd
柞	vama
轡	pwks
啖	djkh
蘅	hgcd
鶉	iynw
鋌	dkjz
鋌	tkjz
鈿	dmjt
鈿	tmjt
摞	lofs
篙	gcvk
琰	yjwh
涮	urdd
飭	iiul
餾	lqut
祉	vipv
嗬	hekk
姝	uunn
賡	gggb
屐	jiuy
芊	qmcu
哂	ufkx
棹	vcmu
棹	vomu
喙	hvkn
篝	gzva
湎	mmda
娉	pkng
懣	mfxd
袤	mcwy
鏖	aolj
韃	dagz
圇	lykc
儻	thrh
鰍	qqah
謄	tgby
蹇	jmbz
俚	lira
鈐	qmjv
澧	lidd
儈	kkro
莠	yzcp
蕎	qnck
櫚	lvmk
鳶	yrnq
鎂	mwjd
唰	uxkd
軻	keik
絛	tcrs
孑	jpva
疽	jubq
菏	heck
忤	wuxu
珮	pwwj
懨	yjxq
蹉	cozg
鉉	xrjd
圜	hrky
圜	yrky
戩	jmag
傣	ddrd
赭	veto
椏	yama
徉	yhry
伉	khrj
酮	tsyk
蓑	socy
鷓	veng
紓	uusa
綦	qiqs
酩	mkyk
袞	gywy
贋	yjib
麋	milm
逡	qyzw
幃	wwja
嶂	vheu
綰	wjsk
鑠	uojm
寮	lnbx
苒	rjca
酶	mwyd
蘄	qicj
燾	dchu
燾	tchu
笞	iivk
玥	ytwo
兗	yjwe
瘍	yhbp
諶	ifyv
諶	ufyv
獐	vhqu
暹	xmzo
踮	dmzk
遴	lbzm
餑	bouz
驁	aomf
釧	irja
挈	qpuf
妤	yuna
狎	xxqa
蝟	wwio
惲	yyxi
熵	uhhk
砒	piuv
岷	mbeq
闞	hjmw
闞	kjmw
氅	ihmx
輥	gyiv
鷂	ycnv
殞	yydb
碉	dnuk
螳	thit
羸	lwwd
姮	hgna
鶩	wuns
歟	yupq
豌	wjdv
睇	diop
忸	nqxa
挲	uaud
誑	klyw
綃	xnso
褓	bcpm
剜	wjdb
菡	hjck
駢	pmmc
淦	gjdj
橇	qnmm
殫	djda
汨	mido
鉅	jujk
鉅	juja
耷	dade
昀	yyod
躅	vuzi
汐	xidd
襁	qlpi
莢	jxcn
郜	gcen
佻	tnrd
鈦	tdjd
鉚	mcje
佗	torv
杼	vuma
茴	hvck
徜	ihrk
揶	yefe
嗄	aakw
嗄	uakw
肛	ghog
玳	ddwd
噘	jtkq
圩	wwtu
圩	xutu
噼	piku
枇	pimv
酊	dkyd
鄢	yjea
掮	qmfo
竽	yuvu
畿	jivt
遛	lqzp
爰	yrvy
痔	vibc
氰	qkqo
葳	wwcn
臬	nppm
弁	bmsc
弁	bmyu
癆	lcbl
鎳	npjm
陟	viep
奼	ianq
遒	qqzq
鸛	grnc
誚	qnyo
獼	miqx
孱	ijuz
杓	bnmd
杓	ucmd
洙	vudn
驃	bnmx
驃	pnmx
犛	lian
犛	mcan
佝	gzrk
杴	xmmq
醴	liyd
鰭	qiao
觥	gsje
僉	qmrr
縊	yism
蔻	kzcy
嬈	rcne
鋰	lija
陂	bwep
陂	piep
陂	poep
嘭	pgkp
煬	yhhp
怩	nixv
姘	pbnc
撳	qbfq
蛐	quia
慪	ouxk
囫	hukp
烴	tkhg
艄	ucvo
顎	eeka
倨	jurk
邋	lazv
酈	liea
酈	viea
宥	yzbo
鍘	vajd
旄	mcfm
刎	wfdg
燧	svhz
嫚	mjny
痼	gubk
胱	gloe
肱	gsos
鶚	eenk
蘢	lscl
楂	iama
楂	vama
邐	liza
媪	aonm
犒	kcnk
喁	yskd
謖	suyw
邡	fhef
歿	mody
顥	hcoa
忝	tmax
汞	gsgd
遢	tazo
氦	hdqr
儆	jkrw
饈	xqua
碣	jpuv
碣	yauv
篋	qpvn
紕	bisv
紕	pisv
跎	tozv
墒	uhtk
糅	rzmm
圄	yukk
螟	mkib
弭	mige
擘	bouu
阡	qmeu
腈	jkoo
簣	kvvb
傖	cfrk
傖	ifrk
霈	pwyj
擢	voff
猢	huqo
菅	jmck
燴	hvho
蝌	keiu
趄	juzq
趄	qpzq
蘚	xmcy
妊	rfnu
冪	mibj
甌	oukw
杷	pamv
搡	shfm
滁	iudh
俳	pdra
蟑	vhiu
莒	juck
嶗	lcel
濠	hcdn
呦	yzkl
邛	qseg
穰	rhhy
崴	wden
崴	wwen
頦	kewa
癬	xrby
豕	uian
蠹	duai
珈	jxwk
牝	pbnv
翕	xiry
摜	grfb
裾	jupk
忪	ssxs
忪	vsxs
煨	wwhn
錕	kyjv
鋇	bwjb
鵪	annd
酯	viyo
喑	ybko
浜	bbdb
浜	bhdb
轂	guuy
僭	jmro
齜	ziiv
戕	qlvg
胴	dsok
癇	xmbo
銼	cojt
誆	klyw
閎	hsms
灤	lrdm
墀	iitn
箝	qmvc
垸	hrte
垸	yrte
蜥	xiij
舛	irpa
崆	kseg
炷	vuhw
餿	szuy
邙	mhew
湜	uidr
虻	mgiv
矍	jtoy
囀	vrkc
軛	eeiv
葺	qice
鏞	ysja
橐	toam
勖	xukl
奐	hrdn
鞬	jmgz
琍	liwd
琭	luwd
彀	gzuy
踽	juzd
郗	xiex
鷁	yinq
犄	jink
噝	siks
輅	luik
踅	xtzf
酰	xmye
咭	jikk
咭	kakk
逶	wwzh
嵬	wweg
孢	bczv
珣	xywo
鉸	jnjf
嶠	jnek
嶠	qnek
髭	ziav
漕	ccdo
矽	xiud
噱	jtkn
噱	xtkn
苜	muco
鄖	yyek
羶	djya
羶	ujya
蛹	ysia
艹	ccaa
呶	ncky
輜	ziit
殤	uhdp
粳	jkmn
闃	qumq
闈	wwma
硒	xiux
齲	quid
歙	uerq
歙	xirq
秣	mohn
笳	jxvk
隗	kveg
隗	wweg
鐙	dgjd
澍	uudc
澍	vudc
猗	yiqk
嬗	ujna
帙	vijn
賅	gdbr
攛	crfu
悒	yixv
絝	kusg
亳	bowq
儔	izrc
猻	syqs
蚱	vaia
杈	iamd
傈	lirm
銨	anjn
砭	bmun
唳	likq
貉	hcvk
貉	hevk
貉	movk
饕	tcuk
氖	ndqp
濛	mgdn
虢	govh
鱔	ujak
郅	viea
鉑	bojb
暝	mkob
鏵	hxja
獠	lnqx
弒	uixd
愾	kdxm
愾	xixm
祜	hupk
罅	xxfu
砼	tsug
塋	ykht
烊	yhhy
詬	gzyk
舢	ujve
彙	hvvn
胛	jxoa
鄆	yyeb
牖	yzpd
稗	bdhu
篁	hlvw
痂	jxbk
鴆	vfnd
醮	jnyh
蠊	lmin
藪	szcw
聃	djea
堇	jbca
鰥	grad
鱸	luam
恚	hvxt
癰	ysbf
槨	gome
愎	bixw
樨	ximn
嗝	geka
湟	hldw
苫	ujck
奩	lmdk
畲	uert
睾	gcpu
鍔	eejg
騮	lqmt
飴	yiuk
鬻	yuga
聵	kveb
蕨	jtcq
諍	vgya
嗲	dxkd
婺	wuns
痍	yibn
偈	jirv
偈	jprv
銥	yijy
壅	ystw
峁	mcee
孳	ziqz
螫	uiit
螫	veit
蚪	dziu
媾	gzna
佶	jirk
儕	idra
諤	eeyg
僖	xirk
珙	gswb
汊	iadd
舂	isfa
柘	vemu
陘	xkeg
蜢	mgim
摑	gofa
鮭	gvat
鮭	xpat
孬	ncaz
崧	sses
硼	pguo
奘	vlda
蜍	iuih
闇	anmo
皰	pcpv
庠	xlgy
諡	uiym
詁	guyk
繅	scsm
籩	bmvz
瓔	ykwn
鶻	gung
鶻	hung
馗	kvjo
癯	qubf
訇	hsgy
闐	tmmb
躕	iuzc
鏃	zuju
瀧	lsdl
瀧	uldl
萸	yucn
綣	qrsv
粑	bamv
蜴	yiip
讕	ljyd
娠	ufnn
堃	kytf
狒	fwqa
沆	hhdj
鷙	vint
篾	mpvd
肓	hlwo
妯	vzna
讎	izyf
讎	qqyf
吋	cykv
盱	xuou
墉	ysta
訐	jpyu
噔	dgkd
愆	qmxr
磣	ifup
垓	gdtr
諢	hyyi
鍺	vejo
稞	kehn
靛	dmfr
狷	jrqo
鱘	xyac
笏	huvp
魷	yzad
枸	gzmk
枸	jumk
鳧	funj
惇	dyxz
趔	lpzd
蚩	iiei
嗩	sokb
靼	daga
娌	lina
詒	ddyk
詒	yiyk
沭	uudd
灞	bado
褡	dapk
藎	jbcm
琊	yawe
蓿	xucb
鎰	yijm
桁	hgmd
桁	hhmd
嘜	makd
嘜	mdkd
鈀	bajv
冼	xmde
賚	ldba
肄	yipa
躑	vize
縞	gcsk
嘁	qikx
葭	jxcy
繾	qmsz
蒯	kkdc
枰	pkmu
噹	dhkt
耋	dptt
閬	lhmn
磴	dgud
錳	mgjm
苕	tnck
苕	ucck
仡	gerg
仡	yirg
譙	qnyh
炔	qthn
毖	biad
泫	xrds
駑	numn
廩	lbgh
燊	ufhm
邳	piea
苧	nkcd
苧	nkca
苧	vucd
苧	vuca
轔	lbia
鎢	wujh
薺	jica
薺	qica
滎	xkdh
滎	ykdh
櫈	dgmj
檵	jimv
茯	fucq
軫	vfip
弇	yjrc
蹼	puzn
厝	coio
眇	mnop
儐	bbrb
幛	vhju
玢	bbwd
玢	ffwd
瞽	guou
詎	juya
穡	sehk
衿	jbpv
堊	eeta
鮎	nmak
溧	lidm
黿	yrev
夤	ybpb
齟	juiq
鬈	qrav
紆	yusu
眥	ziov
驄	csmx
繇	ycvs
繇	yzvs
扦	qmfu
睥	biou
睥	piou
謇	jmby
鐳	lwjt
韙	wwoa
荑	ticn
荑	yicn
咩	mpky
螻	lzin
啁	tnkk
啁	vckk
啁	vzkk
欹	qidq
騏	qimb
疥	jpba
蠣	liid
簟	dmvu
蔫	nmch
鼉	tokv
帔	pwjp
蓼	lncp
蓼	lucp
鴟	iinp
瓤	rhwg
悱	fwxa
糗	qqmq
哞	mzkn
柢	dimd
柢	iimd
緹	tisr
躉	dycz
蒗	lhcn
洌	lpdd
崍	lden
鏜	thjt
衽	rfpu
箬	rovk
篦	bivv
耒	lwan
摭	vifh
蜇	veif
蠔	hcin
杲	gcom
瓴	lkrw
犟	jlng
衩	iapd
褳	lmpz
跆	tdzk
琚	juwk
雒	lowf
腓	fwoa
瓚	zjwb
邨	cyua
瀲	lmdw
薌	xlce
牯	gunk
旯	laoj
珺	jywk
嗶	bika
孃	nlny
橛	jtmq
齬	yuik
瑗	yrwy
釩	fjjd
碭	dhup
臏	bbob
旮	gajo
蓖	bicv
梔	vimv
寤	wubk
樅	csmr
樅	zsmr
鋥	zgjw
氹	dhdg
氹	tfdg
崮	guek
縵	mjsy
讖	ifyg
壎	xyth
醛	qryw
蘧	qucz
逖	tizq
鬣	lpaa
柰	ndmx
齎	jiwa
巋	kvej
嬙	qlnk
瘢	bjby
蛭	viit
碓	dvuf
漚	oudk
蜉	fuiz
贇	yybw
嵯	coeg
鐃	ncje
嘣	bgko
愀	qnxh
魑	iigd
緇	zist
徼	jnrw
鬮	jqav
樾	ytmv
鈈	bujd
檣	qlmk
踟	iizk
秭	zihp
疸	djba
郄	qpex
郄	xiex
蓁	vfch
醪	lcyp
饜	yjiu
郯	tjeh
毽	jmmz
蟈	goia
抻	iffa
邰	tdes
搴	qmbu
趿	tazn
甯	nkba
甯	nkbd
髖	krgd
肽	tdod
盍	hemt
洮	tcdd
氙	xmqe
燜	mfhx
贄	vibt
鈷	gujk
刈	yidx
縟	rusc
疣	yzbd
羯	jpyv
廡	wugh
摶	trfc
彠	hoey
齇	vapq
齦	kfin
齦	ybin
頊	xuwa
坨	totv
拊	fufc
菽	uucy
迨	ddzs
轤	luim
腱	jmoz
喵	mnkt
鏑	dijk
漯	lods
漯	lwds
漯	tads
屣	xiur
笄	jivc
乜	mpgv
乜	npgv
捌	bafd
淥	ludd
噻	sdkt
昝	zjwo
傴	yurk
溘	kedm
曷	heov
乩	jiav
皴	cysp
輳	czid
躚	xmzz
壠	lstl
鮫	jnaf
橈	ncme
橈	rcme
倀	ihrn
玟	mbww
玟	wfww
鏨	zjji
蓊	wgcy
黧	lihh
懍	lbxh
櫪	limv
哐	klkw
唿	hukx
榫	symu
撟	jnfk
澠	mmdv
澠	ugdv
蓍	uico
瀣	xpda
罘	fusd
櫱	npem
訾	ziyv
焯	ichu
焯	vohu
獾	hrqf
豸	vivp
酡	toyv
麂	jilj
籙	luvd
疋	pivr
璦	aiww
坻	ditd
坻	iitd
酢	cuya
酢	zoya
簞	djva
孛	bwuz
稹	vfhb
爻	ycxx
殛	jida
剡	ujdh
剡	yjdh
慳	qmxt
鬩	xiae
嘵	xnke
蒺	jicu
磔	veum
鰓	sdax
䴉	hrns
釅	yjyw
嬡	ainw
洸	glde
摁	enfx
啵	bokp
礆	jmua
閽	hymo
鷥	sins
鑷	npje
茌	iicu
逯	luzv
婧	jkno
痾	eebk
痾	kebk
痾	oobk
痾	vebk
錙	zijt
擼	lufo
峴	xmej
旃	vjfw
薜	bicu
僳	surm
邗	hjea
鎵	jxjn
觶	vija
訌	hsyg
鱈	xtae
怫	fuxa
禳	rhpy
櫟	limm
櫟	ytmm
苴	iacq
苴	jucq
蓴	iycc
棖	igmn
噌	cgko
戢	jikg
伕	furd
伕	fuan
佤	warw
笤	tnvk
煲	bchr
篪	iivh
軔	rfid
蝣	yziz
逄	phzw
煢	qshu
侑	yzro
湫	qqdh
鄯	ujey
彿	fopa
彿	fora
彿	fupa
彿	fura
櫸	juma
鉦	vgjv
薏	yicx
魎	llgr
嶷	yier
萵	wock
蚋	rvid
殄	tmdp
翥	vuty
莧	xmcj
捭	bdfu
呎	iikn
胝	viod
鞣	rzgm
釺	qmju
鯁	ggan
鞅	yhgn
闥	tamz
猱	ncqm
鼐	ndgv
岬	jxea
蕖	qucm
閶	ihmo
醍	tiyr
竦	ssln
擀	gjfu
趲	zjzb
鎩	uajy
懟	dvxa
棻	ffcm
緗	xlso
魍	whgv
鑊	hojy
柒	qimd
曩	nhoy
仵	wuru
嫫	mond
襦	rupa
晷	gvok
凇	ssds
莜	yzcw
唑	zokt
槊	uomq
嵊	ugen
鷸	yuns
槿	jbma
菖	ihco
漵	xudw
糌	zjmo
倥	ksrg
玀	loqf
椋	llmx
楝	lmmn
眙	iiok
眙	yiok
騅	vvmf
輊	viit
螭	iiid
洄	hvdk
磧	qiub
鍇	kdjb
閆	yjms
圉	yuku
獪	kkqo
顓	vrea
胼	pmoc
芨	jicn
苣	juca
苣	quca
跖	vizk
碇	dkur
詈	lisy
癘	libd
筮	uivr
堖	nctx
隹	vvrf
圮	pitv
砝	faus
槭	qimx
槭	semx
螯	aoif
嬖	binu
魈	xngo
饉	jbuf
妁	uond
嘬	zoky
矇	mgon
蟮	ujik
鉬	mujo
媯	gvnh
紱	fusd
傕	jtrf
傕	qtrf
矸	gjuu
鋃	lhjn
埭	ddtn
瘻	lzbn
甑	zgbw
幪	mgjn
愍	mbxv
狺	ybqk
廛	ijgt
碚	bwuk
泮	pjda
縶	vist
槎	iamg
蹕	biza
騭	vime
顳	npea
犖	lohn
醐	huyo
紇	gesg
紇	hesg
蕤	rvca
怙	huxk
銃	isje
褊	bmpc
舨	bjvy
仨	sars
詘	quyk
邾	vuep
毳	cvmm
嶧	yieu
庥	xqgm
浼	mwdv
薨	hscv
櫳	lsml
儋	djry
髑	dugi
喆	veuk
彘	vivv
鏹	qlji
逋	buza
嚦	likv
緡	mbso
呲	cikv
呲	zikv
擤	xkfa
邴	bkea
鶿	cinq
苻	fucc
龑	yjld
仫	murs
迓	yaza
椐	jumk
卟	bukd
鯔	ziat
蚜	yaip
鱒	zyac
餮	tpud
圪	getg
砣	touv
楮	iumo
姒	sinr
牠	tanx
觚	gujg
痿	wwbn
蚨	fuin
柙	xxma
痧	uabp
琺	faws
臠	lrwr
樗	iumg
亍	iuea
豉	iidy
銻	tijp
虺	hvai
僨	ffrb
牾	wunk
滹	huda
汜	sidv
掾	yrfn
醚	miyz
堞	dptm
瓠	hudg
屨	juun
朐	iyok
朐	quok
酐	gjyu
鯀	gyas
欷	xixq
怍	vaxa
酚	ffyd
卮	vipv
隰	xieh
帑	nujn
帑	thjn
妗	jbnv
霰	xmyw
扃	jshk
氐	dipd
搠	uofo
瀠	ykds
桉	anmn
貲	zibv
爨	crph
膂	lvof
搦	nofd
逑	qqza
俅	qqrd
螓	qbih
忭	bmxd
簋	gvvm
嬛	hrny
嬛	qsny
嬛	xrny
髫	tnak
軲	guik
狍	pcqv
萇	ihcn
咣	glke
鈑	bjjy
楸	qqmh
藁	gccm
齏	jiwa
飧	sypu
絰	dpst
芄	wjcd
蓽	bica
膈	geoa
雩	yuyg
懌	yixu
秈	xmme
畚	bfst
傯	zsrx
翮	heay
雎	juqf
菀	wjcv
菀	yycv
睒	ujoj
螄	siij
睃	soow
裎	igpw
菟	tucd
琿	hvwi
琿	hywi
尻	kcuj
戇	ghxl
戇	vlxl
噲	kkko
暌	kvod
縻	migs
纛	dcfs
菘	sscs
禰	mipx
攖	ykfn
侉	kxrg
栲	kcmg
郾	yjek
珥	erwe
璫	dhwt
杪	mnmp
窨	xybo
窨	ybbo
淝	fwdv
閫	kymm
匏	pcdv
刖	ytdo
燠	yuhn
荇	xkcd
芾	fucj
芾	fwcj
燹	xmha
鄞	ybec
覿	diuj
鎏	lqjd
彧	yukd
腚	dkor
淶	lddn
劬	qugl
蛩	qsig
戧	qlrg
煅	drhy
笥	sivk
塬	yrtx
覘	ijaj
洎	jido
罟	gusk
檮	dcmc
檮	izmc
檮	tcmc
鞫	jugy
劼	jpul
癤	jpbe
悰	csxx
玎	dkwd
勰	xplx
戡	kjqg
譫	vjyy
鑭	ljjd
蒔	uicc
鱖	gvaq
鱖	jtaq
捩	lpfq
冏	jskk
媵	ykon
顙	shya
褙	bwpo
砉	hxfu
砉	xufu
紿	ddsk
沔	mmdv
蟎	mjir
紺	gjsc
蜮	yuik
埡	yata
晗	hjok
羆	pihh
芘	bicv
芘	picv
阼	zoea
髀	bigu
桷	jtmj
鼙	piuu
檟	jxmb
砦	vdvu
洹	hrda
牤	mhnv
酆	fgee
嶴	aope
羼	ijuy
繒	zgso
蛉	lkis
艏	uzvo
鵜	tinb
祆	xmpd
蠃	lowd
勐	mgzl
拶	zafd
拶	zjfd
溴	xqdq
鮐	tdak
怛	daxa
欏	lomf
菰	gucg
鯢	niae
礱	lslu
壙	kltb
蜊	liid
趺	fuzn
氘	dcqa
呔	ddkd
呔	tdkd
駘	tdmk
縑	jmsn
嘏	guuy
堀	kute
茭	jncf
蒡	bhcf
痱	fwba
黷	duhb
晞	xioj
麩	fuan
萘	ndcx
諞	pmyc
蜆	xmij
櫬	ifmj
甦	suaa
甦	suaf
茆	mcce
妣	binv
鏍	lojs
遄	irze
魃	bagd
庹	togn
旒	lqfv
殂	cudq
鷦	jnnr
臚	luom
叻	lekl
獒	aoqf
鉺	erje
鑌	bbjb
驂	cjmp
蛄	guik
坼	ietd
陬	zzey
醯	xiym
黢	quhw
芫	yjce
芫	yrce
郇	hreg
郇	xyeg
鰱	lmaz
皤	pobt
苡	yicr
枳	vimb
齶	eevg
裰	dopy
愔	ybxo
崁	kjeq
隳	doex
隳	hvex
茀	fuca
焓	hjhk
憒	kvxb
泔	gjdc
鋮	igjv
暾	tyow
麈	vulw
莪	eecd
蕁	qmcc
蕁	xycc
韉	jmgh
塍	igot
岜	baev
厙	ueii
躓	vizb
騶	zzme
狻	srqw
燔	fjht
郛	fuev
藿	hocf
硌	geuk
硌	louk
憮	wuxh
筌	qrvw
鉍	bijp
趑	zizq
篳	biva
缶	fzrk
缶	fzff
缶	grrk
缶	grff
幘	zejb
钁	jtjy
芟	ujcy
嘞	lekl
嘞	lwkl
畋	tmwt
棰	ivma
蚶	hjic
纈	xpsa
溽	rudc
趵	bczd
饢	nhuy
紘	hsss
徂	cura
犍	jmnz
犍	qmnz
旆	pwfj
薹	tdct
薹	tdck
囝	jmkz
菸	yjcd
菸	yjhd
鸕	lunh
仉	vhrj
梃	tkmz
眄	mmov
跗	fuzc
蒹	jmcn
葸	xicx
貺	klbe
徭	ycrf
埕	igtw
慊	qmxn
慊	qpxn
喱	lika
筲	ucvo
枋	fhmf
艟	isva
瘳	izbp
鼬	yzua
穠	nshn
隈	wwen
澌	sidj
嗵	tskz
嫠	lian
睚	yaot
瞀	mcos
鬲	geaa
蝮	fuiw
殍	pndz
浬	lidt
鶘	hunu
孌	lrns
褫	iiph
糲	limd
黼	fuad
椹	ufmv
椹	vfmv
殳	uujy
佾	yiro
哏	gfkn
哏	hfkn
杌	wume
槃	pjmv
縋	vvsz
痤	cobt
喈	jpkb
秫	uuhd
涫	grdk
檉	igmw
黻	fuad
螈	yrix
蹁	pmzc
圯	yitv
屙	eeuk
廨	xpgn
倕	ivra
唣	zckq
崟	ybej
吔	yekx
箐	jkvo
箐	qkvo
篚	fwva
榘	jumu
榘	juua
蠲	jrqi
巹	jbvv
螅	xiix
釹	nvjn
鄹	zzee
鯖	qkao
檁	lbmh
孥	nuzn
蹓	lqzt
笸	povk
魴	fhaf
兕	siae
皸	jybp
鴰	gxnp
憷	iuxr
麇	jylh
麇	qylh
刳	kudd
滉	hldg
脘	wjoe
糝	ufmp
鶇	dsna
坭	nitv
鯡	fwaa
蕈	xycu
跣	xmzp
簦	dgvd
瞵	lboa
嚯	hokf
鏊	aojf
猊	niqe
籀	vzvt
昴	mcoe
楦	xrma
瀰	midx
絎	hhsd
櫝	dumb
蔟	cucu
蟯	ncie
縲	lwss
蹀	dpzm
齠	tnik
蠆	idci
瓿	bulw
甾	zdvt
溷	hydn
髡	kyae
佺	qrrw
硐	dsuk
鉭	tjja
跫	qszg
鼴	yjun
獁	maqm
揎	xrfa
葚	ufcv
畈	fjty
緱	gzsu
萁	qicb
郟	jxea
呤	lkks
鬯	ihkv
鯛	dnak
鷯	lnna
釤	ujjp
蒽	encx
肫	iyov
肫	vyov
垧	uhtk
漶	hrdx
耜	silk
冮	ghdg
綯	tcsf
嗾	szku
伢	yarp
酹	lwyc
鰣	uiac
芎	xscg
硨	ieui
埴	vitq
嗞	zikd
紲	xpsv
媸	iini
浠	xidj
桫	somp
彖	trvn
臁	lmon
鱠	kkao
癭	ykbn
滏	fuda
踣	bozk
饔	yswu
淠	pida
淠	pwda
慝	texk
苾	bicp
蟊	mcsi
歃	uapq
鮒	fuac
桕	jqma
糴	dirf
笱	gzvk
吡	bikv
吡	pikv
犴	anqu
犴	hjqu
啉	lbkm
啉	ljkm
疔	dkbd
餈	ciud
餈	cisd
籜	tovu
桴	fumz
蹚	thzt
槧	qmmi
頇	hjaa
腩	njou
艿	ndcp
蕷	yuca
焐	wuhk
嗪	qbkh
裼	tipp
裼	xipp
徬	phrf
觳	huuy
畀	bita
羥	qlyg
豇	jldg
蠐	qiia
濼	lodm
鮁	baad
氡	dsqd
跬	kvzt
脲	nnod
瘞	yibt
癜	dmby
醢	hdym
綮	qish
綮	qksh
逭	hrzb
鈮	nijv
鰨	taay
踔	iozu
蛺	jxin
輞	whiv
毿	sjsm
舁	yupc
崤	xneo
恝	jxxf
襉	jmpo
蟥	hlib
芰	jicy
閼	eemd
鍶	sijx
粢	cimd
粢	zimd
灃	fgdd
妳	ninx
殭	jlda
屺	qiev
椴	drmy
笪	dava
顢	mjca
笫	zivp
誄	lwyn
譖	zfyo
筧	jmvj
醅	pwyk
緦	sisx
黥	qkhx
讜	dhyh
璩	quwn
肭	naod
襝	lmpr
陔	gder
菹	zucq
鎦	lqjt
棼	ffmd
潲	ucdo
埝	nmtx
荸	bicz
旰	gjou
旰	hjou
湓	pfdm
糶	tnef
悛	qrxw
芪	qicq
檾	qkhm
鰈	dpam
崚	lgew
崚	lkew
嗌	aikm
嗌	yikm
瀦	vudo
崦	yjev
疃	trta
鄄	jrex
塚	vstn
餳	xkup
伲	nirv
蕞	zvcy
殪	yidd
宄	gvbj
愬	soxb
亶	djwa
呋	fukn
疝	ujbe
埸	yitp
窬	yubd
薅	hccc
箜	ksvg
鋯	gcjk
鎘	geja
柝	tomd
鶼	jmnq
杻	izma
杻	nqma
溏	thdk
篌	hzvu
旻	mbow
嗐	hdkk
眭	gvot
眭	svot
砑	yaup
蘼	mica
蠖	hoiy
纘	zrsb
猓	goqm
熗	qlhk
苷	gjcc
澶	ijda
湔	jmdd
蔸	dzce
劌	gvdv
貔	pivv
倬	voru
聱	aoef
鶓	mnnc
蕻	hscb
紼	fusa
鮪	wwao
俁	yurd
埒	lptc
尥	lnjd
覯	gzaj
舄	xiph
堉	yuto
侔	mzrn
彳	iipa
迴	hvzk
壢	litv
罾	zgso
傢	jxrn
亓	qiea
鋈	wujd
莨	lhcn
莨	llcn
饊	sjuw
溱	qbdh
溱	vfdh
螬	ccio
蝰	kvit
倮	lorn
揠	yafn
掊	pzfk
煳	huho
楗	jmmz
捽	zofu
蔌	sucq
啶	dkkr
躞	xpzy
蔦	nncn
墁	mjty
榧	fwma
濉	svdf
呯	pkku
飫	yuud
蝥	mcis
惝	ihxk
惝	thxk
秕	bihv
壚	lutm
祓	fupd
矬	cout
紵	vusa
黽	mbav
黽	mgav
黽	mmav
匭	gvkj
蓯	cscr
瘂	yaba
庳	bwgu
柁	domv
柁	tomv
舡	ghvg
餼	xium
祧	tnpd
猁	liqd
葑	fgcc
狴	biqt
銫	sejv
瞍	szoy
莩	fucz
涑	sudn
囟	xbpx
縭	liss
蠓	mgin
耨	nzlc
洧	wwdo
嗉	suks
髹	xqam
簏	luvl
掎	jifk
櫧	vumo
騸	ujmy
錁	kejn
埽	sctj
鵓	bonu
霪	ybyu
熳	mjhy
黹	viad
喹	kvkt
狨	rsqu
坫	dmtk
蓐	rucc
諑	voyn
苠	mbcq
揸	vafa
筇	qsve
葒	hscg
芡	qmcq
戽	huhu
詵	ufye
猞	ueqk
岞	zoea
耬	lzln
勣	jifl
硤	xxun
觫	sujn
覡	xigj
袷	qxpk
崑	kyev
窶	jubn
眚	ugno
仳	pirv
鵂	xqrn
梘	jmmj
炆	wfhw
牴	dind
蜩	tnik
蕢	kkcb
蕢	kvcb
誶	svyu
艉	wwvm
鉈	tajv
鉈	tojv
賾	zekb
脩	xqro
菪	dhcu
僦	jqrd
濞	bida
濞	pida
禕	yipa
嚳	kupk
芴	hucp
芴	wucp
酤	guyk
忮	vixy
埤	pitu
袪	qups
鎣	ykjh
甍	mgcw
垚	yctt
蹧	zczo
甙	ddcq
帨	uvje
昃	zeor
萏	djca
薤	xpca
徳	derx
鯧	ihao
齕	heig
鯿	bmac
褰	qmby
蛞	koik
笊	vcvv
翬	hvyi
鄣	vhel
瘰	lobs
睏	kyok
睏	kyom
岍	qmec
攮	nhfy
吽	hskn
蚺	rjia
銚	dnjd
銚	tnjd
銚	ycjd
蕘	rcce
楙	mcmm
蚧	jpia
檗	bomu
俜	pkrg
惛	hyxo
惛	mfxo
豳	bbea
畛	vftp
贐	jbbm
汔	qidg
郫	piep
曛	xyoh
愨	qtxu
諏	zzyy
酲	igyw
酎	vzyc
戔	jmgg
襞	biyu
鱟	hzpa
摽	bnfx
廾	gsaa
礌	lwut
撙	zyfc
讞	yjyq
畎	qrtq
塄	lgtf
鈹	pijp
岢	keek
溲	szdy
袢	pjpa
櫨	lumm
螽	vswi
瞢	mgco
艫	luvm
枵	xnmg
毐	aiup
岨	jueq
呣	mzkd
呣	omkd
呣	vmkd
轢	liim
嘸	omkv
堝	gotk
檠	qkmc
噦	hvkp
噦	ytkp
凼	dhkd
蚵	eeik
孓	jtvn
蚍	piiv
啗	djka
芩	qbcv
夐	xsdw
炅	gvoh
炅	jsoh
躐	lpzv
柷	iume
柷	vume
晡	buod
勍	qkwl
糸	mivx
糸	miav
糸	sivx
糸	siav
屄	biub
屝	fwua
碁	qiqu
鞀	tcgk
齔	ifiv
栳	lcmv
傒	xird
邠	bbeb
鯗	xlay
襻	pjpu
敉	miwm
諼	xryy
嶝	dged
萆	bicu
垡	fatr
洇	ybdd
埏	ujtv
埏	yjtv
磽	qnue
箅	biva
頏	hhwa
鈧	khjj
樫	jmmt
扆	yihy
尢	yzuv
窆	bmbn
磾	diua
茛	gfcn
瘐	yubn
髁	kegn
疳	gjbc
跽	jizx
鋏	jxjn
耔	zilz
洫	xudx
瀋	ufdt
琇	xqwp
槲	humu
劓	yidp
躔	ijzt
餷	iaua
窳	yubg
囍	xiuk
鰩	ycaf
瘼	mobd
齙	bciv
獬	xpqn
貅	xqvm
晫	voou
萑	hrcf
趼	jmzc
躦	zrzb
鞽	qngk
櫞	yrmn
鮃	pkau
儇	xrry
硎	xkud
堙	ybtt
胙	zooa
觜	zijv
觜	zvjv
舾	xivx
癧	libv
詿	gxyt
銣	rujk
繯	hrsy
貊	movb
噍	jnkh
壼	kyua
戥	dgog
坩	gjtc
瘙	scbi
斝	jxku
菝	bacd
閿	wfmy
胗	vfop
嚌	jika
蟣	jiid
屌	dnuj
擐	hrfy
溮	uidj
氬	yaqa
枘	rvmd
尪	whuw
悃	kyxm
禊	xipd
艋	mgvm
纊	klsb
蚰	yzia
蜣	qliv
澮	hvdo
澮	kkdo
碲	diuj
嘓	goka
蘺	licf
耪	phlf
蒴	uoco
栝	gxmk
栝	komk
栝	tmmk
貰	uibc
洩	xpdp
臌	guoy
舴	zeva
跂	qizy
偰	xprd
龠	ytrc
綞	dosa
忉	dcxd
滻	ijdf
脒	miom
跏	jxzk
鋨	eejd
瘥	cdbg
瘥	idbg
蠛	mpic
璺	wfpw
騍	kemn
黌	hsdb
謦	qiyu
塒	uitc
鏌	mojd
髟	bnap
狳	yuqh
嬲	nnnl
蕕	yzcq
鍪	mzjs
礅	dyuw
鋩	mhjv
蝓	yuid
裒	pzwy
蘩	fjcs
醑	xuyo
玠	jpwa
紬	yzsa
暸	lnox
骱	jpga
嵫	zies
搿	geru
葖	tucq
衄	nvxa
唵	ankv
遘	gzza
砟	vaua
勱	mdcl
坌	bftb
鷳	xmnm
鄶	gver
鄶	kker
襆	fujn
釷	tujt
丌	jiaa
銪	yzjo
錈	jrjv
厶	sivd
螗	thik
穭	lvho
岣	gzek
剴	kdde
酞	tdyd
鰾	bnax
繐	svhx
敔	yuww
垤	dptt
獍	jkqe
誒	eiyu
汆	crrd
揲	uefm
岈	yaep
磙	gyuy
撢	djfu
爝	jthc
蟛	pgip
浯	wudk
胍	gxog
舯	vsva
鍤	iaja
隉	npeg
庋	gvgy
鱺	lial
鰷	tnam
咴	hvkh
癔	yibx
昉	fhof
婞	xknu
矧	ufua
簀	zevb
笮	zeva
笮	zova
惓	qrxv
艨	mgvn
莰	kjcq
堍	tutv
腠	czod
銦	ybjd
錛	bfjc
碡	vzud
鮓	vaaa
晢	veof
苄	bmcd
羝	diyd
潷	bida
樘	thmt
哌	pdkn
賻	fubc
醵	juyn
緄	gysv
鏝	mjjy
罱	ljsu
髕	bbgb
嶁	lzen
烀	huha
偲	sirx
檫	iamx
旐	vcfd
酃	lkey
瘌	labd
蠑	rsim
悝	kvxa
悝	lixa
恧	nvxa
曈	tsoa
拏	naun
鏐	lqjp
泐	ledl
蓰	xicr
堋	bgto
堋	pgto
忳	dyxv
忳	tyxv
忳	vyxv
釕	lnja
嚭	piuk
鴝	qung
芑	qicv
吲	ybka
拃	vafa
黲	cjhp
嵛	yued
鼯	wuuk
亹	mfwq
亹	wwwq
綆	ggsn
菔	fucy
畬	uert
畬	yurt
迍	vyzv
榿	qimd
蔞	lzcn
蜾	goin
劁	qndr
迕	wuzr
肼	jkoa
鵒	yunb
鍰	hrjy
倖	xkru
僬	jnrh
朊	rroe
唸	nmkx
毹	uurm
嚮	xlvk
犰	qqqj
讚	zjyb
撚	nmfh
堠	hztu
軹	viib
氽	tyrd
匚	klav
儦	bnrh
帟	yiwj
瀹	ytdc
墼	jita
嗍	soko
鋦	jujk
鰉	hlaw
鰹	jmat
緙	kesg
脤	ufoy
荽	svcn
勅	cial
勅	iial
癀	hlbb
臑	ncoa
槔	gcmu
綟	lisq
舳	vuva
蝤	qqiy
盃	bwma
炱	tdsh
甏	bgwu
氾	fjdv
廑	jbga
廑	qbga
綈	tisp
桄	glme
捨	uefk
黟	yihd
眵	iiod
崙	lyrc
葎	lvca
晱	ujoh
摛	iifs
溈	wwdh
顬	ruya
苤	ppca
耱	molu
熘	lqht
唪	fgka
垌	dstk
垌	tstk
艽	jncj
艽	qqcj
諝	xuyo
骺	hzgk
搛	jmfn
偓	wort
厴	yjia
洳	rudk
砬	laul
砬	liul
攄	uufx
譾	jmyy
唼	uakn
洚	jlda
貘	movd
潿	wwda
咼	gokk
咼	gxkk
咼	hekk
咼	wakk
咼	wdkk
咼	wokk
鯫	zzay
剄	jkda
啣	xmke
鐔	ijju
鐔	tjju
鐔	xbju
鴯	erna
罨	yjsv
緶	bmsn
璠	fjwt
迺	ndzx
羋	miaa
炻	uihu
鯒	ysaa
颮	bnfv
髂	qxgk
胩	kaod
浥	yidv
脷	liod
駔	zhmq
釃	udyl
釃	uiyl
栘	yimd
篥	livm
漭	mhdc
鋣	yeje
廒	aogw
糈	xumo
碹	xrua
碸	fguf
鱅	ysaa
膦	lboa
蟪	hvix
穸	xibd
筢	pavv
煸	bmhc
嘌	pnkx
鐿	yijx
鐦	kdjc
鈰	uijj
鎇	mwjo
蟶	igiw
羰	thyh
氪	keqe
塏	kdtd
卣	yzaa
鼢	ffud
鯝	guak
鯇	hrae
骶	digd
鑔	iajx
鈁	fhjf
釔	yijg
銎	qsjg
螵	pnix
蛸	xnio
籪	drvj
崞	goez
垵	antn
哚	dokm
	cjhp
	dadz
	wokn
	yajp
鼽	qqpj
鼷	xiud
麴	quum
麴	quaa
鹺	coag
鸌	huny
鷚	lqny
鶥	mwnv
鵯	bwnp
鱧	liad
鰵	mbar
鰳	leal
鰠	scai
鰒	fuaw
鱝	ffab
鯴	uiai
鯪	lkaw
鱭	jiaa
鮞	eraa
鮚	jpak
鬏	jqah
驏	ijmz
馘	goqk
鞴	bwga
韝	gzaa
鞔	mfgv
鞔	mjgv
陴	pieu
阽	dmek
阢	wuee
阢	wwee
閌	khmj
鑹	crju
鐠	pujo
鐓	dvjw
鑥	lujo
鏷	pujn
鏇	xrjr
鎿	naju
鐨	fwjb
鎄	aijy
鎪	szjy
錟	tjjh
錇	pwjk
鍃	hojx
鍀	dejc
鍩	nojk
錆	qljo
錒	aajk
鋟	qbjy
鋶	lqjv
鋝	ltjc
鋱	tejx
錸	ldjn
鐒	lcjl
鐋	thjp
鉿	hajk
鉿	kejk
銩	dqjs
銱	dnjj
銠	lcjv
鈽	bujj
鉕	pojk
鈳	kejk
鈄	dzju
鈥	hojh
鍆	mfjm
釙	pojd
釓	gajv
鐾	bwju
醭	buyn
醣	thyk
醌	kyyv
酴	tuyh
酏	yiyv
邶	bwea
迮	zezr
輇	qriw
軺	ycik
軤	huia
蹯	fjzt
踺	jmzz
躒	lizm
躒	lozm
賧	djbh
賕	qqbd
諗	ufyx
觖	jtjn
裉	kfpn
袼	gepk
蠼	quiy
蟓	xlin
螋	sziy
蝽	iyio
蝻	njiu
蜱	piiu
蜞	qiib
蛘	yhiy
蛑	mzin
蚴	yzil
虼	geig
虍	huaq
薷	ruca
蕺	jica
蕹	wgcf
蘞	lmcw
蒎	pdcn
蒈	kdcb
蕆	ijcb
葶	tkcd
葜	qxcd
葙	xlco
萜	tpck
菥	xicj
薟	lmcr
薟	xmcr
莛	tkcu
葤	vzcc
蕒	mdcb
茼	tsck
茺	isce
茳	jlcg
茚	ybce
茈	cicv
茈	zicv
茇	bacd
苊	eecv
藶	licv
芤	kzcv
芏	duct
艴	fuvv
艚	ccvo
舭	bivv
艤	yivd
膪	ikol
膪	vaol
膪	vdol
膣	viot
腽	waom
腧	uuod
腙	zsox
腡	look
脬	pcoz
脞	coot
脎	saom
胲	hdor
胬	nurn
腖	dson
胂	ufoa
肷	qmoq
肟	woog
肜	rsop
肀	yiva
聹	nked
耵	dked
耩	jlla
耥	thlk
耮	lcll
耠	holk
耖	iclp
羧	soyw
繰	qnsm
繰	scsm
繢	hvsb
鞝	uhsk
糨	jlmi
餱	hzmu
粞	ximx
篼	dzve
箢	yrvv
筻	ghvn
筘	kzvk
筅	xmve
窀	vybv
稃	fuhz
稂	lhhn
禚	voph
礤	caux
礞	mgun
礓	jlua
磲	quum
磉	shum
碥	bmuc
硭	mhuv
硪	woud
硇	ncux
砹	aiux
砩	fuua
砩	fwua
砘	dyuv
眢	yrop
瞘	kzok
癍	bjbw
癃	lsba
瘵	vdbx
瘭	bnbx
瘛	iibx
瘕	jxby
瘕	xxby
瘊	hzbu
癉	djba
瘃	vubn
痦	wubk
痄	vaba
痃	xrbs
疰	vubw
甓	piwu
瓞	dpgn
璁	cswx
瑭	thwk
珧	ycwd
獯	xyqh
猹	iaqa
猹	vaqa
猸	mwqo
獫	xmqr
狃	nqqa
狁	yyqe
犏	pmnc
犋	junb
牿	gunk
牮	jmnr
煺	tvhz
瀵	ffdb
澉	gjdw
漤	ljdn
灄	uede
溻	tady
渫	xpdm
浞	vodz
湞	vfdb
澩	xtdp
泖	mcde
沲	dodv
氚	irqa
氕	ppqp
氍	quom
氌	lumo
氆	pumo
毪	mumn
檑	lwmt
檎	qbmd
櫫	vuma
榱	cvmy
榍	xpmo
榀	pbmk
楱	zzmd
桊	jrbm
柃	lkms
榪	mamm
敫	jnwb
攵	wfpx
攉	hoff
擗	pifu
撖	hjfw
搌	vjfn
搋	ikfh
揞	anfo
揞	yefo
揞	yjfo
掭	tmfx
捃	jyfk
戤	gdgg
憝	dvxw
怊	icxk
弳	jkgg
庀	pigv
幬	czjc
幬	dcjc
幬	izjc
巰	qqav
巛	vevv
嵴	jieo
崾	ycen
崬	dsen
岵	huek
屮	ieva
尜	gaxx
嫜	vhnu
嫘	lwns
夼	klda
墚	lltm
塥	geta
坶	mutd
圬	wutg
圊	qkko
嚆	hckk
嘧	mike
哿	gelk
哳	vakj
唚	qbky
吖	aaka
吖	yaka
勹	bcpv
劐	hodc
劂	jtdi
剞	jidd
冱	huda
囅	ijkn
傺	iirx
佴	erre
佴	ndre
佧	kard
仂	lerl
乇	topv
乇	vepv
齣	iuvk
齢	lkis
鼕	dsud
黶	yjih
黙	moha
黒	hwhh
黐	iips
麪	mmag
鹸	jman
鹵	luax
鶺	jind
鶹	lqnp
鶲	wgnb
鶖	qqnh
鶊	ggng
鵐	wunr
鷽	xtnp
鴒	lknr
鴞	xnnk
鶬	chnr
鸊	pinu
鷿	pinu
鷴	xmnm
鷉	tinp
鷈	tinp
鶪	juno
鶏	jinv
鶄	jknf
鵰	dnnk
鵁	jnnw
鴷	lpnd
鴎	ounk
鴃	jtnn
鳾	uina
鰛	wfam
鯷	tiar
鰺	ufap
鮊	baab
鮊	boab
鱇	khyx
鱆	vhau
鰧	tgoy
鰤	uiaj
鰕	xxay
鰌	qqay
鰆	iyyo
鯱	huyj
鯰	nmax
鯆	buad
鯆	puad
鮣	ybae
鮟	anan
魆	xugg
鬨	hsab
鬚	xuaa
鬍	huao
髪	favy
髄	svgz
骻	kxgg
駸	qbmy
驫	bnmm
馹	rimo
験	yjmn
騒	scmi
駻	hjmu
駆	qumx
駅	yimn
馼	wfmw
餎	geuk
餎	leuk
飣	dkud
饑	jiud
餵	wwun
餬	huuo
餔	buud
颺	yhfp
颳	gxfk
颱	tdfk
頴	ykpa
顕	xmoa
顔	yjla
頼	ldab
韆	qmgz
鞦	qqgh
靉	aiyw
靆	ddyz
霊	lkya
霂	muym
雑	zajf
隻	viry
隷	liun
隩	aoed
隩	yued
隠	ybex
険	xmen
陥	xmeo
闠	gvmb
闍	dumo
闍	uemo
闘	iumc
闆	bjmk
閪	hwmx
閤	gemk
閤	hemk
関	grmd
閑	xmmm
鑞	lajv
鐶	hrjy
钂	thjh
鍠	hljw
錩	ihjo
銛	gxjk
銛	tmjk
銛	xmjk
錏	yaya
鉋	bcjv
鉋	pcjv
鑒	jmjk
鑀	aijw
鐯	vojo
鐧	jmjo
鐝	jtjq
鐘	vsja
鐇	fjjt
鏺	pojy
鏥	xqjb
鏚	qijx
鎲	thje
鎌	jkjn
鎌	lmjn
鎅	gdja
鍼	vfjk
鍮	tzjd
鍊	lmjn
鍅	fhjs
鍄	lljx
鍁	xmjq
錼	najx
錶	bnjy
録	lujd
錬	lmjn
鋳	vujc
鋂	mwjd
銭	qmjg
鉾	mzjn
鉳	pwjv
鉱	gljs
鉆	zrjk
鉄	tpjn
鈡	vsja
鈅	ycjo
鈅	ytjo
釾	yajp
釦	kzjk
釟	bajb
釈	uipn
醸	nlyy
醤	jlyd
酔	zvyu
郿	mwev
郷	xlev
郃	heer
邅	vjza
遅	iizy
週	vzzk
逓	dizp
迆	tozx
迆	yizx
辺	bmzd
轣	liiv
轗	kjix
輓	wjiv
軽	qkit
転	vris
軚	tdid
躂	dazz
蹟	jizb
踦	qizk
踡	qrzv
踎	bwzk
踄	uezp
跼	juzk
趷	kezv
賙	vzbk
賛	zjba
貙	iuvk
貍	lipt
豊	fgad
讌	yjyh
譲	rhyy
譲	rjyy
譭	hvyy
譟	zcym
謡	ycyf
謚	uiym
読	duye
読	dzye
誌	viyx
誂	dnyd
誂	tnyd
詑	iayv
証	vgyv
註	vuyw
訳	yiyn
訢	xbij
訢	xiij
訢	ybij
観	grrj
覧	ljjk
覚	jnxj
覚	jtxj
覇	baxo
襴	ljpn
襬	bdyv
襏	bopy
襇	jmpo
褟	tapy
褘	hvpa
褕	yupd
褌	kypi
複	fupw
製	viyp
裯	izpk
裡	lipt
裛	yiwy
裇	svpx
袗	vfpp
衹	vipq
衠	vyrd
衚	hurd
衕	tsrd
衒	xrrd
衎	kjrd
衊	mpxd
衃	pwxa
蠨	xnia
蠋	vuii
蟫	xyiu
蟫	ybiu
螱	wwui
螮	diij
螣	tgoi
螠	yiim
蝲	laid
蝘	yjik
蝋	laia
蜐	jpil
蜎	yrio
蜅	puzd
蛍	ykxi
蛃	bkir
蚲	pkiu
蚆	baiv
蚄	bhif
蚄	fhif
虸	ziiz
虷	hjiu
虤	yjhj
虓	xnjj
虒	sipj
蘘	rhcy
蘗	npcm
蘀	tocu
藷	uuco
藷	vuco
藭	qscg
藨	bnch
藨	pcch
藦	mocu
藠	jncb
藟	lwct
薿	nicr
薸	pncx
薴	nkcd
薴	vucd
薳	wwcz
薳	yrcz
薬	yccm
薫	xych
薢	xpcn
薘	dacz
薑	jlya
薁	yucd
薀	yycm
蕗	luck
蕓	yycs
蔵	chca
蔵	zhca
蔘	cjcp
蔘	ufcp
蔔	boct
蔔	buct
蔊	hjcu
蔈	bncx
蔆	lkcw
蔃	qlci
蔀	buce
蓢	lhco
蓏	locg
蓇	guco
蓆	xicj
蓂	mkcb
蒻	rocd
蒱	pucf
蒭	iuce
蒨	qmco
蒟	juck
蒐	szcs
蒐	szcg
蒄	grcc
葴	vfcg
葰	jycw
葯	yccd
葧	bocl
葓	hscb
萹	bmcc
萳	njcu
萩	qqch
萣	dkcr
菼	tjch
菴	ancv
菍	npcx
菍	rfcx
菉	lucd
菂	dicd
莿	cicd
莝	coct
莙	jyck
荘	vlcu
荖	lccp
荓	pkcc
荄	gdcr
荁	hrca
茽	vsca
茝	idck
茓	xtcb
茋	vicd
苳	dscd
苉	pice
芼	mccm
芣	fucx
芠	wfcw
芃	pgcd
艷	yjfv
艎	hlvw
艅	yuvh
舲	lkvs
舥	pavb
舠	dcvd
臢	zaob
臓	zhoa
膞	vroc
膙	jloi
膕	gooa
腯	tuoo
腨	uroa
腒	juok
腍	rfox
脿	bnoy
脳	ncok
脰	dzoa
脟	lpoc
胣	iioy
胠	quos
胈	baoy
肸	xiou
肶	biop
肏	ccrr
聴	tkex
聤	tked
耲	hkly
耰	yzmy
耤	jilo
耤	jplo
耑	drea
耏	erap
耏	ndap
耇	gztk
翀	isya
羓	bayv
罉	chru
罈	tjfu
罃	ykfh
缹	fzhf
紝	rfsu
繿	ljsm
繻	xusa
繫	jisa
繫	xisa
繍	xqsa
繊	qmsa
繊	visa
繊	xmsa
縺	lmsz
縴	qmsn
縴	xmsn
縦	zssr
縄	ugsv
縁	yrsn
緻	visw
緤	xpsm
緤	yesm
緔	uhsk
緑	lusd
緑	lvsd
総	zsxx
綵	cdsm
綳	bgso
続	xuse
辻	uizu
継	jisv
絵	hvss
経	jkst
絅	jssk
絃	xmss
紮	vasm
糺	jqsv
糰	trmc
粦	lbma
粛	suva
粛	xuva
粋	cvmu
粋	tvmu
粃	bamp
粃	pamp
籔	uuvw
簽	qmvr
篠	xnvm
箇	gevk
筴	jxvn
筊	jnvx
竜	lslv
竚	vuld
竑	hsls
窸	xixb
窣	subu
穫	hohy
穣	rhhy
穏	wfhx
穇	cjhp
穂	svhx
穀	guuy
稲	dcho
禦	yuxr
禡	mapm
禘	dipj
祫	xxpk
祊	bgpf
祇	qipq
祇	vipq
祂	tapx
礵	ulio
礒	yiud
礄	qnuk
磡	kjul
磠	luux
磑	wwud
碔	wuud
硃	vuun
砵	boia
砲	pciv
砢	louk
砕	svuu
砆	fuun
矻	kuug
瞶	kvob
瞭	leox
瞭	lnox
瞜	lzon
瞓	ffoa
瞓	xyoa
瞇	mioz
睺	hzou
睪	gcsu
眛	mwon
県	xmox
盪	dhmd
盦	anmr
盉	hemh
皕	biab
発	favv
癥	vgbw
癒	yubx
痩	uzby
痠	srbw
畳	dptq
畳	tptq
畑	tmht
甴	zaka
璿	xrwo
璵	yuwb
璟	jkwx
璈	aoww
瑲	chwk
瑲	qlwk
瑄	xrwa
琤	igwa
珢	kfwy
珢	ybwy
珅	ufwa
玦	jtwn
玘	qiwv
玕	gjwu
獴	mgqn
獮	xmqx
獣	uzxq
猟	lpqa
狉	piqa
犺	khqj
犠	xind
犇	bfnn
爟	grhf
燻	xyhh
燬	hvhy
煆	xxhy
焼	uche
焼	yche
焠	cvhu
焜	kyhv
焗	juhk
焌	jyhw
焌	quhw
烱	jlhk
烱	jshk
烝	vghv
烜	xrha
烚	xxhk
灧	yjdv
灠	ljdj
灕	lidf
瀬	ldda
瀍	ijdt
濬	jydo
濆	ffdb
澾	dadz
澦	yuda
滝	lsdv
滝	uldv
溳	yydb
満	mjdk
湉	tmdk
渢	fgdf
渓	xidn
渋	sedd
渉	uedp
済	jida
渇	kedv
淴	hudx
淩	lkdw
淒	qidn
涙	lwdd
浛	hjdk
浄	jkda
洴	pkdc
洑	fudq
泙	pgdu
泙	pkdu
泇	jxdk
泃	judk
泂	jsdk
沺	tmdt
沬	mwdn
沢	zedn
沚	vidv
沘	bidp
沖	isda
沍	huda
沊	djdd
沇	yjde
沄	yyds
汭	rvdd
汫	jkda
汧	qmdc
汙	wudu
汎	fjdd
汍	wjdd
汋	qtdd
汋	vodd
汈	dnda
氿	gvdj
氿	jqdj
気	qiqx
毬	qqmd
毚	ijdd
毎	mwra
毌	grvu
毌	wjvu
殻	keuy
殻	qnuy
殣	jbdf
歴	liiv
歯	iivk
歩	buvp
歜	iusq
歔	xuhq
歓	hrrq
歅	ybxq
歅	yjxq
欻	ixhq
欻	xuhq
欸	aisq
欸	eisq
欸	vdsq
欞	lkmr
欐	liml
欂	bomc
櫆	kvmu
櫂	vcmf
櫂	yimf
枱	cimk
枱	simk
枱	tdmk
檞	jpmn
橾	qnmm
橾	uumm
橦	ilma
橦	tsma
橞	hvmx
橑	lnmx
権	qrmf
樢	wunm
槱	icmh
槱	yzmh
槫	qrmc
槫	trmc
槫	urmc
槥	hvme
槤	lmmz
槜	zvmg
様	yhmd
榅	wfmm
榰	vimo
榣	ycmf
榖	guuy
榑	bomc
榑	fumc
榃	tjmt
楽	lemd
楽	lwmd
楽	ytmd
楯	dymo
楯	uymo
楪	dpmm
楪	yemm
楩	pmmn
楛	humk
楛	kumk
楒	simx
椸	yimv
椪	pgma
検	jmmn
椓	vomn
椑	bwmu
椆	dnmk
椆	izmk
椆	vzmk
椀	wjmv
棽	ifmg
棽	ufmg
棶	ldmn
棬	jrmv
棬	qrmv
棫	yumg
棪	yjmh
棨	qihm
棤	qtmo
棡	ghmk
棓	bhmk
棓	bwmk
棓	pzmk
棐	fwam
棁	vome
梽	vimx
梹	bkmb
梴	ijmz
梴	yjmz
梱	kymm
梣	ifmg
梡	krme
梠	lvmk
梌	iamh
梌	tumh
梂	qqmd
桿	gjmu
桹	lhmn
桲	bomz
桯	tkmw
桯	ykmw
桟	vjmd
桝	jpma
桜	ykmn
栻	uimd
栴	vjmd
栟	bfmc
栒	xymo
栐	ysmn
栄	rsxm
柮	vome
柤	vamq
柖	ucmk
柊	vsmd
柈	bjma
柈	pjma
枹	bcmv
枲	xism
枓	dzmu
枍	yimv
枅	jimc
杧	mhmw
杙	yimd
杗	mhwm
杕	dimd
杕	domd
杄	qmmu
朸	liml
朳	bamb
朮	uumd
朘	jrow
朓	tnod
朏	fwoe
朏	kuoe
曽	cgbo
曽	zgbo
曱	gaka
曨	lsol
曚	mgon
曏	xloe
曌	vcog
曆	liio
暿	xiok
暶	xror
暵	hjod
暲	vhou
暦	liio
暘	yhop
暕	jmon
暕	ljon
暍	heov
𣈶	xroa
暁	xnoe
晪	tmob
晩	wjov
晙	jyow
晐	gdor
晊	viot
晅	xroa
昺	bkor
昳	dpon
昳	yion
昫	xuok
昪	bmoc
昤	lkos
昣	vfop
昡	xrod
昒	huop
昈	huoh
昇	ugoc
昇	ugoa
昄	bjoy
旿	wuou
旵	ijoe
旴	xuoa
旞	svfz
斶	iuji
斠	jncu
斎	vdwa
斉	qiwa
斆	xnwp
斆	xtwp
攽	bjbw
攰	gvul
攰	lwul
擿	tifz
擿	vdfz
擿	vifz
擽	lefm
擭	hofy
擣	dcfc
擝	mgfm
擓	kkfk
撹	jnfj
撝	wwfh
撏	xmfc
撃	jiui
摴	iufv
摏	isfa
摂	npfd
摂	uefd
搾	vafa
揾	wffm
搲	wafg
搣	mifa
搣	mpfa
搒	bhff
搒	pgff
搊	izfe
搆	gzfa
揼	djfd
揼	dyfd
揺	ycff
揹	bwfo
揳	xpfd
揗	uyfo
揕	vffv
掻	scfi
掹	mgfm
掲	jpfv
掲	qifv
掲	qpfv
掤	bffo
掞	ujfh
掞	yjfh
捵	dmfb
捵	nmfb
捲	jrfv
捲	jrbv
捯	dcfd
捜	szfy
挿	iafa
挙	juxu
挓	vafq
拤	qxfd
拡	klfs
拡	kofs
拠	jufj
拝	bdff
拝	pdff
拑	qmfc
抦	bkfr
択	vdfn
択	zefn
抜	bafy
抜	bofy
抔	pzfx
抌	vffe
抆	mffw
抆	wffw
抃	bmfd
扽	dffv
扺	vifq
扱	xifn
扞	hjfu
払	fufs
扊	yjhh
扅	yihd
扂	dmhk
戻	lihd
戻	lwhd
戱	xihg
戭	yjbg
戦	vjdg
戣	kvvg
戙	dskg
懞	mgxx
懞	mgxn
懐	hkxy
憺	djxk
憭	lnxx
憙	xiux
憖	ybxa
憕	dgxa
憕	igxa
憕	vgxa
慾	yuxb
慼	qixp
慬	jbxa
慬	qbxa
慥	zcxz
慓	pnxx
慇	ybpx
慆	tcxa
愭	qixo
愒	kdxv
愐	mmxa
愃	xrxa
惙	ioxy
惙	ivxy
惗	npxx
惔	djxh
惔	tjxh
惎	jiqx
悪	eexa
悪	wuxa
悩	ncxk
悢	llxn
悗	mjxv
悈	jpxg
悈	kexg
悆	uurx
悆	yurx
恵	hvxa
恔	jnxf
恔	xnxf
恓	qixx
恓	xixx
怗	tpxk
忺	xmxq
忞	mbwx
忞	wfwx
応	ykgx
徴	vgrw
徛	jirk
従	csrr
従	turr
彔	luvd
彊	jlga
彆	bpgx
弾	tjga
弸	pggo
弶	jlgx
弢	tcgy
弔	dnga
弔	dnva
弐	erad
弍	ered
弆	jutc
廙	yigc
廕	ybgs
廎	qkga
廋	szgy
廆	gvgg
廆	hvgg
廆	wwgg
廃	fwgv
庱	iggw
庤	vigc
広	glgs
庁	tkgd
幖	bnjx
帰	gvaj
帡	pkjc
巻	jrbv
巣	ccdn
巣	icdn
巌	yjew
巉	ijev
巇	xieg
嶲	gveg
嶲	jreg
嶲	xieg
嶮	xmer
嶨	xtep
嶦	ujek
嶦	vjek
嶢	ycee
嶟	zyec
嶔	qbeq
嶓	boet
嶒	cgeo
嶍	xieb
嶅	aofe
嵲	npem
嵖	iaea
嵎	yued
嵅	hjeg
嵁	kjev
嵁	vjev
崿	eeev
崶	fgec
崡	hjek
崒	cvei
崒	zuei
崌	juek
崀	lhen
峿	wuek
峱	ncqe
峧	jnef
峛	lied
峘	hrea
峗	wwev
峂	tsed
岠	juek
岊	jpve
屾	ufee
屼	wuee
屘	miuz
屘	mjuz
屓	xibu
尨	lsud
尨	mgud
尨	mhud
尨	phud
尐	dixn
専	vrac
対	dvdc
寛	krbj
寁	zjbr
寀	cdbm
宬	igbv
宧	yiba
実	uibn
孖	mazz
孖	zizz
孅	qmig
孅	xmig
嬿	yjnh
嬬	runa
嬥	tnnf
嬢	nlny
嬝	nnny
嬃	xunp
嫿	hxna
嫽	lnnx
嫲	mang
嫭	hunu
嫪	lcnp
嫕	yinx
嫑	bcan
嫑	mqan
嫐	ncnn
嫄	yrnx
媱	ycnf
媞	tinr
媖	yknn
媓	hlnw
媆	nfnd
媆	rrnd
媄	mwnd
媂	dinj
媂	tinj
婼	ronk
婻	njnu
婫	hynv
婫	kynv
婥	ionu
婤	iznk
婤	vznk
婘	jrnv
婘	qrnv
婍	qink
婌	uuny
娵	juny
娀	ssng
姽	gvnv
姶	eenk
姶	yank
姱	hunv
姱	kxnv
姪	vint
姦	jmnn
姤	dunk
姤	gznk
姞	jink
姈	lkns
姅	bjna
妭	band
妧	wjne
妧	yrne
妠	nanr
妠	njnr
妘	yyns
奭	uidb
奨	jldd
奡	aoaa
奓	iidd
奓	uedd
奓	vadd
奅	pcde
奀	enad
奀	nfad
夬	gkvn
変	bmww
売	mdue
壱	yiuv
壪	wjtg
壗	jbtm
壌	rhty
壋	dhtt
壊	hkty
墶	datz
墦	fjtt
墣	putn
墡	ujtl
墘	qmtg
増	zgto
墕	yjth
墑	ditk
墐	jbta
墈	kjtl
塽	ultx
塱	lhtd
塮	xptc
塭	wftm
塩	yjtm
塤	xytb
塝	bhtf
塈	jitv
塅	drty
塃	hltv
塁	lwtt
塀	pbtc
堾	irto
堽	ghtv
堼	fgtt
堲	jitv
堨	aitr
堨	eetr
堨	vdtr
堨	yetr
堧	rrtd
堐	yatt
堎	lgtw
堌	gutk
埼	qitk
埵	dota
埫	istk
埫	uhtk
埪	kstg
埞	ditr
埗	butp
埌	lhtn
埇	ysta
埆	jttj
埆	qttj
垿	xuta
垾	hjtu
垺	futz
垺	pztz
垟	yhty
垞	iatq
垙	gltg
垕	hzpt
垏	lvta
垎	hetk
垍	jito
垈	ddtr
坽	lkts
坰	jstk
坬	gxtg
坥	qutq
坒	biat
坋	bftd
坋	fftd
坉	dytv
坉	tytv
圲	qmtu
圫	vytq
圫	yutq
圧	yait
圢	tktd
圙	ltka
圐	kukf
圏	jrkv
圏	qrkv
圌	irka
圌	ivka
囸	rikv
囷	qykh
図	tukx
囲	wwka
囧	jskk
団	trkc
囜	nbks
囌	sukh
囃	zakf
嚲	dowa
嚥	yekh
嚥	yjkh
嚟	likd
嚟	lwkd
嚚	ybkk
嚙	npkv
嚐	ihko
嚄	hoky
嚄	ooky
噛	npkk
噏	haky
噏	xiky
噉	djkw
噇	ilka
噃	bokt
噂	zykc
噁	eekx
噁	wukx
噀	xykc
嘽	ijka
嘽	tjka
嘽	toka
嘩	hxku
嘥	sdkr
嘢	yeka
嘡	thkt
嘚	dekc
嘐	xnkp
嘅	geke
嗻	vekh
嗻	vukh
嗹	lmkz
嗱	naku
嗰	gekk
嗮	sdky
嗊	gskb
嗊	hskb
喺	xiox
営	ykxk
喯	bfkc
喫	iikd
喨	llkj
喤	hlkw
喐	yuek
喎	wdkk
喎	wokk
啹	kokk
啲	dikd
啱	ngou
啱	njou
啱	yjou
啫	uiko
啫	veko
啩	gxkd
啢	llkr
啋	cdkm
唶	coko
唦	uakp
唥	lhks
唞	dzku
唞	tcku
唖	yaka
唓	ieki
唎	likd
哷	lpkc
哷	lvkc
哱	bakz
哱	bokz
哱	pokz
哣	dzka
哣	pzka
哢	lskc
哋	dikx
哃	tskk
咺	xrka
咹	ankn
咹	eekn
咹	vjkn
咲	grkd
咥	dpkt
咡	erke
咗	zokg
咑	dakd
咍	hdkk
咉	yhkn
咈	fuka
咇	bikx
咁	gjka
呪	vzke
呇	qidk
吅	sskk
吅	xrkk
叚	jxvy
叚	xxvy
叕	jtyy
叕	liyy
叕	voyy
叕	yiyy
収	uzvy
厾	dugs
厳	yjxw
厖	mhip
卹	xuxe
卲	uced
卬	ahep
卬	yhep
単	djxa
単	ijxa
単	ujxa
卐	wjxx
卍	wjxx
卌	xiaa
匽	yjkn
匼	kekk
匼	qxkk
匜	yiky
勲	xyhp
勩	yicl
勧	qrrl
勦	icvl
勦	jnvl
勠	luyl
勗	xuol
勔	mmal
劻	klkl
効	xnwl
労	lcxl
劄	vadv
剷	ijdl
剰	ugdp
剦	yjdd
剤	jidw
剣	jmdd
剟	dody
剗	ijdg
剕	fwda
剒	codc
剋	kedu
剋	keud
剋	kwdu
剋	kwud
剅	lzda
処	iuwj
凘	sidj
凓	lidm
冧	lfbm
冚	kjbe
冔	xuoa
冇	mcuk
円	yeaa
円	yraa
兲	tmwb
児	erae
儸	lorf
儴	rhry
儴	xlry
儳	ijrd
儘	jbrm
儅	dhrt
儁	jyrg
僰	bora
僩	xmro
僜	dgra
僔	zyrc
僎	vrrc
僇	lurp
傚	xnrw
傉	nurc
傃	surx
偺	zjro
偯	yiry
偭	mmra
偡	vjrv
偁	ifra
偁	igra
倻	yere
倹	jmrn
倴	bfrc
倧	zsrx
値	virv
倣	fhrw
倞	jkrx
倞	llrx
倓	tjrh
倈	ldrn
俶	iury
俶	tiry
俵	bnry
俬	sirs
俥	ieri
俙	xirj
俔	qmrj
俍	llrn
係	jirx
係	jips
係	xirx
係	xips
侹	tkrz
侷	jurk
侴	hcrd
価	jprx
価	jxrx
侘	iarq
侂	torq
侁	ufre
佽	cirq
佸	hork
併	bkrc
佢	qura
佖	birp
佈	burj
佁	iirk
佁	yirk
伾	pira
伭	xmrd
伭	xrrd
伝	irrs
伝	vrrs
伋	jirn
伈	xbrx
仮	jxry
仏	fors
仏	furs
亜	yaaa
乸	naxd
乗	igpn
乗	ugpn
乂	yipn
丼	dsad
両	llak
丏	mmag
○	lkvv
〇	lkoo
腌	aaov
锕	aajk
肮	ahoj
爱	aivy
碍	aiuc
暧	aioy
蔼	aicv
霭	aiyv
皑	aibv
嗳	aiky
嫒	ainy
瑷	aiwy
锿	aijy
叆	aiey
谙	anyo
鹌	annd
铵	anjn
埯	antv
奥	aopd
鳌	aoaf
袄	aopd
骜	aomf
岙	aope
媼	aonm
罢	bass
坝	batb
钯	bajv
鲅	baad
鲌	baab
宾	bbbb
滨	bbdb
镔	bbjb
鬓	bbab
濒	bbda
缤	bbsb
槟	bbmb
殡	bbdb
膑	bbob
摈	bbfb
傧	bbrb
髌	bbgb
报	bcfy
宝	bcbw
饱	bcuv
剥	bcde
鲍	bcav
鸨	bcnp
龅	bciv
败	bdwb
摆	bdfs
呗	bdkb
贲	bfbu
锛	bfjc
绷	bgso
帮	bhjf
绑	bhse
镑	bhjf
谤	bhyf
秘	bihp
毕	biua
闭	bimp
笔	bivm
币	bipj
毙	biav
辟	biuu
痹	biba
贲	bibu
纰	bisv
哔	biku
荜	bicu
跸	bizu
铋	bijp
筚	bivu
滗	bidm
赑	bibb
办	bjld
颁	bjba
绊	bjsa
坂	bjty
钣	bjjy
并	bkqc
禀	bkwx
饼	bkuc
槟	bkmb
边	bmzl
变	bmwy
编	bmsc
辩	bmyu
贬	bmbn
辫	bmsu
笾	bmvz
鳊	bmac
缏	bmsn
标	bnmx
镖	bnjx
飙	bnqf
飚	bnfh
骠	bnmx
镳	bnjh
飑	bnfv
鳔	bnax
骉	bnmm
拨	bofd
驳	bomx
剥	bode
钵	boja
钹	bojd
饽	bouz
铂	bojb
鹁	bonu
袯	bopy
鉢	boja
鲌	boab
别	bpdk
瘪	bpbv
鳖	bpax
鱉	bpax
补	bupd
钚	bujd
钸	bujj
备	bwwt
辈	bwia
贝	bwkr
狈	bwqb
惫	bwxw
呗	bwkb
钡	bwjb
鹎	bwnp
采	cdvm
财	cdbp
纔	cdsd
测	cedd
侧	cerd
册	cepa
厕	ceid
栅	cema
恻	cexd
伧	cfrv
层	cgus
苍	chcv
仓	chrv
舱	chvv
沧	chdv
鸧	chnr
玱	chwv
词	ciyk
辞	cipu
赐	cibp
兹	ciqs
鹚	cinq
糍	cims
参	cjsp
残	cjdg
惨	cjxp
灿	cjhe
惭	cjxj
蚕	cjai
骖	cjmp
黪	cjhp
䅟	cjhp
错	cojo
锉	cojt
鹾	coag
窜	crba
攒	crfb
蹿	crza
撺	crfa
镩	crja
从	csrr
聪	csex
丛	csar
骢	csmx
枞	csmr
苁	cscr
蔥	cscx
囪	cspx
凑	czdd
辏	czid
帱	czjc
达	dazd
惮	daxa
鞑	dagz
哒	dakz
荙	dacz
跶	dazz
垯	datz
㳠	dadz
导	dcvc
岛	dcne
盗	dcmd
祷	dcpc
捣	dcfe
焘	dchf
帱	dcjc
梼	dcmc
带	ddfj
贷	ddbr
绐	ddsk
诒	ddyk
叇	ddez
锝	dejc
灯	dghd
邓	dgey
镫	dgjd
当	dhxe
党	dhxe
挡	dhfe
荡	dhcp
档	dhme
铛	dhje
裆	dhpe
砀	dhup
谠	dhye
垱	dhte
珰	dhwe
敌	diwp
递	dizb
缔	disj
谛	diyj
涤	didm
诋	diyd
镝	dijk
籴	dirm
觌	diuj
䃅	diuu
䗖	diij
单	djba
担	djfa
弹	djga
胆	djoa
诞	djyv
惮	djxa
郸	djeb
掸	djfa
膻	djoa
殚	djda
箪	djva
瘅	djba
赕	djbh
顶	dkda
订	dkyd
钉	dkjd
锭	dkjr
铤	dkjz
饤	dkud
点	dmha
电	dmav
颠	dmua
垫	dmtf
巅	dmea
癫	dmba
淀	dmdr
钿	dmjt
调	dnyk
鸟	dnna
钓	dnjd
鲷	dnak
铞	dnjj
铫	dnjd
夺	dodc
堕	dote
铎	doja
驮	domd
缍	dosa
亸	dowa
㙍	doty
叠	dpyq
谍	dpym
鲽	dpam
䏲	dpop
绖	dpst
丢	dqps
铥	dqjs
断	drmj
锻	drjy
缎	drsy
簖	drvj
动	dsel
东	dsad
冻	dsdd
栋	dsmd
胨	dsod
鸫	dsna
岽	dsed
独	duqi
读	duyd
赌	dubo
笃	duvm
渎	dudd
镀	dujy
犊	dund
牍	dupd
黩	duhd
椟	dumd
对	dvyc
队	dver
怼	dvxy
镦	dvjw
兌	dvbe
顿	dyaa
吨	dykv
钝	dyjv
炖	dyhv
趸	dyaz
斗	dzdu
读	dzyd
窦	dzbd
钭	dzju
恶	eexa
额	eeba
饿	eeud
鹅	eenp
鳄	eeag
颚	eeka
讹	eeyv
垩	eeta
鹗	eenk
锷	eejg
谔	eeyg
腭	eeog
阏	eemd
轭	eeiv
锇	eejd
诶	eiyu
儿	erpv
尔	erdx
饵	erue
迩	erzd
贰	erqb
铒	erje
鸸	erna
鲕	eraa
发	favd
罚	fasd
阀	famg
珐	faws
纷	ffsd
奋	ffdt
愤	ffxb
坟	fftw
粪	ffmb
偾	ffrb
鲼	ffab
风	fgjx
凤	fgjy
峰	fgef
锋	fgjf
疯	fgbf
枫	fgmf
丰	fgaa
冯	fgdm
缝	fgsz
讽	fgyf
沣	fgdf
砜	fguf
沨	fgdx
访	fhyf
纺	fhsf
鲂	fhaf
钫	fhjf
饭	fjuy
范	fjcv
烦	fjha
贩	fjby
矾	fjud
钒	fjjd
复	furw
负	fubd
妇	fune
抚	fufv
肤	fuon
辅	fuid
赋	fubd
缚	fusc
辐	fuit
驸	fumc
凫	funj
讣	fuyd
绂	fusd
幞	fujn
麸	fufn
鲋	fuac
绋	fusa
鳆	fuaw
赙	fubc
䓛	fuce
㕮	fukx
㳇	fudx
飞	fwvd
费	fwbv
废	fwgd
绯	fwsa
诽	fwya
鲱	fwaa
镄	fwjb
夹	gaan
轧	gaiv
钆	gajv
镐	gcjk
诰	gcyk
缟	gcsk
锆	gcjk
该	gdyr
盖	gdmy
钙	gdjg
赅	gdbr
个	gera
阁	gemk
搁	gefk
鸽	genr
颌	gera
纥	gesg
铬	gejk
镉	geja
饹	geuk
亘	gfaa
颈	ggva
鲠	ggan
赓	gggb
绠	ggsn
鹒	ggng
刚	ghdk
钢	ghjx
岗	ghex
冈	ghkx
纲	ghsx
杠	ghmg
戆	ghxl
㭎	ghmx
干	gjau
赶	gjzu
尴	gjjm
赣	gjlb
秆	gjhu
绀	gjsc
㽏	gjdc
柺	gkml
广	gldi
犷	glqg
过	gozc
国	gokw
锅	gojd
涡	godr
帼	gojw
蝈	goiw
椁	gomz
掴	gofw
呙	gokd
埚	gotd
腘	goow
啯	gokw
关	grqd
观	gryj
馆	gruk
惯	grxb
贯	grbv
纶	grsv
掼	grfb
鹳	grnc
鳏	grad
宫	gsbk
贡	gsbg
龚	gslb
巩	gsgd
䢼	gsec
唝	gskb
顾	guia
贾	gubx
雇	guhf
蛊	gumi
锢	gujk
鸪	gunu
鹘	gung
轱	guik
钴	gujk
毂	guuy
诂	guyk
䓛	guce
鲴	guak
规	gvaj
贵	gvba
归	gvae
诡	gvyv
柜	gvma
龟	gvdv
轨	gvij
闺	gvmt
桧	gvms
刽	gvdr
匮	gvkb
鲑	gvat
妫	gvnd
郐	gver
匦	gvkj
刿	gvde
鳜	gvaq
阓	gvmb
嬀	gvnh
给	gwsk
挂	gxft
剐	gxdk
呙	gxkd
鸹	gxnp
诖	gxyt
铦	gxjk
滚	gydy
衮	gywy
鲧	gyas
辊	gyiv
绲	gysv
够	gzgd
构	gzms
购	gzbs
沟	gzds
钩	gzjs
诟	gzyk
鞲	gzga
缑	gzsu
觏	gzcj
鉤	gzjk
铪	hajk
#jp	hanjihanji
号	hckg
镐	hcjk
灏	hcda
颢	hcoa
蚝	hcim
还	hdza
骇	hdmr
吓	hekd
贺	hebl
鹤	hend
阖	hemm
颌	hera
诃	heyk
阂	hemr
呙	hekd
纥	hesg
覈	hexw
龁	heig
横	hgmb
恒	hgxa
颃	hhwa
绗	hhsd
汉	hjdy
韩	hjua
颔	hjra
阚	hjmw
顸	hjaa
㘎	hjkw
㘚	hjkw
怀	hkxd
坏	hktd
黄	hlcb
谎	hlyv
鳇	hlaw
锽	hljw
㿠	hlbg
伙	horh
获	hocq
货	hobr
祸	hopd
钬	hojh
镬	hojy
锪	hojx
彟	hoey
㸌	hoha
还	hrza
欢	hryq
缓	hrsy
换	hrfn
环	hrwd
唤	hrkn
焕	hrhn
涣	hrdn
痪	hrbn
奂	hrdn
缳	hrsy
锾	hrjy
鲩	hrae
镮	hrjy
鹮	hrns
㬊	hroy
红	hssg
轰	hsiy
鸿	hsdn
讧	hsyg
闳	hsms
荭	hscg
黉	hsxb
唝	hskb
护	hufh
壶	huua
沪	hudh
沪	hudx
鹄	hunn
浒	hudu
鹘	hung
鹕	huun
鹱	huny
覈	huxw
轷	huia
戶	hupu
会	hvrs
挥	hvfi
毁	hvpy
辉	hvgi
汇	hvdk
绘	hvss
堕	hvte
讳	hvya
晖	hvoi
秽	hvhd
贿	hvbo
诲	hvyd
桧	hvms
诙	hvyh
荟	hvcs
烩	hvhs
珲	hvwi
哕	hvkd
浍	hvds
缋	hvsb
袆	hvpa
翚	hvyi
话	hxyk
华	hxur
划	hxdg
画	hxak
哗	hxku
桦	hxmu
骅	hxmu
铧	hxju
婳	hxnk
浑	hydi
荤	hyci
珲	hywi
馄	hyuv
诨	hyyi
阍	hymo
后	hzpk
鲎	hzxa
糇	hzmu
刹	iadx
诧	iayq
姹	ianq
镲	iajx
锸	iaja
馇	iaua
绰	icsu
钞	icjp
钗	idjd
侪	idra
虿	idai
车	ieaa
彻	ierd
砗	ieui
㬚	ieow
陈	ifed
称	ifhx
尘	iftx
衬	ifpc
碜	ifup
谌	ifyv
谶	ifyg
伧	ifrv
龀	ifiv
榇	ifmm
称	ighx
抢	igfv
诚	igyv
撑	igfu
惩	igxr
铛	igje
骋	igmg
铖	igjv
柽	igmt
蛏	igit
枨	igmn
长	ihpn
场	ihtp
厂	ihap
尝	ihxs
偿	ihrs
畅	ihap
肠	ihop
怅	ihxn
伥	ihrn
苌	ihcn
鲳	ihao
阊	ihmo
锠	ihjo
迟	iizu
齿	iivk
驰	iimv
耻	iiev
炽	iihb
饬	iiul
鸱	iinp
单	ijba
产	ijlp
颤	ijwa
缠	ijsa
禅	ijpa
蝉	ijia
铲	ijji
搀	ijfd
阐	ijma
掺	ijfp
忏	ijxu
馋	ijud
婵	ijna
谄	ijya
谗	ijyd
镡	ijju
冁	ijbn
蒇	ijcb
觇	ijaj
骣	ijmz
刬	ijdg
啴	ijka
浐	ijdi
床	ilgm
创	ildr
闯	ilmm
疮	ilbv
怆	ilxv
绰	iosu
龊	ioiz
辍	ioiy
传	irrd
钏	irja
种	isha
冲	isda
虫	isad
宠	isbl
铳	isje
㳘	isde
处	iuwd
触	iuji
础	iuuk
储	iuro
厨	iuic
雏	iudf
橱	iumc
锄	iujl
绌	iusk
刍	iude
蹰	iuzc
䝙	iuvk
䢺	iuee
锤	ivja
纯	iysv
唇	iyik
鹑	iynw
莼	iycv
䲠	iyyo
丑	izva
筹	izvc
绸	izsk
踌	izzc
畴	iztc
俦	izrc
雠	izyf
帱	izjc
梼	izmc
进	jbza
紧	jbas
尽	jbud
仅	jbry
劲	jbvl
锦	jbjj
晋	jbao
谨	jbya
烬	jbhd
觐	jbcj
缙	jbso
荩	jbcd
馑	jbua
卺	jbvv
赆	jbbd
几	jipg
给	jisk
机	jimj
极	jimn
记	jiyv
计	jiyu
击	jiak
级	jisn
继	jisv
际	jiex
纪	jisv
济	jida
迹	jizw
积	jihb
鸡	jiny
挤	jifa
绩	jisb
辑	jiie
剂	jidw
饥	jiuj
玑	jiwj
讥	jiyj
缉	jise
叽	jikj
羁	jism
矶	jiuj
骥	jimb
霁	jiya
觊	jiej
齑	jiwa
蓟	jicd
诘	jiyk
跻	jiza
鲫	jiae
赍	jibu
荠	jica
哜	jika
虮	jiij
鲚	jiaa
经	jksg
惊	jkxx
静	jkfa
劲	jkvl
镜	jkje
净	jkda
径	jkrg
竞	jkle
颈	jkva
荆	jkdc
鲸	jkax
迳	jkzv
靓	jkfj
茎	jkcg
痉	jkbg
泾	jkdg
胫	jkog
刭	jkdv
弪	jkgg
䴖	jknf
将	jldc
强	jlgi
讲	jlya
奖	jldd
蒋	jlcc
浆	jldd
缰	jlsa
酱	jlyd
绛	jlsa
桨	jlmd
繮	jlsa
见	jmkv
间	jmmo
剑	jmdr
简	jmvo
渐	jmdj
坚	jmta
监	jmma
检	jmma
减	jmdk
键	jmjz
舰	jmvj
艰	jmyn
鉴	jmja
贱	jmbg
践	jmzg
溅	jmdg
捡	jmfa
荐	jmcz
歼	jmdu
拣	jmfd
缄	jmsk
茧	jmci
戬	jmag
涧	jmdo
俭	jmra
槛	jmmm
笺	jmvg
谏	jmyn
睑	jmoa
锏	jmjo
碱	jmuk
饯	jmug
鞯	jmgz
鹣	jmnq
枧	jmmj
缣	jmsn
硷	jmua
笕	jmvj
裥	jmpo
戋	jmad
鲣	jmat
谫	jmyd
觉	jnxj
脚	jnoe
较	jnif
娇	jnna
骄	jnma
轿	jnia
搅	jnfj
绞	jnsf
缴	jnsw
胶	jnof
侥	jnre
浇	jnde
矫	jnua
饺	jnuf
鲛	jnaf
峤	jnea
铰	jnjf
挢	jnfa
鹪	jnnr
䴔	jnnw
结	jpsk
节	jpce
杰	jphm
阶	jpea
洁	jpdk
届	jpua
诫	jpyd
颉	jpua
诘	jpyk
讦	jpyu
疖	jpbe
鲒	jpak
𠝹	jpdt
㛃	jpnf
旧	jqao
纠	jqsa
鹫	jqnw
鸠	jqnj
厩	jqiv
阄	jqmv
㠇	jqed
绢	jrso
鹃	jrnk
隽	jrrp
镌	jrjp
锩	jrjv
䌹	jssk
䐃	jsok
觉	jtxj
绝	jtsv
决	jtdn
诀	jtyn
谲	jtyk
镢	jtjq
鳜	jtaq
㵐	jtdq
车	juaa
举	juxa
据	jufk
剧	judu
惧	juxb
柜	juma
驹	jumk
锯	jujk
飓	jufb
钜	juja
榉	juma
龃	juiq
屦	juun
讵	juya
窭	jubn
锔	jujk
䴗	juno
价	jxra
驾	jxml
夹	jxan
颊	jxaa
贾	jxbx
挟	jxfn
颉	jxua
浃	jxdn
郏	jxea
荚	jxcn
钾	jxja
铗	jxjn
蛱	jxin
镓	jxjn
槚	jxmb
军	jybi
龟	jydv
钧	jyjd
骏	jymw
隽	jyrp
皲	jybp
铐	kcjg
㸆	kcha
开	kdac
凯	kdej
铠	kdjv
恺	kdxv
忾	kdxq
锴	kdjb
剀	kdde
垲	kdtv
锎	kdjc
颗	keaa
课	keyn
壳	keuj
轲	keik
颏	kewa
疴	kebk
锞	kejn
缂	kesg
铪	kejk
骒	kemn
钶	kejk
恳	kfxv
垦	kftv
龈	kfin
铿	kgjt
钪	khjj
闶	khmj
槛	kjmm
龛	kjrl
阚	kjmw
会	kkrs
块	kktn
侩	kkrs
哙	kkks
脍	kkos
狯	kkqs
郐	kker
蒉	kkcb
浍	kkds
㧟	kkfk
况	klde
矿	klug
旷	klog
邝	kleg
诳	klyw
诓	klyw
纩	klsg
圹	kltg
贶	klbe
扩	kofg
阔	komk
宽	krbj
髋	krgj
库	kugi
裤	kupi
绔	kusg
喾	kuxk
亏	kveg
溃	kvdb
窥	kvbj
馈	kvub
篑	kvvb
匮	kvkb
聩	kveb
岿	kvee
愦	kvxb
蒉	kvcb
夸	kxdg
鲲	kyav
锟	kyjv
阃	kymm
裈	kypi
壸	kyua
抠	kzfx
眍	kzox
腊	laoo
蜡	laio
临	lbaa
凛	lbdx
邻	lber
鳞	lbaa
躏	lbzf
赁	lbbr
蔺	lbcf
懔	lbxx
辚	lbia
廪	lbgx
檩	lbmx
劳	lccl
络	lcsk
捞	lcfl
唠	lckl
涝	lcdl
崂	lcel
痨	lcbl
铹	lcjl
耢	lcll
铑	lcjv
来	ldan
莱	ldcn
赖	ldab
籁	ldvb
癞	ldbb
睐	ldon
濑	lddb
徕	ldrn
涞	lddn
崃	lden
赉	ldba
铼	ldjn
俫	ldrn
梾	ldmn
乐	lepd
鳓	leal
饹	leuk
棱	lgmw
阆	lhmn
锒	lhjn
㫰	lhon
㮾	lhmd
里	liaa
里	liat
离	liwd
丽	liad
礼	lipv
厉	liip
历	liil
励	liil
隶	livn
栗	lixm
雳	liyl
厘	liia
篱	livs
沥	lidl
鲤	liaa
砾	liud
郦	liea
骊	limd
俪	lird
砺	liup
莅	licl
蛎	liip
呖	likl
逦	liza
栎	limd
鹂	lina
枥	liml
疠	libp
缡	liss
锂	lija
蓠	lics
粝	limp
坜	litl
疬	libl
苈	licl
鲡	liad
鳢	liad
跞	lizd
轹	liid
㰀	limd
兰	ljqe
蓝	ljcm
拦	ljfs
烂	ljhs
懒	ljxb
岚	ljef
篮	ljvm
栏	ljms
览	ljja
澜	ljdd
揽	ljfj
滥	ljdm
缆	ljsj
阑	ljmd
斓	ljwd
榄	ljmj
褴	ljpm
谰	ljyd
镧	ljjd
𨅬	ljzn
领	lkra
灵	lkeh
铃	lkjs
龄	lkis
岭	lkes
绫	lksw
棱	lkmw
棂	lkmh
鲮	lkaw
鸰	lknr
㥄	lkxw
两	llad
梁	llmd
凉	lldx
粮	llmn
俩	llrd
辆	llid
谅	llyx
靓	llfj
魉	llgd
唡	llkr
连	lmzi
脸	lmoa
联	lmed
练	lmsd
怜	lmxs
炼	lmhd
莲	lmcz
恋	lmxw
链	lmjz
帘	lmbj
敛	lmwr
涟	lmdz
镰	lmjn
潋	lmdw
琏	lmwz
殓	lmda
裢	lmpz
裣	lmpa
奁	lmdx
鲢	lmaz
莶	lmca
蔹	lmcw
梿	lmmz
疗	lnba
辽	lnzv
缭	lnsx
镣	lnjx
鹩	lnnu
钌	lnja
罗	losd
络	losk
逻	lozs
骆	lomk
萝	locd
锣	lojd
骡	loms
荦	locn
箩	lovd
猡	loqd
脶	lood
椤	lomd
镙	lojs
泺	lodd
跞	lozd
啰	lokd
㑩	lord
猎	lpqo
䴕	lpnd
刘	lqdw
陆	lqek
浏	lqdd
绺	lqsk
镏	lqjt
骝	lqmt
馏	lqut
锍	lqjv
鹨	lqny
鹠	lqnp
乱	lrpv
鸾	lrwn
峦	lrwe
挛	lrwu
孪	lrwz
銮	lrwj
栾	lrwm
滦	lrdm
脔	lrwr
娈	lrwn
龙	lsud
笼	lsvl
拢	lsfl
珑	lswl
咙	lskl
胧	lsol
聋	lsle
垄	lstl
陇	lsel
泷	lsdl
茏	lscl
栊	lsml
垅	lstl
砻	lslu
昽	lsol
锊	ltjc
䂮	ltfu
陆	luek
绿	lusd
鲁	luao
录	luvd
卢	luau
炉	luhh
芦	luch
虏	luhl
禄	lupd
颅	luaa
噜	luko
庐	lugh
掳	lufl
赂	lubk
卤	luax
鹭	lunz
辘	luil
撸	lufo
泸	ludu
橹	lumo
辂	luik
胪	luou
鲈	luau
轳	luiu
渌	ludd
鸬	luna
栌	lumi
垆	lutu
舻	luvi
氇	lumo
镥	lujo
硵	luux
箓	luvd
绿	lvsd
虑	lvhx
吕	lvkk
缕	lvsn
屡	lvun
侣	lvrk
驴	lvmh
沪	lvdh
沪	lvdx
滤	lvdx
褛	lvpn
铝	lvjk
偻	lvrn
闾	lvmk
榈	lvmk
稆	lvhk
类	lwmd
泪	lwdo
垒	lwts
镭	lwjt
缧	lwss
诔	lwyn
论	lyyv
轮	lyiv
伦	lyrv
仑	lyrv
沦	lydv
抡	lyfv
纶	lysv
囵	lykv
楼	lzmn
搂	lzfn
髅	lzgn
喽	lzkn
娄	lzmn
蝼	lzin
篓	lzvn
镂	lzjn
偻	lzrn
蒌	lzcn
瘘	lzbn
耧	lzln
嵝	lzen
䁖	lzon
马	mava
吗	makm
妈	manm
骂	mamk
码	maum
玛	mawm
蚂	maim
犸	maqm
杩	mamm
唛	makw
祃	mapm
悯	mbxw
闵	mbmw
闽	mbmi
缗	mbso
黾	mbkv
鳘	mbar
猫	mcqt
贸	mcbp
锚	mcjt
牦	mcnm
铆	mcje
买	mdvd
卖	mdud
脉	mdon
麦	mdfw
迈	mdza
唛	mdkw
劢	mdal
荬	mdcd
么	meps
们	mfrm
门	mfdg
闷	mfmx
懑	mfxd
扪	mffm
焖	mfhx
钔	mfjm
梦	mgmd
锰	mgjm
黾	mgkv
㠓	mgen
铓	mhjv
秘	mihp
弥	migx
谜	miyz
觅	mivj
祢	mipx
谧	miym
猕	miqx
幂	mibj
芈	miaa
满	mjdd
蛮	mjwi
瞒	mjod
馒	mjuy
鳗	mjay
谩	mjyy
缦	mjsy
颟	mjca
镘	mjjy
螨	mjid
鸣	mknk
铭	mkjk
绵	mmsj
缅	mmsa
腼	mmoa
渑	mmdv
黾	mmkv
麺	mmfa
庙	mnga
缪	mnsp
缈	mnsp
鹋	mnnc
么	mops
没	mody
无	moav
脉	moon
麽	mogs
蓦	mocm
嬷	mons
谟	moyd
馍	moud
殁	mody
镆	mojd
灭	mpah
缪	mqsp
谬	mqyp
亩	muwt
钼	mujo
没	mwdy
霉	mwyd
镁	mwjd
镅	mwjo
鹛	mwnv
谋	mzym
缪	mzsp
纳	nasd
呐	nakd
钠	najd
镎	naju
脑	ncok
闹	ncmj
恼	ncxk
挠	ncfe
铙	ncje
桡	ncme
蛲	ncie
垴	nctk
呐	nekd
讷	neyd
馕	nhuy
拟	nifr
腻	niod
昵	niov
鲵	niae
铌	nijv
难	njyf
宁	nkbd
狞	nkqd
拧	nkfd
咛	nkkd
泞	nkdd
柠	nkmd
聍	nked
酿	nlyn
辗	nmin
撵	nmfi
辇	nmia
鲶	nmax
鲇	nmak
鸟	nnna
袅	nnny
茑	nncn
嫋	nnnd
诺	noyk
傩	norf
锘	nojk
摄	npfy
聂	npey
蹑	npzy
嗫	npky
啮	npkk
镊	npjy
镍	npjm
蘖	npcm
颞	npea
陧	npet
纽	nqsa
钮	nqja
农	nsdn
浓	nsdn
哝	nskn
侬	nsrn
脓	nson
秾	nshn
㶶	nshn
疟	ntba
驽	numn
钕	nvjn
内	nwad
馁	nwun
呒	omkv
区	oukx
欧	oukq
呕	oukx
殴	ouky
瓯	oukw
鸥	ounk
怄	ouxx
讴	ouyx
沤	oudx
贫	pbbb
频	pbva
嫔	pbnb
颦	pbvu
抛	pcfl
疱	pcbv
喷	pfkb
鹏	pgon
苹	pgcu
庞	phgl
罢	piss
辟	piuu
纰	pisv
罴	pihs
铍	pijp
䴙	pinu
盘	pjmv
蹒	pjzd
凭	pkjr
评	pkyu
冯	pkdm
苹	pkcu
鲆	pkau
骗	pmmc
骈	pmmc
谝	pmyc
㛹	pmnn
飘	pnxf
朴	pnmd
缥	pnsx
骠	pnmx
颇	popa
朴	pomd
泼	podd
钋	pojd
钷	pojk
䥽	pojd
扑	pufd
铺	pujd
仆	purd
朴	pumd
谱	puyo
镨	pujo
镤	pujn
赔	pwbk
辔	pwks
锫	pwjk
亲	qblm
钦	qbjq
寝	qbby
揿	qbfq
吣	qbkx
锓	qbjy
嵚	qbeq
气	qirv
齐	qiwa
骑	qimk
弃	qiwc
岂	qiev
启	qihk
凄	qidn
绮	qisk
栖	qimx
颀	qija
脐	qioa
鳍	qiao
讫	qiyg
蕲	qicj
骐	qimb
荠	qica
碛	qiub
蛴	qiia
桤	qimv
䓫	qick
啓	qikh
轻	qkig
亲	qklm
请	qkyo
庆	qkgd
倾	qkra
顷	qkaa
氢	qkqg
鲭	qkao
苘	qkck
庼	qkga
强	qlgi
枪	qlmv
墙	qltk
抢	qlfv
跄	qlzv
呛	qlkv
蔷	qlck
锵	qljc
戗	qlrg
嫱	qlnk
炝	qlhv
樯	qlmk
镪	qlji
羟	qlyg
锖	qljo
玱	qlwv
钱	qmjg
潜	qmdo
牵	qmdn
纤	qmsu
签	qmva
浅	qmdg
谦	qmyn
迁	qmzp
谴	qmyz
铅	qmjk
钳	qmjc
堑	qmti
佥	qmra
骞	qmbm
钎	qmju
缱	qmsz
悭	qmxt
钤	qmjv
荨	qmcc
椠	qmmi
伣	qmrj
乔	qnpa
桥	qnma
壳	qnuj
翘	qnay
窍	qnbg
跷	qnze
侨	qnra
锹	qnjh
诮	qnyo
谯	qnyh
荞	qnca
峤	qnea
鞒	qnga
硗	qnue
缲	qnsm
硚	qnua
窃	qpbd
惬	qpxn
锲	qpjd
箧	qpvn
龟	qqdv
虬	qqiv
鳅	qqah
巯	qqvv
赇	qqbd
鹙	qqnh
权	qrmy
劝	qryl
诠	qryw
颧	qrca
铨	qrjw
绻	qrsv
辁	qriw
穷	qsbl
琼	qswx
茕	qscu
䓖	qscl
却	qteu
确	qtuj
阙	qtmq
鹊	qtnc
阕	qtmd
悫	qtxu
区	qukx
躯	quux
驱	qumx
趋	quze
觑	quhj
岖	quex
阒	qumq
龋	quid
鸲	qung
诎	quyk
䓛	quce
麹	qufm
㭕	qums
群	qyvy
绕	rcse
扰	rcfd
饶	rcue
娆	rcne
荛	rcce
桡	rcme
热	rehf
认	rfyr
韧	rfad
饪	rfuu
纫	rfsd
轫	rfid
纴	rfsu
让	rhya
驲	rimo
䎃	rjay
软	rriq
荣	rscm
绒	rssu
冗	rsbj
嵘	rsem
蝾	rsim
镕	rsjk
缛	rusc
颥	ruya
铷	rujk
锐	rvje
銳	rvje
润	rydw
闰	rymw
萨	saci
洒	sadx
飒	salf
扫	scfe
骚	scmi
缫	scsn
缲	scsm
鳋	scai
赛	sdbb
鳃	sdax
涩	sedv
啬	seuk
穑	sehk
铯	sejv
㴔	sedx
婶	sfna
丧	shun
颡	shya
丝	siav
厮	siij
厕	siid
饲	siuk
咝	sika
鸶	sivn
驷	sims
蛳	siij
缌	sisx
锶	sijx
㟃	siek
伞	sjru
馓	sjuw
毵	sjsm
叄	sjss
缩	sosb
锁	sojb
琐	sowb
唢	sokb
松	ssms
耸	sser
颂	ssba
诵	ssya
讼	ssys
怂	ssxr
𩠌	ssuz
㧐	ssfy
㩳	ssfy
诉	suyd
苏	sucd
肃	suva
稣	suah
谡	suyw
虽	svki
随	svez
岁	sved
绥	svsn
谇	svyu
孙	syzx
损	syfb
笋	syvp
荪	sycx
狲	syqx
飕	szfy
擞	szfw
馊	szuy
薮	szcw
锼	szjy
挞	tafz
獭	taqb
闼	tamz
铊	tajv
鳎	taay
讨	tcyc
涛	tcdc
韬	tcaa
绦	tcsm
焘	tchf
鼗	tcey
梼	tcmc
态	tdxd
钛	tdjd
骀	tdmk
鲐	tdak
臺	tdtu
擡	tdft
檯	tdmt
铽	tejx
腾	tgom
誊	tgby
䲢	tgoy
汤	thdp
烫	thhd
傥	thre
镗	thjt
铴	thjp
䣘	thex
镋	thje
㓥	thdx
㓥	thde
体	tira
题	tioa
缇	tisr
屉	tiuv
鹈	tinb
锑	tijp
绨	tisp
䏲	tiop
䴘	tinp
鳀	tiar
谈	tjyh
叹	tjky
弹	tjga
坛	tjts
贪	tjbr
摊	tjff
谭	tjyu
滩	tjdf
瘫	tjbf
昙	tjos
锬	tjjh
镡	tjju
钽	tjja
啴	tjka
嘆	tjkn
听	tkkj
厅	tkid
铤	tkjz
烃	tkhg
䗴	tkiz
阗	tmmb
钿	tmjt
铦	tmjk
条	tnwm
调	tnyk
粜	tnem
龆	tnik
鲦	tnam
铫	tnjd
㕮	tnkx
托	tofq
驼	tomv
驮	tomd
椭	tomo
鸵	tonv
鼍	tokv
铊	tojv
箨	tova
脫	tooe
萚	toca
讬	toyv
啴	toka
铁	tpjn
贴	tpbk
团	trkp
抟	trfd
统	tsse
铜	tsjk
恸	tsxl
㛚	tsna
图	tukd
涂	tudh
秃	tuhj
钍	tujt
㻬	tuwv
颓	tvha
蛻	tvie
饨	tyuv
头	tzdd
杀	uaxm
刹	uadx
纱	uasp
厦	uaiw
鲨	uaad
铩	uajm
烧	uche
绍	ucsk
晒	udox
筛	udvj
酾	udyd
设	ueyy
摄	uefy
慑	uexy
赊	uebx
厍	ueii
滠	uedy
参	ufsp
审	ufba
渗	ufdp
绅	ufsa
肾	ufoa
谌	ufyv
诜	ufye
糁	ufmp
渖	ufda
谂	ufyx
声	ugup
胜	ugof
圣	ugty
绳	ugsv
渑	ugdv
伤	uhrl
赏	uhbx
殇	uhdp
觞	uhjp
绱	uhsk
时	uioc
实	uibd
师	uiaj
势	uilf
视	uipj
识	uiyb
试	uiyd
适	uizp
释	uipa
尸	uivp
诗	uiyc
饰	uiuj
湿	uida
驶	uimn
狮	uiqj
嘘	uika
蚀	uiui
弑	uixd
轼	uiid
虱	uigi
谥	uiym
莳	uicc
埘	uitc
酾	uiyd
鲥	uiac
铈	uijj
贳	uibc
鲺	uiai
䏡	uiox
䴓	uina
浉	uidj
溼	uidt
单	ujba
闪	ujmr
禅	ujpa
姗	ujna
讪	ujye
陕	ujen
栅	ujma
删	ujdp
掺	ujfp
掸	ujfa
缮	ujsk
膻	ujoa
赡	ujby
鳝	ujak
骟	ujmy
钐	ujjp
帅	ukaj
双	ulyy
泷	uldl
说	uoye
烁	uohd
硕	uoua
铄	uojd
說	uoye
闩	urma
数	uuwm
书	uuvd
术	uumd
树	uumc
属	uuud
输	uuid
竖	uula
枢	uumx
赎	uubd
纾	uusa
摅	uufx
说	uvye
谁	uvyf
說	uvye
稅	uvhe
谁	uwyf
顺	uypa
兽	uzbk
寿	uzfc
绶	uzsy
诈	vaya
栅	vama
闸	vama
轧	vaiv
咤	vakq
铡	vajd
䃎	vaud
齄	vaph
赵	vczx
诏	vcyk
钊	vcdj
侧	vdrd
择	vdfa
债	vdrb
斋	vdwa
这	vezw
辙	veiw
辄	veiv
蛰	veif
谪	veyk
鹧	veng
锗	vejo
䗪	vegi
阵	vfei
镇	vfjb
针	vfju
贞	vfba
侦	vfrb
诊	vfyp
祯	vfpb
缜	vfsb
赈	vfbn
帧	vfjb
桢	vfmb
鸩	vfnd
轸	vfip
浈	vfdb
争	vgda
证	vgyv
征	vgrv
睁	vgoa
郑	vgeq
挣	vgfa
铮	vgja
狰	vgqa
筝	vgva
峥	vgea
诤	vgya
钲	vgjv
长	vhpn
张	vhgn
帐	vhjn
涨	vhdn
胀	vhon
账	vhbn
识	viyb
质	vipb
职	vieb
织	visb
执	vifd
纸	visq
滞	vidj
掷	vife
帜	vijb
挚	viuf
贽	vibf
郦	viea
栉	vime
鸷	vinf
轾	viit
絷	visf
骘	vime
踯	vize
栀	vimv
觯	vija
踬	vizb
轵	viib
战	vjag
占	vjak
颤	vjwa
斩	vjij
绽	vjsr
栈	vjmg
盏	vjmg
崭	vjej
辗	vjin
毡	vjmk
谵	vjyy
装	vlyd
状	vldq
庄	vlgt
壮	vldu
妆	vldn
桩	vlmt
戆	vlxl
衆	vlxn
妝	vldn
缴	vosw
浊	vodi
镯	voji
诼	voyn
䓬	vocu
䦃	vojo
梲	vome
转	vrid
传	vrrd
专	vrad
赚	vrbn
砖	vrud
颛	vrea
馔	vrub
啭	vrkd
䏝	vrod
种	vsha
众	vsrr
终	vssd
钟	vsja
肿	vsoa
锺	vsja
衆	vsxn
属	vuud
诸	vuyo
筑	vuvd
驻	vumw
猪	vuqo
烛	vuhi
嘱	vukd
诛	vuyn
铸	vujc
瞩	vuod
伫	vura
贮	vuba
铢	vujm
苎	vuca
槠	vumo
潴	vudo
橥	vumq
纻	vusa
坠	vvte
锥	vvjf
缀	vvsy
赘	vvbf
骓	vvmf
缒	vvsz
这	vwzw
挝	vxfz
准	vydf
谆	vyyz
皱	vzdp
骤	vzmn
轴	vzia
昼	vzua
纣	vzsc
诌	vzye
绉	vzse
荮	vzcc
赒	vzbk
冑	vzyo
冑	vzao
㑇	vzre
㑳	vzre
㤘	vzxe
㥮	vzxe
娲	wanr
袜	wapn
洼	wadt
呙	wakd
膃	waom
呙	wdkd
问	wfmk
闻	wfme
稳	wfhx
纹	wfsw
韫	wfam
阌	wfmy
鰮	wfam
搵	wffm
榲	wfmm
溫	wfdm
縕	wfsm
缊	wfsm
瓮	wgbw
网	whkx
辋	whiv
万	wjap
弯	wjwg
湾	wjdg
顽	wjea
纨	wjsd
绾	wjsk
塆	wjtg
窝	wobd
涡	wodr
龌	woit
蜗	woid
挝	wofz
呙	wokd
莴	wocd
臥	wokd
㖞	wokn
无	wuav
务	wuwl
恶	wuxa
吴	wukd
误	wuyd
乌	wupa
雾	wuyl
呜	wuka
妩	wunv
芜	wucv
坞	wuta
诬	wuyr
邬	wuep
鹉	wuna
骛	wums
鹜	wuns
钨	wuja
庑	wugv
怃	wuxv
为	wwld
围	wwka
卫	wwea
维	wwsf
伟	wwra
谓	wwyo
违	wwza
韦	wwaa
伪	wwrd
玮	wwwa
纬	wwsa
苇	wwca
炜	wwha
猬	wwqo
韪	wwoa
诿	wwyn
闱	wwma
潍	wwdf
帏	wwja
鲔	wwao
沩	wwdd
涠	wwda
衛	wwrd
潙	wwdh
㧑	wwfd
衅	xbxa
锌	xbju
镡	xbju
䜣	xbij
细	xist
习	xiga
戏	xiyg
袭	xily
牺	xinx
锡	xijp
腊	xioo
栖	ximx
玺	xidw
忾	xixq
铣	xije
阋	xime
觋	xipj
饩	xiuq
䜣	xiij
屃	xibu
戯	xihg
兴	xkxb
荥	xkcd
陉	xkeg
饧	xkup
响	xlkk
项	xlga
乡	xlvp
详	xlyy
厢	xlio
镶	xljy
饷	xluk
骧	xlmy
缃	xlso
飨	xlvu
鲞	xlba
芗	xlcp
现	xmwj
显	xmoa
线	xmsg
险	xmea
鲜	xmay
闲	xmmm
县	xmqs
献	xmuq
贤	xmba
纤	xmsu
羡	xmyr
宪	xmbe
衔	xmrd
咸	xmgk
娴	xmnm
掺	xmfp
馅	xmua
苋	xmcj
藓	xmcy
铣	xmje
跹	xmzz
锨	xmjq
痫	xmbm
蚬	xmij
岘	xmej
籼	xmme
鹇	xmnm
莶	xmca
铦	xmjk
嫺	xmno
崄	xmea
挦	xmfc
狝	xmqx
猃	xmqa
㬎	xmho
萧	xnca
晓	xnoe
啸	xnka
销	xnjo
潇	xnda
嚣	xnkk
箫	xnva
枭	xnnm
骁	xnme
绡	xnso
哓	xnke
蟏	xnia
鸮	xnnk
敩	xnxw
谢	xpyc
叶	xpku
写	xpba
协	xpud
胁	xpod
携	xpfp
挟	xpfn
蝎	xpiv
泻	xpda
谐	xpyb
亵	xpwy
颉	xpua
撷	xpfa
鲑	xpat
缬	xpsa
绁	xpsv
㙦	xptr
绣	xqsp
锈	xqjp
馐	xqua
鸺	xqrn
䗛	xqij
选	xrzn
轩	xriu
悬	xrxq
绚	xrso
癣	xrby
铉	xrjd
镟	xrjr
谖	xryy
暅	xroa
凶	xskx
汹	xsdk
学	xtxz
谑	xtya
鳕	xtae
泶	xtxd
峃	xtxe
敩	xtxw
许	xuyu
续	xusd
须	xupa
虚	xuha
绪	xuso
吁	xuku
叙	xury
嘘	xuka
顼	xuwa
诩	xuyy
浒	xudu
溆	xudy
谞	xuyo
媭	xunp
敘	xuwr
吓	xxkd
侠	xxrn
峡	xxen
狭	xxqn
厦	xxiw
辖	xxik
虾	xxid
硖	xxun
寻	xyec
训	xyya
讯	xyyu
询	xyyo
逊	xyzz
勋	xykl
熏	xyhp
驯	xyma
埙	xytb
鲟	xyac
浔	xydc
荨	xycc
勳	xypl
亚	yaaa
压	yaid
讶	yayp
哑	yaka
娅	yana
鸦	yana
鸭	yana
轧	yaiv
桠	yama
垭	yata
氩	yaqa
痖	yaba
䥺	yajp
银	ybjn
隐	ybex
阴	ybeo
饮	ybur
瘾	ybbx
荫	ybco
龈	ybin
铟	ybjd
䜣	ybij
䲟	ybae
慭	ybax
么	ycps
摇	ycff
药	yccd
遥	yczv
瑶	ycwf
尧	ycae
钥	ycjo
谣	ycyf
侥	ycre
肴	ycxo
窑	ycbf
鹞	ycnv
疟	ycba
鳐	ycaf
轺	ycik
铫	ycjd
峣	ycee
㙘	yctn
业	yeaa
爷	yefe
叶	yeku
页	yeba
烨	yehu
靥	yeia
邺	yeea
谒	yeyv
晔	yeou
铘	yeje
样	yhmy
阳	yheo
杨	yhmp
扬	yhfp
养	yhya
痒	yhby
炀	yhhp
鸯	yhan
疡	yhbp
钖	yhjp
飏	yhfp
旸	yhop
异	yivc
义	yixd
议	yiyd
医	yiku
艺	yicg
遗	yiza
亿	yirg
忆	yixg
仪	yird
译	yiya
谊	yiyq
蚁	yiid
驿	yima
诣	yiyo
绎	yisa
颐	yika
呓	yikg
贻	yibk
轶	yiin
饴	yiuk
缢	yism
峄	yiea
镒	yijm
铱	yijy
诒	yiyk
怿	yixa
瘗	yibt
镱	yijx
舣	yivd
钇	yijg
勚	yicl
㑊	yird
祎	yipa
㴔	yidx
严	yjai
烟	yjhd
验	yjma
颜	yjla
艳	yjfv
厌	yjiq
岩	yjeu
阎	yjma
彦	yjlp
盐	yjmt
砚	yjuj
俨	yjri
兖	yjwe
魇	yjig
阉	yjmv
滟	yjdv
谚	yjyp
腌	yjov
恹	yjxq
赝	yjib
闫	yjms
鼹	yjun
厣	yjia
酽	yjyi
餍	yjiu
谳	yjyq
贗	yjib
䶮	yjld
黡	yjvi
应	ykga
营	ykck
鹰	ykgn
赢	ykwd
莹	ykcw
婴	yknb
樱	ykmn
颖	ykpa
莺	ykcn
蝇	ykiv
萤	ykci
滢	ykdw
荧	ykch
萦	ykcs
缨	yksn
颍	ykpa
鹦	yknb
嘤	ykkn
罂	ykfb
荥	ykcd
璎	ykwn
茔	ykct
撄	ykfn
瘿	ykbn
潆	ykds
蓥	ykcj
䓨	ykcf
哟	yokd
远	yrze
员	yrbk
愿	yrix
圆	yrkb
园	yrke
缘	yrsn
渊	yrda
辕	yriy
鸳	yrnp
鸢	yrnq
鼋	yrev
橼	yrmn
拥	ysfa
涌	ysda
佣	ysra
咏	yskn
踊	ysza
镛	ysja
痈	ysba
鳙	ysaa
㶲	ysha
说	ytye
乐	ytpd
约	ytsd
跃	ytzd
岳	ytpe
阅	ytme
钥	ytjo
粤	ytpg
钺	ytjd
栎	ytmd
哕	ytkd
說	ytye
閱	ytme
悅	ytxe
于	yuau
与	yuaa
语	yuyk
余	yurh
鱼	yuda
预	yusa
狱	yuqq
郁	yueu
誉	yuxy
吁	yuku
渔	yuda
娱	yund
钰	yujw
驭	yumy
舆	yupb
谕	yuyd
屿	yuea
馀	yuuh
妪	yunx
觎	yurj
谀	yuyn
阈	yuma
鹬	yuns
纡	yusu
龉	yuik
俣	yurd
欤	yuaq
伛	yurx
蓣	yuca
饫	yuud
鹆	yunb
滪	yudb
玙	yuwa
㳚	yudd
㺄	yuqd
云	yyes
运	yyze
晕	yyoi
韵	yyla
蕴	yycm
匀	yyga
陨	yyeb
酝	yyys
殒	yydb
纭	yyss
恽	yyxi
韫	yyam
郓	yyeb
郧	yyek
蕰	yycm
蘊	yycm
醞	yyym
慍	yyxm
氳	yyqm
涢	yydb
縕	yysm
缊	yysm
游	yzdz
优	yzrd
犹	yzqd
忧	yzxd
诱	yzyp
邮	yzea
铀	yzja
鱿	yzad
莸	yzcd
铕	yzjo
杂	zajm
臜	zaob
凿	zcau
枣	zcad
皁	zcbu
竈	zcbe
侧	zdrd
载	zdig
灾	zdbh
则	zedb
责	zebf
择	zefa
泽	zeda
啧	zekb
赜	zekb
帻	zejb
箦	zevb
谮	zfyo
赠	zgbo
锃	zgjw
缯	zgso
䎖	zgby
脏	zhot
赃	zhbt
驵	zhmq
资	zibd
兹	ziqs
咨	zikd
渍	zidb
辎	ziit
眦	ziov
龇	ziiv
缁	zist
锱	zijt
谘	ziyk
赀	zibv
鲻	ziat
赞	zjbn
暂	zjoi
赚	zjbn
攒	zjfb
辗	zjin
瓒	zjwb
錾	zjji
趱	zjzb
钻	zrjk
躜	zrzb
缵	zrsb
总	zsxb
纵	zssr
踪	zszx
综	zssx
偬	zsrx
枞	zsmr
糉	zsmw
组	zusq
诅	zuyq
镞	zuju
贼	zwbu
鳟	zyac
邹	zzed
驺	zzme
鲰	zzay
诹	zzyy
