的	debd
的	dibd
一	yiaa
了	leva
了	lnva
是	uior
不	buad
我	wopd
人	rfpn
在	zdut
这	vezw
这	vwzw
他	tarv
有	yzuo
来	ldan
道	dczq
你	nirx
个	gera
大	daan
大	ddan
到	dcda
上	uhaa
说	uoye
说	uvye
说	ytye
们	mfrm
着	vcyo
着	veyo
着	voyo
出	iuek
中	vsaa
地	detv
地	ditv
那	naev
就	jqwd
也	yevv
下	xxad
要	ycxn
么	meps
么	mops
么	ycps
子	ziva
时	uioc
为	wwld
然	rjhp
可	kedk
她	tanv
过	gozc
之	vidn
以	yivr
看	kjuo
会	hvrs
会	kkrs
得	derc
得	dwrc
天	tmad
去	quts
自	zipo
好	hcnz
心	xbdd
和	hehk
和	hohk
和	huhk
没	mody
没	mwdy
能	ngsv
对	dvyc
后	hzpk
还	hdza
还	hrza
里	liaa
里	liat
小	xnad
手	uzpa
而	eraa
起	qizv
只	vikb
身	ufpp
想	xlxm
都	duet
都	dzet
头	tzdd
如	runk
无	moav
无	wuav
面	mmaa
多	dopd
已	yivv
发	favd
事	uiaa
生	ugpf
知	viuk
家	jxbn
前	qmqd
声	ugup
开	kdac
方	fhwp
经	jksg
现	xmwj
笑	xnvd
什	ufru
什	uiru
力	ligp
点	dmha
两	llad
法	fads
国	gokw
样	yhmy
所	sopj
成	iggv
意	yixl
见	jmkv
但	djra
老	lctv
用	yspa
又	yzvn
情	qkxo
于	yuau
当	dhxe
动	dsel
己	jivv
些	xpev
行	hhrd
行	xkrd
此	civv
眼	yjon
气	qirv
把	bafv
回	hvkk
话	hxyk
将	jldc
真	vfub
长	ihpn
长	vhpn
三	sjae
间	jmmo
进	jbza
年	nmra
神	ufpa
明	mkoo
十	uiaa
女	nvva
向	xlpk
定	dkbr
正	vgav
实	uibd
本	bfaa
很	hfrn
同	tskk
从	csrr
高	gcwk
问	wfmk
才	cdap
全	qrrw
被	bwpp
被	pipp
主	vudw
再	zdaa
走	zztr
却	qteu
儿	erpv
分	ffbd
口	kzaa
其	qiqb
作	zora
种	isha
种	vsha
几	jipg
外	wdpd
打	dafd
最	zvoy
门	mfdg
与	yuaa
给	gwsk
给	jisk
光	glxe
白	bdpo
等	dgvc
听	tkkj
因	ybkd
重	ispa
重	vspa
少	ucxp
风	fgjx
相	xlmo
住	vurw
次	cidr
何	herk
让	rhya
色	sedv
色	uddv
二	eraa
公	gsbs
日	rika
怎	zfxr
名	mkpk
死	sidv
便	bmrn
便	pmrn
位	wwrl
部	buel
果	goan
应	ykga
体	tira
感	gjxg
太	tddd
内	nwad
觉	jnxj
觉	jtxj
水	uvan
先	xmne
难	njyf
王	what
比	biav
别	bpdk
入	rupn
边	bmzl
第	divp
直	viuq
机	jimj
理	liwa
快	kkxn
更	ggan
做	zorw
处	iuwd
者	veto
并	bkqc
接	jpfn
西	xiaa
马	mava
轻	qkig
四	sike
关	grqd
山	ujka
月	ytpe
放	fhwf
连	lmzi
加	jxlk
目	muka
脸	lmoa
飞	fwvd
使	uirn
龙	lsud
强	jlgi
强	qlgi
张	vhgn
由	yzaa
金	jbrb
立	lila
叫	jnka
安	anbn
师	uiaj
吧	bakv
剑	jmdr
信	xbrk
学	xtxz
军	jybi
望	whww
算	srvc
原	yrix
美	mwyd
像	xlrn
平	pkau
东	dsad
场	ihtp
吗	makm
战	vjag
特	tenc
万	wjap
数	uuwm
云	yyes
清	qkdo
今	jbrv
变	bmwy
任	rfru
空	ksbg
表	bnfy
完	wjbe
合	gerk
合	herk
带	ddfj
常	ihxj
量	lloa
海	hddd
受	uzvy
解	jpjn
解	xpjn
文	wfwx
命	mkre
转	vrid
斯	siqj
通	tszs
冷	lgds
思	sixt
黑	hwha
世	uicv
该	gdyr
双	ulyy
利	lidh
至	vita
非	fwaa
林	lbmm
呢	nekv
呢	nikv
新	xblj
步	buvp
候	hzru
五	wuaa
李	limz
度	dogy
度	dugy
虽	svki
路	luzk
惊	jkxx
微	wwrw
跟	gfzn
似	uirr
物	wunp
许	xuyu
化	hxrv
制	vidp
火	hodr
性	xkxf
反	fjpy
武	wuvd
总	zsxb
指	vifo
系	jips
系	xips
结	jpsk
花	hxcv
亲	qblm
亲	qklm
教	jnwt
功	gsgl
刚	ghdk
提	difr
提	tifr
杀	uaxm
竟	jkle
士	uiua
远	yrze
百	bdab
红	hssg
它	tabv
离	liwd
满	mjdd
找	vcfg
落	lack
落	lcck
落	lock
容	rsbk
必	bidp
深	ufdm
城	igtv
拉	lafl
奇	jidk
奇	qidk
若	rock
各	gewk
失	uipn
尔	erdx
言	yjwk
传	irrd
传	vrrd
且	qpaa
形	xkap
青	qkfo
石	djak
石	uiak
干	gjau
半	bjba
近	jbzj
认	rfyr
怕	paxb
队	dver
电	dmav
夫	fuan
往	whrw
突	tubq
吃	iikg
啊	aakk
倒	dcrd
活	hodk
件	jmrn
随	svez
绝	jtsv
刻	kedw
息	xixp
即	jiev
工	gsaa
早	zcou
极	jimn
乎	hupu
界	jpta
记	jiyv
紧	jbas
怪	gkxt
流	lqdv
报	bcfy
车	ieaa
车	juaa
管	grvk
音	yblo
衣	yiwy
保	bcrm
暗	anoo
弟	dibp
及	jipn
交	jnwf
影	ykop
华	hxur
爱	aivy
精	jkmo
伤	uhrl
势	uilf
民	mbvq
令	lkrs
计	jiyu
决	jtdn
玉	yuwd
服	fuoy
条	tnwm
众	vsrr
领	lkra
哥	gedk
南	njuu
般	bjvy
元	yree
罗	losd
收	uzwv
未	wwan
始	uink
办	bjld
题	tioa
星	xkof
克	keue
根	gfmn
谁	uvyf
谁	uwyf
阵	vfei
则	zedb
象	xldn
男	njtl
达	dazd
告	gcnk
展	vjun
击	jiak
坐	zotr
灵	lkeh
血	xppm
血	xtpm
整	vgav
员	yrbk
兵	bkpb
急	jixd
千	qmpu
切	qpqd
越	ytzv
喜	xiuk
语	yuyk
站	vjlk
请	qkyo
德	derx
帮	bhjf
敢	gjwv
消	xndo
业	yeaa
姐	jpnq
周	vzpk
视	uipj
字	zibz
八	bapn
每	mwrd
苦	kuck
房	fhhf
忙	mhxv
雷	lwyt
团	trkp
片	pmpv
哪	nake
尽	jbud
书	uuvd
备	bwwt
求	qqad
司	sigk
北	bwav
静	jkfa
错	cojo
断	drmj
准	vydf
江	jldg
刀	dcgp
建	jmzv
兄	xske
终	vssd
足	zukr
兴	xkxb
冲	isda
阳	yheo
代	ddrd
或	hoga
楚	iumr
底	digd
夜	yewd
术	uumd
格	gemk
识	uiyb
识	viyb
持	iifc
答	davk
哈	hakk
留	lqtp
确	qtuj
易	yiop
七	qiav
论	lyyv
父	fubx
拿	naru
程	ighw
阿	aaek
阿	eeek
害	hdbk
族	zufu
破	poup
孩	hdzr
魔	mogg
官	grbk
沉	ifdj
显	xmoa
够	gzgd
宝	bcbw
取	quey
单	djba
单	ijba
单	ujba
掌	vhxu
务	wuwl
低	dird
雪	xtye
响	xlkk
布	buuj
市	uiwj
摇	ycff
依	yiry
久	jqpn
级	jisn
首	uzqo
运	yyze
朝	icuo
朝	vcuo
待	ddrc
娘	nlnn
客	kebk
统	tsse
忽	huxg
速	suza
复	furw
修	xqrp
欢	hryq
异	yivc
式	uiqd
护	hufh
爷	yefe
况	klde
脚	jnoe
招	vcfk
九	jqpg
集	jimr
区	oukx
区	qukx
晚	wjov
铁	tpjn
黄	hlcb
友	yzuy
亚	yaaa
除	iueh
钱	qmjg
送	sszq
兰	ljqe
联	lmed
政	vgwa
义	yixd
丝	siav
古	guuk
六	lqwb
六	luwb
器	qikk
甚	ufqv
照	vcho
基	jitq
闪	ujmr
院	yree
装	vlyd
居	juuk
产	ijlp
呼	huku
杨	yhmp
露	luyk
露	lzyk
句	gzgk
句	jugk
乱	lrpv
举	juxa
敌	diwp
斗	dzdu
香	xlho
停	tkrd
台	tdsk
群	qyvy
嘴	zvkj
希	xixj
酒	jqdy
巴	bavv
怀	hkxd
议	yiyd
类	lwmd
支	viuy
慢	mjxy
陈	ifed
仙	xmre
段	drpy
调	dnyk
调	tnyk
顿	dyaa
派	pddn
英	ykcn
喝	hekv
期	qiqo
威	wwgn
另	lkkl
府	fugc
改	gdwv
旁	phlf
资	zibd
续	xusd
造	zczn
乐	lepd
乐	ytpd
攻	gswg
左	zoug
愿	yrix
围	wwka
疑	yipr
念	nmxr
引	ybga
热	rehf
怒	nuxn
退	tvzv
缓	hrsy
线	xmsg
注	vudw
细	xist
图	tukd
背	bwoa
需	xuya
痛	tsba
观	gryj
组	zusq
雨	yuad
曾	cgbo
曾	zgbo
约	ytsd
包	bcgv
木	muan
技	jify
示	uiex
皇	hlbw
据	jufk
差	ciyg
差	iayg
差	idyg
设	ueyy
密	mibe
谢	xpyc
鬼	gvps
穿	irbp
脑	ncok
赶	gjzu
莫	mocd
丽	liad
品	pbkk
叶	xpku
叶	yeku
既	jivv
存	cyuz
睛	jkoo
宫	gsbk
烈	lphd
诉	suyd
追	vvzp
推	tvff
您	nbxr
右	yzuk
商	uhlk
争	vgda
角	jnda
角	jtda
淡	djdh
止	viaa
谈	tjyh
严	yjai
恶	eexa
恶	wuxa
狂	klqw
挥	hvfi
亮	llwj
卫	wwea
闻	wfme
忍	rfxd
态	tdxd
汉	hjdy
继	jisv
模	momd
模	mumd
银	ybjn
仍	rgrp
跑	pczv
否	fzak
君	jyvk
妹	mwnn
隐	ybex
母	muvd
科	kehu
凌	lkdw
选	xrzn
梦	mgmd
刘	lqdw
寒	hjbd
局	juuk
冰	bkdd
禁	jbmx
境	jkte
掉	dnfu
究	jqbj
余	yurh
查	iama
激	jidw
号	hckg
防	fhef
费	fwbv
恐	ksxg
楼	lzmn
导	dcvc
肯	kfvo
故	guwu
游	yzdz
球	qqwd
树	uumc
叹	tjky
救	jqwa
施	uifv
帝	dilj
佛	fora
佛	fura
简	jmvo
料	lnmu
际	jiex
顾	guia
齐	qiwa
抓	vxfv
玩	wjwe
猛	mgqm
份	ffrd
米	mibm
仅	jbry
具	juqb
胜	ugof
治	vidk
章	vhlu
巨	juka
险	xmea
守	uzbc
散	sjwc
须	xupa
眉	mwvo
抱	bcfv
权	qrmy
试	uiyd
独	duqi
震	vfyn
索	sous
证	vgyv
礼	lipv
助	vuql
圣	ugty
股	guoy
跳	tnzd
波	bodp
负	fubd
虎	huhj
练	lmsd
姑	gunk
唐	thgk
室	uitb
伙	horh
沙	uadp
妈	manm
阴	ybeo
称	ifhx
称	ighx
投	tzfy
柔	rzsm
扬	yhfp
规	gvaj
毫	hcwm
温	wfdm
较	jnif
毒	dufd
耳	eraa
座	zogt
座	zotr
射	ueuc
厉	liip
层	cgus
副	fuda
担	djfa
参	cjsp
参	ufsp
置	visq
历	liil
初	iupd
卡	kaad
卡	qxad
承	igvn
质	vipb
属	uuud
属	vuud
渐	jmdj
蓝	ljcm
船	irvk
逃	tczp
皮	pivy
药	yccd
呀	yakp
靠	kcna
充	iswe
标	bnmx
坚	jmta
贵	gvba
共	gscb
赵	vczx
维	wwsf
陆	lqek
陆	luek
块	kktn
吸	xikn
刺	cida
堂	thtx
醒	xkyf
考	kctg
松	ssms
排	pdfa
划	hxdg
换	hrfn
河	hedk
环	hrwd
土	tuua
志	vixu
责	zebf
致	viwa
压	yaid
素	sufs
湖	hudo
睡	uvoa
苏	sucd
京	jkwx
效	xnww
朋	pgoo
宇	yubu
顺	uypa
紫	zisv
伸	ufra
赛	sdbb
超	iczk
忘	whxw
幸	xktu
遇	yuza
孙	syzx
顶	dkda
拍	pdfb
警	jkyc
按	anfn
察	iabx
广	gldi
藏	chca
藏	zhca
胡	huuo
秘	bihp
秘	mihp
凡	fjjd
型	xkta
尚	uhxk
恩	enxk
脱	tooe
营	ykck
增	zgto
价	jxra
史	uian
节	jpce
秋	qqhh
翻	fjpy
迷	mizm
州	vzda
付	furc
项	xlga
萧	xnca
状	vldq
尼	niuv
雅	yaaf
凤	fgjy
秦	qbfh
草	cccu
败	bdwb
著	vcco
著	vcyo
著	veco
著	veyo
著	voco
著	voyo
著	vuco
著	vuyo
咱	zjko
朱	vupn
呆	ddkm
封	fgtc
普	puqo
景	jkox
专	vrad
味	wwkn
舞	wura
弄	nswc
虚	xuha
毕	biua
讲	jlya
福	fupt
纪	jisv
握	woft
习	xiga
社	uept
永	ysdn
寻	xyec
默	mohq
洞	dsdk
控	ksfg
骑	qimk
钟	vsja
徐	xurh
辈	bwia
假	jxry
病	bkbn
胸	xsok
欲	yubq
伯	bdrb
伯	borb
峰	fgef
肉	rzar
岁	sved
医	yiku
野	yeaa
值	virq
职	vieb
尊	zyqc
恨	hfxn
狠	hfqn
田	tmku
魂	hyeg
毛	mcpv
免	mmdv
短	drud
秀	xqhp
麻	magm
坏	hktd
印	ybep
良	lldn
迎	ykzp
枪	qlmv
弹	djga
弹	tjga
骨	guko
探	tjfm
啦	lakl
研	yjuc
妖	ycnd
劲	jbvl
劲	jkvl
临	lbaa
宁	nkbd
屋	wuut
案	anbm
杰	jphm
欧	oukq
饭	fjuy
村	cymc
升	ugpc
抬	tdfk
蒙	mgcn
略	lttk
丹	djpa
源	yrdx
纷	ffsd
雄	xsuf
烟	yjhd
危	wwdv
优	yzrd
写	xpba
床	ilgm
罪	zvss
网	whkx
食	sirn
食	uirn
食	yirn
板	bjmy
校	jnmf
校	xnmf
某	mzcm
妙	mnnp
休	xqrm
珠	vuwn
列	lpdd
盘	pjmv
透	tzzh
春	iyfo
委	wwhn
移	yihd
呵	hekk
偷	tzrd
奥	aopd
吴	wukd
验	yjma
牙	yaap
泪	lwdo
宗	zsbx
摆	bdfs
善	ujyk
浪	lhdn
羽	yuga
肩	jmho
智	viou
拥	ysfa
弱	rogd
柳	lqme
硬	ykun
纳	nasd
洛	lodk
范	fjcv
混	hydv
玄	xrws
买	mdvd
济	jida
徒	turr
烦	fjha
配	pwyv
适	uizp
端	drla
娜	nane
娜	none
哭	kuqk
凝	nkdr
镇	vfjb
率	lvwu
率	ukwu
避	bizu
拳	qrbu
创	ildr
采	cdvm
晓	xnoe
托	tofq
森	sfmm
哼	hgka
惜	xixo
束	uuan
熟	uuhw
熟	uzhw
归	gvae
抗	khfj
邪	xpea
邪	yeea
庄	vlgt
喊	hjkk
梅	mwmd
韩	hjua
罢	bass
罢	piss
仇	izrj
仇	qqrj
奔	bfdc
亡	whwv
富	fubt
限	xmen
吓	hekd
吓	xxkd
养	yhya
厅	tkid
贝	bwkr
娇	jnna
省	ugxo
省	xkxo
占	vjak
横	hgmb
飘	pnxf
戏	xiyg
画	hxak
暴	bcod
灭	mpah
域	yutk
瞧	qnoh
软	rriq
摸	mofd
席	xigj
稳	wfhx
绿	lusd
绿	lvsd
伊	yirp
讨	tcyc
释	uipa
获	hocq
店	dmgk
敬	jkwc
谷	gubk
仿	fhrf
借	jpro
丈	vhan
姓	xknf
挑	tnfd
祖	zupq
套	tcds
困	kykm
墙	qltk
冒	mcoo
夏	xxaw
叔	uuay
架	jxml
鱼	yuda
织	visb
尖	jmxd
丁	dkaa
牛	nqpa
旧	jqao
扑	pufd
彩	cdvp
降	jlea
降	xlea
燕	yjhc
卷	jrbv
臂	biou
臂	bwou
桌	voam
卖	mdud
嘿	hwkh
骂	mamk
鲜	xmay
幽	yzev
训	xyya
演	yjdb
闭	bimp
巧	qngg
奋	ffdt
杂	zajm
亦	yiwd
预	yusa
尤	yzud
偏	pmrc
替	tioa
箭	jmvd
残	cjdg
拜	bduf
腿	tvoz
婆	pond
唯	wwkf
迹	jizw
班	bjdw
诸	vuyo
吉	jiuk
诺	noyk
狼	lhqn
洋	yhdy
虑	lvhx
杯	bwmd
袋	ddyr
策	cevn
腰	ycon
殿	dmuy
番	fjpt
番	pjpt
测	cedd
输	uuid
杜	dumt
惨	cjxp
盟	mgmo
鲁	luao
豪	hcwn
积	jihb
趣	quzy
圆	yrkb
午	wuru
户	hudu
执	vifd
妇	fune
沈	ufdv
登	dgdv
懂	dsxa
含	hjrk
犹	yzqd
互	huaa
律	lvra
锋	fgjf
抢	igfv
抢	qlfv
厚	hziz
聚	juen
尸	uivp
闹	ncmj
纵	zssr
凭	pkjr
迅	xyzv
财	cdbp
搞	gcfk
嘛	makm
侧	cerd
侧	vdrd
侧	zdrd
农	nsdn
稍	ucho
介	jpra
宣	xrba
抽	izfa
颜	yjla
躲	doum
舒	uura
供	gsrb
傲	aorw
勇	yssl
阶	jpea
犯	fjqv
益	yimq
尘	iftx
甲	jxaa
皱	vzdp
街	jprd
孤	guzg
协	xpud
兽	uzbk
碰	pgua
伟	wwra
塔	tatk
批	pifv
盖	gdmy
监	jmma
劳	lccl
碎	svuu
撞	vlfa
阻	zueq
操	ccfm
概	gdmv
曲	quaa
胆	djoa
轮	lyiv
婚	hyno
迟	iizu
凶	xskx
党	dhxe
爸	bafv
剧	judu
弃	qiwc
奈	nddx
逐	vuza
疯	fgbf
距	juza
附	fuec
谓	wwyo
歌	gedq
哦	eekd
哦	ookd
构	gzms
咬	yckf
误	wuyd
塞	sdbt
塞	sebt
慕	mucx
笔	bivm
孔	kszv
牌	pdpu
陪	pwek
折	uefj
折	vefj
窗	ilbd
逼	biza
材	cdmp
挡	dhfe
岛	dcne
择	vdfa
择	zefa
袭	xily
挂	gxft
伦	lyrv
遍	bmzh
芒	mhcv
征	vgrv
触	iuji
瞪	dgod
荡	dhcp
抵	difd
郎	lhed
滚	gydy
怜	lmxs
乃	ndgp
幻	hrvg
臣	ifka
判	pjdb
烧	uche
翼	yiyb
腾	tgom
欣	xbjq
灯	dghd
库	kugi
妻	qian
私	sihs
荣	rscm
夺	dodc
园	yrke
壁	bitu
贼	zwbu
颗	keaa
累	lwts
宋	ssbm
狗	gzqk
悄	qnxo
颤	ijwa
颤	vjwa
吟	ybkv
伏	furq
瞬	uyoa
舍	uerk
补	bupd
扫	scfe
跃	ytzd
艺	yicg
挺	tkfz
岳	ytpe
悲	bwxa
圈	jrkv
圈	qrkv
旋	xrfr
瑞	rvwa
惑	hoxg
竹	vupa
蛋	djvi
艾	aicx
艾	yicx
扎	vafv
莉	licd
损	syfb
迫	pdzb
迫	pozb
盛	igmg
盛	ugmg
企	qirv
缘	yrsn
纯	iysv
俊	jyrw
努	nuln
逸	yizd
菲	fwca
抖	dzfu
乌	wupa
油	yzda
炼	lmhd
唇	iyik
幕	mucj
康	khgn
吐	tukt
汗	hjdu
馆	gruk
昨	zooa
赞	zjbn
茶	iacm
苍	chcv
恢	hvxh
裂	lpyd
育	yuwo
央	yhan
闲	xmmm
吼	hzkv
爆	bchd
鼓	guuy
乡	xlvp
陷	xmea
曼	mjoy
泰	tdfd
踪	zszx
灰	hvuh
赤	iitd
萨	saci
缺	qtfn
宽	krbj
岂	qiev
伴	bjra
猜	cdqo
额	eeba
遗	yiza
谋	mzym
浮	fudz
昏	hypo
融	rsai
妮	ninv
菜	cdcm
例	lird
盯	dkod
涌	ysda
遭	zczc
洲	vzda
潜	qmdo
拼	pbfc
勒	legl
勒	lwgl
博	bouc
蛇	ueiv
港	ghdv
貌	mcve
绍	ucsk
拔	bafd
洗	xide
彻	ierd
针	vfju
纸	visq
莱	ldcn
县	xmqs
剩	ugdp
扶	fufn
愤	ffxb
镜	jkje
爵	jtvc
晶	jkoo
佩	pwrj
讯	xyyu
忧	yzxd
鼻	bipa
御	yure
均	jytd
枫	fgmf
泽	zeda
凯	kdej
浩	hcdk
奶	ndnp
怨	yrxp
毁	hvpy
壮	vldu
诚	igyv
忠	vsxa
洪	hsdb
雾	wuyl
糊	humo
固	gukk
轰	hsiy
坦	tjta
睁	vgoa
佳	jxrt
爹	dpfd
蒂	dicj
丢	dqps
庆	qkgd
亿	yirg
词	ciyk
辛	xblu
丰	fgaa
缩	sosb
吹	ivkq
仰	yhre
迪	diza
晃	hlog
庭	tkgz
莲	lmcz
梁	llmd
仔	zdrz
仔	zirz
侠	xxrn
阁	gemk
检	jmma
暂	zjoi
读	duyd
读	dzyd
郭	goew
绕	rcse
插	iafa
凉	lldx
净	jkda
召	ucdk
召	vcdk
减	jmdk
侍	uirc
慌	hlxv
敏	mbwr
伍	wurw
鹰	ykgn
朗	lhdo
讶	yayp
诗	uiyc
货	hobr
掩	yjfv
码	maum
浑	hydi
隔	geea
傅	furc
疾	jibu
鸟	dnna
鸟	nnna
赏	uhbx
摩	mogu
池	iidv
氏	uipq
振	vffn
途	tuzr
闷	mfmx
童	tsla
朵	dojm
傻	uarw
粗	cumq
旦	djoa
悉	xixp
鸣	mknk
径	jkrg
旅	lvfn
赫	hetd
穴	xtbb
延	yjzp
惯	grxb
唤	hrkn
皆	jpba
盗	dcmd
琴	qbwv
帐	vhjn
戴	ddtg
忆	yixg
仁	rfre
宜	yibq
甘	gjca
炸	vaha
戒	jpgc
琳	lbwm
浓	nsdn
吻	wfkp
季	jihz
疼	tgbd
桑	shym
侯	hzru
堡	bctr
珍	vfwp
贴	tpbk
符	fuvc
芳	fhcf
嗯	enkx
嗯	ogkx
羞	xqya
典	dmab
劫	jptl
骗	pmmc
旗	qifb
啸	xnka
堆	dvtf
霸	bayo
廷	tkzp
促	curz
惧	juxb
耐	ndac
庞	phgl
荒	hlcv
序	xuga
躺	thuk
粉	ffmd
慧	hvxf
餐	cjua
喃	njku
踏	tazo
吕	lvkk
孟	mgmz
抚	fufv
匆	csgd
漫	mjdy
乘	igpn
乘	ugpn
启	qihk
脉	mdon
脉	moon
仪	yird
络	lcsk
络	losk
拒	jufa
洁	jpdk
郑	vgeq
奉	fgfa
漂	pndx
愈	yuxr
倍	bwrk
拖	tofv
怔	vgxv
映	ykon
访	fhyf
奴	nuny
乔	qnpa
颇	popa
愣	lgxf
献	xmuq
编	bmsc
健	jmrz
扭	nqfa
缠	ijsa
核	hemr
核	humr
评	pkyu
享	xlwz
尾	wwum
碧	biuw
瓦	waad
尺	iiun
票	pnxx
玛	mawm
川	irpa
彼	birp
焰	yjha
醉	zvyu
述	uuza
痕	hfbn
晨	ifon
薄	bccc
薄	bocc
胖	phoa
胖	pjoa
恭	gscx
辉	hvgi
绪	xuso
倾	qkra
亏	kveg
躯	quux
磨	mogu
隆	lsef
岸	aneu
括	kofk
废	fwgd
狐	huqg
吞	tyak
丫	yaba
锁	sojb
忌	jixv
悟	wuxk
滑	hxdg
椅	yimk
赌	dubo
垂	ivpa
粮	llmn
厂	ihap
辰	ifin
曹	ccao
霍	hoyf
遥	yczv
痴	iibk
款	kruq
贫	pbbb
扩	kofg
督	duoa
乖	gkpv
欺	qiqq
聊	lnee
悠	yzxr
艳	yjfv
奖	jldd
帅	ukaj
估	gurk
爬	pavv
匹	pike
录	luvd
截	jprg
牢	lcbn
锐	rvje
递	dizb
唱	ihko
唉	aiku
嘻	xikk
董	dsca
刹	iadx
刹	uadx
钢	ghjx
惹	recx
焦	jnhr
穷	qsbl
援	yrfy
慰	wwxu
措	cofo
悔	hvxd
革	geca
陵	lkew
姿	zind
扯	iefv
泉	qrbd
予	yusa
予	yusn
筑	vuvd
勾	gzgs
授	uzfy
罩	vcsu
埋	mdta
埋	mjta
熊	xshs
潮	icdo
漠	modd
轩	xriu
殊	uudn
哀	aiwy
鸡	jiny
掠	ltfx
肚	duot
聪	csex
斩	vjij
狱	yuqq
俩	llrd
炮	bchv
炮	pchv
俱	jurb
挣	vgfa
邦	bhef
袖	xqpa
泛	fjdn
沿	yjdk
辞	cipu
卓	voau
恼	ncxk
航	hhvj
零	lkys
盈	ykmg
载	zdig
扰	rcfd
末	moan
恋	lmxw
肃	suva
鹏	pgon
姆	mund
屈	quuk
眸	mzon
冥	mkbb
辆	llid
劝	qryl
刃	rfdd
炎	yjhh
姬	jina
拦	ljfs
堪	kjtv
劈	pidu
墨	moth
培	pwtk
霜	ulyo
斜	xpru
审	ufba
甜	tmpc
撒	safw
驾	jxml
耀	ycgf
脆	cvov
袍	pcpv
驻	vumw
霞	xxyy
厌	yjiq
尝	ihxs
弯	wjwg
宏	hsbs
滴	didk
牧	muwn
键	jmjz
耶	yeee
销	xnjo
膀	bhof
膀	phof
寂	jiby
媚	mwno
枝	vimy
牵	qmdn
丧	shun
祝	vupe
趁	ifzp
舌	uepk
课	keyn
麦	mdfw
抹	mafn
抹	mofn
玲	lkws
喷	pfkb
染	rjmd
跪	gvzv
擦	cafx
翔	xlyy
币	bipj
埃	aitu
钻	zrjk
贯	grbv
盾	dypo
灾	zdbh
溜	lqdt
询	xyyo
腹	fuow
渡	dudy
燃	rjhh
眨	vaon
撤	iefw
敲	qnwy
侵	qbry
喘	irka
柄	bkmn
悦	ytxe
嫁	jxnn
岩	yjeu
赖	ldab
烂	ljhs
嘉	jxuk
拾	uifk
泥	nidv
夹	gaan
夹	jxan
版	bjpy
搜	szfy
汇	hvdk
冬	dswd
俗	surk
僧	sgro
竞	jkle
喂	wwkn
骇	hdmr
搭	dafk
暖	nroy
茫	mhcv
返	fjzp
莎	uacp
挤	jifa
宾	bbbb
冠	grbc
析	ximj
郁	yueu
允	yyse
疗	lnba
繁	fjsr
桥	qnma
葛	gecv
祥	xlpy
瘦	uzby
仲	vsra
耸	sser
仗	vhrn
弓	gsvg
违	wwza
豫	yusn
幅	fujt
胁	xpod
瓶	pkqw
愧	kvxg
晕	yyoi
柱	vumw
饰	uiuj
翠	cvyu
勉	mmdl
矮	aiun
宿	subb
宿	xqbb
偶	ourd
汤	thdp
刑	xkda
涛	tcdc
黎	lihd
煞	uahd
贤	xmba
姊	zinp
衫	ujpp
锦	jbjj
抛	pcfl
虫	isad
昂	ahoe
恰	qxxk
咐	fukc
铺	pujd
琪	qiwb
衡	hgrd
饮	ybur
捉	vofz
纤	qmsu
纤	xmsu
袁	yrty
猎	lpqo
赢	ykwd
购	gzbs
卢	luau
础	iuuk
亭	tkwd
娃	want
慈	cixq
晴	qkoo
咒	vzjk
羊	yhba
签	qmva
猫	mcqt
薇	wwcw
覆	fuxw
覆	furw
祸	hopd
罚	fasd
舰	jmvj
魏	wwhg
耗	hclm
寸	cyad
跌	dpzn
俄	eerd
蝶	dpim
详	xlyy
撑	igfu
闯	ilmm
箱	xlvo
弗	fuva
扮	bjfd
诱	yzyp
障	vheu
怖	buxj
屁	piuv
弥	migx
歉	qmqq
砍	kjuq
齿	iivk
踢	tizp
寺	sitc
爪	vcpn
爪	vxpn
贸	mcbp
脏	zhot
棋	qimb
贺	hebl
迈	mdza
捕	bufd
笼	lsvl
浅	qmdg
扣	kzfk
拨	bofd
扇	ujhy
臭	izpq
臭	xqpq
篇	pmvc
猪	vuqo
邓	dgey
泄	xpdv
辱	ruic
肤	fuon
懒	ljxb
裁	cdyg
仆	purd
穆	muhp
昆	kyov
丑	izva
愁	izxh
渊	yrda
勤	qbcl
悬	xrxq
铃	lkjs
韦	wwaa
崇	isex
井	jkaa
帕	pajb
昌	ihoo
鞭	bmgn
叛	pjby
僵	jlra
纹	wfsw
鸿	hsdn
瑶	ycwf
雕	dnpf
洒	sadx
冯	fgdm
冯	pkdm
蛮	mjwi
爽	uldx
跨	kxzg
饶	rcue
矛	mcsp
缝	fgsz
湾	wjdg
税	uvhe
涉	uedp
铜	tsjk
屠	tuuo
麽	mogs
乾	gjug
乾	gjau
乾	qmug
乾	qmau
莹	ykcw
涂	tudh
奸	jmnu
梯	timp
邀	yczb
誉	yuxy
诡	gvyv
慎	ufxb
夕	xipd
婉	wjnv
吩	ffkd
镖	bnjx
摔	ukfu
魄	pobg
卧	wokd
酷	kuyk
丛	csar
巡	xyzv
祭	jipx
崖	yaet
誓	uiyf
描	mnft
奏	zzfd
肖	xnxo
碍	aiuc
曰	ytka
霄	xnyo
糟	zcmo
麟	lbla
枚	mwwm
肌	jioj
欠	qmdr
欠	qmfn
欠	qtdr
欠	qtfn
稀	xihj
阔	komk
液	yedn
笨	bfva
勃	boul
勃	bwul
毅	yily
矿	klug
湿	uida
桃	tcmd
疲	pibp
荷	heck
汽	qidq
姜	jlyn
摄	npfy
摄	uefy
哎	aikx
植	vimq
艰	jmyn
脖	booz
催	cvrf
虹	hsig
巫	wugr
屏	pkuc
咽	yekd
咽	yjkd
驰	iimv
蓉	rsck
凑	czdd
愕	eexg
肥	fwov
绩	jisb
坛	tjts
凄	qidn
搬	bjfy
扔	rgfp
瑟	sewd
杖	vhmn
芙	fucn
畏	wwtn
频	pbva
润	rydw
酸	sryw
割	gedb
绵	mmsj
披	pifp
滋	zids
秒	mnhp
戈	gead
贪	tjbr
捷	jpfr
瞒	mjod
播	boft
逆	nizq
咳	kekr
申	ufaa
卑	bwpu
搂	lzfn
寇	kzby
魅	mwgn
惠	hvxa
宛	wjbv
宛	yrbv
喉	hzku
幼	yzvl
卿	qkpe
龄	lkis
赐	cibp
驶	uimn
瓜	gxpn
氛	ffqd
腕	wjov
污	wudg
谅	llyx
筹	izvc
宠	isbl
碗	wjuv
妃	fwnv
筋	jbvl
甩	ukpv
驱	qumx
寨	vdbm
蕾	lwct
兼	jmqn
婷	tknd
捏	npft
妥	tovn
拓	tafk
拓	tofk
斥	iipd
吵	ickp
订	dkyd
纠	jqsa
璃	liws
届	jpua
饿	eeud
夸	kxdg
倩	qmro
薛	xtcu
窜	crba
崔	cvef
尉	wwuc
尉	yuuc
恒	hgxa
後	hzrw
宴	yjbn
晌	uhok
艘	szvy
辣	laln
哇	wakt
柜	gvma
柜	juma
斤	jbpa
储	iuro
挨	aifu
豹	bcvv
雁	yjif
吾	wuwk
挖	wafg
饱	bcuv
彭	bhup
彭	pgup
役	yiry
琼	qswx
遮	vezg
舟	vzpd
佣	ysra
狮	uiqj
寿	uzfc
陶	tcef
患	hrxa
砸	zauj
颊	jxaa
励	liil
愚	yuxa
腐	fugr
牲	ugnf
哑	yaka
恍	hlxg
裤	kupi
俏	qnro
鼠	uupv
岚	ljef
狄	diqh
妄	whwn
丘	qqpa
抑	yife
呈	igkw
蓦	mocm
尹	ybvp
坡	potp
契	qidf
契	xpdf
嫌	xmnn
津	jbda
售	uzkr
棒	bhma
郡	jyev
撕	sifj
骤	vzmn
疆	jlga
颈	ggva
颈	jkva
贾	gubx
贾	jxbx
咕	gukk
歇	xpoq
漏	lzdd
脾	piou
窝	wobd
嫣	yjnh
盼	pjod
耻	iiev
蜜	mibi
姨	yinn
厨	iuic
珊	ujwa
链	lmjz
裹	gowy
汪	whdw
靖	qklo
殷	ybpy
殷	yjpy
拟	nifr
淫	ybdu
呜	wuka
韵	yyla
柯	kemk
巾	jbaa
庙	mnga
纱	uasp
娶	qune
矩	juua
棍	gymv
晋	jbao
伐	farg
绳	ugsv
涨	vhdn
添	tmdx
陛	biet
嘲	icko
嘲	vcko
捧	pgfa
宅	vdbq
鼎	dkov
谨	jbya
乏	fapn
黛	ddhr
仓	chrv
岗	ghex
掏	tcff
削	xndx
削	xtdx
诧	iayq
灌	grdf
旨	vipo
刷	uxdu
页	yeba
泡	pcdv
辩	bmyu
俞	yurd
婴	yknb
盒	hemr
嚷	rhky
沾	vjdk
漆	qidd
蠢	iyfi
甫	fuad
膝	xiod
墓	muct
逢	fgzw
嫩	nfnw
坠	vvte
雀	qtxf
枯	kumk
偿	ihrs
陌	moeb
屑	xpuo
畅	ihap
陡	dzer
挽	wjfv
鹤	hend
涵	hjdk
署	uuso
沃	wodd
叉	iayd
搏	bofc
逝	uizf
趟	thzk
鞋	xpgt
赴	fuzd
谦	qmyn
砰	pguu
骄	jnma
遂	svzq
泣	qidl
档	dhme
摊	tjff
慨	kdxv
籍	jivo
擒	qbfs
苗	mnct
浴	yudk
鉴	jmja
尴	gjjm
迁	qmzp
疏	uuvv
尬	gaja
赚	vrbn
赚	zjbn
逗	dzza
豆	dzaq
孝	xntz
芬	ffcd
湘	xldo
诀	jtyn
晰	xioj
廉	lmgn
馨	xbuo
辽	lnzv
械	xpmc
吊	dnkj
炉	luhh
串	iraa
裸	lopn
哲	vekf
凛	lbdx
渴	kedv
柏	bdmb
柏	bomb
芸	yics
芸	yicg
芸	yycs
芸	yycg
拱	gsfb
妨	fhnf
揉	rzfm
樱	ykmn
寄	jibk
宙	vzba
宰	zdbu
媒	mwnm
眯	miom
贡	gsbg
崩	bgeo
绑	bhse
斧	fufj
惶	hlxw
嘶	sikj
沟	gzds
禅	ijpa
禅	ujpa
骚	scmi
荆	jkdc
歪	wdav
涯	yadt
耍	uxan
遵	zyzq
伪	wwrd
冤	yrbd
悍	hjxu
耿	ggeh
翅	iiuy
循	xyro
聂	npey
猴	hzqu
拂	fufa
裙	qypk
蓬	pgcz
芝	vicn
昭	vcok
倏	uurq
舱	chvv
肆	siaa
帽	mcjo
岭	lkes
叮	dkkd
拐	gkfl
儒	rura
嫂	scny
瞥	ppox
廊	lhge
赔	pwbk
辨	bmdu
鄙	biek
哩	lika
逊	xyzz
愉	yuxd
摘	vdfk
淋	lbdm
牺	xinx
俯	furc
谭	tjyu
蒋	jlcc
劣	lpxl
玫	mwww
吁	xuku
吁	yuku
肠	ihop
押	yafa
昔	xico
攀	pjmu
乳	ruvv
鹿	lugv
潘	pjdt
娅	yana
藤	tgcd
躬	gsug
蔡	cdcx
粒	liml
涩	sedv
揭	jpfv
揭	qifv
嗓	shkm
啪	pakb
翎	lkry
撼	hjfx
竖	uula
遣	qmza
囊	nhay
眠	mmoq
掀	xmfq
旺	whow
弘	hsgs
戚	qigx
烁	uohd
逍	xnzx
坤	kyta
憾	hjxx
仑	lyrv
租	zuhq
咯	gekk
咯	kakk
咯	lokk
卜	boad
卜	buad
凰	hljw
哄	hskb
匪	fwka
膛	thot
淑	uudy
忖	cyxc
堵	duto
夷	yian
柴	idmv
撇	ppfw
歹	ddad
辜	guuu
沐	mudm
绽	vjsr
辅	fuid
萍	pkcu
敖	aowf
拆	idfd
磊	lwuu
罕	hjbu
冻	dsdd
赋	fubd
趋	quze
瞳	tsoa
杆	gjmu
灿	cjhe
葬	zhcc
篮	ljvm
胞	bcov
颠	dmua
黯	anho
峡	xxen
顽	wjea
朕	vfod
兆	vcpd
擅	ujfa
陀	toev
龟	gvdv
龟	jydv
龟	qqdv
蜂	fgif
贞	vfba
阎	yjma
咦	yikn
惟	wwxf
竭	jplv
厢	xlio
惩	igxr
谎	hlyv
腔	qlog
裴	pwya
玻	bowp
璇	xrwr
溪	xidd
铭	mkjk
邻	lber
朴	pnmd
朴	pomd
朴	pumd
衷	vswy
帘	lmbj
拢	lsfl
魁	kvgu
哗	hxku
侄	virt
茵	ybcd
盆	pfmb
阅	ytme
弦	xmgs
兮	xibg
翁	wgby
贱	jmbg
债	vdrb
斌	bbwd
坑	kgtj
逻	lozs
踩	cdzm
瞎	xxok
躁	zczm
讽	fgyf
钉	dkjd
蓄	xuct
丸	wjgd
丐	gdag
矣	yisu
册	cepa
兔	tudd
溃	kvdb
隙	xiex
叠	dpyq
瞄	mnot
倚	yirk
轿	jnia
舅	jqpl
钦	qbjq
祈	qipj
烛	vuhi
怡	yixk
兹	ciqs
兹	ziqs
肢	vioy
综	zssx
禀	bkwx
於	wufd
於	yufd
壶	huua
雯	wfyw
栏	ljms
览	ljja
斑	bjww
蹲	dyzc
纽	nqsa
践	jmzg
棠	thxm
汹	xsdk
胎	tdok
妾	qpln
篷	pgvz
腥	xkoa
厮	siij
锅	gojd
楞	lgmf
澳	aodd
窃	qpbd
霆	tkyz
桂	gvmt
艇	tkvz
轨	gvij
哨	ucko
寡	gxbd
挪	nofe
翰	hjuy
尧	ycae
咧	lpkd
怯	qpxs
瑰	gvwg
沧	chdv
寞	mobd
叙	xury
彷	fhrf
彷	phrf
佐	zorg
呐	nakd
呐	nekd
卒	cuwu
卒	zuwu
栽	zdmg
焕	hrhn
塌	taty
绣	xqsp
骆	lomk
敛	lmwr
携	xpfp
蹄	tizj
颖	ykpa
棵	kemn
廖	lngp
呻	ufka
痒	yhby
驳	bomx
裳	ihxy
裳	uhxy
睹	duoo
泼	podd
溢	yidm
狡	jnqf
倘	thrk
胳	gaok
胳	geok
羡	xmyr
婢	binu
枕	vfmv
妒	dunu
绮	qisk
噬	uikr
呃	eekv
喔	ookt
喔	wokt
狸	liqa
缕	lvsn
译	yiya
泊	bodb
芷	vicv
咪	mikm
刮	gxdp
咖	gakk
咖	kakk
恕	uuxn
煌	hlhw
嘱	vukd
蚩	iiei
栋	dsmd
锤	ivja
逛	glzq
暇	xxoy
栈	vjmg
溅	jmdg
巷	hhcv
巷	xlcv
填	tmtb
膊	booc
诈	vaya
昧	mwon
乞	qirg
叱	iikq
姚	ycnd
渔	yuda
摧	cvff
遁	dyzp
焚	ffhm
糕	gcmh
衬	ifpc
倦	jrrv
辕	yriy
啡	fwka
啥	uakk
乙	yigg
彦	yjlp
郝	hcet
履	lvuw
匕	biav
潇	xnda
茜	qmcx
茜	xicx
嘟	duke
汝	rudn
耽	djev
旭	xujo
浸	jbdy
畜	iuwt
畜	xuwt
硕	uoua
蕴	yycm
侦	vfrb
佑	yzrk
灼	vohd
嗤	iiki
峻	jyew
菊	jucm
彤	tspp
焉	yjah
敦	dyww
哟	yokd
筒	tsvk
棉	mmmj
霉	mwyd
衰	ukwy
烤	kchg
麒	qilb
钩	gzjs
犬	qrdd
庸	ysga
滩	tjdf
姥	lcnv
桶	tsma
榜	bhmf
茅	mccp
狭	xxqn
剥	bcde
剥	bode
症	vgbv
诞	djyv
乍	vara
翩	pmhy
辑	jiie
棺	grmk
潭	tjdu
歆	xblq
滞	vidj
抄	icfp
谱	puyo
枉	whmw
趴	pazb
狞	nkqd
隶	livn
嗔	ifkb
毙	biav
谊	yiyq
淮	hkdf
笛	diva
缚	fusc
剪	jmqd
囚	qqkr
蔽	bicw
辟	biuu
辟	piuu
碌	luud
塑	sutq
刊	kjda
澜	ljdd
捂	wufk
秃	tuhj
掷	vife
桐	tsmk
霎	uayn
搁	gefk
帆	fjjd
矢	uird
腻	niod
函	hjvk
址	vitv
弩	nugn
邱	qqep
孽	npcz
藉	jico
藉	jiro
藉	jpco
藉	jpro
胀	vhon
兀	wuae
嚣	xnkk
雍	yswf
巍	wweg
匠	jlkj
冉	rjaa
窥	kvbj
蛛	vuin
狈	bwqb
瑜	yuwd
妍	yjnc
衍	yjrd
邵	uced
朽	xqmg
噗	pukn
苟	gzck
鲍	bcav
胃	wwto
壳	keuj
壳	qnuj
暮	muco
萝	locd
恳	kfxv
渠	qumd
挟	jxfn
挟	xpfn
琉	lqwv
熙	xihk
噢	ookd
雇	guhf
碑	bwuu
驼	tomv
俺	anrv
绘	hvss
喀	kakk
捡	jmfa
斐	fwwa
阮	rree
嘎	gakg
吱	viky
炽	iihb
钥	ycjo
钥	ytjo
妆	vldn
杏	xkmk
桓	hrma
昊	hcod
擎	qkuc
贷	ddbr
磁	cius
宪	xmbe
沸	fwda
衙	yard
匙	iiov
匙	uiov
鞘	qngo
鞘	ucgo
剂	jidw
搅	jnfj
猿	yrqy
赠	zgbo
徽	hvrw
裕	yupk
祷	dcpc
株	vumn
蜀	uusi
桩	vlmt
账	vhbn
巢	icvn
堕	dote
堕	hvte
梭	somw
兜	dzep
敞	ihwx
肿	vsoa
骷	kugk
髅	lzgn
娟	jrno
茂	mccp
窄	vdba
菱	lkcw
吨	dykv
絮	xusn
坎	kjtq
琦	qiwk
芦	luch
渗	ufdp
拘	jufk
梵	fjmd
脊	jido
澡	zcdm
窟	kubk
姻	ybnd
捐	jrfo
盏	vjmg
孕	yygz
滔	tcda
挫	coft
伺	cirk
伺	sirk
贩	fjby
扁	bmhc
扁	pmhc
墅	uuta
寝	qbby
侮	wurd
垃	latl
郊	jnew
眶	klow
莽	mhcc
俘	furz
蝉	ijia
卦	gxtd
喧	xrka
圾	jitn
诛	vuyn
澄	dgdd
澄	igdd
妞	nqna
彪	bnhp
淳	iydz
淳	vydz
唔	mkk
唔	wukk
揽	ljfj
厦	uaiw
厦	xxiw
嗡	wgky
勋	xykl
歧	qivy
鸦	yana
聘	pbeg
珑	lswl
哮	xnkz
嗦	soks
虞	yuhd
惭	cjxj
熬	aohf
迭	dpzp
盐	yjmt
啧	zekb
捣	dcfe
梳	uumv
浆	jldd
烫	thhd
虐	ntha
钧	jyjd
掘	jtfk
忿	ffxb
畔	pjta
樊	fjdm
倪	nire
亩	muwt
咙	lskl
邮	yzea
襄	xlwy
禽	qbrd
鳞	lbaa
勿	wugp
炀	yhhp
嫉	jinu
杭	hhmj
嚎	hckn
衔	xmrd
菁	jkco
眩	xros
栗	lixm
蹦	bgzo
喻	yukd
盲	mhwo
虏	luhl
茹	ruck
觑	quhj
佘	uerx
蔓	mjcy
蔓	wjcy
陋	lzev
苹	pgcu
苹	pkcu
娱	yund
堤	ditr
彬	bbmp
绷	bgso
铸	vujc
酬	izya
绞	jnsf
渺	mndp
淘	tcdf
卸	xper
蛟	jnif
朦	mgon
帖	tpjk
菩	puck
坊	fhtf
旷	klog
襟	jbpx
汁	vidu
僻	piru
翘	qnay
盔	kvmu
嘘	uika
嘘	xuka
峨	eeed
疚	jqbn
慑	uexy
粹	cvmu
醋	cuyo
饥	jiuj
秩	vihn
沫	modn
肺	fwoj
咆	pckv
砖	vrud
嘀	dikk
弧	hugg
锡	xijp
顷	qkaa
迦	jxzl
拚	pbfc
胧	lsol
妓	jiny
捞	lcfl
蹈	dcza
坟	fftw
幢	ilja
幢	vlja
湛	vjdv
亨	hgwa
媳	xinx
荐	jmcz
奕	yiwd
吏	lian
磕	keum
皓	hcbk
婿	xuno
跋	bazd
钰	yujw
罡	ghsv
扳	bjfy
屡	lvun
犀	xiun
稿	gchk
蚁	yiid
咚	dskd
耕	ggla
锻	drjy
奢	uedo
诊	vfyp
祺	qipb
泳	ysdn
拭	uifd
蚀	uiui
垒	lwts
冈	ghkx
窍	qnbg
龚	gslb
戟	jiug
萱	xrca
绰	icsu
绰	iosu
脂	vioo
宵	xnbo
钓	dnjd
蔑	mpcd
嵌	qmeq
戮	luyg
叩	kzek
迸	bgzq
淹	yjdv
丞	igva
喇	lakd
哧	iikd
叨	dckd
叨	tckd
瓷	ciwd
炯	jshk
蝎	xpiv
揪	jqfh
沛	pwdj
斋	vdwa
侣	lvrk
挠	ncfe
蝠	fuit
逞	igzk
疫	yiby
眷	jrbo
姗	ujna
懈	xpxn
瘫	tjbf
饼	bkuc
嗅	xqkq
豁	hobk
棚	pgmo
煤	mwhm
框	klmw
绸	izsk
殖	vidq
券	qrbd
券	xrbd
蒸	vgch
熄	xihx
疤	babv
蒲	pucd
稚	vihf
莺	ykcn
冀	jiab
稻	dcha
葡	pucd
侃	kjrv
捆	kyfm
澈	iedw
毯	tjmh
傍	bhrf
旬	xygo
呕	oukx
梧	wumk
寓	yubd
粘	nmmk
粘	vjmk
滨	bbdb
薪	xbcj
阱	jkea
撩	lnfx
舔	tmpx
辖	xxik
舜	uyva
梨	limh
猾	hxqg
抿	mbfq
禹	yupd
啼	tikj
炭	tjeh
砚	yjuj
玑	jiwj
掐	qxfa
夭	ycpd
榻	tamy
哉	zdkg
逮	ddzv
旱	hjou
驴	lvmh
甄	vfxw
煮	vuht
憋	bpxx
缴	jnsw
缴	vosw
蕊	rvcx
稽	jiho
绯	fwsa
喽	lzkn
涡	godr
涡	wodr
滥	ljdm
搓	cofg
颓	tvha
瞅	izoh
铮	vgja
纲	ghsx
揍	zzfd
鹅	eenp
氓	mgwq
氓	mhwq
瑾	jbwa
肝	gjou
踉	llzn
讪	ujye
箫	xnva
腊	laoo
腊	xioo
霓	niye
惫	bwxw
淌	ihdk
淌	thdk
霹	piyu
垫	dmtf
跄	qlzv
茨	cicr
刁	dnga
禄	lupd
膜	mood
诅	zuyq
擂	lwft
轴	vzia
厥	jtiq
讥	jiyj
厄	eeiv
胶	jnof
扛	ghfg
扛	khfg
惕	tixp
瞟	pnox
凸	tuaa
肘	vzoc
媛	yrny
拧	nkfd
浙	vedj
奎	kvdt
熏	xyhp
沁	qbdx
骏	jymw
笙	ugvf
岔	iabe
沮	judq
颅	luaa
酥	suyh
冶	yedk
嗽	szkq
舵	dovv
燥	zchm
拙	vofk
蛊	gumi
瓣	bjgu
吭	hhkj
吭	kgkj
绫	lksw
蝴	huio
罐	grff
糖	thmk
蹙	cugz
琢	vown
漾	yhdn
绅	ufsa
怠	ddxs
嗷	aokw
沦	lydv
鸭	yana
涅	npdt
驭	yumy
咏	yskn
窒	vibt
槐	hkmg
凳	dgvj
臀	tyou
伞	sjru
懊	aoxd
雳	liyl
逾	yuzr
唬	hukh
葫	huco
闺	gvmt
咸	xmgk
镶	xljy
萄	tccf
梢	ucmo
嗜	uiko
戳	ioyg
铲	ijji
缪	mnsp
缪	mqsp
缪	mzsp
猩	xkqf
跺	dozm
蟒	mgic
蟒	mhic
詹	vjdy
晒	udox
浦	pudd
邹	zzed
黝	yzhl
筷	kkvn
狰	vgqa
霖	lbym
炫	xrhs
凹	aoaa
凹	waaa
伶	lkrs
揣	ikfa
揣	trfa
揣	vvfa
窘	jsbk
悸	jixz
垮	kxtg
噜	luko
颔	hjra
嚼	jnkc
嚼	jtkc
尿	nnud
沼	vcdk
塘	thtk
肋	leol
肋	lwol
簇	cuvu
哆	dokd
兢	jkue
琐	sowb
颁	bjba
泻	xpda
鞠	jugm
匿	nikk
膨	pgop
酿	nlyn
颂	ssba
瘾	ybbx
栖	qimx
栖	ximx
蔚	wwcc
楠	njmu
帜	vijb
剔	tido
靴	xtgv
萌	mgco
棘	jian
娥	eend
沌	dydv
谜	miyz
觅	mivj
砂	uaup
脯	fuod
脯	puod
讳	hvya
螺	lois
晖	hvoi
韧	rfad
瞻	vjoy
蜡	laio
瀑	pudd
璧	biwu
蚕	cjai
聋	lsle
漓	lids
踱	dozy
谣	ycyf
敷	fuwa
偎	wwrn
绢	jrso
噩	eewk
搔	scfi
晏	yjon
匣	xxka
倔	jtrk
蹬	dgzd
苑	yrcv
婶	sfna
歼	jmdu
缉	jise
彰	vhlp
拇	mufd
寥	lnbp
昼	vzua
弊	bicx
坪	pktu
敝	biwx
裘	qqay
呸	pwka
憎	zgxo
镔	bbjb
悯	mbxw
舆	yupb
诵	ssya
拎	lbfs
唾	toka
瑛	ykwn
枢	uumx
叭	bakb
挚	viuf
揖	yife
兑	dvbe
蜘	viik
秉	bkpn
荫	ybco
衅	xbxa
壤	rhty
匀	yyga
驯	xyma
浊	vodi
惚	huxx
牟	musn
牟	mzsn
呛	qlkv
祁	qiep
娴	xmnm
蜥	xiij
炒	ichp
婕	jpnr
甸	dmgt
惮	daxa
惮	djxa
碟	dpum
谐	xpyb
叟	szpy
猝	cuqu
侥	jnre
侥	ycre
斟	vfqu
啤	piku
髓	svgz
寰	hrby
峙	uiec
峙	viec
赦	uewt
噪	zckm
枭	xnnm
浇	jnde
腮	sdox
遏	eezo
哽	ggkn
芽	yacp
婪	ljnm
倭	worn
卵	lrpd
暧	aioy
阙	qtmq
诏	vcyk
炙	viph
祟	svex
拣	jmfd
邸	diep
骸	hdgr
谬	mqyp
磋	coug
涕	tidp
瀚	hjdy
邢	xkea
捶	ivfa
袱	fupq
洽	qxdk
峭	qneo
巩	gsgd
檀	tjma
赎	uubd
祀	sipv
滕	tgod
柬	jman
嵩	ssek
嬉	xink
僚	lnrx
睬	cdom
葱	cscx
嬷	mons
缸	ghfg
杉	uamp
杉	ujmp
虔	qmhw
娲	wanr
拽	vkfp
廓	koge
玮	wwwa
蔷	qlck
恃	uixc
竿	gjvu
恙	yhxy
绒	rssu
瑚	huwo
漪	yidk
鹃	jrnk
睫	jpor
鸽	genr
陕	ujen
钞	icjp
蝙	bmic
搀	ijfd
袅	nnny
蝇	ykiv
佬	lcrv
蚂	maim
蚊	wfiw
翡	fwya
朔	uoqo
踹	ikza
嗖	szky
芊	qmcu
崎	qiek
啃	kfko
璋	vhwu
慷	khxn
咋	vaka
咋	zaka
咋	zeka
檐	yjmy
鞍	angn
剿	icdv
剿	jndv
腑	fuoc
悚	ssxn
缎	drsy
匈	xsgk
厕	ceid
厕	siid
鹫	jqnw
涟	lmdz
虾	xxid
漩	xrdr
聆	lkes
栅	cema
栅	ujma
栅	vama
搐	iuft
鸾	lrwn
蓓	bwck
扒	bafb
扒	pafb
穹	qsbg
瑕	xxwy
珀	powb
锥	vvjf
矫	jnua
庐	lugh
暑	uuoo
溶	rsdk
靡	miga
晦	hvod
喳	iaka
喳	vaka
咄	dokk
巅	dmea
墟	xuta
煎	jmhq
芯	xbcx
亢	khwj
掳	lufl
屯	tyav
屯	vyav
叽	jikj
曦	xiog
獠	lnqx
厘	liia
懦	noxa
渣	vada
桀	jpmp
恬	tmxk
缀	vvsy
褪	tvpz
褪	typz
嵋	mweo
筝	vgva
秽	hvhd
庇	bigv
绊	bjsa
褚	iupo
褚	vepo
褚	vupo
拯	vgfa
衲	napd
眺	tnod
悴	cvxu
驹	jumk
钝	dyjv
酋	qqqa
珂	kewk
祢	mipx
狙	juqq
汰	tddd
镯	voji
贿	hvbo
铠	kdjv
粥	vzmg
佟	tsrd
芮	rvcr
奄	yjdv
怅	ihxn
剖	pzdl
伽	gark
伽	jxrk
伽	qprk
忡	isxa
萎	wwcn
凿	zcau
鬟	hray
奠	dmqd
熠	yihb
憔	qnxh
钮	nqja
妩	wunv
抡	lyfv
崆	kseg
弛	iigv
褐	hepv
勘	kjql
妲	dana
唰	uxkd
惺	xkxa
膏	gcwo
筠	jyva
贬	bmbn
绚	xrso
嗨	hdkd
怦	pgxu
晤	wuok
俐	lird
窦	dzbd
驿	yima
棱	lgmw
棱	lkmw
竺	vuve
烙	lchk
烙	lohk
睿	rvao
锣	lojd
溺	nidd
溺	nndd
恺	kdxv
缔	disj
牡	munt
鬓	bbab
藩	fjct
谕	yuyd
庵	angv
憨	hjxv
瘟	wfbm
钗	idjd
昕	xboj
徊	hkrk
偌	rork
髯	rjaa
缰	jlsa
庶	uugh
札	vamv
缭	lnsx
徘	pdra
曙	uuoo
阀	famg
殆	dddk
巳	sivv
纬	wwsa
缄	jmsk
澎	pgdp
掣	ieup
惘	whxv
槽	ccmo
诣	yiyo
曳	yeap
娄	lzmn
胤	ybpv
惋	wjxv
虬	qqiv
倡	ihro
芭	bacv
琛	ifwm
肴	ycxo
蹭	cgzo
庚	gggn
飙	bnqf
仕	uiru
貂	dnvk
嚓	iakx
蜴	yiip
募	mucl
昱	yuol
圳	vfta
氧	yhqy
悻	xkxu
佯	yhry
锵	qljc
隋	doeo
隋	sveo
笃	duvm
筱	xnvw
忑	texa
捅	tsfa
捺	nafx
茉	mocn
萤	ykci
佗	torv
睨	nioe
邃	svzb
谴	qmyz
霏	fwya
屎	uium
乒	pkpp
谍	dpym
缅	mmsa
忐	tjxa
暄	xroa
簌	suvq
鲸	jkax
涎	xmdv
瞩	vuod
攒	crfb
攒	zjfb
蟹	xpij
茄	jxck
茄	qpck
漱	uudq
饲	siuk
嗣	sikk
诫	jpyd
阐	ijma
瑭	thwk
熔	rshk
冽	lpdd
棕	zsmx
酱	jlyd
辫	bmsu
辙	veiw
闵	mbmw
殴	ouky
蛙	wait
滢	ykdw
晁	icod
删	ujdp
裔	yiyk
膳	ujok
殃	yhdn
蔼	aicv
茱	vucn
苛	keck
跷	qnze
痊	qrbw
樵	qnmh
烘	hshb
癫	dmba
懿	yiux
扼	eefv
吆	ycks
鸠	jqnj
茧	jmci
孜	ziwz
侨	qnra
幡	fjjt
咎	jqwk
蔬	uucv
酣	hjyc
亵	xpwy
哝	nskn
隧	svez
禾	hepm
纺	fhsf
黏	nmhk
湃	pddf
绛	jlsa
崛	jtek
嘈	ccko
眈	djov
皙	xibm
礁	jnuh
琅	lhwn
睦	muot
薰	xych
璐	luwk
蹿	crza
邑	yikv
躇	iuzo
菌	jych
枣	zcad
踌	izzc
迢	tnzd
赃	zhbt
臻	vfah
苇	wwca
篝	gzva
袜	wapn
崭	vjej
屿	yuea
娆	rcne
靳	jbgj
咨	zikd
煜	yuhl
聿	yuva
陨	yyeb
鸳	yrnp
榴	lqmt
帷	wwjf
钵	boja
毋	wuvp
橙	igmd
雌	civf
丙	bkan
琥	huwh
匡	klkw
狩	uzqc
芜	wucv
羿	yiyc
璀	cvwf
鲨	uaad
冕	mmov
讷	neyd
蠕	ruia
砌	qiud
戾	lihq
掺	ijfp
掺	ujfp
掺	xmfp
拈	nmfk
酌	voyd
殇	uhdp
忒	teqd
忒	tvqd
铅	qmjk
戎	rsgu
蹑	npzy
唠	lckl
苔	tdck
栩	xumy
烨	yehu
吝	lbwk
啜	ikky
啜	ioky
涣	hrdn
甬	yssa
莞	grce
莞	wjce
恻	cexd
雏	iudf
窖	jnbk
傀	gvrg
傀	kvrg
蜷	qriv
岱	dder
疙	gebg
飒	salf
衮	gywy
谑	xtya
乓	phpd
棣	ddmn
棣	dimn
棣	timn
磅	bhuf
磅	phuf
焱	yjhh
猖	ihqo
簿	buvc
譬	piyu
羁	jism
戬	jmag
拗	aofl
拗	nqfl
煦	xuho
烬	jbhd
伫	vura
葵	kvcd
镰	lmjn
瘩	dabk
笠	livl
趾	vizv
攸	yzrw
剌	lada
唧	jike
睽	kvod
坝	batb
紊	wfws
渍	zidb
迳	jkzv
靶	bagv
糙	ccmz
宦	hrba
吮	uyke
勺	ucgd
祯	vfpb
邯	hjec
鄂	eeek
窑	ycbf
圭	gvtt
侈	iird
粪	ffmb
杠	ghmg
鸯	yhan
炬	juha
浏	lqdd
橡	xlmn
孰	uuwd
琶	pawv
俨	yjri
泓	hsds
涧	jmdo
呗	bdkb
呗	bwkb
麾	hvgm
昵	niov
屹	yieg
恤	xuxx
寐	mwbn
婧	jkno
闸	vama
韶	uclk
菇	guck
靓	jkfj
靓	llfj
椒	jnmy
荀	xyco
癸	gvvd
饕	tcuk
啐	cvku
啐	qiku
疮	ilbv
岑	cfev
辎	ziit
攘	rhfy
琵	piwv
稷	jihw
肮	ahoj
矜	grsv
矜	jbsv
矜	qbsv
楣	mwmo
渎	dudd
荧	ykch
噎	yekd
呱	gxkn
崽	zdxe
饵	erue
拷	kcfg
锭	dkjr
缥	pnsx
瘪	bpbv
瞠	igot
沪	hudh
沪	hudx
沪	lvdh
沪	lvdx
奚	xivd
籁	ldvb
湮	yjdt
萦	ykcs
劭	ucdl
铛	dhje
铛	igje
茗	mkck
弑	uixd
痹	biba
飕	szfy
铿	kgjt
璨	cjwm
赘	vvbf
缨	yksn
畴	iztc
儡	lwrt
冢	vsbn
辐	fuit
蜈	wuid
珞	lowk
鞑	dagz
咻	xqkm
笈	jivn
扈	huhv
壑	heta
骰	tzgy
撰	vrfb
鲲	kyav
噤	jbkx
煽	ujhy
玺	xidw
炳	bkhn
捻	nmfx
诶	eiyu
嗒	dakk
嗒	takk
锯	jujk
浣	hrde
窿	lsbf
坞	wuta
鑫	xbjj
磷	lbua
蜒	yjiv
噔	dgkd
绎	yisa
咔	kakd
扉	fwha
阖	hemm
穗	svhx
叁	sjss
茸	rsce
踞	juzk
皂	zcbq
璞	puwn
垢	gztk
枷	jxmk
珏	jtww
骋	igmg
矗	iuua
缇	tisr
蹊	qizd
蹊	xizd
粟	suxm
呦	yzkl
驸	fumc
唆	sokw
馒	mjuy
寅	ybbb
撮	cofy
撮	zofy
羹	ggyd
楮	iumo
峦	lrwe
灶	zcht
餮	tpud
靥	yeia
嬴	ykwd
遐	xxzv
胭	yjod
顼	xuwa
榕	rsmk
胯	kxog
迂	yuza
惦	dmxk
伎	jiry
诬	wuyr
癌	aibe
桨	jlmd
黠	xxhk
逵	kvzt
韬	tcaa
嫡	dink
悼	dcxu
喏	nokk
喏	rekk
帛	bobj
俭	jmra
啄	vokn
咣	glke
铐	kcjg
咫	viub
钳	qmjc
骼	gegk
舷	xmvs
祠	cipk
箍	guvj
橱	iumc
鳄	eeag
袂	mwpn
溟	mkdb
锈	xqjp
篱	livs
缈	mnsp
淤	yudd
铎	doja
囔	nhky
蚣	gsis
痞	pibk
吒	vakq
迄	qizr
稼	jxhn
汀	tkdd
槛	jmmm
槛	kjmm
漉	ludl
椎	ivmf
椎	vvmf
辗	nmin
辗	vjin
辗	zjin
滤	lvdx
洼	wadt
醇	iyyz
瘤	lqbt
桅	wwmv
喵	mnkt
亥	hdwr
渝	yudd
惬	qpxn
淼	mndd
咛	nkkd
蛾	eeid
筛	udvj
髻	jiak
幌	hljg
笺	jmvg
憧	isxa
梗	ggmn
颍	ykpa
瓢	pnxg
馀	yuuh
殉	xydo
翟	diyf
翟	vdyf
翟	zdyf
盎	ahma
濒	bbda
簧	hlvb
馈	kvub
孺	ruza
伢	yarp
闽	mbmi
楷	jpmb
楷	kdmb
亘	gfaa
惴	vvxa
瓒	zjwb
笋	syvp
咀	jukq
幺	ycvs
蒜	srcx
掂	dmfk
杵	iumu
瞑	mkob
兖	yjwe
峒	dsek
峒	tsek
颐	yika
曜	ycof
螂	lhie
毗	pitv
飓	jufb
缆	ljsj
芥	jpca
缤	bbsb
蜿	wjiv
翊	yily
卉	hvuc
屉	tiuv
翱	aoby
拴	urfw
湄	mwdo
稠	izhk
桦	hxmu
鹊	qtnc
咂	zakj
燎	lnhx
谏	jmyn
贮	vuba
猥	wwqn
峥	vgea
溯	sudo
佼	jnrf
喋	dpkm
喋	vakm
诩	xuyy
渥	wodt
曝	bcod
剃	tidb
邺	yeea
羔	gchy
匾	bmkc
汲	jidn
邬	wuep
赂	lubk
炜	wwha
锢	gujk
吠	fwkq
锄	iujl
蛤	geik
蛤	haik
藻	zccm
烹	pghw
蹋	tazy
垦	kftv
迥	jszk
岐	qiey
耷	dade
隘	aiem
淬	cvdu
嚅	ruka
慵	ysxa
烽	fghf
诲	hvyd
橘	jumk
翌	yiyl
濮	pudn
蟾	ijiy
垣	yrta
锺	vsja
抉	jtfn
茬	iact
啷	lhke
淇	qidb
硝	xnuo
沥	lidl
褥	rupc
踝	hkzn
矶	jiuj
骁	xnme
酝	yyys
梓	zimu
唷	yoko
玎	dkwd
憬	jkxx
霭	aiyv
蕉	jnch
眦	ziov
墩	dytw
毡	vjmk
蕃	boct
蕃	fjct
弼	biag
肇	vcha
阑	ljmd
垄	lstl
晟	igov
晟	ugov
呲	cikv
呲	zikv
毓	yurv
痪	hrbn
陇	lsel
鳌	aoaf
袒	tjpa
谛	diyj
忏	ijxu
拌	bjfa
拌	pjfa
臾	yupn
瀛	ykdd
簪	zjvo
懵	mgxo
纶	grsv
纶	lysv
跤	jnzf
胴	dsok
浚	jydw
唏	xikj
筏	favg
甥	ugnl
蝗	hliw
癞	ldbb
瓮	wgbw
驮	domd
驮	tomd
涤	didm
捍	hjfu
膺	ykgo
铳	isje
芹	qbcj
嘭	pgkp
骥	jimb
炕	khhj
匐	fugt
羌	qlyv
娓	wwnm
壕	hctn
宓	fubd
宓	mibd
隼	syur
泌	bidp
泌	midp
嗫	npky
桔	jpmk
桔	jumk
圃	pukd
抒	uufa
稣	suah
瓯	oukw
鲤	liaa
磐	pjuv
萃	cvcu
魃	bagd
侬	nsrn
讼	ssys
萼	eecg
皎	jnbf
簸	bovy
姒	sinr
叼	dnkp
茎	jkcg
瞿	juof
瞿	quof
剁	dodj
篆	vrvn
羲	xiyg
骡	loms
鹦	yknb
蕙	hvcx
隅	yued
瘸	qtbr
炊	ivhq
饷	xluk
辄	veiv
嘤	ykkn
颌	gera
颌	hera
腆	tmob
嫖	pnnx
惆	izxk
媲	pinv
馁	nwun
娉	pkng
褒	bcwy
旖	yifk
馋	ijud
噘	jtkq
呤	lkks
缜	vfsb
荃	qrcw
捋	lofc
捋	lvfc
胥	xuvo
潺	ijdz
卯	mcep
婵	ijna
撅	jtfq
涔	cfdv
舫	fhvf
柿	uimj
偕	xprb
汩	gudo
汩	yudo
榨	vama
苞	bccv
胄	vzao
坍	tjtw
麓	lulm
鸥	ounk
掬	jufm
礴	bouc
轧	gaiv
轧	vaiv
轧	yaiv
纣	vzsc
淀	dmdr
糜	mwgm
昙	tjos
壹	yiud
埔	butd
埔	putd
诃	heyk
魇	yjig
凋	dndk
蹂	rzzm
荼	tuch
镑	bhjf
鹉	wuna
臧	zhga
褂	gxpd
筐	klvw
纨	wjsd
筵	yjvv
轼	uiid
蘑	mocu
潞	ludk
榆	yumd
沣	fgdf
黔	qmhv
玟	mbww
玟	wfww
婊	bnny
旌	jkfa
痉	jkbg
魑	iigd
嫦	ihnj
卞	bmdd
瘴	vhbu
丕	piaa
贽	vibf
袄	aopd
砾	liud
挛	lrwu
麴	quum
麴	quaa
腋	yeod
隽	jrrp
隽	jyrp
躏	lbzf
撂	lnfk
偃	yjrn
馅	xmua
醺	xyyh
嗥	hcku
渭	wwdo
阉	yjmv
蟆	maid
盅	vsma
沓	dado
沓	tado
榭	xpmc
睐	ldon
婀	eenk
哒	dakz
啬	seuk
郢	ykek
噼	piku
琬	wjwv
栓	urmw
冗	rsbj
睚	yaot
硫	lquv
癖	pibu
霈	pwyj
甭	bgaa
侏	vurn
皑	aibv
拄	vufw
夙	sujd
渲	xrda
秤	ighu
攫	jtfy
岌	jien
遽	juzh
蛆	quiq
赧	njty
踵	vsza
汴	bmdd
鸨	bcnp
剐	gxdk
窈	ycbl
潼	tsda
靼	daga
睑	jmoa
霁	jiya
沅	yrde
卤	luax
掰	bdbu
攥	zrfs
鹭	lunz
藕	oucd
颚	eeka
蛰	veif
幔	mjjy
腼	mmoa
篡	crvs
恣	zixd
蟠	pjit
噌	cgko
嫔	pbnb
裆	dhpe
哺	bukd
跚	ujza
馥	fuhw
孚	fuzv
僖	xirk
窕	tnbd
盂	yuma
钊	vcdj
囤	dykv
囤	tykv
喟	kvko
跛	bozp
刨	bcdg
刨	pcdg
槌	ivmz
臊	scom
苜	muco
渤	bodl
螳	thit
肾	ufoa
荤	hyci
捎	ucfo
镭	lwjt
糗	qqmq
薯	uuco
徨	hlrw
蜕	tvie
瑙	ncwx
噫	yikx
鳖	bpax
妤	yuna
谪	veyk
贲	bfbu
贲	bibu
隗	kveg
隗	wweg
裟	uayd
擞	szfw
濑	lddb
绔	kusg
鳅	qqah
戍	uugd
摹	mocu
堑	qmti
绾	wjsk
捱	aift
捱	aifu
旎	nifv
谄	ijya
谒	yeyv
谧	miym
嚏	tikr
苋	xmcj
恸	tsxl
粤	ytpg
姣	jnnf
姣	xnnf
碳	tjuh
殒	yydb
哂	ufkx
龌	woit
啾	jqkh
蹒	pjzd
蝼	lzin
龊	ioiz
娼	ihno
揩	kdfb
沂	yidj
舶	bovb
泞	nkdd
啻	iilk
阜	fupu
弋	yiqd
恪	kexk
蜃	ufii
搪	thfk
辘	luil
挲	uaud
娑	sond
嗝	geka
饺	jnuf
桉	anmn
岖	quex
杳	ycmo
碾	nmun
妪	yunx
袈	jxyl
赈	vfbn
摒	bkfc
孵	fupz
菡	hjck
哐	klkw
羚	lkys
撬	qnfm
颉	jpua
颉	jxua
颉	xpua
晔	yeou
罔	whkv
倜	tirk
倌	grrk
藐	mnce
髦	mcma
猊	niqe
汐	xidd
颦	pbvu
臌	guoy
獒	aoqf
粼	lbmv
杞	qimv
蚌	bgif
蚌	bhif
郸	djeb
揄	yufd
竣	jylw
嗲	dxkd
瞌	keom
胚	pwoa
愠	yyxm
谙	anyo
恁	nfxr
龇	ziiv
啵	bokp
匍	pugd
脓	nson
撵	nmfi
痰	tjbh
蛹	ysia
觎	yurj
畿	jivt
殛	jida
泯	mbdq
讹	eeyv
潦	lndx
犁	linh
苓	lkcs
犷	glqg
俟	qiru
俟	siru
邝	kleg
弈	yiwc
呓	yikg
汛	xydu
螓	qbih
觊	jiej
玷	dmwk
瞰	kjow
槟	bbmb
槟	bkmb
椰	yeme
垠	ybtn
邕	ysvv
臆	yiox
钛	tdjd
挎	kxfg
粱	llmd
涸	hedk
糯	noma
霾	mdya
禧	xipk
俸	fgra
箕	jivb
坷	ketk
祗	vipd
熹	xihu
俑	ysra
怂	ssxr
噙	qbks
湍	trda
赣	gjlb
芋	yucu
咝	sika
潋	lmdw
噶	gakv
巽	xyvb
汕	ujde
仞	rfrd
釜	fufa
鬃	zsax
嗵	tskz
颀	qija
锚	mcjt
螭	iiid
洵	xydo
犸	maqm
珈	jxwk
魍	whgv
摁	enfx
疵	cibv
忤	wuxu
汾	ffdd
汜	sidv
琰	yjwh
褛	lvpn
惰	doxo
蚯	qqia
斓	ljwd
觐	jbcj
梆	bhme
漳	vhdu
镣	lnjx
贻	yibk
粲	cjma
恿	ysxs
谲	jtyk
咿	yikp
咤	vakq
篓	lzvn
飚	bnfh
篑	kvvb
憩	qixp
椭	tomo
睥	biou
睥	piou
沽	gudk
犄	jink
怏	yhxn
魉	llgd
鼾	hjpu
堰	yjtn
齑	jiwa
帚	vzej
亟	jiva
镀	dujy
骠	bnmx
骠	pnmx
苯	bfca
宸	ifbn
僮	tsra
僮	vlra
阗	tmmb
榄	ljmj
辇	nmia
豺	idvp
翦	jmqy
纰	bisv
纰	pisv
阂	hemr
旃	vjfw
荦	locn
蚓	ybia
趄	juzq
趄	qpzq
猬	wwqo
劾	hewl
趔	lpzd
蜻	qkio
嵘	rsem
铝	lvjk
滇	dmdb
呷	xxka
暹	xmzo
蠡	livi
淄	zidt
囵	lykv
掸	djfa
掸	ujfa
溉	gddv
坳	aotl
轲	keik
皋	gcbu
骜	aomf
螃	phif
帧	vfjb
蘅	hgcd
剽	pndx
坂	bjty
涓	jrdo
魈	xngo
怆	ilxv
袤	mcwy
嗳	aiky
踊	ysza
锏	jmjo
濡	ruda
昀	yyod
鹞	ycnv
氲	yyqm
厩	jqiv
徙	xirr
瑁	mcwo
箩	lovd
斡	wouu
抠	kzfx
褶	vepb
痣	vibx
晾	llox
廿	nmaa
揶	yefe
炖	dyhv
氤	ybqd
蹩	bpzx
芍	uccd
愫	suxs
玳	ddwd
嗬	hekk
臼	jqpa
淅	xidj
嘣	bgko
桧	gvms
桧	hvms
腺	xmod
壬	rfpu
瘁	cvbu
堇	jbca
侗	dsrk
侗	tsrk
赁	lbbr
匝	zakj
孱	ijuz
灸	jqph
褴	ljpm
镂	lzjn
畸	jitk
碴	iaua
羯	jpyv
暨	jiva
谤	bhyf
彝	yivc
嘹	lnkx
雹	bcyv
忱	ifxv
蔫	nmch
荔	licl
鲛	jnaf
硅	gvut
刽	gvdr
悖	bwxz
脐	qioa
骧	xlmy
夥	hoad
盹	dyov
孪	lrwz
谆	vyyz
殡	bbdb
诌	vzye
琊	yawe
敕	iiwa
禺	yuad
罂	ykfb
犊	dund
滟	yjdv
藜	licd
蟑	vhiu
郦	liea
郦	viea
绥	svsn
讧	hsyg
潢	gldb
潢	hldb
夔	kvqw
橄	gjmw
桢	vfmb
酆	fgee
淆	xndo
涮	urdd
蜗	woid
垛	dotm
啕	tckf
孬	ncaz
臃	ysof
澹	djdy
澹	tjdy
耘	yyls
徵	vgrw
徵	virw
銮	lrwj
豚	tyon
蓟	jicd
汶	mfdw
汶	wfdw
皿	mbka
遑	hlzb
倨	jurk
燧	svhz
佻	tnrd
诘	jiyk
诘	jpyk
碉	dnuk
摞	lofs
镐	gcjk
镐	hcjk
诽	fwya
掖	yefn
峋	xyeo
戛	gaag
戛	jxag
蒯	kkdc
叵	pokk
泗	sids
鄢	yjea
鏖	aolj
邋	lazv
舐	uipq
獗	jtqq
酉	yzxa
煊	xrha
嗟	jpkg
忻	xbxj
泱	yhdn
蔻	kzcy
蓁	vfch
琮	cswx
遢	tazo
庖	pcgv
帼	gojw
琏	lmwz
诋	diyd
骊	limd
荻	dich
遨	aozf
俪	lird
秧	yhhn
怵	iuxd
瘠	jibo
诠	qryw
忪	ssxs
忪	vsxs
鹄	hunn
卟	bukd
腴	yuon
嶙	lbea
犒	kcnk
挞	tafz
焊	hjhu
碱	jmuk
傥	thre
迩	erzd
馊	szuy
摺	uefb
摺	uefj
摺	vefb
摺	vefj
珩	hgwd
葳	wwcn
绉	vzse
斫	vouj
跆	tdzk
珉	mbwq
泠	lkds
忸	nqxa
闩	urma
鸵	tonv
彗	hvef
麝	uelc
耙	balv
耙	palv
岷	mbeq
鸶	sivn
粽	zsmx
蝈	goiw
闳	hsms
骛	wums
佝	gzrk
蜓	tkiu
笆	bavv
怩	nixv
奂	hrdn
掇	dofy
艮	gfvn
舀	ycva
膘	bnox
踮	dmzk
匮	gvkb
匮	kvkb
濠	hcdn
狒	fwqa
宕	dhbu
皖	wjbe
燮	xpyh
邙	mhew
喙	hvkn
莓	mwcd
颛	vrea
椿	iymo
陲	ivea
恫	dsxk
钹	bojd
檄	ximw
绡	xnso
鳍	qiao
椁	gomz
偻	lvrn
偻	lzrn
纾	uusa
鹧	veng
弭	mige
漕	ccdo
荑	ticn
荑	yicn
贰	erqb
槿	jbma
牒	dppm
鸢	yrnq
砺	liup
雉	viuf
鸪	gunu
绺	lqsk
橇	qnmm
跻	jiza
轶	yiin
戊	wugp
猷	yzqq
锹	qnjh
衾	qbry
钺	ytjd
祚	zopa
闾	lvmk
涝	lcdl
荥	xkcd
荥	ykcd
逅	hzzp
肪	fhof
囱	cspd
洱	erde
峪	yuek
鄱	poep
箬	rovk
嫒	ainy
繇	ycvs
繇	yzvs
莆	pucd
阪	bjey
镳	bnjh
浃	jxdn
佞	nkrn
麋	milm
搡	shfm
蘸	vjch
挝	vxfz
挝	wofz
岈	yaep
唳	likq
娣	dinp
忾	kdxq
忾	xixq
戌	xuga
幄	wojt
氢	qkqg
霰	xmyw
蔺	lbcf
骅	hxmu
蚱	vaia
谀	yuyn
俦	izrc
昶	ihdo
撸	lufo
狻	srqw
荏	rfcu
磬	qkuu
昴	mcoe
杈	iamd
闰	rymw
缮	ujsk
谚	yjyp
龛	kjrl
鸩	vfnd
谗	ijyd
砥	diud
俎	zurq
瘀	yubd
邂	xpzj
沏	qidd
邈	mnzv
埠	butu
坯	pita
咭	jikk
咭	kakk
缙	jbso
蹇	jmbz
俾	biru
蜚	fwia
箐	jkvo
箐	qkvo
籽	zimz
阚	hjmw
阚	kjmw
嗄	aakw
嗄	uakw
钠	najd
泾	jkdg
腓	fwoa
驽	numn
辍	ioiy
鞅	yhgn
蹶	jtzq
迤	yizr
诮	qnyo
哔	biku
赳	jqza
刎	wfdg
聒	goek
抨	pgfu
腌	aaov
腌	yjov
佥	qmra
炷	vuhw
淙	csdx
饯	jmug
垩	eeta
磺	hlub
鳗	mjay
钏	irja
氅	ihmx
胛	jxoa
遛	lqzp
涿	vodn
酪	lcyk
糠	khmn
翕	xiry
姝	uunn
佶	jirk
茴	hvck
呔	ddkd
呔	tdkd
檬	mgmn
衩	iapd
柩	jqmn
恹	yjxq
翳	yiky
纂	zrvs
姹	ianq
浒	hudu
浒	xudu
跖	vizk
琨	kywv
铄	uojd
镌	jrjp
佃	dmrt
佃	tmrt
钜	juja
莅	licl
嗑	kekm
沱	todv
膻	djoa
膻	ujoa
楔	xpmd
徇	xyro
懑	mfxd
豸	vivp
儆	jkrw
貉	hcvk
貉	hevk
貉	movk
潸	ujdo
仨	sars
讫	qiyg
圜	hrky
圜	yrky
孀	ulno
秣	mohn
蜍	iuih
汨	mido
柠	nkmd
唁	yjkk
舄	xiph
呶	ncky
戗	qlrg
璎	ykwn
莜	yzcw
泸	ludu
谟	moyd
椋	llmx
扪	mffm
聃	djea
辔	pwks
逖	tizq
猡	loqd
剜	wjdb
佰	bdrb
掴	gofw
绶	uzsy
茁	vock
罄	qkfu
町	dktd
町	tktd
龅	bciv
蛀	vuiw
诳	klyw
颧	qrca
嵇	jihe
谩	mjyy
砝	faus
殓	lmda
胫	jkog
螟	mkib
玖	jqwn
蛭	viit
祛	qups
裨	bipu
裨	pipu
赝	yjib
氐	dipd
湫	qqdh
葆	bccm
蒺	jicu
睇	diop
樽	zymc
绦	tcsm
涪	fudk
啮	npkk
锲	qpjd
懔	lbxx
囡	njkn
蹴	cuzd
篙	gcvk
葩	pacv
濯	vodf
矍	jtoy
溥	pudc
藓	xmcy
铨	qrjw
盥	grmp
黜	iuhk
覃	qbxu
覃	tjxu
煅	drhy
谡	suyw
坨	totv
淞	ssds
铤	dkjz
铤	tkjz
犟	jlng
璜	hlwb
铀	yzja
驷	sims
樟	vhmu
猕	miqx
菠	bocy
鱿	yzad
瘌	labd
诰	gcyk
滂	phdf
葭	jxcy
槁	gcmk
獐	vhqu
栾	lrwm
饪	rfuu
殄	tmdp
栉	vime
酵	jnyz
噱	jtkn
噱	xtkn
醐	huyo
锉	cojt
崧	sses
砧	vfuk
蔗	vech
牦	mcnm
榷	qtmf
泵	bgud
嫱	qlnk
槊	uomq
醍	tiyr
逡	qyzw
赡	ujby
鎏	lqjd
鸷	vinf
灞	bado
荪	sycx
骓	vvmf
酗	xuyx
咩	mpky
箴	vfvk
哓	xnke
蚤	zcyi
罹	lisf
馍	moud
滓	zidu
鹗	eenk
釉	yzpa
棂	lkmh
赊	uebx
熨	yuhu
熨	yyhu
塾	uutw
瑗	yrwy
锟	kyjv
挹	yifv
夯	hhdl
囫	hukp
诙	hvyh
酡	toyv
痍	yibn
痿	wwbn
绌	iusk
莘	ufcu
莘	xbcu
殁	mody
兕	siae
刍	iude
奘	vlda
獬	xpqn
箸	vuvo
锷	eejg
崴	wden
崴	wwen
纭	yyss
骞	qmbm
锃	zgjw
蝮	fuiw
柑	gjmc
秆	gjhu
圉	yuku
馗	kvjo
嶂	vheu
莒	juck
膑	bbob
荟	hvcs
豢	hrbn
灏	hcda
脶	lood
衢	qurd
仄	zeir
鹘	gung
鹘	hung
痘	dzbq
嚯	hokf
碇	dkur
晷	gvok
渚	vudo
碜	ifup
蛎	liip
隍	hlew
砣	touv
谔	eeyg
泅	qqdr
骈	pmmc
懋	mcxm
仝	tsrg
稔	rfhx
泫	xrds
哞	mzkn
乜	mpgv
乜	npgv
诓	klyw
蓿	xucb
桠	yama
耒	lwan
糅	rzmm
烯	xihj
镫	dgjd
貅	xqvm
猱	ncqm
犴	anqu
犴	hjqu
纫	rfsd
褓	bcpm
蕲	qicj
偈	jirv
偈	jprv
溧	lidm
訇	hsgy
媾	gzna
榛	vfmh
郏	jxea
葺	qice
铩	uajm
蚨	fuin
掾	yrfn
靛	dmfr
螯	aoif
耦	ould
萋	qicn
侩	kkrs
恽	yyxi
徉	yhry
枰	pkmu
鹜	wuns
褫	iiph
琚	juwk
蜮	yuik
抻	iffa
襁	qlpi
遴	lbzm
蓑	socy
皈	gvby
娩	mmnv
虱	uigi
菟	tucd
阈	yuma
觞	uhjp
呖	likl
箝	qmvc
狎	xxqa
邳	piea
轾	viit
幂	mibj
阡	qmeu
忝	tmax
窳	yubg
貔	pivv
炅	gvoh
炅	jsoh
舢	ujve
铢	vujm
糨	jlmi
髭	ziav
抟	trfd
沆	hhdj
铣	xije
铣	xmje
腩	njou
烩	hvhs
锴	kdjb
殚	djda
秸	jphk
砀	dhup
氮	djqh
孑	jpva
愎	bixw
睢	svof
逦	liza
薜	bicu
嘞	lekl
嘞	lwkl
狴	biqt
悌	tixp
猢	huqo
爻	ycxx
牍	dupd
羸	lwwd
囗	wwaa
撺	crfa
鹑	iynw
缃	xlso
饽	bouz
嶷	yier
蒿	hcck
蝾	rsim
稹	vfhb
雒	lowf
仃	dkrd
俅	qqrd
狍	pcqv
梏	gumk
橐	toam
韪	wwoa
橹	lumo
鳕	xtae
轸	vfip
黢	quhw
徜	ihrk
桎	vimt
鬣	lpaa
擢	voff
肓	hlwo
泷	lsdl
泷	uldl
镏	lqjt
呙	gokd
呙	gxkd
呙	hekd
呙	wakd
呙	wdkd
呙	wokd
璺	wfpw
铡	vajd
碘	dmub
镁	mwjd
伥	ihrn
珐	faws
辂	luik
崂	lcel
炝	qlhv
祉	vipv
狲	syqx
榔	lhme
钙	gdjg
媪	aonm
珲	hvwi
珲	hywi
肛	ghog
濂	lmdn
芩	qbcv
诿	wwyn
镞	zuju
鼬	yzua
臬	nppm
岫	xqea
氯	lvqd
阆	lhmn
箔	bovb
貊	movb
澧	lidd
饨	tyuv
蜇	veif
馄	hyuv
蜢	mgim
镛	ysja
寮	lnbx
蛔	hvik
诨	hyyi
酊	dkyd
璁	cswx
骢	csmx
砒	piuv
纛	dcfs
楸	qqmh
蟊	mcsi
煲	bchr
爿	pjap
谌	ifyv
谌	ufyv
狷	jrqo
聩	kveb
媸	iini
掼	grfb
蛐	quia
莠	yzcp
钨	wuja
镝	dijk
怼	dvxy
旮	gajo
酩	mkyk
韫	wfam
韫	yyam
诟	gzyk
硭	mhuv
摈	bbfb
蚋	rvid
赭	veto
絷	visf
歃	uapq
黩	duhd
耆	qito
闱	wwma
嘬	zoky
飨	xlvu
茯	fucq
邴	bkea
缛	rusc
驺	zzme
訾	ziyv
轱	guik
卅	saaa
祆	xmpd
鲧	gyas
甯	nkba
甯	nkbd
蹉	cozg
氨	anqn
遒	qqzq
僭	jmro
谯	qnyh
倥	ksrg
孢	bczv
嵬	wweg
誊	tgby
旯	laoj
妁	uond
岬	jxea
孛	bwuz
泖	mcde
裾	jupk
榈	lvmk
荚	jxcn
跎	tozv
囿	yzko
悒	yixv
檑	lwmt
谥	uiym
谶	ifyg
蚺	rjia
痂	jxbk
虺	hvai
牯	gunk
镗	thjt
煨	wwhn
饴	yiuk
獾	hrqf
眇	mnop
闫	yjms
伉	khrj
祧	tnpd
胪	luou
啖	djkh
钴	gujk
揆	kvfd
苻	fucc
錾	zjji
鼹	yjun
阒	qumq
笞	iivk
豕	uian
耄	mctm
撷	xpfa
椤	lomd
痔	vibc
菀	wjcv
菀	yycv
嫫	mond
蟋	xiix
拮	jpfk
拮	jxfk
暝	mkob
岿	kvee
阕	qtmd
滁	iudh
弁	bmsc
弁	bmyu
荇	xkcd
逶	wwzh
蚪	dziu
喑	ybko
蟀	ukiu
嘁	qikx
糸	mivx
糸	miav
糸	sivx
糸	siav
茕	qscu
埙	xytb
獭	taqb
觥	gsje
晗	hjok
蝌	keiu
俚	lira
磔	veum
墒	uhtk
搽	iafm
滦	lrdm
姘	pbnc
湎	mmda
螫	uiit
螫	veit
畹	wjtv
笮	zeva
笮	zova
饬	iiul
菅	jmck
肱	gsos
徕	ldrn
傈	lirm
汞	gsgd
蓐	rucc
徭	ycrf
鳝	ujak
巯	qqvv
鲽	dpam
铆	mcje
剡	ujdh
剡	yjdh
猁	liqd
柚	yzma
逑	qqza
捭	bdfu
脔	lrwr
鬈	qrav
哙	kkks
铂	bojb
挈	qpuf
绻	qrsv
跹	xmzz
瑷	aiwy
铖	igjv
炻	uihu
癣	xrby
颢	hcoa
裱	bnpy
蕤	rvca
悱	fwxa
猞	ueqk
赅	gdbr
楹	ykmm
恚	hvxt
潍	wwdf
衽	rfpu
貘	movd
钎	qmju
凼	dhkd
蜉	fuiz
粕	pomb
钿	dmjt
钿	tmjt
涞	lddn
雩	yuyg
鲫	jiae
傩	norf
莳	uicc
斛	huju
珙	gswb
纥	gesg
纥	hesg
筅	xmve
胰	yion
荜	bicu
焘	dchf
焘	tchf
怄	ouxx
栎	limd
栎	ytmd
讴	ouyx
洌	lpdd
觜	zijv
觜	zvjv
瘙	scbi
唿	hukx
缳	hrsy
戕	qlvg
锝	dejc
埂	ggtn
拊	fufc
讦	jpyu
螈	yrix
锌	xbju
郗	xiex
仵	wuru
烊	yhhy
篁	hlvw
搴	qmbu
獍	jkqe
杷	pamv
脍	kkos
醴	liyd
鹂	lina
邰	tdes
郜	gcen
纩	klsg
堞	dptm
鹬	yuns
牝	pbnv
湟	hldw
酃	lkey
冼	xmde
氦	hdqr
锒	lhjn
篾	mpvd
缦	mjsy
杌	wume
硌	geuk
硌	louk
骝	lqmt
碣	jpuv
碣	yauv
鏊	aojf
虻	mgiv
膂	lvof
咴	hvkh
缟	gcsk
荞	qnca
偬	zsrx
暾	tyow
窨	xybo
窨	ybbo
鼐	ndgv
帏	wwja
洮	tcdd
胱	gloe
铉	xrjd
鲟	xyac
竦	ssln
虢	govh
椽	irmn
韭	jqaa
佤	warw
蕨	jtcq
狯	kkqs
屐	jiuy
癯	qubf
鳃	sdax
苌	ihcn
侔	mzrn
腚	dkor
腱	jmoz
圻	qitj
圻	ybtj
痨	lcbl
眙	iiok
眙	yiok
竽	yuvu
缢	yism
辚	lbia
尜	gaxx
趺	fuzn
茔	ykct
蝰	kvit
囹	lkks
洇	ybdd
鼋	yrev
芫	yjce
芫	yrce
赍	jibu
宥	yzbo
樘	thmt
酶	mwyd
墉	ysta
嘌	pnkx
恂	xyxo
罅	xxfu
镊	npjy
椴	drmy
彀	gzuy
洹	hrda
盱	xuou
噻	sdkt
旄	mcfm
犍	jmnz
犍	qmnz
庹	togn
欹	qidq
珥	erwe
吡	bikv
吡	pikv
撄	ykfn
狃	nqqa
裢	lmpz
镙	lojs
圩	wwtu
圩	xutu
铬	gejk
馐	xqua
峄	yiea
馏	lqut
搠	uofo
炔	qthn
踟	iizk
鼍	tokv
仟	qmru
鹌	annd
戡	kjqg
苫	ujck
襦	rupa
擀	gjfu
娈	lrwn
昃	zeor
荛	rcce
龈	kfin
龈	ybin
焖	mfhx
诤	vgya
峤	jnea
峤	qnea
犰	qqqj
蟥	hlib
蹼	puzn
殳	uujy
妣	binv
楫	jime
燹	xmha
缱	qmsz
厣	yjia
傣	ddrd
狁	yyqe
帔	pwjp
锰	mgjm
圄	yukk
痢	libd
嵯	coeg
樨	ximn
纡	yusu
畲	uert
瘐	yubn
腭	eeog
瓴	lkrw
蠹	duai
裣	lmpa
郓	yyeb
柞	vama
砦	vdvu
杼	vuma
闼	tamz
鞒	qnga
芨	jicn
蛉	lkis
骐	qimb
吖	aaka
吖	yaka
瘿	ykbn
笳	jxvk
郧	yyek
黟	yihd
舛	irpa
钾	jxja
憷	iuxr
稞	kehn
颏	kewa
佚	dprn
佚	yirn
苡	yicr
勐	mgzl
淖	iodu
淖	ncdu
淖	vodu
澍	uudc
澍	vudc
勖	xukl
铰	jnjf
褡	dapk
诜	ufye
薨	hscv
濉	svdf
檫	iamx
郇	hreg
郇	xyeg
骘	vime
凫	funj
垭	yata
罨	yjsv
邗	hjea
钯	bajv
搦	nofd
荠	jica
荠	qica
喁	yskd
枋	fhmf
浔	xydc
煸	bmhc
矽	xiud
苕	tnck
苕	ucck
謇	jmby
垓	gdtr
沔	mmdv
粑	bamv
蝓	yuid
躅	vuzi
锨	xmjq
瀣	xpda
迓	yaza
杓	bnmd
杓	ucmd
喈	jpkb
烷	wjhe
矾	fjud
缁	zist
蜊	liid
陉	xkeg
堠	hztu
鄯	ujey
幛	vhju
愀	qnxh
瓤	rhwg
蕈	xycu
踯	vize
鲵	niae
刭	jkdv
怫	fuxa
罴	pihs
坩	gjtc
焙	bwhk
氰	qkqo
渑	mmdv
渑	ugdv
疥	jpba
肜	rsop
厶	sivd
氟	fuqa
鲰	zzay
疟	ntba
疟	ycba
笫	zivp
褰	qmby
痼	gubk
鲑	gvat
鲑	xpat
黍	uuhd
沭	uudd
缗	mbso
菸	yjcd
菸	yjhd
悭	qmxt
疱	pcbv
衿	jbpv
艏	uzvo
裎	igpw
孳	ziqz
庠	xlgy
旒	lqfv
栳	lcmv
茏	lscl
阄	jqmv
亳	bowq
艨	mgvn
邛	qseg
麂	jilj
尻	kcuj
樯	qlmk
豌	wjdv
踽	juzd
鲈	luau
艄	ucvo
鲶	nmax
眭	gvot
眭	svot
陂	bwep
陂	piep
陂	poep
榉	juma
氖	ndqp
笏	huvp
廪	lbgx
怛	daxa
蚍	piiv
铙	ncje
殍	pndz
泶	xtxd
淝	fwdv
菘	sscs
蒹	jmcn
忉	dcxd
桁	hgmd
桁	hhmd
疹	vfbp
蝣	yziz
喱	lika
妊	rfnu
萑	hrcf
擘	bouu
逋	buza
埚	gotd
苒	rjca
锗	vejo
唢	sokb
谰	ljyd
歙	uerq
歙	xirq
焯	ichu
焯	vohu
矬	cout
疽	jubq
艟	isva
趸	dyaz
蹰	iuzc
荩	jbcd
縻	migs
亍	iuea
佧	kard
叻	lekl
趿	tazn
勰	xplx
嘏	guuy
桫	somp
侪	idra
疴	kebk
翥	vuty
蚝	hcim
鲠	ggan
雎	juqf
毂	guuy
茑	nncn
觚	gujg
阋	xime
洄	hvdk
焓	hjhk
跗	fuzc
猗	yiqk
胺	anon
鹕	huun
笤	tnvk
跸	bizu
钬	hojh
镪	qlji
馕	nhuy
疡	yhbp
篦	bivv
鹈	tinb
踅	xtzf
棼	ffmd
睾	gcpu
鹳	grnc
漭	mhdc
烃	tkhg
瞽	guou
逄	phzw
锍	lqjv
哚	dokm
砬	laul
砬	liul
蝥	mcis
钲	vgjv
陟	viep
耋	dptt
酮	tsyk
塄	lgtf
痫	xmbm
蚧	jpia
埘	uitc
枸	gzmk
枸	jumk
柢	dimd
柢	iimd
潆	ykds
笄	jivc
醮	jnyh
彖	trvn
稗	bdhu
窠	kebn
萘	ndcx
郯	tjeh
掮	qmfo
尢	yzuv
鲇	nmak
鼙	piuu
畦	qitt
舸	gevk
帑	nujn
帑	thjn
睃	soow
蚜	yaip
溘	kedm
蠃	lowd
岢	keek
矸	gjuu
鸱	iinp
狳	yuqh
祜	hupk
囟	xbpx
扦	qmfu
枥	liml
庾	yugn
菔	fucy
蟛	pgip
嗉	suks
擤	xkfa
莪	eecd
觋	xipj
醪	lcyp
倬	voru
爰	yrvy
蚰	yzia
轳	luiu
锱	zijt
鬻	yuga
鳏	grad
栲	kcmg
渌	ludd
蛄	guik
嬗	ujna
谘	ziyk
鋈	wujd
阍	hymo
杲	gcom
柘	vemu
毖	biad
禳	rhpy
馔	vrub
鳐	ycaf
鳟	zyac
耔	zilz
辊	gyiv
镍	npjm
侑	yzro
娠	ufnn
槎	iamg
芾	fucj
芾	fwcj
豳	bbea
钤	qmjv
锕	aajk
孥	nuzn
綦	qiqs
锑	tijp
洙	vudn
榫	symu
疣	yzbd
砭	bmun
筮	uivr
酽	yjyi
愆	qmxr
栀	vimv
耪	phlf
薅	hccc
蜞	qiib
崤	xneo
椟	dumd
糁	ufmp
茇	bacd
啁	tnkk
啁	vckk
啁	vzkk
氪	keqe
萁	qicb
龃	juiq
墀	iitn
芪	qicq
莰	kjcq
菏	heck
嵊	ugen
蛩	qsig
鞯	jmgz
楂	iama
楂	vama
缒	vvsz
乩	jiav
捌	bafd
毽	jmmz
愍	mbxv
瘢	bjby
铋	bijp
铧	hxju
髋	krgj
鹚	cinq
儋	djry
奁	lmdx
樾	ytmv
滹	huda
穑	sehk
茌	iicu
骶	digd
刖	ytdo
嫜	vhnu
溏	thdk
螽	vswi
囝	jmkz
戽	huhu
橛	jtmq
舂	isfa
遄	irze
坭	nitv
澶	ijda
熵	uhhk
镬	hojy
飧	sypu
枞	csmr
枞	zsmr
柙	xxma
硎	xkud
缯	zgso
蔌	sucq
鲂	fhaf
冱	huda
岙	aope
殂	cudq
艉	wwvm
蠼	quiy
匏	pcdv
痈	ysba
鹾	coag
尕	gagx
攮	nhfy
樗	iumg
皲	jybp
髡	kyae
坻	ditd
坻	iitd
伧	cfrv
伧	ifrv
剀	kdde
椐	jumk
瓠	hudg
讣	fuyd
髁	kegn
龉	yuik
彘	vivv
棹	vcmu
棹	vomu
疠	libp
薮	szcw
隈	wwen
龋	quid
朐	iyok
朐	quok
橼	yrmn
芰	jicy
圹	kltg
敉	miwm
暌	kvod
饧	xkup
泔	gjdc
赜	zekb
黧	lihh
筚	bivu
蓖	bicv
鸬	luna
蚬	xmij
醯	xiym
钪	khjj
餍	yjiu
鸹	gxnp
哏	gfkn
哏	hfkn
甑	zgbw
疋	pivr
膣	viot
螅	xiix
锞	kejn
髫	tnak
宄	gvbj
摭	vifh
檠	qkmc
盍	hemt
绂	fusd
骟	ujmy
棰	ivma
缡	liss
苷	gjcc
蹁	pmzc
铗	jxjn
鞣	rzgm
圯	yitv
涑	sudn
箜	ksvg
芎	xscg
蔟	cucu
觯	vija
鍪	mzjs
镟	xrjr
夤	ybpb
妫	gvnd
熘	lqht
硼	pguo
秫	uuhd
阏	eemd
飑	bnfv
啭	vrkd
枳	vimb
礅	dyuw
耨	nzlc
茭	jncf
钡	bwjb
捩	lpfq
柁	domv
柁	tomv
苴	iacq
苴	jucq
铊	tajv
铊	tojv
寤	wubk
牖	yzpd
赀	zibv
醚	miyz
柽	igmt
栌	lumi
肄	yipa
脘	wjoe
酎	vzyc
鲳	ihao
柒	qimd
浠	xidj
蛳	siij
壅	ystw
枇	pimv
楱	zzmd
焐	wuhk
秭	zihp
笥	sivk
茈	cicv
茈	zicv
蒌	lzcn
谵	vjyy
跏	jxzk
镆	mojd
怙	huxk
枵	xnmg
痱	fwba
膈	geoa
卮	vipv
圊	qkko
圮	pitv
堀	kute
氚	irqa
皴	cysp
绐	ddsk
蟮	ujik
邡	fhef
庑	wugv
廨	xpgn
钭	dzju
觳	huuy
闶	khmj
檗	bomu
漯	lods
漯	lwds
漯	tads
瓿	bulw
眚	ugno
芴	hucp
芴	wucp
诂	guyk
郴	ifme
鳓	leal
俣	yurd
徼	jnrw
桡	ncme
桡	rcme
楗	jmmz
莨	lhcn
莨	llcn
酰	xmye
雠	izyf
喾	kuxk
揿	qbfq
笊	vcvv
苎	vuca
黥	qkhx
僳	surm
芏	duct
菖	ihco
蓊	wgcy
袢	pjpa
馑	jbua
卺	jbvv
垆	lutu
旆	pwfj
曛	xyoh
汊	iadd
硒	xiux
穰	rhhy
粳	jkmn
酾	udyd
酾	uiyd
鲷	dnak
鹣	jmnq
塬	yrtx
曩	nhoy
莴	wocd
蕞	zvcy
蘖	npcm
怃	wuxv
欤	yuaq
玢	bbwd
玢	ffwd
蕖	qucm
镒	yijm
厝	coio
坶	mutd
屣	xiur
揎	xrfa
榧	fwma
芑	qicv
蓥	ykcj
钣	bjjy
鬲	geaa
鳔	bnax
鼗	tcey
仂	lerl
婺	wuns
嫠	lian
愦	kvxb
癍	bjbw
癔	yibx
碓	dvuf
箧	qpvn
缶	fzrk
缶	fzff
缶	grrk
缶	grff
蘧	qucz
妗	jbnv
幞	fujn
沤	oudx
痦	wubk
蛑	mzin
詈	lisy
钚	bujd
铴	thjp
锆	gcjk
丌	jiaa
岘	xmej
枧	jmmj
柰	ndmx
浜	bbdb
浜	bhdb
蓼	lncp
蓼	lucp
蛞	koik
鄣	vhel
偾	ffrb
藿	hocf
酢	cuya
酢	zoya
铟	ybjd
锛	bfjc
阊	ihmo
骖	cjmp
鲆	pkau
檩	lbmx
燔	fjht
猓	goqm
蘼	mica
趵	bczd
酲	igyw
鹩	lnnu
乇	topv
乇	vepv
屙	eeuk
揸	vafa
碛	qiub
笸	povk
赓	gggb
鄄	jrex
铱	yijy
黻	fuad
伲	nirv
缂	kesg
蜣	qliv
蜩	tnik
谝	pmyc
铍	pijp
伛	yurx
傧	bbrb
揠	yafn
昝	zjwo
溽	rudc
胙	zooa
萏	djca
隹	vvrf
麈	vulw
妯	vzna
孓	jtvn
溱	qbdh
溱	vfdh
碚	bwuk
蕺	jica
锊	ltjc
镧	ljjd
髀	bigu
坫	dmtk
崃	lden
戢	jikg
糌	zjmo
缬	xpsa
邶	bwea
坼	ietd
梃	tkmz
瞢	mgco
缧	lwss
菽	uucy
豉	iidy
仳	pirv
堙	ybtt
忭	bmxd
砷	ufua
筌	qrvw
箪	djva
艿	ndcp
郅	viea
鲢	lmaz
鳎	taay
厍	ueii
哕	hvkd
哕	ytkd
廑	jbga
廑	qbga
敫	jnwb
栊	lsml
癜	dmby
碹	xrua
磙	gyuy
笾	bmvz
篪	iivh
缌	sisx
苣	juca
苣	quca
荨	qmcc
荨	xycc
诹	zzyy
诼	voyn
钒	fjjd
嗍	soko
槠	vumo
欷	xixq
淦	gjdj
甏	bgwu
胝	viod
蓍	uico
蛱	jxin
裉	kfpn
辏	czid
颞	npea
麸	fufn
娌	lina
椹	ufmv
椹	vfmv
缫	scsn
翮	heay
诒	ddyk
诒	yiyk
郾	yjek
铯	sejv
锂	lija
鞫	jugy
卣	yzaa
圬	wutg
尥	lnjd
槲	humu
氘	dcqa
瘘	lzbn
耩	jlla
轫	rfid
迨	ddzs
馓	sjuw
啉	lbkm
啉	ljkm
圪	getg
泺	lodd
熳	mjhy
璩	quwn
胗	vfop
苁	cscr
薹	tdct
薹	tdck
锘	nojk
阌	wfmy
鳊	bmac
唑	zokt
溻	tady
瘰	lobs
砗	ieui
砩	fuua
砩	fwua
羝	diyd
茺	isce
蓠	lics
俳	pdra
刳	kudd
唣	zckq
悝	kvxa
悝	lixa
慊	qmxn
慊	qpxn
瘳	izbp
茼	tsck
麇	jylh
麇	qylh
黾	mbkv
黾	mgkv
黾	mmkv
嗾	szku
嵛	yued
杩	mamm
狨	rsqu
狺	ybqk
痧	uabp
砜	fguf
缍	dosa
芡	qmcq
蓣	yuca
顸	hjaa
槭	qimx
槭	semx
溲	szdy
痤	cobt
眄	mmov
糍	cims
葚	ufcv
郐	gver
郐	kker
酹	lwyc
镢	jtjq
隳	doex
隳	hvex
鹋	mnnc
唛	makw
唛	mdkw
嬖	binu
怍	vaxa
朊	rroe
涫	grdk
绲	gysv
胼	pmoc
腧	uuod
葑	fgcc
蠓	mgin
踬	vizb
鞲	gzga
饫	yuud
刈	yidx
垲	kdtv
嵴	jieo
帻	zejb
旰	gjou
旰	hjou
畚	bfst
荭	hscg
萸	yucn
蘩	fjcs
颃	hhwa
颟	mjca
鸲	qung
龠	ytrc
呒	omkv
嗌	aikm
嗌	yikm
疸	djba
硖	xxun
绁	xpsv
耧	lzln
蚴	yzil
蛸	xnio
裰	dopy
謦	qiyu
跣	xmzp
踺	jmzz
逯	luzv
陔	gder
凇	ssds
堋	bgto
堋	pgto
屦	juun
峁	mcee
廛	ijgt
栝	gxmk
栝	komk
栝	tmmk
磴	dgud
篌	hzvu
芘	bicv
芘	picv
葸	xicx
薏	yicx
踔	iozu
鄞	ybec
醢	hdym
铒	erje
镲	iajx
鲮	lkaw
仉	vhrj
侉	kxrg
桄	glme
泮	pjda
燠	yuhn
皤	pobt
粝	limp
蹀	dpzm
颡	shya
鲞	xlba
唪	fgka
嗪	qbkh
掭	tmfx
畈	fjty
簦	dgvd
绨	tisp
胍	gxog
胲	hdor
舻	luvi
铘	yeje
锩	jrjv
鲋	fuac
崮	guek
庋	gvgy
毳	cvmm
箅	biva
缣	jmsn
菹	zucq
虿	idai
谇	svyu
贶	klbe
陧	npet
隰	xieh
僬	jnrh
匦	gvkj
垧	uhtk
疔	dkbd
肭	naod
蝤	qqiy
谖	xryy
趑	zizq
轭	eeiv
酐	gjyu
醅	pwyk
醑	xuyo
醛	qryw
锬	tjjh
劂	jtdi
垅	lstl
悛	qrxw
戥	dgog
拶	zafd
拶	zjfd
硷	jmua
笕	jmvj
簟	dmvu
莼	iycv
蒴	uoco
藁	gccm
诖	gxyt
谠	dhye
谳	yjyq
邾	vuep
陴	pieu
鬏	jqah
龀	ifiv
剞	jidd
劬	qugl
埸	yitp
嬲	nnnl
嵝	lzen
搿	geru
柝	tomd
桴	fumz
洧	wwdo
浯	wudk
疝	ujbe
笱	gzvk
肽	tdod
舯	vsva
艋	mgvm
芤	kzcv
葙	xlco
鲔	wwao
鸸	erna
佾	yiro
墁	mjty
嫘	lwns
榇	ifmm
煳	huho
硪	woud
礞	mgun
菰	gucg
蚵	eeik
趱	zjzb
躜	zrzb
钼	mujo
鲱	fwaa
匚	klav
呋	fukn
媵	ykon
崦	yjev
楝	lmmn
潲	ucdo
獯	xyqh
瘵	vdbx
绀	gjsc
绋	fusa
莩	fucz
觫	sujn
辋	whiv
镡	ijju
镡	tjju
镡	xbju
髂	qxgk
鬯	ihkv
鹨	lqny
亓	qiea
劓	yidp
埕	igtw
曷	heov
洚	jlda
碲	diuj
磲	quum
粜	tnem
绱	uhsk
芄	wjcd
酚	ffyd
铪	hajk
铪	kejk
髌	bbgb
鲥	uiac
俜	pkrg
刿	gvde
吣	qbkx
垤	dptt
枘	rvmd
氽	tyrd
溷	hydn
甍	mgcw
笪	dava
胬	nurn
舨	bjvy
芟	ujcy
蒽	encx
銎	qsjg
铵	anjn
锶	sijx
骱	jpga
鹆	yunb
岣	gzek
岵	huek
怿	yixa
慝	texk
挢	jnfa
掎	jifk
毹	uurm
汆	crrd
沲	dodv
湔	jmdd
甙	ddcq
罟	gusk
羼	ijuy
菝	bacd
讵	juya
诎	quyk
谮	zfyo
赉	ldba
郄	qpex
郄	xiex
鐾	bwju
鲎	hzxa
啶	dkkr
塍	igot
屺	qiev
庥	xqgm
掊	pzfk
撙	zyfc
柃	lkms
檎	qbmd
毵	sjsm
渖	ufda
砘	dyuv
窭	jubn
肟	woog
蔸	dzce
蚶	hjic
蛏	igit
躞	xpzy
酯	viyo
锾	hrjy
饩	xiuq
劢	mdal
嘧	mike
嵫	zies
擐	hrfy
湓	pfdm
蝻	njiu
蠖	hoiy
觖	jtjn
跬	kvzt
鳜	gvaq
鳜	jtaq
仡	gerg
仡	yirg
垌	dstk
垌	tstk
氆	pumo
氇	lumo
汔	qidg
篼	dzve
缑	gzsu
舾	xivx
莸	yzcd
蛲	ncie
蠛	mpic
蠲	jrqi
褊	bmpc
醣	thyk
骀	tdmk
倮	lorn
僦	jqrd
崾	ycen
渫	xpdm
瘗	yibt
箦	zevb
肼	jkoa
腽	waom
臁	lmon
舳	vuva
芈	miaa
荽	svcn
蒉	kkcb
蒉	kvcb
蛴	qiia
袼	gepk
跫	qszg
遘	gzza
儇	xrry
埽	sctj
庀	pigv
戆	ghxl
戆	vlxl
扃	jshk
搛	jmfn
杪	mnmp
浼	mwdv
滏	fuda
瓞	dpgn
疃	trta
砟	vaua
硗	qnue
禊	xipd
篥	livm
簋	gvvm
綮	qish
綮	qksh
苤	ppca
踣	bozk
躐	lpzv
酴	tuyh
钽	tjja
锸	iaja
锼	szjy
阃	kymm
鞔	mfgv
鞔	mjgv
鲭	qkao
鹪	jnnr
黪	cjhp
黼	fuad
榀	pbmk
榘	jumu
榘	juua
浍	hvds
浍	kkds
炱	tdsh
煺	tvhz
犋	junb
砻	lslu
秕	bihv
籼	xmme
耜	silk
肀	yiva
肫	iyov
肫	vyov
肷	qmoq
胂	ufoa
莛	tkcu
裥	jmpo
逭	hrzb
钋	pojd
钌	lnja
钸	bujj
髑	dugi
鳆	fuaw
鼯	wuuk
佴	erre
佴	ndre
吲	ybka
帱	czjc
帱	dcjc
帱	izjc
搌	vjfn
擗	pifu
桷	jtmj
氡	dsqd
氩	yaqa
溴	xqdq
畋	tmwt
硐	dsuk
糇	hzmu
腠	czod
葶	tkcd
袷	qxpk
陬	zzey
黉	hsxb
龆	tnik
哜	jika
埴	vitq
岜	baev
徂	cura
惝	ihxk
惝	thxk
烀	huha
眢	yrop
瞵	lboa
筇	qsve
簏	luvl
芗	xlcp
蝽	iyio
蟪	hvix
郫	piep
钕	nvjn
钫	fhjf
镉	geja
镘	mjjy
颥	ruya
黹	viad
坜	litl
埤	pitu
廾	gsaa
彳	iipa
楦	xrma
氙	xmqe
澌	sidj
畛	vftp
疳	gjbc
瘅	djba
砉	hxfu
砉	xufu
砹	aiux
碡	vzud
穸	xibd
缵	zrsb
羟	qlyg
膦	lboa
菪	dhcu
虼	geig
蛘	yhiy
螨	mjid
裼	tipp
裼	xipp
迕	wuzr
铈	uijj
锇	eejd
锔	jujk
锪	hojx
镓	jxjn
镦	dvjw
镱	yijx
霪	ybyu
骒	kemn
鹁	bonu
冁	ijbn
哿	gelk
噍	jnkh
埝	nmtx
弪	jkgg
攉	hoff
浞	vodz
潴	vudo
畀	bita
籴	dirm
罱	ljsu
羰	thyh
胨	dsod
胩	kaod
舴	zeva
苊	eecv
茆	mcce
茛	gfcn
蒇	ijcb
虮	jiij
蠊	lmin
裒	pzwy
襞	biyu
觇	ijaj
轺	ycik
锿	aijy
髹	xqam
鸫	dsna
哌	pdkn
垸	hrte
垸	yrte
埏	ujtv
埏	yjtv
墼	jita
帙	vijn
悃	kyxm
揲	uefm
晡	buod
榍	xpmo
榱	cvmy
殪	yidd
淠	pida
淠	pwda
漤	ljdn
疬	libl
砑	yaup
缲	qnsm
缲	scsm
罘	fusd
苈	licl
萆	bicu
谂	ufyx
鄹	zzee
酞	tdyd
钔	mfjm
铥	dqjs
镅	mwjo
髟	bnap
鲡	liad
鲦	tnam
鳇	hlaw
鹇	xmnm
鹱	huny
埒	lptc
岽	dsed
悫	qtxu
攵	wfpx
桊	jrbm
桕	jqma
槔	gcmu
溆	xudy
漶	hrdx
牾	wunk
畎	qrtq
疖	jpbe
矧	ufua
稂	lhhn
窀	vybv
籀	vzvt
腈	jkoo
苄	bmcd
薷	ruca
褙	bwpo
赙	fubc
跽	jizx
钐	ujjp
锖	qljo
镎	naju
饔	yswu
骣	ijmz
鳙	ysaa
坌	bftb
氍	quom
沩	wwdd
洫	xudx
澉	gjdw
瀹	ytdc
爨	crph
珧	ycwd
瘊	hzbu
瞍	szoy
硇	ncux
筘	kzvk
粢	cimd
粢	zimd
聍	nked
舁	yupc
艚	ccvo
荸	bicz
蜱	piiu
钍	tujt
铞	dnjj
铫	dnjd
铫	tnjd
铫	ycjd
骺	hzgk
鲼	ffab
劐	hodc
哳	vakj
唼	uakn
忮	vixy
恝	jxxf
戋	jmad
椠	qmmi
瘕	jxby
瘕	xxby
瘛	iibx
瘼	mobd
祓	fupd
窆	bmbn
窬	yubd
篚	fwva
粞	ximx
羧	soyw
脬	pcoz
艽	jncj
艽	qqcj
葜	qxcd
蓰	xicr
觌	diuj
豇	jldg
轵	viib
醵	juyn
铌	nijv
镄	fwjb
阼	zoea
鞴	bwga
鲅	baad
鲒	jpak
埯	antv
恧	nvxa
憝	dvxw
搋	ikfh
氕	ppqp
洳	rudk
浈	vfdb
濞	bida
濞	pida
礤	caux
聱	aoef
艹	ccaa
蟓	xlin
襻	pjpu
趼	jmzc
迮	zezr
钆	gajv
铷	rujk
镨	pujo
驵	zhmq
鲣	jmat
鳘	mbar
鸺	xqrn
嚆	hckk
堍	tutv
嶝	dged
巛	vevv
廒	aogw
桤	qimv
橥	vumq
爝	jthc
甾	zdvt
痄	vaba
癀	hlbb
筲	ucvo
箨	tova
罾	zgso
耵	dked
舣	yivd
荬	mdcd
蕹	wgcf
诔	lwyn
赆	jbbd
蹯	fjzt
钇	yijg
钶	kejk
铕	yzjo
镤	pujn
鲚	jiaa
鲻	ziat
鳢	liad
鹛	mwnv
塥	geta
庳	bwgu
怊	icxk
捃	jyfk
揞	anfo
揞	yefo
揞	yjfo
洎	jido
涠	wwda
滠	uedy
猸	mwqo
甓	piwu
瘃	vubn
瞀	mcos
砼	tsug
礓	jlua
绠	ggsn
耱	molu
脎	saom
脒	miom
脞	coot
萜	tpck
蕻	hscb
薤	xpca
跞	lizd
跞	lozd
轹	liid
锎	kdjc
锓	qbjy
馇	iaua
鲐	tdak
鲩	hrae
仫	murs
垡	fatr
垴	nctk
岍	qmec
崞	goez
枨	igmn
毪	mumn
牮	jmnr
癃	lsba
眍	kzox
眵	iiod
稃	fuhz
筢	pavv
腙	zsox
舭	bivv
菥	xicj
蜾	goin
螬	ccio
螵	pnix
衄	nvxa
谫	jmyd
躔	ijzt
郛	fuev
酤	guyk
钷	pojk
锫	pwjk
镩	crja
阢	wuee
阢	wwee
鼷	xiud
劁	qndr
埭	ddtn
墚	lltm
摅	uufx
撖	hjfw
泐	ledl
滗	bidm
牿	gunk
犏	pmnc
猹	iaqa
猹	vaqa
疰	vubw
痃	xrbs
痖	yaba
瘥	cdbg
瘥	idbg
磉	shum
箢	yrvv
簖	drvj
缋	hvsb
缏	bmsn
耥	thlk
脲	nnod
膪	ikol
膪	vaol
膪	vdol
苠	mbcq
茳	jlcg
莶	lmca
莶	xmca
蒎	pdcn
蒡	bhcf
虍	huaq
螗	thik
贳	uibc
醌	kyyv
醭	buyn
铹	lcjl
铼	ldjn
镥	lujo
阽	dmek
馘	goqk
鲺	uiai
鹎	bwnp
鼽	qqpj
傺	iirx
勹	bcpv
喹	kvkt
戤	gdgg
瀵	ffdb
醃	aayv
錒	aajk
卬	ahep
骯	ahkj
藹	aicv
鎄	aijy
叆	aiey
鑀	aijw
噯	aikw
靄	aiyv
靉	aiyw
堨	aitr
嬡	ainw
愛	aivw
曖	aiow
欸	aisq
毐	aiup
璦	aiww
皚	aibd
礙	aiur
菴	ancv
諳	anyo
銨	anjn
咹	ankn
唵	ankv
闇	anmo
垵	antn
鮟	anan
鵪	annd
盦	anmr
襖	aopd
隩	aoed
奡	aoaa
奧	aopd
驁	aomf
媼	aonm
鰲	aoaf
嶅	aofe
嶴	aope
璈	aoww
胈	baoy
蚆	baiv
覇	baxo
釟	bajb
鈀	bajv
哱	bakz
壩	bato
妭	band
鮁	baad
鮊	baab
鲌	baab
抜	bafy
朳	bamb
粃	bamp
罷	basp
羓	bayv
臏	bbob
賓	bbbb
邠	bbeb
儐	bbrb
鑌	bbjb
髕	bbgb
鬢	bbab
擯	bbfb
檳	bbmb
殯	bbdb
濱	bbdb
瀕	bbda
繽	bbsb
鉋	bcjv
剝	bcdv
報	bcty
飽	bcuv
嫑	bcan
鮑	bcav
寶	bcbb
鴇	bcnp
齙	bciv
枹	bcmv
襬	bdyv
唄	bdkb
拝	bdff
擺	bdfv
敗	bdwb
賁	bfbu
倴	bfrc
錛	bfjc
喯	bfkc
坋	bftd
掤	bffo
栟	bfmc
犇	bfnn
祊	bgpf
綳	bgso
繃	bgso
蚄	bhif
謗	bhyf
鎊	bhjf
塝	bhtf
幫	bhtj
搒	bhff
棓	bhmk
綁	bhse
肶	biop
苾	bicp
蓽	bica
賁	bibu
赑	bibb
蹕	biza
佖	birp
鉍	bijp
咇	bikx
閉	bimp
闢	biuu
嗶	bika
坒	biat
屄	biub
幣	bijx
斃	bixv
沘	bidp
潷	bida
畢	bita
痺	bibu
皕	biab
祕	bipp
筆	biva
篳	biva
紕	bisv
辦	bjll
鈑	bjjy
闆	bjmk
頒	bjba
姅	bjna
攽	bjbw
昄	bjoy
柈	bjma
絆	bjsa
蛃	bkir
並	bkqa
併	bkrc
餅	bkuc
抦	bkfr
昺	bkor
梹	bkmb
檳	bkmb
稟	bkwh
萹	bmcc
變	bmws
貶	bmbn
辮	bmsu
辯	bmyu
辺	bmzd
邊	bmzp
変	bmww
鯿	bmac
抃	bmfd
昪	bmoc
碥	bmuc
籩	bmvz
編	bmsa
緶	bmsn
脿	bnoy
蔈	bncx
藨	bnch
俵	bnry
儦	bnrh
錶	bnjy
鏢	bnjx
鑣	bnjh
颮	bnfv
飆	bnqf
飈	bnfh
驃	bnmx
驫	bnmm
骉	bnmm
鰾	bnax
幖	bnjx
摽	bnfx
標	bnmx
瘭	bnbx
葧	bocl
蔔	boct
袯	bopy
襏	bopy
僰	bora
鈸	bojd
鉑	bojb
剝	bodv
鉢	boja
哱	bokz
噃	bokt
餑	bouz
駁	bomx
鮊	boab
鲌	boab
鵓	bonu
嶓	boet
抜	bofy
撥	bofy
桲	bomz
榑	bomc
欂	bomc
砵	boia
別	bpdk
鱉	bpax
彆	bpgx
癟	bpbc
蔀	buce
蔔	buct
補	bupd
佈	burj
鈈	bujd
鈽	bujj
埗	butp
餔	buud
鯆	buad
歩	buvp
貝	bwob
踎	bwzk
輩	bwia
備	bwra
鋇	bwjb
唄	bwkb
鵯	bwnp
憊	bwxr
揹	bwfo
棓	bwmk
椑	bwmu
狽	bwqb
痺	bwbu
盃	bwma
肏	ccrr
巣	ccdn
財	cdbp
啋	cdkm
寀	cdbm
採	cdfm
綵	cdsm
纔	cdsd
側	cerd
冊	ceaa
廁	cegd
惻	cexd
柵	cema
測	cedd
傖	cfrk
層	cguo
嶒	cgeo
曽	cgbo
艙	chvk
蒼	chck
蔵	chca
倉	chrk
鶬	chnr
鸧	chnr
滄	chdk
玱	chwv
瑲	chwk
罉	chru
茲	cics
莿	cicd
詞	ciyk
賜	cibp
佽	cirq
辭	civu
勅	cial
餈	ciud
餈	cisd
鶿	cinq
枱	cimk
䅟	cjhp
蔘	cjcp
蠶	cjai
參	cjsp
驂	cjmp
黲	cjhp
慘	cjxp
慚	cjxj
	cjhp
殘	cjdg
燦	cjhm
穇	cjhp
莝	coct
剒	codc
銼	cojt
錯	cojo
唶	coko
鹺	coag
躥	crzu
鑹	crju
攛	crfu
攢	crfb
竄	crbu
聰	csex
蓯	cscr
蔥	cscx
叢	csay
囪	cspx
驄	csmx
従	csrr
從	csrr
悰	csxx
樅	csmr
崒	cvei
焠	cvhu
粋	cvmu
邨	cyua
吋	cykv
輳	czid
幬	czjc
湊	czdd
荙	dacz
薘	dacz
跶	dazz
躂	dazz
達	dazy
咑	dakd
噠	dakz
垯	datz
韃	dagz
墶	datz
憚	daxa
	dadz
澾	dadz
㳠	dadz
舠	dcvd
導	dccv
島	dcne
幬	dcjc
捯	dcfd
搗	dcfe
擣	dcfc
梼	dcmc
檮	dcmc
燾	dchu
盜	dcmd
禱	dcpc
稲	dcho
詒	ddyk
貸	ddbr
叇	ddez
靆	ddyz
垈	ddtr
帶	ddfj
紿	ddsk
鍀	dejc
嘚	dekc
徳	derx
扽	dffv
僜	dgra
鄧	dgev
鐙	dgjd
憕	dgxa
櫈	dgmj
燈	dghd
蕩	dhcp
襠	dhpt
讜	dhyh
儅	dhrt
鐺	dhjt
噹	dhkt
垱	dhte
壋	dhtt
黨	dhxh
擋	dhft
檔	dhmt
氹	dhdg
珰	dhwe
璫	dhwt
當	dhxt
盪	dhmd
碭	dhup
䃅	diuu
菂	dicd
䗖	diij
螮	diij
覿	diuj
詆	diyd
諦	diyj
逓	dizp
遞	dizp
鏑	dijk
哋	dikx
啲	dikd
埞	ditr
墑	ditk
媂	dinj
尐	dixn
敵	diwl
杕	dimd
滌	didm
牴	dind
磾	diua
禘	dipj
糴	dirf
締	disj
膽	djok
誕	djyv
賧	djbh
赕	djbh
亶	djwa
鄲	djek
単	djxa
啗	djka
單	djka
噉	djkw
彈	djga
惔	djxh
憚	djxa
憺	djxk
揼	djfd
撢	djfu
撣	djfa
擔	djfk
殫	djda
沊	djdd
癉	djba
簞	djva
羶	djya
萣	dkcr
訂	dkyd
釘	dkjd
鋌	dkjz
錠	dkjr
頂	dkda
飣	dkud
饤	dkud
鈿	dmjt
電	dmyv
顛	dmua
墊	dmtu
巔	dmea
點	dmhk
扂	dmhk
捵	dmfb
澱	dmdy
癲	dmba
誂	dnyd
調	dnyk
釣	dnjd
銚	dnjd
銱	dnjj
鯛	dnak
屌	dnuj
鳥	dnnh
鵰	dnnk
弔	dnga
弔	dnva
椆	dnmk
汈	dnda
亸	dowa
剟	dody
鐸	doju
嚲	dowa
埵	dota
墮	dote
奪	dodc
馱	domd
杕	domd
㙍	doty
綞	dosa
䏲	dpop
諜	dpym
咥	dpkt
鰈	dpam
昳	dpon
楪	dpmm
畳	dptq
疊	dptq
絰	dpst
绖	dpst
丟	dqps
銩	dqjs
耑	drea
鍛	drjy
塅	drty
斷	drsj
籪	drvj
緞	drsy
腖	dson
苳	dscd
丼	dsad
凍	dsdd
動	dspl
崬	dsen
鶇	dsna
鼕	dsud
戙	dskg
東	dsan
棟	dsmd
読	duye
讀	duyb
賭	dubo
鍍	dujy
厾	dugs
闍	dumo
姤	dunk
黷	duhb
櫝	dumb
瀆	dudb
牘	dupb
犢	dunb
獨	duqi
篤	duvm
兌	dvbe
鐓	dvjw
隊	dven
対	dvdc
對	dvac
懟	dvxa
躉	dycz
鈍	dyjv
噸	dyka
坉	dytv
頓	dyaa
忳	dyxv
惇	dyxz
揼	dyfd
楯	dymo
燉	dyhw
脰	dzoa
読	dzye
讀	dzyb
鈄	dzju
哣	dzka
唞	dzku
鬥	dzaa
枓	dzmu
竇	dzbb
訛	eeyv
諤	eeyg
軛	eeiv
鋨	eejd
鍔	eejg
咹	eekn
閼	eemd
噁	eekx
堊	eeta
堨	eetr
額	eeba
顎	eeka
餓	eeud
姶	eenk
鱷	eeak
崿	eeev
鵝	eenp
鶚	eenk
齶	eevg
悪	eexa
惡	eexa
痾	eebk
誒	eiyu
欸	eisq
奀	enad
耏	erap
貳	erqb
邇	erza
児	erae
兒	erpe
鉺	erje
咡	erke
餌	erue
鮞	eraa
鲕	eraa
鴯	erna
弍	ered
弐	erad
爾	erax
閥	famg
髪	favy
琺	faws
発	favv
發	favy
罰	fasd
僨	ffrb
坋	fftd
墳	fftb
奮	ffdt
鱝	ffab
鼢	ffud
憤	ffxb
棻	ffcm
濆	ffdb
瞓	ffoa
糞	ffmb
紛	ffsd
諷	fgyf
豊	fgad
豐	fgad
鋒	fgjf
堼	fgtt
風	fgji
馮	fgdm
峯	fgef
鳳	fgjh
崶	fgec
楓	fgmf
沨	fgdx
渢	fgdf
灃	fgdd
瘋	fgbf
碸	fguf
縫	fgsz
蚄	fhif
訪	fhyf
倣	fhrw
鈁	fhjf
鍅	fhjs
魴	fhaf
昉	fhof
紡	fhsf
販	fjby
釩	fjjd
鐇	fjjt
墦	fjtt
飯	fjuy
氾	fjdv
汎	fjdd
煩	fjha
璠	fjwt
礬	fjum
範	fjvv
仏	fors
彿	fopa
彿	fora
膚	fuho
艴	fuvv
芣	fucx
茀	fuca
䓛	fuce
複	fupw
襆	fujn
訃	fuyd
負	fubd
賦	fubd
賻	fubc
仏	furs
輔	fuid
伕	furd
伕	fuan
輻	fuit
咈	fuka
垺	futz
駙	fumc
婦	funj
鮒	fuac
鰒	fuaw
鳧	funj
麩	fuan
彿	fupa
彿	fura
復	furw
払	fufs
撫	fufh
榑	fumc
洑	fudq
㕮	fukx
砆	fuun
㳇	fudx
紱	fusd
紼	fusa
縛	fusc
誹	fwya
費	fwbv
剕	fwda
鐨	fwjb
飛	fwvd
鯡	fwaa
屝	fwua
廃	fwgv
廢	fwgy
朏	fwoe
棐	fwam
緋	fwsa
缹	fzhf
軋	gaiv
釓	gajv
夾	gaan
曱	gaka
㗎	gakm
誥	gcyk
鋯	gcjk
鎬	gcjk
睪	gcsu
縞	gcsk
荄	gdcr
蓋	gdcm
該	gdyr
賅	gdbr
鈣	gdjg
鎅	gdja
晐	gdor
個	gerk
鉻	gejk
鎘	geja
閣	gemk
閤	gemk
嗰	gekk
嘅	geke
頜	gera
餎	geuk
饹	geuk
鴿	genr
擱	gefk
箇	gevk
紇	gesg
亙	gfaa
賡	gggb
頸	ggva
鯁	ggan
鶊	ggng
鹒	ggng
綆	ggsn
舡	ghvg
冮	ghdg
剛	ghdk
堽	ghtv
岡	ghkk
崗	ghek
戇	ghxl
棡	ghmk
槓	ghmb
㭎	ghmx
筻	ghvn
綱	ghsk
贛	gjlb
趕	gjzu
咁	gjka
尷	gjum
幹	gjuu
桿	gjmu
玕	gjwu
稈	gjhu
紺	gjsc
㽏	gjdc
夬	gkvn
柺	gkml
鉱	gljs
垙	gltg
広	glgs
廣	glgb
洸	glde
獷	glqb
腘	goow
膕	gooa
蟈	goia
過	gozk
鍋	gojk
咼	gokk
啯	gokw
嘓	goka
國	goka
堝	gotk
幗	goja
摑	gofa
槨	gome
渦	godk
蒄	grcc
観	grrj
觀	gryj
貫	grbv
咲	grkd
関	grmd
關	grma
館	gruk
鰥	grad
鸛	grnc
慣	grxb
摜	grfb
毌	grvu
爟	grhf
綸	grsc
䢼	gsec
貢	gsbg
唝	gskb
嗊	gskb
鞏	gsgg
宮	gsbk
龔	gslb
蓇	guco
䓛	guce
蠱	gumi
詁	guyk
賈	gubx
軲	guik
轂	guuy
僱	gurf
鈷	gujk
錮	gujk
堌	gutk
顧	guha
鯝	guak
鲴	guak
鴣	gunu
鶻	gung
榖	guuy
穀	guuy
規	gvaj
詭	gvyv
貴	gvba
軌	gvij
鄶	gver
劊	gvdr
劌	gvdv
匭	gvkj
匱	gvkb
閨	gvmt
闠	gvmb
阓	gvmb
姽	gvnv
媯	gvnh
嬀	gvnh
鮭	gvat
鱖	gvaq
嶲	gveg
帰	gvaj
廆	gvgg
龜	gvpx
攰	gvul
檜	gvmo
櫃	gvmb
歸	gvpe
氿	gvdj
給	gwsk
詿	gxyt
剮	gxdk
銛	gxjk
咼	gxkk
铦	gxjk
啩	gxkd
坬	gxtg
颳	gxfk
鴰	gxnp
掛	gxfd
袞	gywy
輥	gyiv
鯀	gyas
滾	gydy
緄	gysv
耇	gztk
覯	gzaj
觏	gzcj
詬	gzyk
購	gzba
鉤	gzjk
韝	gzaa
夠	gzdk
姤	gznk
搆	gzfa
構	gzma
溝	gzda
緱	gzsu
鉿	hajk
噏	haky
#jp	hanjihanji
號	hckj
蠔	hcin
侴	hcrd
鎬	hcjk
顥	hcoa
灝	hcda
還	hdzy
咍	hdkk
嗐	hdkk
駭	hdmr
覈	hexw
訶	heyk
賀	hebl
郃	heer
咼	hekk
閡	hemr
閤	hemk
闔	hemm
嚇	hekv
嚇	hekd
垎	hetk
頜	hera
鶴	hend
齕	heig
龁	heig
暍	heov
盉	hemh
紇	hesg
姮	hgna
恆	hgxa
橫	hgmb
頏	hhwa
絎	hhsd
绗	hhsd
蔊	hjcu
虷	hjiu
闞	hjmw
垾	hjtu
韓	hjua
頇	hjaa
頷	hjra
駻	hjmu
崡	hjek
嵅	hjeg
扞	hjfu
暵	hjod
浛	hjdk
漢	hjdn
㘎	hjkw
㘚	hjkw
耲	hkly
壊	hkty
壞	hkty
懐	hkxy
懷	hkxy
㷫	hkhh
艎	hlvw
謊	hlyv
鍠	hljw
锽	hljw
喤	hlkw
塃	hltv
媓	hlnw
鰉	hlaw
黃	hlcb
滉	hldg
㿠	hlbg
耠	holk
貨	hobr
佸	hork
鈥	hojh
鍃	hojx
鑊	hojy
嚄	hoky
彟	hoey
彠	hoey
擭	hofy
獲	hoqy
禍	hopk
穫	hohy
㸌	hoha
荁	hrca
䴉	hrns
還	hrzy
鍰	hrjy
鐶	hrjy
镮	hrjy
喚	hrkn
奐	hrdn
嬛	hrny
鯇	hrae
峘	hrea
鹮	hrns
換	hrfn
歓	hrrq
歡	hrcq
渙	hrdn
煥	hrhn
環	hrwy
瘓	hrbn
㬊	hroy
緩	hrsy
繯	hrsy
葒	hscg
葓	hscb
訌	hsyg
轟	hsii
吽	hskn
唝	hskb
閎	hsms
嗊	hskb
鬨	hsab
鴻	hsdn
黌	hsdb
竑	hsls
紅	hssg
紘	hsss
衚	hurd
覈	huxw
護	huyc
軤	huia
轷	huia
壺	huua
餬	huuo
姱	hunv
嫭	hunu
鬍	huao
鯱	huyj
鵠	hunn
鶘	hunu
鶻	hung
鸌	huny
戶	hupu
昈	huoh
昒	huop
楛	humk
沍	huda
淴	hudx
滸	hudu
薈	hvco
袆	hvpa
褘	hvpa
詼	hvyh
誨	hvyd
諱	hvya
譭	hvyy
賄	hvbo
輝	hvgi
迴	hvzk
匯	hvkd
噦	hvkp
墮	hvte
廆	hvgg
彙	hvvn
恵	hvxa
揮	hvfi
暉	hvoi
會	hvro
槥	hvme
橞	hvmx
檜	hvmo
毀	hvpy
澮	hvdo
燬	hvhy
燴	hvho
琿	hvwi
穢	hvhd
絵	hvss
繢	hvsb
繪	hvso
翚	hvyi
翬	hvyi
閪	hwmx
黒	hwhh
華	hxca
話	hxyk
譁	hxka
劃	hxdv
鏵	hxja
嘩	hxku
驊	hxma
婳	hxnk
嫿	hxna
樺	hxma
畫	hxaa
葷	hyci
諢	hyyi
閽	hymo
餛	hyuv
婫	hynv
惛	hyxo
渾	hydi
琿	hywi
垕	hzpt
餱	hzmu
鱟	hzpa
睺	hzou
詑	iayv
詫	iayq
侘	iarq
剎	iadx
鍤	iaja
鑔	iajx
垞	iatq
餷	iaua
奼	ianq
嵖	iaea
挿	iafa
梌	iamh
耖	iclp
鈔	icjp
勦	icvl
巣	icdn
弨	icgk
槱	icmh
綽	icsu
茝	idck
蠆	idci
儕	idra
釵	idjd
車	ieaa
俥	ieri
唓	ieki
屮	ieva
徹	iewr
硨	ieui
㬚	ieow
襯	ifpj
諶	ifyv
讖	ifyg
偁	ifra
傖	ifrk
陳	ifed
塵	iflt
齔	ifiv
梣	ifmg
棽	ifmg
櫬	ifmj
磣	ifup
稱	ifha
蟶	igiw
誠	igyv
乗	igpn
偁	igra
鋮	igjv
鐺	igjt
騁	igmg
宬	igbv
庱	iggw
憕	igxa
懲	igxr
搶	igfk
撐	igfp
棖	igmn
檉	igmw
琤	igwa
稱	igha
腸	ihop
萇	ihcn
倀	ihrn
償	ihrb
錩	ihjo
锠	ihjo
長	ihan
閶	ihmo
嘗	ihxo
嚐	ihko
場	ihtp
鯧	ihao
廠	ihiw
悵	ihxn
暢	ihap
胣	iioy
佁	iirk
遅	iizy
遲	iizu
勅	iial
呎	iikn
喫	iikd
飭	iiul
奓	iidd
馳	iimv
鴟	iinp
黐	iips
齒	iivk
恥	iiex
摛	iifs
歯	iivk
熾	iihb
蕆	ijcb
蟬	ijia
覘	ijaj
諂	ijya
讒	ijyd
儳	ijrd
刬	ijdg
剗	ijdg
剷	ijdl
単	ijxa
鏟	ijjf
鐔	ijju
啴	ijka
單	ijka
闡	ijma
嘽	ijka
囅	ijkn
顫	ijwa
饞	ijud
驏	ijmz
嬋	ijna
巉	ijev
懺	ijxd
摻	ijfp
攙	ijfd
旵	ijoe
梴	ijmz
毚	ijdd
浐	ijdi
滻	ijdf
瀍	ijdt
產	ijwf
禪	ijpa
纏	ijst
創	ildr
闖	ilmm
噇	ilka
愴	ilxk
橦	ilma
牀	ildm
瘡	ilbk
輟	ioiy
婥	ionu
齪	ioiz
惙	ioxy
綽	iosu
伝	irrs
傳	irrc
釧	irja
圌	irka
堾	irto
蟲	isii
衝	isrd
銃	isje
埫	istk
寵	isbl
摏	isfa
沖	isda
種	isha
㳘	isde
翀	isya
芻	iuge
蒭	iuce
處	iuhj
䝙	iuvk
䢺	iuee
觸	iuji
貙	iuvk
躕	iuzc
俶	iury
儲	iuro
処	iuwj
鋤	iujl
闘	iumc
雛	iugf
廚	iugc
齣	iuvk
摴	iufv
斶	iuji
柷	iume
歜	iusq
礎	iuur
絀	iusk
倕	ivra
錘	ivja
圌	ivka
惙	ivxy
欻	ixhq
脣	iyio
蓴	iycc
䲠	iyyo
鰆	iyyo
鶉	iynw
純	iysv
裯	izpk
讎	izyf
躊	izzc
儔	izrc
醜	izvg
婤	iznk
幬	izjc
搊	izfe
杻	izma
梼	izmc
椆	izmk
檮	izmc
疇	iztc
籌	izvc
綢	izsk
藎	jbcm
覲	jbcj
謹	jbya
贐	jbbm
進	jbzf
僅	jbrf
儘	jbrm
勁	jbal
錦	jbjj
墐	jbta
壗	jbtm
饉	jbuf
巹	jbvv
慬	jbxa
晉	jbao
殣	jbdf
燼	jbhm
盡	jbmv
緊	jbks
縉	jbso
耤	jilo
薊	jicd
薺	jica
蟣	jiid
覬	jiej
計	jiyu
記	jiyv
詰	jiyk
譏	jiyd
跡	jizd
蹟	jizb
躋	jiza
伋	jirn
輯	jiie
係	jirx
係	jips
剤	jidw
劑	jidw
勣	jifl
嚌	jika
際	jiex
雞	jinv
霽	jiya
垍	jito
堲	jitv
塈	jitv
飢	jiuj
饑	jiud
姞	jink
驥	jimb
鯽	jiae
鱭	jiaa
鶏	jinv
鶺	jind
幾	jisg
齎	jiwa
齏	jiwa
徛	jirk
惎	jiqx
撃	jiui
擊	jiui
擠	jifa
枅	jimc
極	jima
機	jimj
檵	jimv
済	jida
濟	jida
璣	jiwd
㓤	jidu
磯	jiud
積	jihb
紀	jisv
級	jisn
給	jisk
継	jisv
緝	jise
績	jisb
繫	jisa
繼	jisv
羈	jism
脛	jkog
荊	jkcd
莖	jkcg
䴖	jknf
逕	jkza
倞	jkrx
剄	jkda
勁	jkal
鎌	jkjn
鏡	jkje
靚	jkfj
靜	jkfa
頸	jkva
驚	jkcm
鯨	jkax
鶄	jknf
弳	jkgg
徑	jkrg
汫	jkda
浄	jkda
涇	jkdg
淨	jkda
璟	jkwx
痙	jkbg
競	jkle
経	jkst
經	jksg
膙	jloi
蔣	jlcc
薑	jlya
講	jlya
醤	jlyd
醬	jlyd
奨	jldd
將	jldc
弶	jlgx
強	jlgi
彊	jlga
槳	jlmd
殭	jlda
漿	jldd
烱	jlhk
獎	jldq
絳	jlsa
繮	jlsa
艦	jmvm
艱	jmcn
薦	jmch
襇	jmpo
襉	jmpo
見	jmoe
諫	jmyn
譾	jmyy
賤	jmbg
踐	jmzg
倹	jmrn
儉	jmrr
剣	jmdd
劍	jmdr
鍵	jmjz
鐗	jmjo
鐧	jmjo
鑑	jmjm
鑒	jmjk
間	jmmo
鞬	jmgz
韉	jmgh
堅	jmtk
餞	jmug
姦	jmnn
鰹	jmat
鶼	jmnq
鹸	jman
鹼	jmar
戔	jmgg
戩	jmag
揀	jmfd
撿	jmfr
暕	jmon
梘	jmmj
検	jmmn
樫	jmmt
檢	jmmr
檻	jmmm
殲	jmdd
減	jmdk
漸	jmdj
澗	jmdo
濺	jmdg
監	jmmk
瞼	jmor
礆	jmua
筧	jmvj
箋	jmvg
簡	jmvo
緘	jmsk
縑	jmsn
繭	jmci
腳	jnoe
膠	jnop
藠	jncb
覚	jnxj
覺	jnpj
䴔	jnnw
較	jnif
轎	jnik
僥	jnre
鉸	jnjf
勦	jnvl
餃	jnuf
驕	jnmk
嬌	jnnk
鮫	jnaf
峧	jnef
鵁	jnnw
嶠	jnek
鷦	jnnr
恔	jnxf
撟	jnfk
撹	jnfj
攪	jnfj
斠	jncu
澆	jnde
矯	jnuk
筊	jnvx
絞	jnsf
繳	jnsw
耤	jplo
蜐	jpil
訐	jpyu
詰	jpyk
誡	jpyd
𠝹	jpdt
価	jprx
傑	jprm
價	jprb
劼	jpul
階	jpeb
頡	jpua
鮚	jpak
屆	jpua
岊	jpve
悈	jpxg
掲	jpfv
桝	jpma
檞	jpmn
潔	jpds
玠	jpwa
癤	jpbe
㛃	jpnf
節	jpve
結	jpsk
舊	jqca
鬮	jqav
鳩	jqnj
鷲	jqnw
廄	jqgy
氿	jqdj
㠇	jqed
糺	jqsv
糾	jqsa
錈	jrjv
鐫	jrjg
雋	jrrg
圏	jrkv
婘	jrnv
鵑	jrnk
嶲	jreg
巻	jrbv
捲	jrfv
捲	jrbv
朘	jrow
棬	jrmv
絹	jrso
䌹	jssk
䐃	jsok
䢛	jszk
冏	jskk
囧	jskk
坰	jstk
泂	jsdk
烱	jshk
絅	jssk
覚	jtxj
覺	jtpj
訣	jtyn
譎	jtyk
傕	jtrf
叕	jtyy
鐝	jtjq
钁	jtjy
埆	jttj
鱖	jtaq
鴃	jtnn
決	jtdn
玦	jtwn
㵐	jtdq
絕	jtsv
腒	juok
舉	jupa
蒟	juck
詎	juya
䴗	juno
跼	juzk
車	juaa
侷	jurk
鉅	jujk
鉅	juja
劇	judh
鋦	jujk
鋸	jujk
颶	jufb
駒	jumk
娵	juny
屨	juun
岠	juek
岨	jueq
崌	juek
鶪	juno
弆	jutc
齟	juiq
懼	juxf
拠	jufj
挙	juxu
據	jufn
櫃	jumb
櫸	juma
泃	judk
焗	juhk
窶	jubn
莢	jxcn
蛺	jxin
賈	jxbx
仮	jxry
価	jxrx
傢	jxrn
郟	jxea
價	jxrb
鉀	jxja
鋏	jxjn
鎵	jxjn
叚	jxvy
頡	jxua
頰	jxaa
夾	jxan
駕	jxml
挾	jxfn
斝	jxku
槚	jxmb
檟	jxmb
泇	jxdk
浹	jxdn
㗎	jxkm
筴	jxvn
莙	jyck
葰	jycw
軍	jybi
儁	jyrg
鈞	jyjd
雋	jyrg
駿	jymw
龜	jypx
晙	jyow
濬	jydo
焌	jyhw
珺	jywk
皸	jybp
銬	kcjg
㸆	kcha
蒈	kdcb
凱	kdej
剴	kdde
鍇	kdjb
鎧	kdjd
鐦	kdjc
開	kdmk
塏	kdtd
愒	kdxv
愷	kdxd
愾	kdxm
課	keyn
趷	kezv
軻	keik
鈳	kejk
剋	kedu
剋	keud
鉿	kejk
錁	kejn
匼	kekk
頦	kewa
顆	keaa
騍	kemn
悈	kexg
殻	keuy
殼	keuy
渇	kedv
痾	kebk
㞹	keek
緙	kesg
墾	kftv
齦	kfin
懇	kfxv
珢	kfwy
鏗	kgjt
鈧	khjj
閌	khmj
鱇	khyx
犺	khqj
衎	kjrd
轗	kjix
冚	kjbe
闞	kjmw
墈	kjtl
崁	kjeq
嵁	kjev
龕	kjrl
檻	kjmm
磡	kjul
膾	kkoo
蕢	kkcb
儈	kkro
鄶	kker
噲	kkko
塊	kktg
鱠	kkao
擓	kkfk
會	kkro
澮	kkdo
獪	kkqo
㧟	kkfk
誆	klyw
誑	klyw
貺	klbe
鄺	kleg
劻	klkl
壙	kltb
夼	klda
拡	klfs
曠	klob
況	klde
礦	klub
纊	klsb
啹	kokk
闊	komk
拡	kofs
擴	kofb
髖	krgd
寛	krbj
寬	krbd
梡	krme
埪	kstg
褲	kupi
嚳	kupk
圐	kukf
庫	kugi
朏	kuoe
楛	kumk
矻	kuug
絝	kusg
聵	kveb
蕢	kvcb
虧	kvhg
匱	kvkb
饋	kvub
巋	kvej
憒	kvxb
戣	kvvg
櫆	kvmu
潰	kvdb
瞶	kvob
窺	kvbj
簣	kvvb
剋	kwdu
剋	kwud
誇	kxyg
姱	kxnv
骻	kxgg
裈	kypi
褌	kypi
錕	kyjv
閫	kymm
堃	kytf
壸	kyua
壼	kyua
婫	kynv
鯤	kyav
崑	kyev
梱	kymm
焜	kyhv
睏	kyok
睏	kyom
釦	kzjk
摳	kzfk
瞘	kzok
臘	laov
蝋	laia
蝲	laid
蠟	laiv
鑞	lajv
臨	lbkk
藺	lbcf
賃	lbbr
躪	lbzf
轔	lbia
鄰	lbem
凜	lbdh
鱗	lbaa
廩	lbgh
懍	lbxh
檁	lbmh
粦	lbma
耢	lcll
耮	lcll
荖	lccp
銠	lcjv
労	lcxl
勞	lchl
鐒	lcjl
铑	lcjv
嘮	lckl
嫪	lcnp
嶗	lcel
撈	lcfl
澇	lcdl
癆	lcbl
絡	lcsk
萊	ldcn
賚	ldba
賴	ldab
來	ldan
俫	ldrn
倈	ldrn
錸	ldjn
頼	ldab
崍	lden
徠	ldrn
梾	ldmn
棶	ldmn
淶	lddn
瀨	lddb
瀬	ldda
癩	ldbb
睞	ldon
籟	ldvb
餎	leuk
饹	leuk
鰳	leal
擽	lefm
楽	lemd
樂	lemv
瞭	leox
冧	lfbm
堎	lgtw
崚	lgew
稜	lgmw
蒗	lhcn
蓢	lhco
鋃	lhjn
唥	lhks
閬	lhmn
埌	lhtn
塱	lhtd
崀	lhen
桹	lhmn
㫰	lhon
㮾	lhmd
脷	liod
蒞	licl
藶	licv
蘺	licf
蠣	liid
裏	liwy
裡	lipt
貍	lipt
躒	lizm
轢	liim
轣	liiv
邐	liza
儷	lirl
酈	liea
釐	liaa
凓	lidm
鋰	lija
勵	liil
厲	liid
叕	liyy
唎	likd
嚟	likd
嚦	likv
隷	liun
隸	limn
離	liwf
靂	liyv
壢	litv
驪	liml
鯉	liaa
鱧	liad
鱺	lial
峛	lied
鸝	lina
麗	lial
慄	lixm
戻	lihd
暦	liio
曆	liio
朸	liml
櫟	limm
櫪	limv
欐	liml
歴	liiv
歷	liiv
浬	lidt
瀝	lidv
灕	lidf
犛	lian
琍	liwd
癘	libd
癧	libv
礪	liud
礫	lium
禮	lipd
㰀	limd
籬	livf
糲	limd
綟	lisq
縭	liss
藍	ljcm
蘭	ljcn
襤	ljpm
襴	ljpn
覧	ljjk
覽	ljjk
讕	ljyd
躝	ljzj
躝	ljzn
𨅬	ljzn
鑭	ljjd
闌	ljmd
嵐	ljef
懶	ljxb
攔	ljfn
攬	ljfj
斕	ljwd
暕	ljon
欄	ljmd
欖	ljmj
濫	ljdm
瀾	ljdd
灠	ljdj
爛	ljhs
籃	ljvm
繿	ljsm
纜	ljsj
舲	lkvs
蔆	lkcw
鈴	lkjs
霊	lkya
靈	lkya
坽	lkts
領	lkra
姈	lkns
鯪	lkaw
鴒	lknr
崚	lkew
嶺	lkea
鸰	lknr
齡	lkis
齢	lkis
○	lkvv
昤	lkos
櫺	lkmk
欞	lkmr
淩	lkdw
〇	lkoo
㥄	lkxw
稜	lkmw
綾	lksw
諒	llyx
両	llak
輛	llir
俍	llrn
倆	llrr
倞	llrx
兩	llar
鍄	lljx
唡	llkr
啢	llkr
喨	llkj
靚	llfj
魎	llgr
悢	llxn
樑	llmm
涼	lldx
糧	llma
聯	lmea
臉	lmor
蓮	lmcz
蔹	lmcw
薟	lmcr
蘞	lmcw
褳	lmpz
襝	lmpr
連	lmzi
錬	lmjn
鍊	lmjn
鎌	lmjn
鏈	lmjz
鐮	lmjn
嗹	lmkz
奩	lmdk
鰱	lmaz
憐	lmxa
戀	lmxs
斂	lmwr
梿	lmmz
槤	lmmz
殮	lmdr
漣	lmdz
瀲	lmdw
煉	lmhd
璉	lmwz
簾	lmvn
練	lmsn
縺	lmsz
遼	lnzx
釕	lnja
鐐	lnjx
嫽	lnnx
鷯	lnna
憭	lnxx
暸	lnox
橑	lnmx
療	lnbx
瞭	lnox
繚	lnsx
腡	look
蓏	locg
蘿	locf
躒	lozm
邏	lozs
儸	lorf
鏍	lojs
鑼	lojf
啰	lokd
囉	lokf
駱	lomk
騾	loms
欏	lomf
濼	lodm
犖	lohn
玀	loqf
㑩	lord
砢	louk
籮	lovf
絡	losk
羅	losf
脟	lpoc
䴕	lpnd
哷	lpkc
鴷	lpnd
猟	lpqa
獵	lpqv
蹓	lqzt
劉	lqdp
鋶	lqjv
鎦	lqjt
鏐	lqjp
陸	lqet
餾	lqut
騮	lqmt
鶹	lqnp
鷚	lqny
鹠	lqnp
瀏	lqdd
綹	lqsk
臠	lrwr
亂	lrvv
鑾	lrjs
孌	lrns
孿	lrjs
巒	lres
鸞	lrws
攣	lrus
欒	lrms
灤	lrdm
聾	lsle
蘢	lscl
哢	lskc
嚨	lskl
隴	lsel
壟	lstl
壠	lstl
尨	lsud
龍	lsla
攏	lsfl
昽	lsol
曨	lsol
朧	lsol
櫳	lsml
滝	lsdv
瀧	lsdl
瓏	lswl
礱	lslu
竜	lslv
籠	lsvl
䂮	ltfu
鋝	ltjc
圙	ltka
臚	luom
艫	luvm
菉	lucd
蕗	luck
蘆	lucm
虜	luhl
賂	lubk
輅	luik
轆	luil
轤	luim
僇	lurp
勠	luyl
錄	luvd
録	lujd
鑥	lujo
陸	luet
嚕	luko
顱	luha
壚	lutm
魯	luao
鱸	luam
鷺	lunz
鸕	lunh
鹵	luax
廬	lugm
彔	luvd
擄	lufl
擼	lufo
櫓	lumo
櫨	lumm
氌	lumo
淥	ludd
滷	luax
瀘	ludm
爐	luhm
琭	luwd
盧	luhm
硵	luux
磠	luux
祿	lupd
箓	luvd
籙	luvd
綠	lusd
緑	lusd
葎	lvca
褸	lvpn
侶	lvrk
僂	lvrn
鋁	lvjk
呂	lvkk
哷	lvkc
閭	lvmk
垏	lvta
驢	lvmm
屢	lvun
慮	lvhx
梠	lvmk
櫚	lvmk
濾	lvdx
稆	lvhk
穭	lvho
綠	lvsd
緑	lvsd
縷	lvsn
藟	lwct
誄	lwyn
鐳	lwjt
嚟	lwkd
塁	lwtt
類	lwma
壘	lwtt
戻	lwhd
攰	lwul
楽	lwmd
涙	lwdd
淚	lwdq
礌	lwut
縲	lwss
論	lyya
輪	lyic
侖	lyrc
倫	lyrc
圇	lykc
崙	lyrc
掄	lyfc
淪	lydc
綸	lysc
耬	lzln
䁖	lzon
蔞	lzcn
螻	lzin
僂	lzrn
剅	lzda
鏤	lzjn
嘍	lzkn
婁	lzan
髏	lzgn
嶁	lzen
摟	lzfn
樓	lzmn
瘻	lzbn
瞜	lzon
簍	lzvn
螞	maim
嗎	makm
嘜	makd
馬	maah
媽	manm
嫲	mang
嬤	mand
嬤	mans
孖	mazz
榪	mamm
獁	maqm
瑪	mawm
碼	maum
祃	mapm
禡	mapm
罵	mams
閔	mbmw
閩	mbmi
鰵	mbar
黽	mbav
忞	mbwx
憫	mbxw
旻	mbow
緡	mbso
芼	mccm
貓	mcvt
貿	mcbp
冇	mcuk
鉚	mcje
錨	mcjt
楙	mcmm
犛	mcan
脈	mdon
蕒	mdcb
買	mdbs
賣	mdbu
邁	mdzc
勱	mdcl
嘜	mdkd
売	mdue
麥	mdad
麼	megs
亹	mfwq
們	mfrm
鍆	mfjm
門	mfaa
悶	mfmx
惛	mfxo
懣	mfxd
抆	mffw
捫	mffm
燜	mfhx
錳	mgjm
夢	mgcd
尨	mgud
幪	mgjn
黽	mgav
懞	mgxx
懞	mgxn
掹	mgfm
擝	mgfm
曚	mgon
濛	mgdn
獴	mgqn
矇	mgon
㠓	mgen
鋩	mhjv
厖	mhip
铓	mhjv
尨	mhud
杗	mhwm
杧	mhmw
牤	mhnv
覓	mivj
謎	miyz
謐	miym
冪	mibj
屘	miuz
彌	migx
搣	mifa
瀰	midx
獼	miqx
瞇	mioz
祕	mipp
禰	mipx
羋	miaa
蟎	mjir
蠻	mjis
謾	mjyy
鏝	mjjy
顢	mjca
饅	mjuy
嫚	mjny
鰻	mjay
屘	mjuz
悗	mjxv
満	mjdk
滿	mjdr
瞞	mjor
縵	mjsy
蓂	mkcb
銘	mkjk
鳴	mknk
丏	mmag
偭	mmra
勔	mmal
靦	mmaj
麪	mmag
麺	mmfa
黽	mmav
愐	mmxa
澠	mmdv
綿	mmsj
緬	mmsa
鶓	mnnc
廟	mngo
緲	mnsp
繆	mnsp
脈	moon
藦	mocu
謨	moyd
鏌	mojd
饃	moud
驀	mocm
嬤	mond
嬤	mons
麼	mogs
黙	moha
歿	mody
沒	mody
無	morh
衊	mpxd
搣	mpfa
滅	mpda
謬	mqyp
嫑	mqan
繆	mqsp
鉬	mujo
霂	muym
畝	muwn
郿	mwev
鋂	mwjd
鎂	mwjd
鎇	mwjo
媄	mwnd
鶥	mwnv
黴	mwyw
毎	mwra
沒	mwdy
沬	mwdn
眛	mwon
謀	mzym
鉾	mzjn
呣	mzkd
繆	mzsp
乸	naxd
鈉	najd
錼	najx
鎿	naju
吶	nakr
嗱	naku
妠	nanr
拏	naun
納	nasd
囜	nbks
脳	ncok
腦	ncox
臑	ncoa
蟯	ncie
鐃	ncje
堖	nctx
嫐	ncnn
鬧	ncaj
峱	ncqe
悩	ncxk
惱	ncxx
撓	ncfe
橈	ncme
耏	ndap
迺	ndzx
訥	neyd
吶	nekr
奀	nfad
媆	nfnd
啱	ngou
饢	nhuy
膩	niod
薿	nicr
鈮	nijv
妳	ninx
鯢	niae
擬	nifr
暱	niok
暱	niov
萳	njcu
啱	njou
難	njcf
妠	njnr
婻	njnu
聹	nked
苧	nkcd
苧	nkca
薴	nkcd
嚀	nkkd
寧	nkbd
擰	nkfd
檸	nkmd
濘	nkdd
獰	nkqd
醸	nlyy
釀	nlyn
嬢	nlny
孃	nlny
輦	nmia
輾	nmin
唸	nmkx
鮎	nmak
鯰	nmax
捵	nmfb
撚	nmfh
攆	nmfi
蔦	nncn
裊	nnny
嫋	nnnd
嬝	nnny
鳥	nnnh
諾	noyk
儺	norf
鍩	nojk
聶	npee
菍	npcx
蘗	npcm
躡	npze
鎳	npjm
鑷	npje
噛	npkk
隉	npeg
嚙	npkv
囁	npke
顳	npea
嵲	npem
齧	npfi
惗	npxx
摂	npfd
攝	npfe
櫱	npem
鈕	nqja
鈕	nqsa
杻	nqma
紐	nqsa
膿	nson
農	nsan
儂	nsrn
噥	nskn
濃	nsdn
燶	nshn
秾	nshn
穠	nshn
㶶	nshn
瘧	ntba
傉	nurc
駑	numn
釹	nvjn
內	nwad
餒	nwun
呣	omkd
嘸	omkv
嚄	ooky
痾	oobk
謳	ouyk
區	oukk
嘔	oukk
鴎	ounk
鷗	ounk
慪	ouxk
歐	oukq
毆	ouky
漚	oudk
甌	oukw
舥	pavb
粃	pamp
貧	pbbb
頻	pbva
塀	pbtc
顰	pbvu
嬪	pbnb
藨	pcch
鉋	pcjv
奅	pcde
拋	pcfl
皰	pcpv
砲	pciv
拝	pdff
噴	pfkb
芃	pgcd
蘋	pgcb
鵬	pgon
弸	pggo
搒	pgff
椪	pgma
泙	pgdu
尨	phud
徬	phrf
苉	pice
䴙	pinu
伾	pira
鈹	pijp
闢	piuu
嚭	piuk
鷿	pinu
鸊	pinu
狉	piqa
痺	pibu
紕	pisv
罷	pisp
羆	pihh
蹣	pjzr
柈	pjma
槃	pjmv
盤	pjmv
荓	pkcc
蘋	pkcb
蚲	pkiu
評	pkyu
呯	pkku
馮	pkdm
鮃	pkau
帡	pkjc
憑	pkxd
泙	pkdu
洴	pkdc
諞	pmyc
駢	pmmc
騙	pmmc
楩	pmmn
㛹	pmnn
薸	pncx
飄	pnxf
驃	pnmx
慓	pnxx
樸	pnmd
縹	pnsx
䥽	pojd
釙	pojd
鉕	pojk
鏺	pojy
哱	pokz
頗	popa
樸	pomd
潑	pody
蒱	pucf
蜅	puzd
譜	puyo
僕	purd
鋪	pujd
鏷	pujn
鐠	pujo
墣	putn
鯆	puad
撲	pufd
樸	pumd
衃	pwxa
賠	pwbk
轡	pwks
鉳	pwjv
錇	pwjk
珮	pwwj
哣	pzka
垺	pztz
抔	pzfx
棓	pzmk
親	qblj
鋟	qbjy
唚	qbky
駸	qbmy
寢	qbby
嵚	qbeq
嶔	qbeq
慬	qbxa
撳	qbfq
欽	qbjq
臍	qioa
䓫	qick
薺	qica
蘄	qicj
蠐	qiia
訖	qiyg
豈	qied
跂	qizy
踦	qizk
鏚	qijx
呇	qidk
啓	qikh
啟	qiwh
埼	qitk
頎	qija
騎	qimk
騏	qimb
婍	qink
鰭	qiao
齊	qiwa
恓	qixx
悽	qixn
愭	qixo
慼	qixp
掲	qifv
斉	qiwa
棄	qiwm
棨	qihm
棲	qimn
榿	qimd
気	qiqx
氣	qiqm
淒	qidn
玘	qiwv
碁	qiqu
磧	qiub
祇	qipq
綺	qisk
苘	qkck
親	qklj
請	qkyo
軽	qkit
輕	qkig
傾	qkra
勍	qkwl
頃	qkaa
鯖	qkao
庼	qkga
廎	qkga
慶	qkgw
檾	qkhm
氫	qkqg
蔃	qlci
薔	qlck
蹌	qlzk
錆	qljo
鏘	qljc
鏹	qlji
嗆	qlkk
嬙	qlnk
強	qlgi
戧	qlrg
搶	qlfk
槍	qlmk
檣	qlmk
熗	qlhk
牆	qlpk
玱	qlwv
瑲	qlwk
羥	qlyg
蒨	qmco
蕁	qmcc
謙	qmyn
譴	qmyz
伣	qmrj
俔	qmrj
遷	qmzx
僉	qmrr
釺	qmju
鈐	qmjv
鉗	qmjc
鉛	qmjk
銭	qmjg
錢	qmjg
圲	qmtu
韆	qmgz
塹	qmti
墘	qmtg
騫	qmbm
孅	qmig
慳	qmxt
拑	qmfc
杄	qmmu
槧	qmmi
汧	qmdc
淺	qmdg
潛	qmdo
牽	qmwn
簽	qmvr
籤	qmvg
縴	qmsn
繊	qmsa
繾	qmsz
纖	qmsg
蕎	qnck
誚	qnyo
譙	qnyh
蹺	qnze
僑	qnrk
鍬	qnjh
喬	qnpk
鞽	qngk
嶠	qnek
橋	qnmk
橾	qnmm
殻	qnuy
殼	qnuy
硚	qnua
磽	qnue
礄	qnuk
竅	qnbw
繰	qnsm
翹	qnty
鍥	qpjd
愜	qpxn
掲	qpfv
竊	qpbs
篋	qpvn
萩	qqch
虯	qqia
讎	qqyf
賕	qqbd
赇	qqbd
鞦	qqgh
鰌	qqay
鰍	qqah
鶖	qqnh
巰	qqav
鹙	qqnh
龜	qqpx
梂	qqmd
毬	qqmd
詮	qryw
踡	qrzv
輇	qriw
佺	qrrw
辁	qriw
銓	qrjw
勧	qrrl
勸	qrcl
圏	qrkv
顴	qrca
婘	qrnv
惓	qrxv
棬	qrmv
槫	qrmc
権	qrmf
權	qrmf
綣	qrsv
䓖	qscl
藭	qscg
嬛	qsny
煢	qshu
瓊	qsww
窮	qsbg
傕	qtrf
卻	qtek
闋	qtmd
闕	qtmq
埆	qttj
鵲	qtnc
愨	qtxu
棤	qtmo
汋	qtdd
確	qtuf
胠	quos
䓛	quce
袪	qups
覷	quhj
詘	quyk
趨	quze
軀	quuk
佢	qura
區	qukk
闃	qumq
坥	qutq
駆	qumx
驅	qumk
鴝	qung
嶇	quek
麹	qufm
齲	quid
焌	quhw
㭕	qums
匼	qxkk
拤	qxfd
囷	qykh
羣	qyvy
蕘	rcce
饒	rcue
嬈	rcne
擾	rcfw
橈	rcme
繞	rcse
熱	reht
腍	rfox
菍	rfcx
認	rfyx
軔	rfid
韌	rfad
飪	rfuu
紉	rfsd
紝	rfsu
纴	rfsu
蘘	rhcy
譲	rhyy
讓	rhyy
儴	rhry
壌	rhty
穣	rhhy
囸	rikv
馹	rimo
驲	rimo
䎃	rjay
譲	rjyy
蒻	rocd
婼	ronk
軟	rriq
堧	rrtd
媆	rrnd
蠑	rsim
鎔	rsjk
镕	rsjk
嶸	rsem
栄	rsxm
榮	rshm
絨	rssu
銣	rujk
顬	ruya
嬬	runa
縟	rusc
銳	rvje
汭	rvdd
閏	rymw
潤	rydw
薩	sacf
颯	salf
灑	sadl
騒	scmi
騷	scmi
鰠	scai
鳋	scai
掃	scfj
掻	scfi
繅	scsm
繰	scsm
賽	sdbb
嗮	sdky
嘥	sdkr
鰓	sdax
銫	sejv
嗇	seak
渋	sedd
澀	sedv
穡	sehk
㴔	sedx
嬸	sfnt
喪	shun
顙	shya
虒	sipj
螄	siij
俬	sirs
偲	sirx
凘	sidj
鍶	sijx
噝	siks
飼	siuk
駟	sims
鷥	sins
廁	sigd
廝	sigj
枱	simk
楒	simx
㟃	siek
絲	siss
緦	sisx
傘	sjru
叄	sjss
饊	sjuw
毿	sjsm
鎖	sojb
嗩	sokb
愬	soxb
瑣	sowb
縮	sosb
痠	srbw
聳	sser
訟	ssys
誦	ssya
𩠌	ssuz
吅	sskk
頌	ssba
餸	ssiz
餸	ssuz
娀	ssng
鬆	ssas
慫	ssxr
㧐	ssfy
㩳	ssfy
肅	suva
蘇	such
訴	suyd
謖	suyw
傃	surx
囌	sukh
甦	suaa
甦	suaf
穌	suah
窣	subu
粛	suva
裇	svpx
誶	svyu
隨	svez
雖	svkf
髄	svgz
旞	svfz
歲	svvp
砕	svuu
穂	svhx
綏	svsn
繐	svhx
蓀	sycs
孫	syzs
損	syfb
猻	syqs
筍	syvo
蒐	szcs
蒐	szcg
藪	szcw
螋	sziy
鎪	szjy
颼	szfy
餿	szuy
廋	szgy
捜	szfy
擻	szfw
褟	tapy
鉈	tajv
闥	tamz
鰨	taay
撻	tafz
牠	tanx
獺	taqb
祂	tapx
討	tcyc
唞	tcku
鞀	tcgk
韜	tcaa
弢	tcgy
慆	tcxa
梼	tcmc
檮	tcmc
濤	tcdc
燾	tchu
絛	tcrs
綯	tcsf
臺	tdtu
軚	tdid
鈦	tdjd
颱	tdfk
駘	tdmk
鮐	tdak
態	tdxs
擡	tdft
枱	tdmk
檯	tdmt
鋱	tejx
铽	tejx
氹	tfdg
螣	tgoi
謄	tgby
䲢	tgoy
騰	tgom
鰧	tgoy
䣘	thex
蹚	thzt
儻	thrh
劏	thdx
鎲	thje
鏜	thjt
鐋	thjp
钂	thjh
镋	thje
嘡	thkt
湯	thdp
燙	thhd
㓥	thdx
㓥	thde
䏲	tiop
䴘	tinp
俶	tiry
銻	tijp
題	tioa
媂	tinj
媞	tinr
體	tigd
鯷	tiar
屜	tiuv
鳀	tiar
鵜	tinb
鷈	tinp
鷉	tinp
擿	tifz
綈	tisp
緹	tisr
菼	tjch
談	tjyh
譚	tjyu
貪	tjbr
倓	tjrh
鉭	tjja
錟	tjjh
鐔	tjju
啴	tjka
嘆	tjkn
嘽	tjka
壇	tjta
弾	tjga
彈	tjga
惔	tjxh
攤	tjff
曇	tjos
榃	tjmt
歎	tjcq
灘	tjdf
癱	tjbf
罈	tjfu
聤	tked
聴	tkex
聽	tkex
䗴	tkiz
侹	tkrz
鋌	tkjz
圢	tktd
庁	tkgd
廳	tkgx
桯	tkmw
烴	tkhg
兲	tmwb
鈿	tmjt
銛	tmjk
铦	tmjk
闐	tmmb
晪	tmob
沺	tmdt
湉	tmdk
畑	tmht
誂	tnyd
調	tnyk
銚	tnjd
嬥	tnnf
鰷	tnam
齠	tnik
朓	tnod
條	tnrm
㕮	tnkx
糶	tnef
脫	tooe
萚	toca
蘀	tocu
託	toyv
讬	toyv
侂	torq
迆	tozx
鉈	tojv
啴	toka
嘽	toka
馱	tomd
駝	tomv
鴕	tonv
鼉	tokv
橢	tomo
籜	tovu
貼	tpbk
鉄	tpjn
鐵	tpjg
怗	tpxk
畳	tptq
団	trkc
團	trkc
摶	trfc
槫	trmc
糰	trmc
衕	tsrd
銅	tsjk
劏	tsdx
哃	tskk
峂	tsed
慟	tsxl
曈	tsoa
橦	tsma
㛚	tsna
統	tsse
腯	tuoo
葖	tucq
釷	tujt
図	tukx
圖	tukk
塗	tutd
従	turr
梌	tumh
禿	tuhe
㻬	tuwv
蛻	tvie
頹	tvha
粋	tvmu
坉	tytv
飩	tyuv
忳	tyxv
鍮	tzjd
頭	tzdb
剎	uadx
鎩	uajy
唦	uakp
鯊	uaad
廈	uagw
殺	uaxy
紗	uasp
卲	uced
柖	ucmk
焼	uche
燒	uche
紹	ucsk
釃	udyl
曬	udol
篩	udvj
設	ueyy
賒	uebx
踄	uezp
厙	ueii
闍	uemo
奓	uedd
懾	uexy
捨	uefk
摂	uefd
攝	uefe
渉	uedp
灄	uede
畬	uert
脤	ufoy
腎	ufok
蔘	ufcp
詵	ufye
諗	ufyx
諶	ufyv
侁	ufre
參	ufsp
審	ufbt
鰺	ufap
屾	ufee
棽	ufmg
滲	ufdp
瀋	ufdt
燊	ufhm
珅	ufwa
糝	ufmp
紳	ufsa
聖	ugwe
聲	ugue
乗	ugpn
剰	ugdp
勝	ugol
昇	ugoc
昇	ugoa
澠	ugdv
縄	ugsv
繩	ugsv
觴	uhjp
賞	uhbx
傷	uhrp
鞝	uhsk
埫	uhtk
殤	uhdp
緔	uhsk
䏡	uiox
蒔	uicc
蝕	uiui
蝨	uivi
視	uipj
試	uiyd
詩	uiyc
諡	uiym
謚	uiym
識	uiyg
貰	uibc
䴓	uina
軾	uiid
適	uizk
釃	uiyl
釈	uipn
釋	uipu
鈰	uijj
勢	uilt
啫	uiko
噓	uika
塒	uitc
飾	uiuj
奭	uidb
駛	uimn
実	uibn
實	uibb
鯴	uiai
鰣	uiac
鰤	uiaj
屍	uiup
鳾	uina
師	uipj
弒	uixd
時	uioc
栻	uimd
浉	uidj
湜	uidr
溮	uidj
溼	uidt
獅	uiqj
訕	ujye
贍	ujby
釤	ujjp
刪	ujda
単	ujxa
閃	ujmr
單	ujka
陝	ujen
墡	ujtl
姍	ujna
騸	ujmy
鱔	ujak
嶦	ujek
掞	ujfh
摻	ujfp
撣	ujfa
晱	ujoh
柵	ujma
睒	ujoj
禪	ujpa
繕	ujsk
羶	ujya
帥	ukpj
雙	ulry
塽	ultx
滝	uldv
瀧	uldl
礵	ulio
說	uoye
鑠	uojm
爍	uohm
碩	uoua
腨	uroa
閂	urma
槫	urmc
藷	uuco
術	uurd
豎	uudk
贖	uubb
輸	uuid
婌	uuny
屬	uuui
悆	uurx
攄	uufx
數	uuwa
書	uuvo
朮	uumd
樞	uumk
樹	uumc
橾	uumm
籔	uuvw
紓	uusa
說	uvye
誰	uvyf
帨	uvje
稅	uvhe
誰	uwyf
順	uypa
揗	uyfo
楯	uymo
収	uzvy
壽	uzuc
獣	uzxq
獸	uzkq
痩	uzby
綬	uzsy
䃎	vaud
詐	vaya
軋	vaiv
劄	vadv
鍘	vajd
閘	vama
奓	vadd
鮓	vaaa
齄	vaph
齇	vapq
拃	vafa
挓	vafq
搾	vafa
柤	vamq
柵	vama
紮	vasm
詔	vcyk
趙	vczo
釗	vcdj
旐	vcfd
曌	vcog
櫂	vcmf
側	vdrd
債	vdrb
堨	vdtr
齋	vdwa
択	vdfn
擇	vdfu
擿	vdfz
斎	vdwa
欸	vdsq
䗪	vegi
蟄	veit
謫	veyk
輒	veiv
轍	veiw
這	vezy
鍺	vejo
啫	veko
喆	veuk
嗻	vekh
鷓	veng
晢	veof
痾	vebk
葴	vfcg
䟴	vfzy
袗	vfpp
診	vfyp
貞	vfba
賑	vfbn
軫	vfip
偵	vfrb
針	vfju
鍼	vfjk
鎮	vfjb
陣	vfei
鴆	vfnd
幀	vfjb
抌	vffe
揕	vffv
昣	vfop
楨	vfmb
湞	vfdb
禎	vfpb
縝	vfsb
証	vgyv
諍	vgya
證	vgyd
鄭	vgeq
鉦	vgjv
錚	vgja
崢	vgea
徴	vgrw
憕	vgxa
掙	vgfa
烝	vghv
爭	vgva
猙	vgqa
癥	vgbw
睜	vgoa
箏	vgva
脹	vhon
賬	vhbn
長	vhan
鱆	vhau
帳	vhjn
張	vhgn
暲	vhou
漲	vhdn
職	vieg
茋	vicd
衹	vipq
製	viyp
觶	vija
誌	viyx
識	viyg
質	vibj
贄	vibt
躑	vize
躓	vizb
軹	viib
輊	viit
値	virv
酈	viea
隻	viry
執	vitd
姪	vint
騭	vime
鷙	vint
幟	vijg
庤	vigc
扺	vifq
摯	viut
擲	vife
擿	vifz
晊	viot
梔	vimv
梽	vimx
榰	vimo
櫛	vime
沚	vidv
滯	vidj
祇	vipq
紙	visq
緻	visw
縶	vist
繊	visa
織	visg
譫	vjyy
輾	vjin
佔	vjrk
偡	vjrv
邅	vjza
咹	vjkn
顫	vjwa
嵁	vjev
嶄	vjej
嶦	vjek
戦	vjdg
戰	vjkg
斬	vjij
栴	vjmd
桟	vjmd
棧	vjmg
氈	vjwm
盞	vjgm
綻	vjsr
荘	vlcu
莊	vlcu
衆	vlxn
裝	vlyd
壯	vldu
妝	vldn
戇	vlxl
樁	vlma
狀	vldq
呣	vmkd
䓬	vocu
䦃	vojo
諑	voyn
叕	voyy
鐯	vojo
鐲	voji
晫	voou
柮	vome
梲	vome
棁	vome
椓	vomn
汋	vodd
濁	vodi
禚	voph
繳	vosw
膞	vroc
䏝	vrod
賺	vrbn
転	vris
伝	vrrs
轉	vric
傳	vrrc
僎	vrrc
囀	vrkc
顓	vrea
饌	vrub
専	vrac
專	vrac
磚	vruc
腫	vsoa
茽	vsca
衆	vsxn
鈡	vsja
鍾	vsja
鐘	vsja
塚	vstn
柊	vsmd
眾	vssr
種	vsha
終	vssd
苧	vucd
苧	vuca
薴	vucd
藷	vuco
蠋	vuii
註	vuyw
誅	vuyn
諸	vuyo
豬	vuao
貯	vubd
佇	vurd
銖	vujn
鋳	vujc
鑄	vujc
嗻	vukh
囑	vuki
駐	vumw
屬	vuui
柷	vume
櫧	vumo
櫫	vuma
瀦	vudo
燭	vuhi
矚	vuoi
硃	vuun
竚	vuld
築	vuvm
紵	vusa
纻	vusa
贅	vvbf
錐	vvjf
墜	vvte
騅	vvmf
綴	vvsy
縋	vvsz
這	vwzy
撾	vxfk
衠	vyrd
諄	vyyz
迍	vyzv
圫	vytq
忳	vyxv
準	vyuf
荮	vzcc
葤	vzcc
謅	vzye
賙	vzbk
赒	vzbk
軸	vzia
週	vzzk
冑	vzyo
冑	vzao
呪	vzke
驟	vzmn
婤	vznk
晝	vzva
椆	vzmk
㑇	vzre
㑳	vzre
皺	vzgp
㤘	vzxe
㥮	vzxe
紂	vzsc
縐	vzse
膃	waom
襪	wapn
咼	wakk
婠	wank
媧	wank
搲	wafg
窪	wadt
咼	wdkk
喎	wdkk
聞	wfme
芠	wfcw
問	wfmk
閿	wfmy
韞	wfam
塭	wftm
馼	wfmw
鰛	wfam
鰮	wfam
忞	wfwx
抆	wffw
揾	wffm
搵	wffm
榅	wfmm
榲	wfmm
溫	wfdm
炆	wfhw
穏	wfhx
穩	wfhx
紋	wfsw
縕	wfsm
缊	wfsm
鶲	wgnb
甕	wgww
輞	whiv
尪	whuw
網	whsv
萬	wjcd
輓	wjiv
卍	wjxx
卐	wjxx
頑	wjea
塆	wjtg
壪	wjtg
妧	wjne
婠	wjnk
彎	wjsg
晩	wjov
椀	wjmv
毌	wjvu
汍	wjdd
灣	wjdg
紈	wjsd
綰	wjsk
臥	wokd
萵	wock
蝸	woik
偓	wort
咼	wokk
喎	wokk
齷	woit
撾	wofk
	wokn
渦	wodk
㖞	wokn
窩	wobk
蕪	wuch
誣	wuyr
誤	wuyd
鄔	wuep
務	wusl
鎢	wujh
吳	wukd
嗚	wukh
噁	wukx
霧	wuyl
塢	wuth
騖	wums
嫵	wunh
屼	wuee
峿	wuek
鵐	wunr
鵡	wunq
鶩	wuns
廡	wugh
悪	wuxa
惡	wuxa
憮	wuxh
旿	wuou
樢	wunm
汙	wudu
烏	wuph
無	wurh
碔	wuud
葦	wwca
薳	wwcz
蝟	wwio
螱	wwui
衛	wwrd
諉	wwyn
謂	wwyo
亹	wwwq
偉	wwra
違	wwza
偽	wwrh
闈	wwma
囲	wwka
圍	wwka
韋	wwaa
韙	wwoa
餵	wwun
鮪	wwao
峗	wwev
幃	wwja
廆	wwgg
撝	wwfh
溈	wwdh
潙	wwdh
潿	wwda
濰	wwdf
為	wwdh
煒	wwha
瑋	wwwa
磑	wwud
㧑	wwfd
維	wwsf
緯	wwsa
䜣	xbij
訢	xbij
伈	xbrx
釁	xbpd
鋅	xbju
鐔	xbju
肸	xiou
臘	xiov
蓆	xicj
䜣	xiij
襲	xily
覡	xigj
訢	xiij
係	xirx
係	xips
俙	xirj
傒	xird
釐	xiaa
銑	xije
錫	xijp
卌	xiaa
喺	xiox
噏	xiky
囍	xiuk
餼	xium
鬩	xiae
屃	xibu
屓	xibu
嶍	xieb
嶲	xieg
巇	xieg
恓	xixx
愾	xixm
憙	xiux
戯	xihg
戱	xihg
戲	xihg
扱	xifn
晞	xioj
暿	xiok
枲	xism
棲	ximn
渓	xidn
犠	xind
犧	xind
璽	xiaw
窸	xixb
細	xist
繫	xisa
習	xiyb
興	xkpb
倖	xkru
陘	xkeg
餳	xkup
婞	xknu
滎	xkdh
薌	xlce
詳	xlyy
郷	xlev
鄉	xlev
儴	xlry
鑲	xljy
嚮	xlvk
響	xlso
項	xlga
餉	xluk
饗	xluv
驤	xlmy
鯗	xlay
廂	xlgo
曏	xloe
緗	xlso
莧	xmcj
薟	xmcr
蘚	xmcy
蜆	xmij
賢	xmbk
躚	xmzz
伭	xmrd
僩	xmro
銑	xmje
銛	xmjk
銜	xmrd
鍁	xmjq
铦	xmjk
啣	xmke
閑	xmmm
閒	xmmo
陥	xmeo
険	xmen
險	xmer
顕	xmoa
顯	xmoa
餡	xmua
嫺	xmno
嫻	xmnm
孅	xmig
鮮	xmay
峴	xmej
崄	xmea
嶮	xmer
鷳	xmnm
鷴	xmnm
鹹	xmak
忺	xmxq
憲	xmbx
挦	xmfc
摻	xmfp
撏	xmfc
杴	xmmq
狝	xmqx
猃	xmqa
獫	xmqr
獮	xmqx
獻	xmhq
現	xmwj
癇	xmbo
県	xmox
秈	xmme
㬎	xmho
絃	xmss
線	xmsd
縣	xmqs
縴	xmsn
繊	xmsa
纖	xmsg
羨	xmyr
蕭	xnca
虓	xnjj
蟏	xnia
蠨	xnia
傚	xnrw
銷	xnjo
効	xnwl
嘐	xnkp
嘯	xnka
嘵	xnke
囂	xnkk
驍	xnme
鴞	xnnk
鸮	xnnk
恔	xnxf
敩	xnxw
斆	xnwp
暁	xnoe
曉	xnoe
梟	xnnm
瀟	xnda
篠	xnvm
簫	xnva
綃	xnso
脅	xplo
葉	xpcm
薢	xpcn
蠍	xpiq
褻	xpwy
諧	xpyb
謝	xpyc
偰	xprd
協	xpul
頡	xpua
塮	xptc
鮭	xpat
寫	xpbh
挾	xpfn
揳	xpfd
擷	xpfa
攜	xpfk
洩	xpdp
瀉	xpdh
㙦	xptr
紲	xpsv
緤	xpsm
纈	xpsa
脩	xqro
䗛	xqij
鏥	xqjb
鏽	xqja
饈	xqua
鵂	xqrn
琇	xqwp
繍	xqsa
繡	xqsa
衒	xrrd
諼	xryy
軒	xriu
伭	xrrd
𣈶	xroa
選	xrzb
鉉	xrjd
鏇	xrjr
吅	xrkk
咺	xrka
嬛	xrny
愃	xrxa
懸	xrxq
昡	xrod
晅	xroa
暅	xroa
暶	xror
烜	xrha
瑄	xrwa
璿	xrwo
癬	xrby
絢	xrso
兇	xsxe
夐	xsdw
洶	xsdk
茓	xtcb
謔	xtya
學	xtzp
鱈	xtae
峃	xtxe
嶨	xtep
鷽	xtnp
敩	xtxw
斆	xtwp
澩	xtdp
虛	xuha
許	xuyu
詡	xuyy
諝	xuyo
谞	xuyo
冔	xuoa
勗	xuol
卹	xuxe
噓	xuka
垿	xuta
須	xupa
頊	xuwa
媭	xunp
嬃	xunp
鬚	xuaa
魆	xugg
敘	xuwr
旴	xuoa
昫	xuok
欻	xuhq
歔	xuhq
滸	xudu
漵	xudw
籲	xuva
粛	xuva
糈	xumo
続	xusd
緒	xuso
繻	xusa
續	xusb
蝦	xxiy
轄	xxik
俠	xxrn
叚	xxvy
嚇	xxkv
嚇	xxkd
鰕	xxay
峽	xxen
廈	xxgw
烚	xxhk
煆	xxhy
狹	xxqn
硤	xxun
祫	xxpk
蕁	xycc
薫	xych
蟫	xyiu
訊	xyyu
訓	xyya
詢	xyyo
遜	xyzz
勛	xykl
勲	xyhp
勳	xypl
噀	xykc
塤	xytb
壎	xyth
馴	xyma
尋	xyec
鱘	xyac
栒	xymo
潯	xydc
燻	xyhh
珣	xywo
瞓	xyoa
䥺	yajp
訝	yayp
亜	yaaa
亞	yaaa
軋	yaiv
釾	yajp
錏	yaya
唖	yaka
啞	yaka
圧	yait
埡	yata
堐	yatt
壓	yait
姶	yank
婭	yana
鴉	yana
鴨	yana
	yajp
椏	yama
氬	yaqa
瘂	yaba
茚	ybce
蔭	ybcs
䜣	ybij
蟫	ybiu
訢	ybij
䲟	ybae
銀	ybjn
銦	ybjd
陰	ybes
嚚	ybkk
隠	ybex
隱	ybex
飲	ybur
鮣	ybae
崟	ybej
廕	ybgs
齦	ybin
愔	ybxo
慇	ybpx
慭	ybax
憖	ybxa
歅	ybxq
珢	ybwy
癮	ybbx
葯	yccd
薬	yccm
藥	yccm
謠	ycyf
謡	ycyf
軺	ycik
遙	yczd
僥	ycre
鈅	ycjo
銚	ycjd
鑰	ycjc
垚	yctt
堯	ycae
餚	ycuo
媱	ycnf
鰩	ycaf
峣	ycee
嶢	ycee
鷂	ycnv
麼	ycgs
揺	ycff
搖	ycff
榣	ycmf
焼	yche
瑤	ycwf
瘧	ycba
㙘	yctn
窯	ycbh
約	ycsd
葉	yecm
謁	yeyv
倻	yere
鄴	yeea
円	yeaa
鋣	yeje
吔	yekx
嘢	yeka
嚥	yekh
靨	yeia
頁	yeba
堨	yetr
曄	yeoa
楪	yemm
業	yean
燁	yeha
爺	yefe
緤	yesm
卬	yhep
咉	yhkn
钖	yhjp
陽	yhep
垟	yhty
颺	yhfp
飏	yhfp
養	yhyn
鴦	yhna
揚	yhfp
旸	yhop
暘	yhop
楊	yhmp
様	yhmd
樣	yhmn
煬	yhhp
瘍	yhbp
癢	yhbu
艤	yivd
藝	yics
螠	yiim
蟻	yiid
裛	yiwy
訳	yiyn
詒	yiyk
詣	yiyo
誼	yiyq
譯	yiyu
議	yiyd
貽	yibk
乂	yipn
軼	yiin
佁	yirk
迆	yizx
偯	yiry
遺	yiza
儀	yird
億	yirx
酏	yiyv
醫	yiyk
釔	yijg
銥	yijy
勚	yicl
勩	yicl
匜	yiky
鎰	yijm
叕	yiyy
鐿	yijx
囈	yiks
頤	yika
壱	yiuv
飴	yiuk
駅	yimn
驛	yimu
嫕	yinx
宧	yiba
嶧	yieu
鷁	yinq
帟	yiwj
廙	yigc
憶	yixx
懌	yixu
扅	yihd
扆	yihy
昳	yion
杙	yimd
枍	yimv
栘	yimd
椸	yimv
櫂	yimf
浥	yidv
㑊	yird
異	yitb
瘞	yibt
礒	yiud
祎	yipa
禕	yipa
㴔	yidx
縊	yism
繹	yisu
義	yiyd
艷	yjfv
虤	yjhj
蝘	yjik
諺	yjyp
讌	yjyh
讞	yjyq
豔	yjfm
贋	yjib
贗	yjib
䶮	yjld
儼	yjrw
兗	yjwe
醃	yjyv
釅	yjyw
剦	yjdd
匽	yjkn
厭	yjiq
厳	yjxw
厴	yjia
啱	yjou
閆	yjms
閹	yjmv
閻	yjma
嚥	yjkh
嚴	yjkw
顏	yjwa
顔	yjla
塩	yjtm
墕	yjth
饜	yjiu
験	yjmn
驗	yjmr
嬿	yjnh
魘	yjig
巌	yjew
巖	yjew
鹽	yjmk
黡	yjvi
黶	yjih
弇	yjrc
鼴	yjun
彥	yjwp
龑	yjld
懨	yjxq
戭	yjbg
扊	yjhh
掞	yjfh
梴	yjmz
棪	yjmh
歅	yjxq
沇	yjde
灧	yjdv
灩	yjdm
煙	yjht
硯	yjuj
䓨	ykcf
蛍	ykxi
螢	ykhi
蠅	ykiv
贏	ykwb
鎣	ykjh
営	ykxk
嚶	ykkn
頴	ykpa
塋	ykht
媖	yknn
嬰	yknb
鶯	ykhn
鷹	ykgn
鸚	yknb
応	ykgx
應	ykgx
攖	ykfn
桜	ykmn
桯	ykmw
櫻	ykmn
滎	ykdh
潁	ykpa
瀅	ykdw
瀠	ykds
熒	ykhh
營	ykhk
瑩	ykhw
瓔	ykwn
癭	ykbn
穎	ykpa
縈	ykhs
纓	yksn
罃	ykfh
罌	ykfb
喲	yokd
薳	yrcz
蜎	yrio
轅	yriy
遠	yrzt
円	yraa
員	yrbk
園	yrky
圓	yrkb
願	yria
妧	yrne
嫄	yrnx
鳶	yrnq
鴛	yrnd
黿	yrev
櫞	yrmn
淵	yrda
緣	yrsn
縁	yrsn
詠	yskn
踴	yszl
傭	ysra
鏞	ysja
埇	ysta
鯒	ysaa
鱅	ysaa
擁	ysff
栐	ysmn
湧	ysdl
癰	ysbf
㶲	ysha
說	ytye
躍	ytzf
鈅	ytjo
鉞	ytjd
鑰	ytjc
閱	ytme
噦	ytkp
嶽	yteq
悅	ytxe
楽	ytmd
樂	ytmv
櫟	ytmm
玥	ytwo
粵	ytpg
約	ytsd
與	yupb
艅	yuvh
蕷	yuca
薁	yucd
褕	yupd
覦	yurj
語	yuyk
諛	yuyn
諭	yuyd
譽	yupy
輿	yupb
俁	yurd
傴	yurk
鈺	yujw
喐	yuek
閾	yuma
隩	yued
圫	yutq
堉	yuto
預	yusa
飫	yuud
餘	yuuh
馭	yumy
娛	yund
嫗	yunk
鬱	yump
魚	yudh
嵎	yued
鵒	yunb
嶼	yuea
鷸	yuns
彧	yukd
齬	yuik
悆	yurx
慾	yuxb
敔	yuww
棫	yumg
歟	yupq
滪	yudb
漁	yuda
澦	yuda
獄	yuqq
玙	yuwa
璵	yuwb
畬	yurt
癒	yubx
禦	yuxr
籲	yuva
㳚	yudd
紆	yusu
㺄	yuqd
蕓	yycs
蕰	yycm
薀	yycm
蘊	yycm
贇	yybw
運	yyzb
鄆	yyeb
鄖	yyek
醞	yyym
勻	yyga
隕	yyeb
雲	yyys
韞	yyam
韻	yylb
妘	yyns
惲	yyxi
慍	yyxm
暈	yyoi
殞	yydb
氳	yyqm
沄	yyds
涢	yydb
溳	yydb
紜	yyss
縕	yysm
缊	yysm
耰	yzmy
蕕	yzcq
誘	yzyp
遊	yzzf
郵	yzep
優	yzrw
鈾	yzja
銪	yzjo
魷	yzad
憂	yzwa
槱	yzmh
猶	yzqy
祐	yzpk
紬	yzsa
臜	zaob
臢	zaob
囃	zakf
雑	zajf
雜	zawf
甴	zaka
譟	zcym
蹧	zczo
鑿	zcaj
慥	zcxz
棗	zcan
皁	zcbu
竈	zcbe
載	zdig
側	zdrd
災	zdvh
責	zebf
賾	zekb
則	zedb
嘖	zekb
幘	zejb
択	zefn
擇	zefu
沢	zedn
澤	zedu
簀	zevb
譖	zfyo
䎖	zgby
贈	zgbo
鋥	zgjw
増	zgto
曽	zgbo
繒	zgso
臓	zhoa
蔵	zhca
贓	zhbd
駔	zhmq
髒	zhgc
茲	zics
虸	ziiz
諮	zikd
諮	ziyk
貲	zibv
資	zibd
輜	ziit
錙	zijt
嗞	zikd
孖	zizz
鯔	ziat
齜	ziiv
漬	zidb
眥	ziov
緇	zist
讚	zjyb
賛	zjba
賺	zjbn
贊	zjbn
趲	zjzb
輾	zjin
偺	zjro
鏨	zjji
寁	zjbr
攢	zjfb
暫	zjoi
瓚	zjwb
咗	zokg
岞	zoea
捽	zofu
躦	zrzb
鉆	zrjk
鑽	zrjb
纘	zrsb
蹤	zszr
倧	zsrx
傯	zsrx
樅	zsmr
糉	zsmw
綜	zssx
総	zsxx
縦	zssr
縱	zssr
總	zssx
詛	zuyq
鏃	zuju
崒	zuei
組	zusq
酔	zvyu
槜	zvmg
賊	zwbu
僔	zyrc
噂	zykc
鱒	zyac
嶟	zyec
諏	zzyy
鄒	zzgd
騶	zzme
鯫	zzay

〆	sime
亀	gxdv
伜	cvru
侭	jbrd
俤	tirp
倅	cvru
働	dsrl
儚	mgrd
兎	tupd
冨	fubt
冴	yadp
凖	vyda
凧	tako
凪	vijv
刔	jtdv
劔	jmdr
匁	qmpn
匂	yygb
卆	zaju
厠	ceid
叡	jyay
叺	rukr
呉	wukb
哘	xkkd
喩	yukv
喰	cjku
噺	xbkj
嚊	xika
嚔	tikr
囮	yzkb
圷	xxtd
垰	antd
垳	xktd
埓	lptc
堺	jpta
塙	qttk
塡	tmtb
墺	outd
壜	tjts
壷	huua
壻	xuto
奬	jkvq
妬	dunu
姉	zinj
姫	jink
娯	yunb
婬	ybna
嬶	bina
寔	ubr
寳	bcbb
尠	xmqp
尭	ycue
屛	pkuu
岼	pkeu
峠	qxed
嶋	dcne
帯	ddaj
廻	hvzk
彫	tskp
悳	doxu
惣	zsxn
愼	ufxb
戸	huau
拵	cyfz
捗	bufp
掟	ltfr
揃	jmfd
敍	xury
晄	hloe
晧	hcok
杣	ujme
枠	oomu
枡	dzma
査	iamq
柾	cemv
栂	mwmd
栃	tomg
栞	bfma
栢	bomo
栫	jmmz
梛	nome
梶	wwmm
梺	fumd
椈	jumm
椛	hxmb
楕	jimo
楡	yumv
楢	zymy
榊	ufma
榎	xxmw
榾	gumo
槇	vfmb
槙	vfmb
槻	gvme
樋	tsmz
樒	mime
橿	jlma
欅	jumu
欝	yumc
歳	svex
毘	pitb
毟	ucmc
氷	bkdn
汚	wudg
洟	yidn
渕	yrdd
潟	xpdh
澁	uedv
澪	lkdd
濵	bbdb
濶	jmdk
瀞	jkda
焔	yjho
煕	xihk
熈	xihp
燐	lbha
燗	xmho
燿	ychf
犂	linh
狆	vsqa
狛	boqo
狢	heqk
猯	trqa
獏	moqd
珪	gxwt
瑠	lqwt
瑳	iawg
甃	vfwh
産	ijlf
畠	bdpt
畭	yuth
畷	ioty
皷	guuy
皹	juai
眞	vfbb
瞹	aioy
窓	ilbx
竪	uulk
筈	uevk
筬	igvg
箆	bivb
箙	fuvy
篭	lsvv
簑	ukvy
簓	tsvp
簗	llvm
籐	tgvd
粁	qmmu
粂	oomp
粧	vlmt
糀	koji
糎	limt
糒	bwma
絋	klss
絖	glse
絣	bksc
絶	jtsv
絽	lvsk
綛	rfsx
縅	mpsn
縢	tgox
繋	xisi
纒	ijst
罠	mbsv
罫	kwsd
翆	cvyu
聟	xueu
聡	isex
脇	xpol
舎	uerk
舗	purf
舘	grrk
艀	fuvz
艶	yjav
苺	mucd
莟	hjck
菓	gocm
萠	pjco
蓙	zoct
蔕	ddcj
蕋	vicv
薗	yrcy
薙	vicf
蘂	jicm
蚫	bcis
蛯	lcib
蝿	ykiv
衞	wwid
袴	kxpg
袵	rfpa
袿	gxpt
裄	xkpd
褄	qipn
襷	jupu
説	uoye
讃	zjyb
谺	xxbp
賎	jmbg
躄	bizu
躰	tiua
辷	yiza
辻	uizu
込	kozr
辿	ujze
遡	sozo
鈎	gzjs
鋭	rvje
鋲	bkjb
鋼	ghje
鎚	ivjz
鎹	ssjz
鑓	qmjk
鑪	lujm
閲	ytme
阨	eeev
雫	nayd
雰	ffyd
霙	ykyn
靭	rfgd
靱	rfgd
鞄	bcgv
鞆	bkgr
韮	jqca
頚	jkyb
頬	xxab
駄	tomd
駈	qqma
髢	yeya
髱	bcba
髷	quaa
鬘	mjoa
魬	fjay
鮖	uiau
鮠	wwav
鮨	viao
鮴	xqam
鮹	xnao
鯏	liad
鯑	xiaj
鯣	yiap
鯲	yuad
鯵	sjap
鰊	jman
鰐	eeag
鰡	lqat
鰯	road
鰰	tiua
鱚	xiak
鱶	yhau
鳰	runr
鴈	yjin
鴫	tknt
鴬	ykxn
鵙	junb
鵤	jnnd
鵺	yenw
鶫	dsnd
鶸	rong
鷭	fjnp
麿	mamk
鼈	bpxv
#不知读音或者不能定音的字
凩	oojm
曻	oooa
杁	oomr
杢	oomg
椚	oomm
笹	oovv
躾	ooud
苅	oocd
菫	ooca
蜑	ooiz
蟇	ooic
裃	oopd
癪	oobb
皐	oopi
硲	oouk
竃	oobv
箒	oovj
籾	oomd
粍	oomm
鞐	oogd
顚	oobb
颪	ooaf