吧	baakv
八	baapn
巴	baavv
疤	baabv
叭	baakb
扒	baafb
芭	baacv
笆	baavv
粑	baamv
捌	baafd
岜	baaev
朳	baamb
羓	baayv
蚆	baaiv
釟	baajb
拔	baefd
跋	baezd
魃	baegd
茇	baecd
菝	baecd
妭	baend
抜	baefy
胈	baeoy
把	baufv
靶	baugv
钯	baujv
㞎	bauub
鈀	baujv
把	baifv
罢	baiss
爸	baifv
霸	baiyo
坝	baitb
耙	bailv
灞	baido
鲅	baiad
壩	baito
罷	baisp
覇	baixo
鮊	baiab
鲌	baiab
吧	bavkv
罷	bavsp
宾	bbabb
斌	bbawd
彬	bbamp
滨	bbadb
镔	bbajb
濒	bbada
缤	bbasb
槟	bbamb
豳	bbaea
浜	bbadb
傧	bbarb
儐	bbarb
梹	bbamb
濱	bbadb
濵	bbadb
瀕	bbada
繽	bbasb
賓	bbabb
邠	bbaeb
鑌	bbajb
鬓	bbiab
殡	bbidb
膑	bbiob
摈	bbifb
髌	bbigb
擯	bbifb
殯	bbidb
臏	bbiob
髕	bbigb
鬢	bbiab
包	bcagv
炮	bcahv
胞	bcaov
剥	bcade
褒	bcawy
苞	bcacv
龅	bcaiv
煲	bcahr
孢	bcazv
勹	bcapv
剝	bcadv
齙	bcaiv
薄	bcecc
雹	bceyv
嫑	bcean
保	bcurm
宝	bcubw
堡	bcutr
饱	bcuuv
鸨	bcunp
葆	bcucm
褓	bcupm
寳	bcubb
寶	bcubb
飽	bcuuv
鴇	bcunp
报	bcify
抱	bcifv
暴	bciod
爆	bcihd
豹	bcivv
鲍	bciav
瀑	bcidd
刨	bcidg
趵	bcizd
報	bcity
蚫	bciiv
鉋	bcijv
髱	bcipv
鮑	bciav
掰	bdabu
白	bdepo
百	bduab
摆	bdufs
柏	bdumb
佰	bdurb
捭	bdufu
擺	bdufv
栢	bdumb
襬	bduyv
败	bdiwb
拜	bdiuf
稗	bdihu
鞴	bdiga
唄	bdikb
拝	bdiff
敗	bdiwb
鞁	bdigp
奔	bfadc
贲	bfabu
锛	bfajc
倴	bfarc
喯	bfakc
犇	bfann
賁	bfabu
錛	bfajc
本	bfuaa
奋	bfudt
苯	bfuca
畚	bfust
体	bfira
奔	bfidc
笨	bfiva
夯	bfidl
坌	bfitb
倴	bfirc
崩	bgaeo
嘣	bgako
弸	bgago
搒	bgaff
祊	bgapf
綳	bgaso
繃	bgaso
甭	bgeaa
绷	bguso
繃	bguso
蹦	bgizo
迸	bgizq
蚌	bgiif
泵	bgiud
揼	bgifd
帮	bhajf
邦	bhaef
梆	bhame
浜	bhadb
幫	bhatj
𠳐	bhaek
膀	bhuof
绑	bhuse
榜	bhumf
搒	bhuff
綁	bhuse
膀	bhiof
棒	bhima
榜	bhimf
傍	bhirf
磅	bhiuf
镑	bhijf
蚌	bhiif
谤	bhiyf
甏	bhiwu
蒡	bhicf
塝	bhitf
搒	bhiff
棓	bhimk
稖	bhihk
蚄	bhiif
謗	bhiyf
鎊	bhijf
逼	biaza
屄	biaub
箄	biavu
鼻	biepa
荸	biecz
嬶	bienc
比	biuav
笔	biuvm
彼	biurp
鄙	biuek
匕	biuav
俾	biuru
捭	biufu
吡	biukv
妣	biunv
秕	biuhv
舭	biuvv
沘	biudp
筆	biuva
箄	biuvu
粃	biump
比	biiav
必	biidp
秘	biihp
毕	biiua
避	biizu
臂	biiou
闭	biimp
虑	biihx
壁	biitu
碧	biiuw
币	biipj
陛	biiet
婢	biinu
毙	biiav
蔽	biicw
辟	biiuu
璧	biiwu
弊	biicx
敝	biiwx
庇	biigv
痹	biiba
弼	biiag
睥	biiou
哔	biiku
裨	biipu
愎	biixw
薜	biicu
狴	biiqt
荜	biicu
跸	biizu
篦	biivv
毖	biiad
铋	biijp
筚	biivu
蓖	biicv
髀	biigu
嬖	biinu
箅	biiva
畀	biita
襞	biiyu
萆	biicu
濞	biida
庳	biigu
滗	biidm
佖	biirp
咇	biikx
嗶	biika
坒	biiat
幣	biijx
斃	biixv
潷	biida
畢	biita
痺	biibu
皕	biiab
祕	biipp
箄	biivu
箆	biivp
篳	biiva
肶	biiop
苾	biicp
蓽	biica
觱	biiwj
诐	biiyy
賁	biibu
贔	biibb
赑	biibb
蹕	biiza
躄	biizu
鉍	biijp
閉	biimp
鞁	biigp
鸊	biinu
般	bjavy
班	bjadw
搬	bjafy
斑	bjaww
扳	bjafy
颁	bjaba
瘢	bjaby
癍	bjabw
攽	bjabw
頒	bjaba
板	bjumy
版	bjupy
坂	bjuty
阪	bjuey
钣	bjujy
舨	bjuvy
昄	bjuoy
鈑	bjujy
闆	bjumk
半	bjiba
办	bjild
伴	bjira
扮	bjifd
瓣	bjigu
绊	bjisa
拌	bjifa
姅	bjina
絆	bjisa
辦	bjill
靽	bjiga
并	bkaqc
兵	bkapb
冰	bkadd
屏	bkauc
掤	bkafo
栟	bkamc
梹	bkamb
檳	bkamb
氷	bkadd
鋲	bkajb
柄	bkumn
屏	bkuuc
禀	bkuwx
饼	bkuuc
秉	bkupn
丙	bkuan
炳	bkuhn
邴	bkuea
抦	bkufr
昺	bkuor
稟	bkuwh
絣	bkusa
蛃	bkuir
鞆	bkugr
餅	bkuuc
并	bkiqc
病	bkibn
摒	bkifc
並	bkiqa
併	bkirc
併	bkirc
边	bmazl
编	bmasc
鞭	bmagn
蝙	bmaic
煸	bmahc
砭	bmaun
笾	bmavz
鳊	bmaac
籩	bmavz
編	bmasa
辺	bmazd
邊	bmazp
鯿	bmaac
扁	bmuhc
贬	bmubn
匾	bmukc
褊	bmupc
窆	bmubn
碥	bmuuc
貶	bmubn
便	bmirn
变	bmiwy
遍	bmizh
辩	bmiyu
辨	bmidu
辫	bmisu
卞	bmidd
汴	bmidd
弁	bmisc
弁	bmiyu
忭	bmixd
苄	bmicd
缏	bmisn
変	bmiww
抃	bmifd
昪	bmioc
緶	bmisn
變	bmiws
辮	bmisu
辯	bmiyu
邊	bmvzp
标	bnamx
镖	bnajx
彪	bnahp
飙	bnaqf
飚	bnafh
骠	bnamx
膘	bnaox
镳	bnajh
杓	bnamd
飑	bnafv
髟	bnaap
儦	bnarh
幖	bnajx
摽	bnafx
標	bnamx
瘭	bnabx
脿	bnaoy
蔈	bnacx
藨	bnach
鏢	bnajx
鑣	bnajh
颮	bnafv
飆	bnaqf
飈	bnafh
驫	bnamm
骉	bnamm
嫑	bnean
表	bnufy
婊	bnuny
裱	bnupy
俵	bnury
脿	bnuoy
錶	bnujy
鳔	bniax
脿	bnioy
蔈	bnicx
鰾	bniax
波	boadp
拨	boafd
播	boaft
玻	boawp
剥	boade
钵	boaja
蕃	boact
啵	boakp
菠	boacy
饽	boauz
剝	boadv
哱	boakz
妭	boand
嶓	boaet
撥	boafy
砵	boaia
鉢	boaja
餑	boauz
鮁	boaad
伯	boerb
博	boeuc
薄	boecc
勃	boeul
脖	boeoz
搏	boefc
柏	boemb
驳	boemx
泊	boedb
膊	boeoc
帛	boebj
礴	boeuc
渤	boedl
舶	boevb
钹	boejd
箔	boevb
铂	boejb
亳	boewq
踣	boezk
鹁	boenu
㩧	boefu
僰	boera
桲	boemz
榑	boemc
欂	boemc
狛	boeqb
葧	boecl
袯	boepy
襏	boepy
鈸	boejd
鉑	boejb
駁	boemx
鮊	boeab
鵓	boenu
簸	bouvy
跛	bouzp
薄	boicc
柏	boimb
簸	boivy
捭	boifu
擘	boiuu
檗	boimu
蘖	boicm
卜	bovad
啵	bovkp
噃	bovkt
蔔	bovct
憋	bpaxx
鳖	bpaax
鱉	bpaax
鼈	bpaxv
别	bpedk
蹩	bpezx
別	bpedk
瘪	bpubv
癟	bpubc
别	bpidk
彆	bpigx
逋	buaza
晡	buaod
鈽	buajj
餔	buaud
不	buead
醭	bueyn
补	buupd
捕	buufd
卜	buuad
哺	buukd
卟	buukd
補	buupd
不	buiad
部	buiel
步	buivp
布	buiuj
怖	buixj
簿	buivc
埔	buitd
埠	buitu
瓿	builw
钚	buijd
钸	buijj
鞴	buiga
佈	buirj
埗	buitp
捗	buifp
歩	buivp
蔀	buice
踄	buizp
鈈	buijd
鈽	buijj
餔	buiud
背	bwaoa
杯	bwamd
悲	bwaxa
卑	bwapu
碑	bwauu
陂	bwaep
鹎	bwanp
揹	bwafo
揹	bwafo
棓	bwamk
椑	bwamu
盃	bwama
箄	bwavu
鵯	bwanp
北	bwuav
鉳	bwujv
被	bwipp
备	bwiwt
背	bwioa
辈	bwiia
贝	bwikr
倍	bwirk
狈	bwiqb
惫	bwixw
蓓	bwick
悖	bwixz
孛	bwiuz
焙	bwihk
钡	bwijb
碚	bwiuk
邶	bwiea
鐾	bwiju
褙	bwipo
鞴	bwiga
備	bwira
憊	bwixr
棓	bwimk
狽	bwiqb
糒	bwima
貝	bwiob
輩	bwiia
鋇	bwijb
鞁	bwigp
唄	bwvkb
义	caaxd
差	caayg
插	caafa
擦	caafx
叉	caayd
喳	caaka
嚓	caakx
嚓	caakx
杈	caamd
锸	caaja
馇	caaua
挿	caafa
荖	caacp
鍤	caaja
餷	caaua
查	caema
察	caebx
茶	caecm
叉	caeyd
茬	caect
碴	caeua
搽	caefm
檫	caemx
槎	caemg
楂	caema
猹	caeqa
垞	caetq
嵖	caeea
査	caemq
梌	caemh
叉	cauyd
衩	caupd
镲	caujx
礤	cauux
鑔	caujx
差	caiyg
刹	caidx
诧	caiyq
岔	caibe
杈	caimd
衩	caipd
姹	cainq
汊	caidd
侘	cairq
剎	caidx
囃	caikf
奼	cainq
詫	caiyq
超	ccazk
操	ccafm
抄	ccafp
钞	ccajp
剿	ccadv
糙	ccamz
焯	ccahu
怊	ccaxk
勦	ccavl
弨	ccagk
綽	ccasu
鈔	ccajp
朝	cceuo
曹	cceao
潮	ccedo
嘲	cceko
巢	ccevn
槽	ccemo
晁	cceod
嘈	cceko
漕	ccedo
艚	ccevo
螬	cceio
巣	ccedn
草	ccucu
吵	ccukp
炒	ccuhp
艹	ccuaa
㥮	ccuxe
操	ccifm
耖	ccilp
肏	ccirr
差	cdayg
猜	cdaqo
拆	cdafd
钗	cdajd
偲	cdarx
啋	cdakm
釵	cdajd
才	cdeap
财	cdebp
材	cdemp
裁	cdeyg
柴	cdemv
豺	cdevp
侪	cdera
儕	cdera
纔	cdesd
財	cdebp
采	cduvm
彩	cduvp
踩	cduzm
睬	cduom
啋	cdukm
採	cdufm
綵	cdusm
綵	cdusm
茝	cduck
采	cdivm
菜	cdicm
蔡	cdicx
虿	cdiai
瘥	cdibg
寀	cdibm
蠆	cdici
车	ceaaa
砗	ceaui
俥	ceari
唓	ceaki
硨	ceaui
車	ceaaa
尺	ceuun
扯	ceufv
策	ceivn
测	ceidd
侧	ceird
荣	ceicm
彻	ceird
撤	ceifw
册	ceipa
澈	ceidw
厕	ceiid
栅	ceima
掣	ceiup
恻	ceixd
坼	ceitd
㬚	ceiow
側	ceird
冊	ceiaa
厠	ceiid
屮	ceiva
廁	ceigd
徹	ceiwr
惻	ceixd
測	ceidd
筴	ceivn
轍	ceiiw
沉	cfadj
嗔	cfakb
琛	cfawm
抻	cfafa
郴	cfame
捵	cfafb
棽	cfamg
沉	cfedj
陈	cfeed
沈	cfedv
尘	cfetx
臣	cfeka
晨	cfeon
辰	cfein
岑	cfeev
涔	cfedv
宸	cfebn
忱	cfexv
谌	cfeyv
塵	cfelt
梣	cfemg
諶	cfeyv
陳	cfeed
碜	cfuup
磣	cfuup
趁	cfizp
衬	cfipc
谶	cfiyg
龀	cfiiv
榇	cfimm
櫬	cfimj
稱	cfiha
襯	cfipj
讖	cfiyg
齔	cfiiv
称	cgahx
净	cgada
撑	cgafu
棱	cgamw
瞠	cgaot
噌	cgako
噌	cgako
柽	cgamt
蛏	cgait
偁	cgara
僜	cgara
撐	cgafp
曽	cgabo
檉	cgamw
琤	cgawa
稱	cgaha
罉	cgaru
蟶	cgaiw
赪	cgatb
鐺	cgajt
成	cgegv
城	cgetv
程	cgehw
曾	cgebo
层	cgeus
承	cgevn
盛	cgemg
诚	cgeyv
乘	cgepn
呈	cgekw
惩	cgexr
澄	cgedd
丞	cgeva
橙	cgemd
晟	cgeov
铖	cgejv
裎	cgepw
酲	cgeyw
埕	cgetw
塍	cgeot
枨	cgemn
㨃	cgefz
乗	cgepn
宬	cgebv
層	cgeuo
嶒	cgeeo
憕	cgexa
懲	cgexr
棖	cgemn
筬	cgevg
誠	cgeyv
鋮	cgejv
逞	cguzk
骋	cgumg
樘	cgumt
裎	cgupw
庱	cgugw
騁	cgumg
蹭	cgizo
秤	cgihu
稱	cgiha
苍	chacv
昌	chaoo
仓	charv
舱	chavv
沧	chadv
猖	chaqo
娼	chano
伥	charn
伧	charv
鲳	chaao
菖	chaco
阊	chamo
倀	charn
倉	chark
傖	chark
滄	chadk
艙	chavk
蒼	chack
錩	chajo
锠	chajo
閶	chamo
鯧	chaao
鶬	chanr
鸧	chanr
常	chexj
藏	checa
尝	chexs
偿	chers
肠	cheop
裳	chexy
嫦	chenj
徜	cherk
苌	checn
償	cherb
嘗	chexo
嚐	cheko
場	chetp
腸	cheop
萇	checn
蔵	checa
長	chean
场	chutp
敞	chuwx
昶	chudo
氅	chumx
惝	chuxk
場	chutp
廠	chuiw
唱	chiko
畅	chiap
怅	chixn
倡	chiro
鬯	chikv
悵	chixn
暢	chiap
离	ciawd
吃	ciakg
差	ciayg
刺	ciada
痴	ciabk
蚩	ciaei
嗤	ciaki
哧	ciakd
魑	ciagd
螭	ciaid
疵	ciabv
媸	ciani
笞	ciavk
郗	ciaex
鸱	cianp
眵	ciaod
喫	ciakd
摛	ciafs
鴟	cianp
黐	ciaps
持	ciefc
迟	ciezu
词	cieyk
池	ciedv
辞	ciepu
慈	ciexq
驰	ciemv
磁	cieus
匙	cieov
瓷	ciewd
茨	ciecr
弛	ciegv
雌	cievf
祠	ciepk
踟	ciezk
墀	cietn
芪	ciecq
鹚	cienq
茌	ciecu
坻	cietd
篪	cievh
糍	ciems
枱	ciemk
詞	cieyk
辭	cievu
遅	ciezy
遲	ciezu
餈	cieud
餈	ciesd
馳	ciemv
此	ciuvv
尺	ciuun
齿	ciuvk
耻	ciuev
侈	ciurd
褫	ciuph
豉	ciudy
叺	ciukn
呎	ciukn
恥	ciuex
歯	ciuvk
胣	ciuoy
跐	ciuzb
齒	ciuvk
次	ciidr
刺	ciida
赤	ciitd
赐	ciibp
斥	ciipd
翅	ciiuy
叱	ciikq
炽	ciihb
伺	ciirk
啻	ciilk
敕	ciiwa
饬	ciiul
蚝	ciiim
踅	ciizf
彳	ciipa
瘛	ciibx
傺	ciirx
佁	ciirk
佽	ciirq
勅	ciial
熾	ciihb
莿	ciicd
賜	ciibp
飭	ciiul
参	cjasp
餐	cjaua
搀	cjafd
骖	cjamp
觇	cjaaj
參	cjasp
嘽	cjaka
摻	cjafp
攙	cjafd
梴	cjamz
襜	cjapk
覘	cjaaj
辿	cjaze
鉆	cjajk
驂	cjamp
鰺	cjaap
残	cjedg
缠	cjesa
禅	cjepa
蝉	cjeia
惭	cjexj
蚕	cjeai
蟾	cjeiy
馋	cjeud
潺	cjedz
婵	cjena
孱	cjeuz
谗	cjeyd
澶	cjeda
廛	cjegt
镡	cjeju
躔	cjezt
單	cjeka
嬋	cjena
巉	cjeev
慚	cjexj
殘	cjedg
毚	cjedd
瀍	cjedt
禪	cjepa
纏	cjest
纒	cjest
蟬	cjeia
蠶	cjeai
讒	cjeyd
饞	cjeud
产	cjulp
惨	cjuxp
铲	cjuji
阐	cjuma
谄	cjuya
黪	cjuhp
冁	cjubn
蒇	cjucb
骣	cjumz
䅟	cjuhp
刬	cjudg
剗	cjudg
剷	cjudl
啴	cjuka
嘽	cjuka
囅	cjukn
慘	cjuxp
旵	cjuoe
浐	cjudi
滻	cjudf
產	cjuwf
産	cjulf
蕆	cjucb
襝	cjupr
諂	cjuya
鏟	cjujf
闡	cjuma
驏	cjumz
黲	cjuhp
颤	cjiwa
灿	cjihe
掺	cjifp
璨	cjiwm
忏	cjixu
粲	cjima
孱	cjiuz
羼	cjiuy
儳	cjird
剗	cjidg
懺	cjixd
燦	cjihm
韂	cjigk
顫	cjiwa
揣	ckafa
搋	ckafh
揣	ckufa
踹	ckiza
嘬	ckiky
膪	ckiol
窗	clabd
葱	clacx
疮	clabv
囱	clapd
創	cladr
瘡	clabk
窓	claxb
床	clegm
幢	cleja
噇	cleka
橦	clema
牀	cledm
闯	clumm
闖	clumm
创	clidr
怆	clixv
創	clidr
愴	clixk
搓	coafg
戳	coayg
磋	coaug
撮	coafy
蹉	coazg
踔	coazu
嵯	coeeg
矬	coeut
鹾	coeag
痤	coebt
瘥	coebg
鹺	coeag
脞	couot
错	coijo
措	coifo
挫	coift
绰	coisu
啜	coiky
龊	coiiz
辍	coiiy
锉	coijt
焯	coihu
厝	coiio
剒	coidc
婥	coinu
婼	coink
惙	coixy
棤	coimo
畷	coity
綴	coisy
綽	coisu
莝	coict
輟	coiiy
銼	coijt
錯	coijo
齪	coiiz
穿	crabp
川	crapa
蹿	craza
撺	crafa
氚	craqa
汆	crard
巛	cravv
镩	craja
攛	crafu
躥	crazu
鑹	craju
传	crerd
船	crevk
椽	cremn
遄	creze
伝	crers
伝	crers
傳	crerc
攢	crefb
喘	cruka
舛	crupa
膞	cruoc
窜	criba
串	criaa
篡	crivs
钏	crija
爨	criph
竄	cribu
釧	crija
鑹	criju
冲	csada
充	csawe
涌	csada
匆	csagd
聪	csaex
葱	csacx
忡	csaxa
憧	csaxa
囱	csapd
璁	csawx
骢	csamx
偬	csarx
艟	csava
舂	csafa
枞	csamr
苁	csacr
茺	csace
㳘	csade
囪	csapx
從	csarr
摏	csafa
樅	csamr
橦	csama
沖	csada
翀	csaya
聡	csaex
聰	csaex
蓯	csacr
蔥	csacx
衝	csard
驄	csamx
从	cserr
种	cseha
重	csepa
虫	csead
崇	cseex
丛	csear
烛	csehi
茧	cseci
琮	csewx
淙	csedx
叢	cseay
従	cserr
從	cserr
悰	csexx
蟲	cseii
宠	csubl
埫	csutk
寵	csubl
铳	csije
衝	csird
銃	csije
出	cuaek
初	cuapd
粗	cuamq
樗	cuamg
䝙	cuavk
䢺	cuaee
貙	cuavk
齣	cuavk
除	cueeh
厨	cueic
躇	cuezo
雏	cuedf
橱	cuemc
锄	cuejl
蜍	cueih
刍	cuede
滁	cuedh
蹰	cuezc
殂	cuedq
徂	cuera
儲	cuero
廚	cuegc
櫥	cuemc
芻	cuege
蒭	cuece
躕	cuezc
鋤	cuejl
雛	cuegf
楚	cuumr
础	cuuuk
储	cuuro
褚	cuupo
楮	cuumo
杵	cuumu
柠	cuumd
憷	cuuxr
儲	cuuro
処	cuuwj
礎	cuuur
處	cuuhj
处	cuiwd
触	cuiji
促	cuirz
卒	cuiwu
畜	cuiwt
醋	cuiyo
蹙	cuigz
簇	cuivu
猝	cuiqu
搐	cuift
矗	cuiua
怵	cuixd
蹴	cuizd
黜	cuihk
绌	cuisk
憷	cuixr
亍	cuiea
蔟	cuicu
酢	cuiya
俶	cuiry
斶	cuiji
歜	cuisq
絀	cuisk
處	cuihj
觸	cuiji
吹	cvakq
催	cvarf
崔	cvaef
摧	cvaff
衰	cvawy
炊	cvahq
榱	cvamy
垂	cvepa
锤	cveja
捶	cvefa
椎	cvemf
槌	cvemz
陲	cveea
棰	cvema
倕	cvera
圌	cveka
箠	cveva
錘	cveja
鎚	cvejz
洒	cvudx
璀	cvuwf
脆	cviov
翠	cviyu
粹	cvimu
悴	cvixu
啐	cviku
淬	cvidu
萃	cvicu
瘁	cvibu
毳	cvimm
伜	cviru
倅	cviru
崒	cviei
焠	cvihu
粋	cvimu
翆	cviyu
欻	cxahq
村	cyamc
春	cyafo
椿	cyamo
皴	cyasp
蝽	cyaio
䲠	cyayo
堾	cyato
邨	cyaua
鰆	cyayo
存	cyeuz
纯	cyesv
唇	cyeik
淳	cyedz
醇	cyeyz
鹑	cyenw
莼	cyecv
拵	cyefz
純	cyesv
脣	cyeio
膞	cyeoc
蓴	cyecc
鶉	cyenw
蠢	cyufi
忖	cyuxc
寸	cyiad
吋	cyikv
抽	czafa
楱	czamd
瘳	czabp
搊	czafe
仇	czerj
愁	czexh
筹	czevc
酬	czeya
绸	czesk
踌	czezc
畴	czetc
稠	czehk
惆	czexk
俦	czerc
雠	czeyf
帱	czejc
儔	czerc
幬	czejc
椆	czemk
疇	czetc
籌	czevc
紬	czesa
綢	czesk
裯	czepk
讎	czeyf
躊	czezc
丑	czuva
瞅	czuoh
侴	czurd
杻	czuma
醜	czuvg
臭	czipq
凑	czidd
辏	cziid
腠	cziod
湊	czidd
輳	cziid
答	daavk
搭	daafk
嗒	daakk
耷	daade
哒	daakz
褡	daapk
咑	daakd
噠	daakz
墶	daatz
躂	daazz
打	daefd
达	daezd
答	daevk
胆	daeoa
妲	daena
瘩	daebk
鞑	daegz
靼	daega
怛	daexa
笪	daeva
荙	daecz
薘	daecz
達	daezy
韃	daegz
打	daufd
大	daian
垯	davtz
刀	dcagp
叨	dcakd
忉	dcaxd
氘	dcaqa
舠	dcavd
捯	dcefd
倒	dcurd
导	dcuvc
岛	dcune
祷	dcupc
捣	dcufe
蹈	dcuza
導	dcucv
島	dcune
嶋	dcuen
捯	dcufd
搗	dcufe
擣	dcufc
禱	dcupc
道	dcizq
到	dcida
倒	dcird
盗	dcimd
稻	dciha
悼	dcixu
纛	dcifs
焘	dcihf
幬	dcijc
燾	dcihu
盜	dcimd
稲	dciho
待	ddarc
呆	ddakm
歹	dduad
逮	dduzv
傣	ddurd
大	ddian
带	ddifj
代	ddird
待	ddirc
袋	ddiyr
戴	dditg
黛	ddihr
隶	ddivn
贷	ddibr
逮	ddizv
怠	ddixs
殆	ddidk
岱	ddier
玳	ddiwd
绐	ddisk
迨	ddizs
甙	ddicq
骀	ddimk
埭	dditn
叇	ddiez
垈	dditr
帯	ddifj
帶	ddifj
紿	ddisk
貸	ddibr
軚	ddiid
靆	ddiyz
嘚	deakc
得	deerc
德	deerx
锝	deejc
徳	deerx
悳	deexu
鍀	deejc
的	devbd
地	devtv
得	devrc
底	devgd
登	dgadv
灯	dgahd
噔	dgakd
簦	dgavd
僜	dgara
燈	dgahd
等	dguvc
戥	dguog
瞪	dgiod
邓	dgiey
澄	dgidd
凳	dgivj
蹬	dgizd
镫	dgijd
磴	dgiud
嶝	dgied
僜	dgira
憕	dgixa
櫈	dgimj
鄧	dgiev
鐙	dgijd
当	dhaxe
铛	dhaje
裆	dhape
儅	dhart
噹	dhakt
珰	dhawe
璫	dhawt
當	dhaxt
筜	dhavw
襠	dhapt
鐺	dhajt
党	dhuxe
挡	dhufe
谠	dhuye
擋	dhuft
檔	dhumt
讜	dhuyh
黨	dhuxh
荡	dhicp
档	dhime
宕	dhibu
砀	dhiup
凼	dhikd
菪	dhicu
垱	dhite
壋	dhitt
擋	dhift
檔	dhimt
氹	dhidg
當	dhixt
盪	dhimd
碭	dhiup
蕩	dhicp
低	diard
滴	diadk
堤	diatr
氐	diapd
镝	diajk
羝	diayd
䃅	diauu
啲	diakd
磾	diaua
鏑	diajk
鞮	diagr
的	diebd
敌	diewp
迪	dieza
狄	dieqh
笛	dieva
邮	dieea
嘀	diekk
嫡	dienk
翟	dieyf
涤	diedm
荻	diech
莜	diecw
籴	dierm
觌	dieuj
敵	diewl
滌	diedm
糴	dierf
絛	diers
覿	dieuj
鏑	diejk
髢	dieav
底	diugd
抵	diufd
邸	diuep
诋	diuyd
砥	diuud
氐	diupd
柢	diumd
骶	diugd
坻	diutd
埞	diutr
牴	diund
茋	diucd
詆	diuyd
的	diibd
地	diitv
第	diivp
弟	diibp
帝	diilj
蒂	diicj
递	diizb
隶	diivn
缔	diisj
棣	diimn
谛	diiyj
娣	diinp
睇	diiop
碲	diiuj
䗖	diiij
俤	diirp
哋	diikx
墑	diitk
媂	diinj
杕	diimd
禘	diipj
締	diisj
菂	diicd
蔕	diicj
螮	diiij
諦	diiyj
逓	diizp
遞	diizp
单	djaba
担	djafa
丹	djapa
耽	djaev
眈	djaov
郸	djaeb
聃	djaea
殚	djada
儋	djary
箪	djava
瘅	djaba
単	djaxa
單	djaka
擔	djafk
殫	djada
癉	djaba
簞	djava
鄲	djaek
担	djufa
胆	djuoa
掸	djufa
疸	djuba
亶	djuwa
嘽	djuka
撢	djufu
撣	djufa
膽	djuok
賧	djubh
赕	djubh
但	djira
石	djiak
淡	djidh
担	djifa
弹	djiga
胆	djioa
蛋	djivi
旦	djioa
诞	djiyv
惮	djixa
澹	djidy
氮	djiqh
啖	djikh
萏	djica
倓	djirh
啗	djika
噉	djikw
弾	djiga
彈	djiga
憚	djixa
憺	djixk
擔	djifk
沊	djidd
疍	djiva
癉	djiba
蜑	djiiz
誕	djiyv
丁	dkaaa
灯	dkahd
盯	dkaod
叮	dkakd
钉	dkajd
玎	dkawd
仃	dkard
疔	dkabd
耵	dkaed
釘	dkajd
顶	dkuda
鼎	dkuov
酊	dkuyd
頂	dkuda
定	dkibr
订	dkiyd
锭	dkijr
铤	dkijz
碇	dkiur
腚	dkior
啶	dkikr
掟	dkifr
萣	dkicr
訂	dkiyd
鋌	dkijz
錠	dkijr
飣	dkiud
饤	dkiud
颠	dmaua
巅	dmaea
癫	dmaba
掂	dmafk
滇	dmadb
巔	dmaea
槇	dmamb
槙	dmamb
癲	dmaba
顛	dmaua
点	dmuha
典	dmuab
踮	dmuzk
碘	dmuub
點	dmuhk
电	dmiav
店	dmigk
殿	dmiuy
垫	dmitf
甸	dmigt
奠	dmiqd
惦	dmixk
淀	dmidr
玷	dmiwk
佃	dmirt
靛	dmifr
钿	dmijt
坫	dmitk
癜	dmiby
簟	dmivu
埝	dmitx
阽	dmiek
唸	dmikx
唸	dmikx
墊	dmitu
扂	dmihk
澱	dmidy
鈿	dmijt
電	dmiyv
雕	dnapf
刁	dnaga
貂	dnavk
叼	dnakp
凋	dnadk
碉	dnauk
鲷	dnaak
彫	dnakp
汈	dnada
簓	dnavp
鯛	dnaak
鵰	dnank
屌	dnuuj
调	dniyk
掉	dnifu
吊	dnikj
钓	dnijd
莜	dnicw
铞	dnijj
铫	dnijd
嬥	dninf
弔	dniga
弔	dniva
窎	dnibn
調	dniyk
釣	dnijd
銚	dnijd
銱	dnijj
多	doapd
哆	doakd
咄	doakk
掇	doafy
裰	doapy
㙍	doaty
剟	doady
敠	doayy
度	doegy
夺	doedc
踱	doezy
兑	doebe
铎	doeja
奪	doedc
鐸	doeju
杂	doujm
躲	douum
朵	doujm
垛	doutm
哚	doukm
缍	dousa
亸	douwa
嚲	douwa
埵	douta
綞	dousa
堕	doite
舵	doivv
跺	doizm
剁	doidj
惰	doixo
垛	doitm
墮	doite
柮	doime
馱	doimd
爹	dpafd
跌	dpazn
跌	dpezn
蝶	dpeim
叠	dpeyq
迭	dpezp
碟	dpeum
谍	dpeym
喋	dpekm
牒	dpepm
鲽	dpeam
堞	dpetm
耋	dpett
蹀	dpezm
垤	dpett
瓞	dpegn
䏲	dpeop
咥	dpekt
昳	dpeon
楪	dpemm
畳	dpetq
疊	dpetq
絰	dpest
绖	dpest
諜	dpeym
鰈	dpeam
丢	dqaps
铥	dqajs
丟	dqaps
銩	dqajs
端	drala
短	druud
断	drimj
段	dripy
锻	drijy
缎	drisy
煅	drihy
椴	drimy
簖	drivj
塅	drity
斷	drisj
籪	drivj
緞	drisy
鍛	drijy
东	dsaad
冬	dsawd
咚	dsakd
氡	dsaqd
鸫	dsana
岽	dsaed
崬	dsaen
東	dsaan
苳	dsacd
鶇	dsana
鶫	dsaan
鼕	dsaud
懂	dsuxa
董	dsuca
动	dsiel
洞	dsidk
冻	dsidd
栋	dsimd
峒	dsiek
胴	dsiok
侗	dsirk
恫	dsixk
垌	dsitk
硐	dsiuk
胨	dsiod
凍	dsidd
動	dsipl
戙	dsikg
棟	dsimd
腖	dsion
都	duaet
督	duaoa
嘟	duake
厾	duags
闍	duamo
独	dueqi
毒	duefd
读	dueyd
渎	duedd
犊	duend
牍	duepd
黩	duehd
椟	duemd
髑	duegi
碡	dueud
櫝	duemb
瀆	duedb
牘	duepb
犢	duenb
獨	dueqi
読	dueye
讀	dueyb
黷	duehb
赌	duubo
肚	duuot
堵	duuto
睹	duuoo
竺	duuve
笃	duuvm
篤	duuvm
賭	duubo
度	duigy
杜	duimt
肚	duiot
渡	duidy
妒	duinu
镀	duijy
蠹	duiai
芏	duict
鍍	duijy
追	dvazp
堆	dvatf
㨃	dvufz
对	dviyc
队	dvier
兑	dvibe
怼	dvixy
碓	dviuf
镦	dvijw
憝	dvixw
兌	dvibe
対	dvidc
對	dviac
懟	dvixa
隊	dvien
得	dwurc
嗲	dxukd
蹲	dyazc
敦	dyaww
吨	dyakv
墩	dyatw
礅	dyauw
噸	dyaka
惇	dyaxz
鐓	dyajw
盹	dyuov
趸	dyuaz
躉	dyucz
顿	dyiaa
盾	dyipo
遁	dyizp
沌	dyidv
钝	dyijv
囤	dyikv
炖	dyihv
砘	dyiuv
坉	dyitv
忳	dyixv
扽	dyifv
燉	dyihw
鈍	dyijv
頓	dyiaa
都	dzaet
兜	dzaep
蔸	dzace
篼	dzave
剅	dzada
斗	dzudu
抖	dzufu
陡	dzuer
蚪	dzuiu
唞	dzuku
枓	dzumu
枡	dzuma
逗	dziza
豆	dziaq
窦	dzibd
痘	dzibq
竇	dzibb
脰	dzioa
讀	dziyb
闘	dzimc
鬥	dziaa
发	faavd
発	faavv
發	faavy
罚	faesd
伐	faerg
乏	faepn
阀	faemg
筏	faevg
垡	faetr
罰	faesd
閥	faemg
法	fauds
砝	fauus
鍅	faujs
法	faids
珐	faiws
琺	faiws
髪	faivy
分	ffabd
纷	ffasd
吩	ffakd
氛	ffaqd
芬	ffacd
玢	ffawd
酚	ffayd
棻	ffacm
紛	ffasd
焚	ffehm
坟	ffetw
汾	ffedd
棼	ffemd
墳	ffetb
濆	ffedb
豮	ffeab
鼢	ffeud
粉	ffumd
分	ffibd
份	ffird
奋	ffidt
愤	ffixb
忿	ffixb
粪	ffimb
偾	ffirb
鲼	ffiab
瀵	ffidb
僨	ffirb
坋	ffitd
奮	ffidt
憤	ffixb
糞	ffimb
鱝	ffiab
风	fgajx
封	fgatc
峰	fgaef
锋	fgajf
疯	fgabf
枫	fgamf
丰	fgaaa
蜂	fgaif
烽	fgahf
沣	fgadf
酆	fgaee
砜	fgauf
葑	fgacc
峯	fgaef
崶	fgaec
楓	fgamf
沨	fgadx
灃	fgadd
瘋	fgabf
碸	fgauf
豊	fgaad
豐	fgaad
鋒	fgajf
風	fgaji
冯	fgedm
逢	fgezw
渢	fgedf
縫	fgesz
馮	fgedm
讽	fguyf
唪	fguka
諷	fguyf
凤	fgijy
奉	fgifa
缝	fgisz
俸	fgira
縫	fgisz
赗	fgibo
鳳	fgijh
方	fhawp
芳	fhacf
坊	fhatf
枋	fhamf
邡	fhaef
匚	fhaav
钫	fhajf
蚄	fhaif
鈁	fhajf
房	fhehf
防	fheef
妨	fhenf
坊	fhetf
肪	fheof
鲂	fheaf
魴	fheaf
仿	fhurf
访	fhuyf
彷	fhurf
纺	fhusf
舫	fhuvf
倣	fhurw
昉	fhuof
紡	fhusf
訪	fhuyf
放	fhiwf
翻	fjapy
番	fjapt
帆	fjajd
藩	fjact
幡	fjajt
噃	fjakt
飜	fjapa
凡	fjejd
烦	fjeha
繁	fjesr
帆	fjejd
樊	fjedm
蕃	fject
矾	fjeud
燔	fjeht
钒	fjejd
蘩	fjecs
蹯	fjezt
墦	fjett
煩	fjeha
璠	fjewt
礬	fjeum
釩	fjejd
鐇	fjejt
鷭	fjenp
反	fjupy
返	fjuzp
魬	fjuay
饭	fjiuy
范	fjicv
犯	fjiqv
泛	fjidn
梵	fjimd
贩	fjiby
畈	fjity
氾	fjidv
氾	fjidv
汎	fjidd
範	fjivv
販	fjiby
飯	fjiuy
覅	fnixp
佛	foera
仏	foers
仏	foers
夫	fuaan
肤	fuaon
敷	fuawa
孵	fuapz
趺	fuazn
跗	fuazc
麸	fuafn
呋	fuakn
稃	fuahz
伕	fuard
伕	fuaan
垺	fuatz
枹	fuamv
砆	fuaun
膚	fuaho
麩	fuaan
还	fueza
夫	fuean
服	fueoy
福	fuept
伏	fuerq
浮	fuedz
扶	fuefn
符	fuevc
幅	fuejt
弗	fueva
芙	fuecn
拂	fuefa
俘	fuerz
蝠	fueit
袱	fuepq
辐	fueit
匐	fuegt
孚	fuezv
涪	fuedk
蚨	fuein
茯	fuecq
苻	fuecc
蜉	fueiz
凫	fuenj
怫	fuexa
氟	fueqa
菔	fuecy
芾	fuecj
绂	fuesd
幞	fuejn
黻	fuead
砩	fueua
桴	fuemz
绋	fuesa
莩	fuecz
罘	fuesd
祓	fuepd
鞴	fuega
郛	fueev
咈	fueka
彿	fuepa
彿	fuera
彿	fuera
払	fuefs
榑	fuemc
洑	fuedq
箙	fuevy
紱	fuesd
紼	fuesa
艀	fuevz
艴	fuevv
茀	fueca
褔	fuept
輻	fueit
鳧	fuenj
府	fuugc
抚	fuufv
腐	fuugr
甫	fuuad
斧	fuufj
俯	fuurc
辅	fuuid
脯	fuuod
腑	fuuoc
釜	fuufa
拊	fuufc
呒	fuukv
滏	fuuda
黼	fuuad
㕮	fuukx
嘸	fuukv
撫	fuufh
蜅	fuuzd
輔	fuuid
頫	fuupb
鯆	fuuad
服	fuioy
父	fuibx
复	fuirw
怀	fuixd
仅	fuiry
负	fuibd
副	fuida
付	fuirc
富	fuibt
妇	fuine
附	fuiec
傅	fuirc
腹	fuiow
咐	fuikc
覆	fuixw
覆	fuirw
赴	fuizd
赋	fuibd
缚	fuisc
驸	fuimc
馥	fuihw
阜	fuipu
蝮	fuiiw
讣	fuiyd
鲋	fuiac
鳆	fuiaw
赙	fuibc
㳇	fuidx
冨	fuibt
婦	fuinj
復	fuirw
榑	fuimc
縛	fuisc
複	fuipw
訃	fuiyd
負	fuibd
賦	fuibd
賻	fuibc
駙	fuimc
鮒	fuiac
鰒	fuiaw
飞	fwavd
非	fwaaa
菲	fwaca
妃	fwanv
啡	fwaka
绯	fwasa
霏	fwaya
扉	fwaha
鲱	fwaaa
緋	fwasa
飛	fwavd
鯡	fwaaa
肥	fweov
腓	fweoa
淝	fwedv
蜰	fweio
菲	fwuca
匪	fwuka
斐	fwuwa
翡	fwuya
诽	fwuya
蜚	fwuia
悱	fwuxa
榧	fwuma
篚	fwuva
朏	fwuoe
棐	fwuam
誹	fwuya
费	fwibv
废	fwigd
沸	fwida
肺	fwioj
吠	fwikq
狒	fwiqa
怫	fwixa
芾	fwicj
痱	fwiba
砩	fwiua
镄	fwijb
剕	fwida
屝	fwiua
廃	fwigv
廢	fwigy
蜰	fwiio
費	fwibv
鐨	fwijb
垺	fzetz
芣	fzecx
否	fzuak
缶	fzurk
缶	fzuff
缹	fzuhf
衃	fzuxa
咖	gaakk
旮	gaajo
㹢	gaaqk
嘎	gaekg
噶	gaekv
尜	gaexx
钆	gaejv
軋	gaeiv
釓	gaejv
尕	gaugx
嗰	gaukk
𠮶	gauku
尬	gaija
高	gcawk
糕	gcamh
膏	gcawo
羔	gcahy
皋	gcabu
篙	gcavk
睾	gcapu
槔	gcamu
皐	gcabu
搞	gcufk
稿	gcuhk
镐	gcujk
槁	gcumk
缟	gcusk
杲	gcuom
藁	gcucm
筶	gcuvk
縞	gcusk
鎬	gcujk
告	gcink
诰	gciyk
郜	gcien
锆	gcijk
筶	gcivk
誥	gciyk
鋯	gcijk
该	gdayr
赅	gdabr
垓	gdatr
陔	gdaer
晐	gdaor
荄	gdacr
該	gdayr
賅	gdabr
改	gduwv
盖	gdimy
概	gdimv
丐	gdiag
溉	gdidv
钙	gdijg
戤	gdigg
蓋	gdicm
鈣	gdijg
哥	geadk
歌	geadq
割	geadb
戈	geaad
咯	geakk
胳	geaok
搁	geafk
鸽	geanr
疙	geabg
纥	geasg
圪	geatg
仡	gearg
袼	geapk
擱	geafk
紇	geasg
鴿	geanr
格	geemk
阁	geemk
隔	geeea
革	geeca
葛	geecv
骼	geegk
蛤	geeik
嗝	geeka
膈	geeoa
鬲	geeaa
搿	geeru
镉	geeja
塥	geeta
擱	geefk
鎘	geeja
閣	geemk
閤	geemk
合	geurk
葛	geucv
舸	geuvk
哿	geulk
個	geurk
嗰	geukk
蓋	geucm
𠮶	geuku
个	geira
各	geiwk
硌	geiuk
铬	geijk
虼	geiig
個	geirk
箇	geivk
鉻	geijk
個	gevrk
跟	gfazn
根	gfamn
哏	gfekn
艮	gfuvn
亘	gfiaa
艮	gfivn
茛	gficn
亙	gfiaa
更	ggaan
耕	ggala
庚	ggagn
羹	ggayd
赓	ggagb
賡	ggagb
鶊	ggang
鹒	ggang
耿	ggueh
哽	ggukn
梗	ggumn
埂	ggutn
鲠	gguan
绠	ggusn
㹴	gguqn
綆	ggusn
鯁	gguan
更	ggian
亘	ggiaa
亙	ggiaa
暅	ggioa
𣈶	ggioa
刚	ghadk
钢	ghajx
罡	ghasv
冈	ghakx
纲	ghasx
扛	ghafg
缸	ghafg
肮	ghaoj
肛	ghaog
㭎	ghamx
冮	ghadg
剛	ghadk
堽	ghatv
岡	ghakk
棡	ghamk
槓	ghamb
綱	ghask
舡	ghavg
鋼	ghaje
奋	ghudt
港	ghudv
岗	ghuex
崗	ghuek
杠	ghimg
戆	ghixl
戇	ghixl
槓	ghimb
筻	ghivn
干	gjaau
甘	gjaca
乾	gjaug
乾	gjaau
尴	gjajm
杆	gjamu
肝	gjaou
竿	gjavu
柑	gjamc
坩	gjatc
矸	gjauu
泔	gjadc
苷	gjacc
酐	gjayu
疳	gjabc
咁	gjaka
尷	gjaum
浛	gjadk
玕	gjawu
虷	gjaiu
感	gjuxg
敢	gjuwv
赶	gjuzu
橄	gjumw
秆	gjuhu
擀	gjufu
澉	gjudw
桿	gjumu
稈	gjuhu
趕	gjuzu
个	gjira
干	gjiau
赣	gjilb
淦	gjidj
旰	gjiou
绀	gjisc
㽏	gjidc
幹	gjiuu
紺	gjisc
贛	gjilb
乖	gkapv
掴	gkafw
拐	gkufl
柺	gkuml
怪	gkixt
夬	gkivn
光	glaxe
横	glamb
咣	glake
胱	glaoe
桄	glame
垙	glatg
洸	glade
广	gludi
犷	gluqg
広	glugs
廣	glugb
獷	gluqb
横	glimb
逛	glizq
桄	glime
郭	goaew
锅	goajd
蝈	goaiw
聒	goaek
呙	goakd
埚	goatd
崞	goaez
咼	goakk
啯	goakw
嘓	goaka
堝	goatk
渦	goadk
蟈	goaia
鍋	goajk
国	goekw
帼	goejw
虢	goevh
馘	goeqk
㕵	goekw
國	goeka
幗	goeja
摑	goefa
腘	goeow
膕	goeoa
果	gouan
裹	gouwy
椁	goumz
猓	gouqm
蜾	gouin
槨	goume
粿	goumn
过	goizc
過	goizk
关	graqd
官	grabk
观	grayj
冠	grabc
棺	gramk
莞	grace
倌	grark
鳏	graad
蒄	gracc
観	grarj
觀	grayj
関	gramd
關	grama
鰥	graad
管	gruvk
馆	gruuk
莞	gruce
脘	gruoe
筦	gruve
舘	grurk
館	gruuk
惯	grixb
贯	gribv
冠	gribc
灌	gridf
罐	griff
盥	grimp
掼	grifb
鹳	grinc
涫	gridk
婠	grink
慣	grixb
摜	grifb
毌	grivu
爟	grihf
觀	griyj
貫	gribv
鸛	grinc
公	gsabs
功	gsagl
工	gsaaa
攻	gsawg
宫	gsabk
供	gsarb
恭	gsacx
弓	gsavg
躬	gsaug
龚	gsalb
蚣	gsais
觥	gsaje
肱	gsaos
䢼	gsaec
宮	gsabk
龔	gsalb
拱	gsufb
巩	gsugd
汞	gsugd
珙	gsuwb
廾	gsuaa
鞏	gsugg
共	gsicb
供	gsirb
贡	gsibg
唝	gsikb
貢	gsibg
姑	guank
孤	guazg
估	guark
咕	guakk
辜	guauu
菇	guack
呱	guakn
箍	guavj
沽	guadk
鸪	guanu
轱	guaik
觚	guajg
蛄	guaik
菰	guacg
酤	guayk
軲	guaik
轂	guauy
鴣	guanu
古	guuuk
股	guuoy
骨	guuko
谷	guubk
鼓	guuuy
滑	guudg
蛊	guumi
汩	guudo
臌	guuoy
鹄	guunn
鹘	guung
牯	guunk
钴	guujk
嘏	guuuy
毂	guuuy
瞽	guuou
诂	guuyk
罟	guusk
榖	guuuy
榾	guumo
皷	guuuy
穀	guuuy
蓇	guuco
蠱	guumi
詁	guuyk
賈	guubx
轂	guuuy
鈷	guujk
鵠	guunn
故	guiwu
顾	guiia
固	guikk
估	guirk
雇	guihf
锢	guijk
梏	guimk
痼	guibk
崮	guiek
牿	guink
僱	guirf
堌	guitk
錮	guijk
顧	guiha
鯝	guiak
鲴	guiak
规	gvaaj
归	gvaae
龟	gvadv
瑰	gvawg
闺	gvamt
傀	gvarg
圭	gvatt
硅	gvaut
皈	gvaby
鲑	gvaat
妫	gvand
亀	gvadv
媯	gvanh
嬀	gvanh
帰	gvaaj
槻	gvamj
歸	gvape
溈	gvadh
潙	gvadh
珪	gvawt
袿	gvapt
規	gvaaj
閨	gvamt
鮭	gvaat
龜	gvapx
鬼	gvups
诡	gvuyv
轨	gvuij
癸	gvuvd
晷	gvuok
宄	gvubj
庋	gvugy
匦	gvukj
簋	gvuvm
匭	gvukj
姽	gvunv
氿	gvudj
詭	gvuyv
軌	gvuij
贵	gviba
跪	gvizv
桂	gvimt
桧	gvims
刽	gvidr
炅	gvioh
炔	gvihn
刿	gvide
鳜	gviaq
劊	gvidr
劌	gvidv
匱	gvikb
攰	gviul
檜	gvimo
櫃	gvimb
瞶	gviob
筀	gvivt
貴	gviba
鱖	gviaq
给	gwusk
給	gwusk
括	gxafk
瓜	gxapn
刮	gxadp
鸹	gxanp
栝	gxamk
胍	gxaog
筈	gxavk
蝸	gxaik
颪	gxaai
颳	gxafk
鴰	gxanp
寡	gxubd
剐	gxudk
剮	gxudk
挂	gxift
卦	gxitd
褂	gxipd
诖	gxiyt
啩	gxikd
坬	gxitg
掛	gxifd
罫	gxisd
袿	gxipt
詿	gxiyt
滚	gyudy
衮	gyuwy
鲧	gyuas
辊	gyuiv
磙	gyuuy
绲	gyusv
滾	gyudy
緄	gyusv
袞	gyuwy
輥	gyuiv
鯀	gyuas
棍	gyimv
句	gzagk
勾	gzags
沟	gzads
钩	gzajs
篝	gzava
佝	gzark
枸	gzamk
鞲	gzaga
缑	gzasu
泃	gzadk
溝	gzada
緱	gzasu
鈎	gzajs
鉤	gzajk
韝	gzaaa
构	gzums
狗	gzuqk
苟	gzuck
枸	gzumk
笱	gzuvk
岣	gzuek
耇	gzutk
够	gzigd
构	gzims
勾	gzigs
购	gzibs
垢	gzitk
媾	gzina
诟	gziyk
彀	gziuy
遘	gziza
夠	gzidk
姤	gzink
搆	gzifa
構	gzima
覯	gziaj
觏	gzicj
詬	gziyk
購	gziba
哈	haakk
铪	haajk
鉿	haajk
蛤	haeik
哈	haukk
吓	haikd
蒿	hcack
薅	hcacc
嚆	hcakk
号	hcekg
毫	hcewm
豪	hcewn
嚎	hcekn
壕	hcetn
嗥	hceku
濠	hcedn
蚝	hceim
號	hcekj
蠔	hcein
好	hcunz
郝	hcuet
好	hcinz
号	hcikg
浩	hcidk
耗	hcilm
昊	hciod
皓	hcibk
灏	hcida
颢	hcioa
晧	hciok
灝	hcida
號	hcikj
鎬	hcijk
顥	hcioa
咳	hdakr
嗨	hdakd
咍	hdakk
还	hdeza
孩	hdezr
骸	hdegr
咴	hdekh
還	hdezy
海	hdudd
醢	hduym
胲	hduor
害	hdibk
骇	hdimr
亥	hdiwr
氦	hdiqr
嗐	hdikk
駭	hdimr
喝	heakv
呵	heakk
诃	heayk
嗬	heakk
訶	heayk
和	heehk
何	heerk
合	heerk
河	heedk
核	heemr
荷	heeck
盒	heemr
蝎	heeiv
禾	heepm
阖	heemm
颌	heera
涸	heedk
阂	heemr
劾	heewl
貉	heevk
菏	heeck
盍	heemt
翮	heeay
曷	heeov
狢	heeqk
盉	heemh
紇	heesg
覈	heexw
郃	heeer
閡	heemr
閤	heemk
闔	heemm
鞨	heegv
頜	heera
齕	heeig
龁	heeig
和	heihk
喝	heikv
赫	heitd
贺	heibl
荷	heick
鹤	heind
褐	heipv
壑	heita
垎	heitk
暍	heiov
賀	heibl
鶴	heind
痕	hfebn
很	hfurn
狠	hfuqn
哏	hfukn
恨	hfixn
哼	hgaka
亨	hgawa
横	hgemb
衡	hgerd
恒	hgexa
蘅	hgecd
珩	hgewd
桁	hgemd
姮	hgena
恆	hgexa
橫	hgemb
横	hgimb
堼	hgitt
橫	hgimb
夯	hhadl
行	hherd
航	hhevj
杭	hhemj
吭	hhekj
肮	hheoj
桁	hhemd
颃	hhewa
垳	hhetd
絎	hhesd
绗	hhesd
裄	hhepd
頏	hhewa
沆	hhidj
憨	hjaxv
酣	hjayc
鼾	hjapu
顸	hjaaa
蚶	hjaic
頇	hjaaa
寒	hjebd
韩	hjeua
含	hjerk
涵	hjedk
函	hjevk
邯	hjeec
晗	hjeok
邗	hjeea
焓	hjehk
崡	hjeek
嵅	hjeeg
浛	hjedk
韓	hjeua
喊	hjukk
厂	hjuap
罕	hjubu
阚	hjumw
㘎	hjukw
㘚	hjukw
蔊	hjucu
和	hjihk
汉	hjidy
汗	hjidu
悍	hjixu
撼	hjifx
憾	hjixx
翰	hjiuy
旱	hjiou
颔	hjira
瀚	hjidy
捍	hjifu
菡	hjick
焊	hjihu
撖	hjifw
垾	hjitu
扞	hjifu
暵	hjiod
浛	hjidk
漢	hjidn
莟	hjick
頷	hjira
駻	hjimu
怀	hkexd
淮	hkedf
槐	hkemg
徊	hkerk
踝	hkezn
懐	hkexy
懷	hkexy
耲	hkely
坏	hkitd
孬	hkiaz
壊	hkity
壞	hkity
慌	hlaxv
荒	hlacv
肓	hlawo
塃	hlatv
黄	hlecb
皇	hlebw
横	hlemb
惶	hlexw
凰	hlejw
煌	hlehw
簧	hlevb
蝗	hleiw
徨	hlerw
潢	hledb
遑	hlezb
磺	hleub
璜	hlewb
隍	hleew
篁	hlevw
湟	hledw
蟥	hleib
鳇	hleaw
癀	hlebb
喤	hlekw
媓	hlenw
艎	hlevw
鍠	hlejw
锽	hlejw
鰉	hleaw
黃	hlecb
晃	hluog
恍	hluxg
谎	hluyv
幌	hlujg
晄	hluoe
滉	hludg
謊	hluyv
横	hlimb
晃	hliog
㿠	hlibg
豁	hoabk
锪	hoajx
攉	hoaff
劐	hoadc
耠	hoalk
鍃	hoajx
和	hoehk
活	hoedk
佸	hoerk
火	houdr
伙	hourh
夥	houad
钬	houjh
鈥	houjh
和	hoihk
或	hoiga
获	hoicq
惑	hoixg
货	hoibr
霍	hoiyf
祸	hoipd
豁	hoibk
嚯	hoikf
镬	hoijy
藿	hoicf
蠖	hoiiy
攉	hoiff
劐	hoidc
㸌	hoiha
嚄	hoiky
彟	hoiey
彠	hoiey
擭	hoify
獲	hoiqy
禍	hoipk
穫	hoihy
貨	hoibr
鑊	hoijy
欢	hrayq
獾	hraqf
歓	hrarq
歡	hracq
还	hreza
环	hrewd
桓	hrema
寰	hreby
鬟	hreay
亘	hreaa
圜	hreky
缳	hresy
洹	hreda
萑	hrecf
锾	hrejy
垸	hrete
䴉	hrens
嬛	hreny
峘	hreea
環	hrewy
繯	hresy
荁	hreca
貆	hreva
還	hrezy
鍰	hrejy
鐶	hrejy
镮	hrejy
鹮	hrens
缓	hrusy
㬊	hruoy
緩	hrusy
换	hrifn
幻	hrivg
唤	hrikn
患	hrixa
焕	hrihn
涣	hridn
宦	hriba
浣	hride
痪	hribn
奂	hridn
豢	hribn
擐	hrify
逭	hrizb
漶	hridx
鲩	hriae
㬊	hrioy
喚	hrikn
奐	hridn
換	hrifn
渙	hridn
煥	hrihn
瘓	hribn
鯇	hriae
轰	hsaiy
哄	hsakb
烘	hsahb
訇	hsagy
薨	hsacv
吽	hsakn
轟	hsaii
红	hsesg
触	hseji
洪	hsedb
宏	hsebs
鸿	hsedn
虹	hseig
弘	hsegs
泓	hseds
闳	hsems
荭	hsecg
黉	hsexb
竑	hsels
紅	hsesg
紘	hsess
葒	hsecg
葓	hsecb
訌	hseyg
谼	hsebb
閎	hsems
鴻	hsedn
黌	hsedb
哄	hsukb
嗊	hsukb
讧	hsiyg
蕻	hsicb
訌	hsiyg
鬨	hsiab
乎	huapu
忽	huaxg
呼	huaku
惚	huaxx
唿	huakx
滹	huada
烀	huaha
虍	huaaq
昒	huaop
欻	huahq
淴	huadx
軤	huaia
轷	huaia
和	huehk
湖	huedo
胡	hueuo
糊	huemo
狐	hueqg
壶	hueua
弧	huegg
蝴	hueio
葫	hueco
瑚	huewo
醐	hueyo
囫	huekp
猢	hueqo
斛	hueju
鹕	hueun
觳	hueuy
槲	huemu
煳	hueho
壷	hueua
壺	hueua
衚	huerd
餬	hueuo
鬍	hueao
鵠	huenn
鶘	huenu
鶻	hueng
虎	huuhj
唬	huukh
琥	huuwh
浒	huudu
虍	huuaq
滸	huudu
鯱	huuyj
护	huifh
户	huidu
互	huiaa
糊	huimo
芦	huich
沪	huidh
沪	huidx
扈	huihv
笏	huivp
祜	huipk
戽	huihu
冱	huida
瓠	huidg
怙	huixk
岵	huiek
鹱	huiny
冴	huidy
嫭	huinu
戶	huipu
戸	huiau
昈	huioh
楛	huimk
沍	huida
滬	huidv
護	huiyc
鸌	huiny
挥	hvafi
恢	hvaxh
灰	hvauh
辉	hvagi
徽	hvarw
晖	hvaoi
麾	hvagm
诙	hvayh
睢	hvaof
珲	hvawi
虺	hvaai
咴	hvakh
隳	hvaex
㧑	hvafd
揮	hvafi
撝	hvafh
暉	hvaoi
翚	hvayi
翬	hvayi
袆	hvapa
褘	hvapa
詼	hvayh
輝	hvagi
回	hvekk
茴	hveck
蛔	hveik
洄	hvedk
廻	hvezk
迴	hvezk
迴	hvezk
毁	hvupy
悔	hvuxd
虫	hvuad
虺	hvuai
毀	hvupy
燬	hvuhy
譭	hvuyy
会	hvirs
毁	hvipy
慧	hvixf
汇	hvidk
惠	hvixa
绘	hviss
讳	hviya
晦	hviod
秽	hvihd
贿	hvibo
涣	hvidn
卉	hviuc
诲	hviyd
蕙	hvicx
桧	hvims
彗	hvief
喙	hvikn
荟	hvics
烩	hvihs
恚	hvixt
哕	hvikd
浍	hvids
蟪	hviix
缋	hvisb
匯	hvikd
噦	hvikp
廆	hvigg
彙	hvivn
恵	hvixa
會	hviro
槥	hvime
橞	hvimx
檜	hvimo
燴	hviho
穢	hvihd
絵	hviss
繢	hvisb
繪	hviso
薈	hvico
誨	hviyd
諱	hviya
賄	hvibo
闠	hvimb
阓	hvimb
黑	hwaha
嘿	hwakh
黒	hwahh
化	hxarv
花	hxacv
哗	hxaku
砉	hxafu
嘩	hxaku
椛	hxamp
糀	hxamp
华	hxeur
敌	hxewp
划	hxedg
滑	hxedg
豁	hxebk
猾	hxeqg
骅	hxemu
铧	hxeju
劐	hxedc
劃	hxedv
嘩	hxeku
華	hxeca
譁	hxeka
鏵	hxeja
驊	hxema
话	hxiyk
化	hxirv
画	hxiak
桦	hximu
劃	hxidv
婳	hxink
嫿	hxina
枠	hximu
樺	hxima
畫	hxiaa
華	hxica
觟	hxijt
話	hxiyk
婚	hyano
昏	hyapo
荤	hyaci
阍	hyamo
惛	hyaxo
葷	hyaci
閽	hyamo
魂	hyeeg
混	hyedv
浑	hyedi
馄	hyeuv
渾	hyedi
琿	hyewi
餛	hyeuv
混	hyidv
宪	hyibe
诨	hyiyi
溷	hyidn
婫	hyinv
諢	hyiyi
齁	hzapk
侯	hzeru
喉	hzeku
猴	hzequ
篌	hzevu
糇	hzemu
瘊	hzebu
骺	hzegk
睺	hzeou
餱	hzemu
吼	hzukv
吽	hzukn
后	hzipk
候	hziru
厚	hziiz
後	hzirw
逅	hzizp
堠	hzitu
鲎	hzixa
垕	hzipt
鱟	hzipa
金	jbarb
今	jbarv
禁	jbamx
筋	jbavl
斤	jbapa
津	jbada
巾	jbaaa
襟	jbapx
矜	jbasv
衿	jbapv
觔	jbajl
紧	jbuas
尽	jbuud
仅	jbury
锦	jbujj
谨	jbuya
瑾	jbuwa
堇	jbuca
槿	jbuma
馑	jbuua
卺	jbuvv
廑	jbuga
侭	jburd
僅	jburf
儘	jburm
儘	jburm
墐	jbuta
巹	jbuvv
慬	jbuxa
緊	jbuks
菫	jbuca
謹	jbuya
錦	jbujj
饉	jbuuf
进	jbiza
近	jbizj
尽	jbiud
禁	jbimx
劲	jbivl
晋	jbiao
浸	jbidy
靳	jbigj
烬	jbihd
噤	jbikx
觐	jbicj
缙	jbiso
荩	jbicd
妗	jbinv
赆	jbibd
勁	jbial
壗	jbitm
晉	jbiao
殣	jbidf
燼	jbihm
盡	jbimv
縉	jbiso
藎	jbicm
覲	jbicj
贐	jbibm
進	jbizf
几	jiapg
机	jiamj
奇	jiadk
击	jiaak
基	jiatq
期	jiaqo
激	jiadw
积	jiahb
鸡	jiany
姬	jiana
肌	jiaoj
绩	jiasb
圾	jiatn
饥	jiauj
玑	jiawj
稽	jiaho
讥	jiayj
缉	jiase
叽	jiakj
羁	jiasm
唧	jiake
矶	jiauj
畿	jiavt
箕	jiavb
犄	jiank
齑	jiawa
畸	jiatk
跻	jiaza
咭	jiakk
嵇	jiahe
脔	jiawr
屐	jiauy
赍	jiabu
笄	jiavc
乩	jiaav
丌	jiaaa
剞	jiadd
虮	jiaij
墼	jiata
㚻	jiatn
嘰	jiakd
垍	jiato
幾	jiasg
撃	jiaui
擊	jiaui
枅	jiamc
機	jiamj
璣	jiawd
癪	jiabb
磯	jiaud
積	jiahb
緝	jiase
績	jiasb
羈	jiasm
觭	jiajk
譏	jiayd
跂	jiazy
跡	jiazd
躋	jiaza
雞	jianv
飢	jiauj
饑	jiaud
鶏	jianv
齎	jiawa
齏	jiawa
吃	jiekg
即	jieev
极	jiemn
及	jiepn
急	jiexd
级	jiesn
集	jiemr
吉	jieuk
疾	jiebu
洁	jiedk
猎	jieqo
籍	jievo
辑	jieie
藉	jieco
藉	jiero
嫉	jienu
棘	jiean
蜡	jieio
笈	jievn
汲	jiedn
岌	jieen
殛	jieda
亟	jieva
诘	jieyk
瘠	jiebo
佶	jierk
蒺	jiecu
楫	jieme
芨	jiecn
蕺	jieca
戢	jiekg
嵴	jieeo
伋	jiern
堲	jietv
姞	jienk
尐	jiexn
擊	jieui
極	jiema
級	jiesn
耤	jielo
趌	jiezk
輯	jieie
鶺	jiend
己	jiuvv
几	jiupg
机	jiumj
挤	jiufa
脊	jiudo
戟	jiuug
麂	jiulj
掎	jiufk
虮	jiuij
幾	jiusg
擠	jiufa
給	jiusk
蟣	jiuid
踦	jiuzk
记	jiiyv
计	jiiyu
技	jiify
既	jiivv
继	jiisv
际	jiiex
纪	jiisv
济	jiida
迹	jiizw
季	jiihz
忌	jiixv
寂	jiiby
祭	jiipx
寄	jiibk
剂	jiidw
妓	jiiny
冀	jiiab
悸	jiixz
稷	jiihw
伎	jiiry
髻	jiiak
骥	jiimb
霁	jiiya
觊	jiiej
暨	jiiva
蓟	jiicd
偈	jiirv
鲫	jiiae
荠	jiica
芰	jiicy
哜	jiika
跽	jiizx
鲚	jiiaa
洎	jiido
剤	jiidw
劑	jiidw
勣	jiifl
嚌	jiika
垍	jiito
塈	jiitv
彐	jiiva
徛	jiirk
惎	jiiqx
檵	jiimv
済	jiida
濟	jiida
紀	jiisv
継	jiisv
績	jiisb
繫	jiisa
繼	jiisv
薊	jiicd
薺	jiica
覬	jiiej
計	jiiyu
記	jiiyv
跡	jiizd
蹟	jiizb
際	jiiex
霽	jiiya
驥	jiimb
鯽	jiiae
鱭	jiiaa
经	jkasg
惊	jkaxx
精	jkamo
睛	jkaoo
京	jkawx
晶	jkaoo
荆	jkadc
菁	jkaco
兢	jkaue
鲸	jkaax
茎	jkacg
旌	jkafa
泾	jkadg
粳	jkamn
腈	jkaoo
䴖	jkanf
涇	jkadg
経	jkast
經	jkasg
荊	jkacd
莖	jkacg
驚	jkacm
鯨	jkaax
鶄	jkanf
鼱	jkauo
警	jkuyc
景	jkuox
井	jkuaa
颈	jkuva
阱	jkuea
憬	jkuxx
儆	jkurw
刭	jkudv
肼	jkuoa
丼	jkuad
剄	jkuda
汫	jkuda
璟	jkuwx
頚	jkuyb
頸	jkuva
竟	jkile
静	jkifa
境	jkite
敬	jkiwc
镜	jkije
净	jkida
径	jkirg
竞	jkile
靖	jkilo
迳	jkizv
婧	jkino
靓	jkifj
痉	jkibg
胫	jkiog
獍	jkiqe
弪	jkigg
倞	jkirx
勁	jkial
弳	jkigg
徑	jkirg
浄	jkida
淨	jkida
瀞	jkida
痙	jkibg
競	jkile
脛	jkiog
逕	jkiza
鏡	jkije
靚	jkifj
靜	jkifa
将	jladc
江	jladg
僵	jlara
姜	jlayn
疆	jlaga
浆	jladd
缰	jlasa
豇	jladg
礓	jlaua
茳	jlacg
將	jladc
橿	jlama
殭	jlada
漿	jladd
繮	jlasa
薑	jlaya
讲	jluya
奖	jludd
蒋	jlucc
桨	jlumd
耩	jlula
奨	jludd
奬	jludp
槳	jlumd
獎	jludq
膙	jluoi
蔣	jlucc
講	jluya
强	jligi
降	jliea
虹	jliig
匠	jlikj
酱	jliyd
绛	jlisa
犟	jling
糨	jlimi
洚	jlida
將	jlidc
弶	jligx
強	jligi
彊	jliga
漿	jlidd
絳	jlisa
醤	jliyd
醬	jliyd
开	jmaac
间	jmamo
坚	jmata
肩	jmaho
尖	jmaxd
监	jmama
奸	jmanu
艰	jmayn
兼	jmaqn
歼	jmadu
煎	jmahq
缄	jmask
笺	jmavg
菅	jmack
犍	jmanz
蒹	jmacn
鞯	jmagz
鹣	jmanq
缣	jmasn
湔	jmadd
搛	jmafn
戋	jmaad
鲣	jmaat
堅	jmatk
姦	jmann
戔	jmagg
揃	jmafd
樫	jmamt
殲	jmadd
淺	jmadg
漸	jmadj
監	jmamk
箋	jmavg
緘	jmask
縑	jmasn
艱	jmacn
間	jmamo
靬	jmagu
鞬	jmagz
韉	jmagh
鰹	jmaat
鶼	jmanq
简	jmuvo
检	jmuma
减	jmudk
剪	jmuqd
捡	jmufa
拣	jmufd
柬	jmuan
茧	jmuci
戬	jmuag
俭	jmura
睑	jmuoa
翦	jmuqy
锏	jmujo
碱	jmuuk
蹇	jmubz
謇	jmuby
囝	jmukz
枧	jmumj
硷	jmuua
笕	jmuvj
裥	jmupo
趼	jmuzc
谫	jmuyd
倹	jmurn
儉	jmurr
戩	jmuag
揀	jmufd
撿	jmufr
暕	jmuon
梘	jmumj
検	jmumn
檢	jmumr
減	jmudk
瞼	jmuor
礆	jmuua
筧	jmuvj
簡	jmuvo
繭	jmuci
襇	jmupo
襉	jmupo
譾	jmuyy
鐗	jmujo
鐧	jmujo
鹸	jmuan
鹼	jmuar
见	jmikv
剑	jmidr
件	jmirn
建	jmizv
渐	jmidj
箭	jmivd
健	jmirz
键	jmijz
舰	jmivj
鉴	jmija
贱	jmibg
践	jmizg
溅	jmidg
荐	jmicz
涧	jmido
谏	jmiyn
饯	jmiug
僭	jmiro
腱	jmioz
毽	jmimz
楗	jmimz
踺	jmizz
牮	jminr
剣	jmidd
劍	jmidr
劔	jmidr
栫	jmimz
檻	jmimm
漸	jmidj
澗	jmido
濺	jmidg
監	jmimk
艦	jmivm
薦	jmich
見	jmioe
諫	jmiyn
賎	jmibd
賤	jmibg
踐	jmizg
鍵	jmijz
鑑	jmijm
鑒	jmijk
閒	jmimo
間	jmimo
餞	jmiug
教	jnawt
交	jnawf
娇	jnana
焦	jnahr
骄	jnama
郊	jnaew
蛟	jnaif
胶	jnaof
浇	jnade
礁	jnauh
椒	jnamy
蕉	jnach
跤	jnazf
姣	jnanf
鲛	jnaaf
茭	jnacf
僬	jnarh
鹪	jnanr
艽	jnacj
䴔	jnanw
嬌	jnank
峧	jnaef
澆	jnade
膠	jnaop
詨	jnayf
驕	jnamk
鮫	jnaaf
鵁	jnanw
鷦	jnanr
嚼	jnekc
矯	jneuk
脚	jnuoe
角	jnuda
狡	jnuqf
搅	jnufj
绞	jnusf
缴	jnusw
侥	jnure
剿	jnudv
矫	jnuua
佼	jnurf
皎	jnubf
饺	jnuuf
湫	jnudh
铰	jnujf
徼	jnurw
敫	jnuwb
僬	jnurh
挢	jnufa
僥	jnure
勦	jnuvl
撟	jnufk
撹	jnufj
攪	jnufj
矯	jnuuk
筊	jnuvx
絞	jnusf
繳	jnusw
腳	jnuoe
鉸	jnujf
餃	jnuuf
叫	jnika
教	jniwt
较	jniif
校	jnimf
轿	jniia
叽	jnikj
窖	jnibk
酵	jniyz
峤	jniea
醮	jniyh
徼	jnirw
敫	jniwb
僬	jnirh
噍	jnikh
嶠	jniek
斠	jnicu
筊	jnivx
藠	jnicb
覺	jnipj
較	jniif
轎	jniik
接	jpafn
担	jpafa
阶	jpaea
街	jpard
皆	jpaba
揭	jpafv
楷	jpamb
偕	jparb
嗟	jpakg
秸	jpahk
喈	jpakb
疖	jpabe
掲	jpafv
結	jpask
階	jpaeb
结	jpesk
节	jpece
杰	jpehm
劫	jpetl
截	jperg
捷	jpefr
竭	jpelv
婕	jpenr
睫	jpeor
桀	jpemp
桔	jpemk
颉	jpeua
羯	jpeyv
偈	jperv
孑	jpeva
拮	jpefk
讦	jpeyu
碣	jpeuv
鲒	jpeak
㛃	jpenf
傑	jperm
劼	jpeul
尐	jpexn
岊	jpeve
杢	jpemg
桝	jpema
櫛	jpeme
潔	jpeds
癤	jpebe
節	jpeve
結	jpesk
蜐	jpeil
訐	jpeyu
詰	jpeyk
趌	jpezk
頡	jpeua
鮚	jpeak
解	jpujn
姐	jpunq
姉	jpuna
檞	jpumn
解	jpijn
界	jpita
价	jpira
借	jpiro
介	jpira
戒	jpigc
届	jpiua
藉	jpico
藉	jpiro
诫	jpiyd
芥	jpica
疥	jpiba
蚧	jpiia
唶	jpiko
堺	jpita
屆	jpiua
悈	jpixg
玠	jpiwa
褯	jpipj
誡	jpiyd
鎅	jpija
𠝹	jpidt
價	jpvrb
究	jqabj
纠	jqasa
揪	jqafh
鸠	jqanj
啾	jqakh
赳	jqaza
阄	jqamv
鬏	jqaah
糺	jqasv
糾	jqasa
鬮	jqaav
鳩	jqanj
久	jqupn
九	jqupg
酒	jqudy
灸	jquph
玖	jquwn
韭	jquaa
糺	jqusv
韮	jquca
就	jqiwd
救	jqiwa
旧	jqiao
舅	jqipl
疚	jqibn
鹫	jqinw
咎	jqiwk
厩	jqiiv
臼	jqipa
赳	jqiza
柩	jqimn
僦	jqird
桕	jqima
㠇	jqied
廄	jqigy
柾	jqimv
舊	jqica
鷲	jqinw
圈	jrakv
娟	jrano
捐	jrafo
鹃	jrank
涓	jrado
镌	jrajp
睃	jraow
蠲	jraqi
朘	jraow
鐫	jrajg
鵑	jrank
卷	jrubv
锩	jrujv
巻	jrubv
捲	jrufv
捲	jrubv
卷	jribv
圈	jrikv
倦	jrirv
眷	jribo
绢	jriso
隽	jrirp
狷	jriqo
鄄	jriex
桊	jribm
婘	jrinv
絹	jriso
錈	jrijv
雋	jrirg
扃	jsahk
坰	jsatk
炯	jsuhk
窘	jsubk
迥	jsuzk
炅	jsuoh
䌹	jsusk
䢛	jsuzk
冏	jsukk
囧	jsukk
泂	jsudk
烱	jsuhk
絅	jsusk
噘	jtakq
撅	jtafq
嗟	jtakg
鞽	jtagk
觉	jtexj
绝	jtesv
决	jtedn
脚	jteoe
角	jteda
爵	jtevc
诀	jteyn
掘	jtefk
厥	jteiq
嚼	jtekc
倔	jterk
崛	jteek
珏	jteww
抉	jtefn
攫	jtefy
谲	jteyk
獗	jteqq
蹶	jtezq
矍	jteoy
噱	jtekn
蕨	jtecq
橛	jtemq
柽	jtemt
孓	jtevn
镢	jtejq
劂	jtedi
觖	jtejn
桷	jtemj
爝	jtehc
㵐	jtedq
傕	jterf
刔	jtedv
叕	jteyy
決	jtedn
玦	jtewn
絕	jtesv
絶	jtesv
腳	jteoe
覚	jtexj
覺	jtepj
觼	jtejw
訣	jteyn
譎	jteyk
鐝	jtejq
钁	jtejy
鴃	jtenn
居	juauk
据	juafk
拘	juafk
鞠	juagm
驹	juamk
狙	juaqq
掬	juafm
趄	juazq
琚	juawk
裾	juapk
疽	juabq
雎	juaqf
椐	juamk
苴	juacq
锔	juajk
俥	juari
娵	juany
崌	juaek
泃	juadk
腒	juaok
車	juaaa
鋦	juajk
鋸	juajk
駒	juamk
局	jueuk
菊	juecm
鞠	juegm
橘	juemk
桔	juemk
鞫	juegy
䴗	jueno
侷	juerk
啹	juekk
椈	juemm
焗	juehk
跼	juezk
鋦	juejk
鵙	juenb
鶪	jueno
举	juuxa
柜	juuma
矩	juuua
沮	juudq
咀	juukq
莒	juuck
踽	juuzd
榉	juuma
枸	juumk
龃	juuiq
榘	juumu
榘	juuua
弆	juutc
挙	juuxu
櫸	juuma
欅	juuma
筥	juuvk
舉	juupa
蒟	juuck
襷	juupu
齟	juuiq
句	juigk
具	juiqb
巨	juika
聚	juien
剧	juidu
距	juiza
惧	juixb
拒	juifa
俱	juirb
渠	juimd
炬	juiha
锯	juijk
踞	juizk
飓	juifb
瞿	juiof
遽	juizh
倨	juirk
钜	juija
苣	juica
屦	juiun
讵	juiya
窭	juibn
犋	juinb
醵	juiyn
劇	juidh
坥	juitq
屨	juiun
岠	juiek
懼	juixf
拠	juifj
據	juifn
窶	juibn
詎	juiya
鉅	juijk
鉅	juija
鋸	juijk
颶	juifb
家	jxabn
加	jxalk
佳	jxart
嘉	jxauk
夹	jxaan
咖	jxakk
迦	jxazl
伽	jxark
茄	jxack
枷	jxamk
袈	jxayl
珈	jxawk
浃	jxadn
葭	jxacy
痂	jxabk
笳	jxavk
跏	jxazk
镓	jxajn
㹢	jxaqk
傢	jxarn
傢	jxarn
夾	jxaan
挾	jxafn
泇	jxadk
浹	jxadn
鎵	jxajn
颊	jxeaa
戛	jxeag
郏	jxeea
荚	jxecn
铗	jxejn
蛱	jxein
袷	jxepk
恝	jxexf
夾	jxean
挾	jxefn
揳	jxefd
莢	jxecn
蛺	jxein
郟	jxeea
鋏	jxejn
頬	jxeab
頰	jxeaa
假	jxury
甲	jxuaa
贾	jxubx
胛	jxuoa
岬	jxuea
钾	jxuja
嘏	jxuuy
瘕	jxuby
仮	jxury
叚	jxuvy
斝	jxuku
榎	jxumw
槚	jxumb
檟	jxumb
賈	jxubx
鉀	jxuja
假	jxiry
架	jximl
驾	jximl
嫁	jxinn
稼	jxihn
㗎	jxikm
価	jxirx
價	jxirb
駕	jximl
军	jyabi
君	jyavk
均	jyatd
钧	jyajd
匀	jyaga
菌	jyach
皲	jyabp
麇	jyalh
囷	jyakh
皸	jyabp
皹	jyaai
莙	jyack
軍	jyabi
鈞	jyajd
俊	jyirw
郡	jyiev
峻	jyiew
骏	jyimw
菌	jyich
浚	jyidw
隽	jyirp
竣	jyilw
睃	jyiow
捃	jyifk
䐃	jyiok
儁	jyirg
晙	jyiow
濬	jyido
焌	jyihw
珺	jyiwk
畯	jyitw
葰	jyicw
雋	jyirg
駿	jyimw
咖	kaakk
喀	kaakk
卡	kauad
咔	kaukd
佧	kaurd
胩	kauod
垰	kautn
裃	kaupd
尻	kcauj
訄	kcajy
考	kcutg
烤	kcuhg
拷	kcufg
栲	kcumg
靠	kcina
铐	kcijg
犒	kcink
銬	kcijg
开	kdaac
揩	kdafb
锎	kdajc
鐦	kdajc
開	kdamk
凯	kduej
慨	kduxv
铠	kdujv
恺	kduxv
楷	kdumb
锴	kdujb
剀	kdude
垲	kdutv
凱	kduej
剴	kdude
塏	kdutd
愷	kduxd
蒈	kducb
豈	kdued
鍇	kdujb
鎧	kdujd
忾	kdixq
嘅	kdike
愒	kdixv
愾	kdixm
科	keahu
颗	keaaa
柯	keamk
棵	keamn
磕	keaum
珂	keawk
苛	keack
瞌	keaom
轲	keaik
蝌	keaiu
稞	keahn
颏	keawa
疴	keabk
窠	keabn
髁	keagn
匼	keakk
痾	keabk
趷	keazv
軻	keaik
鈳	keajk
頦	keawa
顆	keaaa
咳	keekr
壳	keeuj
殼	keeuy
頦	keewa
可	keudk
渴	keudv
坷	keutk
岢	keuek
㞹	keuek
渇	keudv
軻	keuik
刻	keidw
克	keiue
客	keibk
课	keiyn
恪	keixk
嗑	keikm
溘	keidm
氪	keiqe
锞	keijn
缂	keisg
骒	keimn
剋	keidu
剋	keiud
悈	keixg
緙	keisg
課	keiyn
錁	keijn
騍	keimn
肯	kfuvo
恳	kfuxv
啃	kfuko
垦	kfutv
龈	kfuin
墾	kfutv
懇	kfuxv
齦	kfuin
裉	kfipn
珢	kfiwy
坑	kgatj
吭	kgakj
铿	kgajt
鏗	kgajt
康	khagn
慷	khaxn
糠	khamn
闶	khamj
閌	khamj
鱇	khayx
𡐓	khatn
扛	khefg
奋	khudt
抗	khifj
亢	khiwj
炕	khihj
伉	khirj
钪	khijj
犺	khiqj
鈧	khijj
看	kjauo
堪	kjatv
刊	kjada
勘	kjaql
龛	kjarl
戡	kjaqg
嵁	kjaev
栞	kjamp
龕	kjarl
砍	kjuuq
坎	kjutq
嵌	kjueq
侃	kjurv
槛	kjumm
莰	kjucq
冚	kjube
檻	kjumm
轗	kjuix
看	kjiuo
瞰	kjiow
墈	kjitl
崁	kjieq
磡	kjiul
薟	kjicr
衎	kjird
闞	kjimw
蒯	kkudc
㧟	kkufk
擓	kkufk
快	kkixn
块	kkitn
筷	kkivn
侩	kkirs
哙	kkiks
脍	kkios
狯	kkiqs
郐	kkier
儈	kkiro
噲	kkiko
塊	kkitg
會	kkiro
澮	kkido
獪	kkiqo
膾	kkioo
鄶	kkier
鱠	kkiao
框	klamw
匡	klakw
筐	klavw
哐	klakw
诓	klayw
劻	klakl
誆	klayw
狂	kleqw
诳	kleyw
誑	kleyw
夼	kluda
况	klide
矿	kliug
眶	kliow
旷	kliog
框	klimw
邝	klieg
纩	klisg
圹	klitg
贶	klibe
壙	klitb
曠	kliob
況	klide
礦	kliub
絋	kliss
絖	klise
纊	klisb
貺	klibe
鄺	klieg
鉱	klijs
适	koizp
括	koifk
扩	koifg
阔	koimk
廓	koige
蛞	koiik
拡	koifs
擴	koifb
濶	koidk
闊	koimk
宽	krabj
髋	kragj
寛	krabj
寬	krabd
髖	kragd
款	kruuq
梡	krume
空	ksabg
崆	ksaeg
倥	ksarg
箜	ksavg
埪	ksatg
恐	ksuxg
孔	ksuzv
倥	ksurg
空	ksibg
控	ksifg
圣	kuaty
哭	kuaqk
枯	kuamk
骷	kuagk
窟	kuabk
堀	kuate
刳	kuadd
圐	kuakf
苦	kuuck
楛	kuumk
库	kuigi
酷	kuiyk
裤	kuipi
绔	kuisg
喾	kuixk
嚳	kuipk
庫	kuigi
矻	kuiug
絝	kuisg
袴	kuipg
褲	kuipi
亏	kvaeg
窥	kvabj
盔	kvamu
岿	kvaee
悝	kvaxa
巋	kvaej
窺	kvabj
虧	kvahg
魁	kvegu
奎	kvedt
葵	kvecd
睽	kveod
逵	kvezt
夔	kveqw
馗	kvejo
揆	kvefd
蝰	kveit
暌	kveod
喹	kvekt
戣	kvevg
櫆	kvemu
傀	kvurg
跬	kvuzt
愧	kvixg
溃	kvidb
馈	kviub
喟	kviko
篑	kvivb
匮	kvikb
聩	kvieb
愦	kvixb
蒉	kvicb
匱	kvikb
憒	kvixb
潰	kvidb
瞶	kviob
簣	kvivb
聵	kvieb
蕢	kvicb
饋	kviub
剋	kwadu
剋	kwaud
夸	kxadg
姱	kxanv
誇	kxayg
夸	kxudg
垮	kxutg
侉	kxurg
跨	kxizg
夸	kxidg
胯	kxiog
挎	kxifg
骻	kxigg
昆	kyaov
坤	kyata
鲲	kyaav
琨	kyawv
锟	kyajv
髡	kyaae
醌	kyayv
堃	kyatf
婫	kyanv
崑	kyaev
崑	kyaev
焜	kyahv
裈	kyapi
褌	kyapi
錕	kyajv
鯤	kyaav
捆	kyufm
阃	kyumm
悃	kyuxm
壸	kyuua
壼	kyuua
梱	kyumm
閫	kyumm
困	kyikm
睏	kyiok
睏	kyiom
抠	kzafx
芤	kzacv
眍	kzaox
摳	kzafk
瞘	kzaok
口	kzuaa
扣	kzifk
寇	kziby
叩	kziek
蔻	kzicy
佝	kzirk
筘	kzivk
釦	kzijk
拉	laafl
啦	laakl
垃	laatl
喇	laakd
邋	laazv
砬	laaul
剌	laeda
旯	laeoj
砬	laeul
喇	laukd
落	laick
辣	lailn
腊	laioo
蜡	laiio
剌	laida
瘌	laibd
臘	laiov
蝋	laiia
蝲	laiid
蠟	laiiv
鑞	laijv
啦	lavkl
鞡	lavgl
拎	lbafs
林	lbemm
临	lbeaa
琳	lbewm
麟	lbela
淋	lbedm
邻	lbeer
鳞	lbeaa
霖	lbeym
磷	lbeua
粼	lbemv
嶙	lbeea
遴	lbezm
辚	lbeia
啉	lbekm
瞵	lbeoa
冧	lbebm
燐	lbeha
箖	lbevm
粦	lbema
臨	lbekk
轔	lbeia
鄰	lbeem
隣	lbeea
鱗	lbeaa
凛	lbudx
懔	lbuxx
廪	lbugx
檩	lbumx
凜	lbudh
廩	lbugh
懍	lbuxh
檁	lbumh
箖	lbuvm
淋	lbidm
吝	lbiwk
躏	lbizf
赁	lbibr
蔺	lbicf
膦	lbioa
藺	lbicf
賃	lbibr
躪	lbizf
捞	lcafl
撈	lcafl
劳	lcecl
牢	lcebn
唠	lcekl
崂	lceel
痨	lcebl
醪	lceyp
铹	lcejl
労	lcexl
勞	lcehl
嘮	lcekl
嶗	lceel
癆	lcebl
鐒	lcejl
老	lcutv
姥	lcunv
佬	lcurv
潦	lcudx
栳	lcumv
橑	lcumx
荖	lcucp
蛯	lcuip
銠	lcujv
铑	lcujv
烙	lcihk
涝	lcidl
酪	lciyk
嘮	lcikl
嫪	lcinp
澇	lcidl
絡	lcisk
耢	lcill
耮	lcill
来	ldean
莱	ldecn
徕	ldern
涞	ldedn
崃	ldeen
铼	ldejn
來	ldean
俫	ldern
倈	ldern
崍	ldeen
徠	ldern
梾	ldemn
棶	ldemn
淶	ldedn
萊	ldecn
錸	ldejn
赖	ldiab
籁	ldivb
癞	ldibb
睐	ldion
濑	ldidb
赉	ldiba
倈	ldirn
瀨	ldidb
瀬	ldida
癩	ldibb
睞	ldion
籟	ldivb
賚	ldiba
賴	ldiab
頼	ldiab
乐	leipd
勒	leigl
垃	leitl
肋	leiol
叻	leikl
鳓	leial
仂	leirl
泐	leidl
楽	leimd
樂	leimv
鰳	leial
了	levva
餎	levuk
棱	lgamw
楞	lgemf
棱	lgemw
塄	lgetf
唥	lgeks
崚	lgeew
稜	lgemw
冷	lguds
愣	lgixf
楞	lgimf
棱	lgimw
啷	lhake
狼	lheqn
郎	lheed
廊	lhege
琅	lhewn
螂	lheie
榔	lheme
阆	lhemn
锒	lhejn
稂	lhehn
桹	lhemn
筤	lhevn
鋃	lhejn
閬	lhemn
朗	lhudo
㫰	lhuon
㮾	lhumd
俍	lhurn
塱	lhutd
悢	lhuxn
蓢	lhuco
浪	lhidn
莨	lhicn
㫰	lhion
埌	lhitn
崀	lhien
蒗	lhicn
閬	lhimn
哩	liaka
离	liewd
黎	liehd
璃	liews
狸	lieqa
梨	liemh
漓	lieds
厘	lieia
篱	lievs
犁	lienh
蠡	lievi
藜	liecd
骊	liemd
罹	liesf
鹂	liena
蜊	lieid
喱	lieka
黧	liehh
缡	liess
嫠	liean
蓠	liecs
鲡	liead
㰀	liemd
灕	liedf
犂	lienh
犛	liean
琍	liewd
籬	lievf
糎	liemt
縭	liess
蘺	liecf
貍	liept
釐	lieaa
離	liewf
驪	lieml
鯏	lieda
鱺	lieal
鸝	liena
麗	lieal
里	liuaa
里	liuat
理	liuwa
李	liumz
礼	liupv
哩	liuka
鲤	liuaa
蠡	liuvi
逦	liuza
澧	liudd
俚	liura
醴	liuyd
娌	liuna
锂	liuja
悝	liuxa
鳢	liuad
峛	liued
浬	liudt
禮	liupd
裏	liuwy
裡	liupt
豊	liuad
邐	liuza
鋰	liuja
鯉	liuaa
鱧	liuad
力	liigp
立	liila
利	liidh
丽	liiad
厉	liiip
历	liiil
莉	liicd
例	liird
励	liiil
粒	liiml
隶	liivn
栗	liixm
吏	liian
雳	liiyl
俐	liird
戾	liihq
笠	liivl
沥	liidl
砾	liiud
荔	liicl
郦	liiea
俪	liird
砺	liiup
唳	liikq
莅	liicl
蛎	liiip
溧	liidm
呖	liikl
傈	liirm
猁	liiqd
栎	liimd
痢	liibd
砬	liiul
枥	liiml
疠	liibp
鬲	liiaa
詈	liisy
粝	liimp
篥	liivm
坜	liitl
疬	liibl
苈	liicl
跞	liizd
轹	liiid
儷	liirl
凓	liidm
勵	liiil
厲	liiid
叕	liiyy
唎	liikd
嚟	liikd
嚦	liikv
壢	liitv
慄	liixm
戻	liihd
暦	liiio
曆	liiio
朸	liiml
栃	liimg
櫟	liimm
櫪	liimv
欐	liiml
歴	liiiv
歷	liiiv
瀝	liidv
癘	liibd
癧	liibv
礪	liiud
礫	liium
糲	liimd
綟	liisq
脷	liiod
蒞	liicl
藶	liicv
蠣	liiid
躒	liizm
轢	liiim
轣	liiiv
酈	liiea
隷	liiun
隸	liimn
靂	liiyv
麗	liial
哩	livka
唎	livkd
兰	ljeqe
蓝	ljecm
拦	ljefs
岚	ljeef
篮	ljevm
栏	ljems
澜	ljedd
婪	ljenm
阑	ljemd
斓	ljewd
褴	ljepm
谰	ljeyd
镧	ljejd
嵐	ljeef
攔	ljefn
斕	ljewd
欄	ljemd
瀾	ljedd
籃	ljevm
繿	ljesm
藍	ljecm
蘭	ljecn
襕	ljepn
襤	ljepm
襴	ljepn
讕	ljeyd
躝	ljezj
躝	ljezn
鑭	ljejd
闌	ljemd
𨅬	ljezn
懒	ljuxb
览	ljuja
揽	ljufj
缆	ljusj
榄	ljumj
懔	ljuxx
罱	ljusu
漤	ljudn
懶	ljuxb
攬	ljufj
欖	ljumj
灠	ljudj
纜	ljusj
覧	ljujk
覽	ljujk
烂	ljihs
滥	ljidm
濫	ljidm
燗	ljiho
爛	ljihs
昤	lkaos
令	lkers
灵	lkeeh
凌	lkedw
怜	lkexs
陵	lkeew
零	lkeys
玲	lkews
铃	lkejs
龄	lkeis
岭	lkees
翎	lkery
菱	lkecw
绫	lkesw
伶	lkers
聆	lkees
棱	lkemw
呤	lkeks
羚	lkeys
苓	lkecs
泠	lkeds
棂	lkemh
酃	lkeey
囹	lkeks
瓴	lkerw
蛉	lkeis
鲮	lkeaw
柃	lkems
〇	lkeoo
㥄	lkexw
坽	lkets
堎	lketw
姈	lkens
櫺	lkemk
欞	lkemr
淩	lkedw
澪	lkedd
綾	lkesw
舲	lkevs
蔆	lkecw
鈴	lkejs
霊	lkeya
靈	lkeya
鯪	lkeaw
鴒	lkenr
鸰	lkenr
齡	lkeis
齢	lkeis
令	lkurs
领	lkura
怜	lkuxs
岭	lkues
嶺	lkuea
領	lkura
令	lkirs
另	lkikl
量	lleoa
惊	llexx
良	lledn
梁	llemd
凉	lledx
粮	llemn
踉	llezn
粱	llemd
椋	llemx
墚	lletm
俍	llern
樑	llemm
涼	lledx
糧	llema
两	lluad
魉	llugd
両	lluak
兩	lluar
唡	llukr
啢	llukr
魎	llugr
量	llioa
亮	lliwj
辆	lliid
谅	lliyx
踉	llizn
晾	lliox
倞	llirx
喨	llikj
悢	llixn
諒	lliyx
輛	lliir
鍄	llijx
靚	llifj
连	lmezi
联	lmeed
怜	lmexs
莲	lmecz
廉	lmegn
帘	lmebj
涟	lmedz
镰	lmejn
濂	lmedn
裢	lmepz
奁	lmedx
鲢	lmeaz
臁	lmeon
搛	lmefn
蠊	lmein
嗹	lmekz
奩	lmedk
憐	lmexa
梿	lmemz
槤	lmemz
漣	lmedz
璉	lmewz
簾	lmevn
縺	lmesz
聯	lmeea
蓮	lmecz
褳	lmepz
連	lmezi
鎌	lmejn
鐮	lmejn
鰱	lmeaz
脸	lmuoa
敛	lmuwr
琏	lmuwz
裣	lmupa
斂	lmuwr
臉	lmuor
蔹	lmucw
薟	lmucr
蘞	lmucw
襝	lmupr
练	lmisd
炼	lmihd
恋	lmixw
链	lmijz
潋	lmidw
殓	lmida
楝	lmimn
戀	lmixs
斂	lmiwr
殮	lmidr
瀲	lmidw
煉	lmihd
練	lmisn
錬	lmijn
鍊	lmijn
鏈	lmijz
鰊	lmian
撩	lnafx
聊	lneee
疗	lneba
辽	lnezv
撩	lnefx
寥	lnebp
僚	lnerx
獠	lneqx
缭	lnesx
燎	lnehx
嘹	lnekx
寮	lnebx
鹩	lnenu
嫽	lnenx
療	lnebx
繚	lnesx
遼	lnezx
鷯	lnena
了	lnuva
燎	lnuhx
蓼	lnucp
钌	lnuja
憭	lnuxx
暸	lnuox
瞭	lnuox
釕	lnuja
料	lnimu
廖	lnigp
撂	lnifk
镣	lnijx
尥	lnijd
瞭	lniox
鐐	lnijx
捋	loafc
啰	loakd
囉	loakf
罗	loesd
逻	loezs
萝	loecd
螺	loeis
锣	loejd
骡	loems
箩	loevd
猡	loeqd
脶	loeod
镙	loejs
㑩	loerd
儸	loerf
欏	loemf
玀	loeqf
籮	loevf
羅	loesf
腡	loeok
蘿	loecf
邏	loezs
鏍	loejs
鑼	loejf
騾	loems
裸	loupn
椤	loumd
蠃	louwd
瘰	loubs
倮	lourn
欏	loumf
砢	louuk
蓏	loucg
落	loick
洛	loidk
络	loisk
咯	loikk
骆	loimk
珞	loiwk
荦	loicn
摞	loifs
酪	loiyk
雒	loiwf
泺	loidd
濼	loidm
犖	loihn
絡	loisk
駱	loimk
咯	lovkk
囉	lovkf
咧	lpakd
倈	lparn
咧	lpukd
毟	lpuxm
烈	lpihd
列	lpidd
裂	lpiyd
猎	lpiqo
劣	lpixl
冽	lpidd
趔	lpizd
邋	lpizv
鬣	lpiaa
洌	lpidd
捩	lpifq
躐	lpizv
䴕	lpind
哷	lpikc
埓	lpitc
猟	lpiqa
獵	lpiqv
綟	lpisq
脟	lpioc
鴷	lpind
溜	lqadt
熘	lqaht
流	lqedv
留	lqetp
刘	lqedw
琉	lqewv
榴	lqemt
浏	lqedd
瘤	lqebt
硫	lqeuv
鎏	lqejd
镏	lqejt
骝	lqemt
馏	lqeut
旒	lqefv
劉	lqedp
瀏	lqedd
瑠	lqewt
鎦	lqejt
鏐	lqejp
餾	lqeut
騮	lqemt
鰡	lqeat
鶹	lqenp
鹠	lqenp
柳	lqume
绺	lqusk
锍	lqujv
綹	lqusk
鋶	lqujv
六	lqiwb
遛	lqizp
镏	lqijt
鹨	lqiny
蹓	lqizt
陸	lqiet
霤	lqiyt
餾	lqiut
鷚	lqiny
鸾	lrewn
峦	lrewe
挛	lrewu
孪	lrewz
銮	lrewj
栾	lrewm
滦	lredm
脔	lrewr
娈	lrewn
孌	lrens
孿	lrejs
巒	lrees
攣	lreus
欒	lrems
灤	lredm
脟	lreoc
臠	lrewr
鑾	lrejs
鸞	lrews
卵	lrupd
乱	lripv
亂	lrivv
隆	lsaef
龙	lseud
隆	lseef
笼	lsevl
珑	lsewl
咙	lsekl
胧	lseol
聋	lsele
窿	lsebf
泷	lsedl
茏	lsecl
栊	lseml
砻	lselu
癃	lseba
嚨	lsekl
昽	lseol
曨	lseol
朧	lseol
櫳	lseml
滝	lsedv
瀧	lsedl
瓏	lsewl
礱	lselu
竜	lselv
篭	lsevv
籠	lsevl
聾	lsele
蘢	lsecl
龍	lsela
拢	lsufl
垄	lsutl
陇	lsuel
垅	lsutl
壟	lsutl
壠	lsutl
攏	lsufl
隴	lsuel
弄	lsiwc
哢	lsikc
略	ltitk
掠	ltifx
锊	ltijc
䂮	ltifu
圙	ltika
擽	ltifm
鋝	ltijc
噜	luako
撸	luafo
嚕	luako
擼	luafo
卢	lueau
炉	luehh
芦	luech
颅	lueaa
庐	luegh
泸	luedu
胪	lueou
鲈	lueau
轳	lueiu
鸬	luena
栌	luemi
垆	luetu
舻	luevi
壚	luetm
廬	luegm
櫨	luemm
瀘	luedm
爐	luehm
盧	luehm
臚	lueom
艫	luevm
蘆	luecm
轤	lueim
鑪	luejm
顱	lueha
鱸	lueam
鸕	luenh
鲁	luuao
虏	luuhl
掳	luufl
卤	luuax
橹	luumo
镥	luujo
擄	luufl
櫓	luumo
氌	luumo
滷	luuax
硵	luuux
磠	luuux
虜	luuhl
鑥	luujo
魯	luuao
鹵	luuax
路	luizk
露	luiyk
陆	luiek
录	luivd
鹿	luigv
碌	luiud
戮	luiyg
禄	luipd
璐	luiwk
漉	luidl
赂	luibk
麓	luilm
潞	luidk
鹭	luinz
辘	luiil
辂	luiik
渌	luidd
蓼	luicp
逯	luizv
簏	luivl
僇	luirp
勠	luiyl
彔	luivd
淥	luidd
琭	luiwd
祿	luipd
箓	luivd
籙	luivd
綠	luisd
菉	luicd
蕗	luick
賂	luibk
輅	luiik
轆	luiil
錄	luivd
録	luijd
陸	luiet
鷺	luinz
驴	lvemh
闾	lvemk
榈	lvemk
櫚	lvemk
瞜	lveon
閭	lvemk
驢	lvemm
旅	lvufn
吕	lvukk
缕	lvusn
履	lvuuw
屡	lvuun
侣	lvurk
捋	lvufc
褛	lvupn
铝	lvujk
膂	lvuof
侶	lvurk
僂	lvurn
呂	lvukk
屢	lvuun
梠	lvumk
稆	lvuhk
穭	lvuho
絽	lvusk
縷	lvusn
褸	lvupn
鋁	lvujk
率	lviwu
绿	lvisd
虑	lvihx
律	lvira
滤	lvidx
氯	lviqd
哷	lvikc
垏	lvita
慮	lvihx
濾	lvidx
綠	lvisd
緑	lvisd
葎	lvica
勒	lwagl
雷	lweyt
擂	lweft
镭	lwejt
羸	lwewd
檑	lwemt
缧	lwess
嫘	lwens
礌	lweut
縲	lwess
鐳	lwejt
累	lwuts
蕾	lwuct
磊	lwuuu
垒	lwuts
儡	lwurt
耒	lwuan
诔	lwuyn
塁	lwutt
壘	lwutt
礌	lwuut
藟	lwuct
誄	lwuyn
类	lwimd
泪	lwido
累	lwits
擂	lwift
肋	lwiol
酹	lwiyc
埒	lwitc
涙	lwidd
淚	lwidq
礌	lwiut
類	lwima
嘞	lwvkl
俩	lxurd
倆	lxurr
抡	lyafv
掄	lyafc
轮	lyeiv
伦	lyerv
仑	lyerv
沦	lyedv
纶	lyesv
囵	lyekv
侖	lyerc
倫	lyerc
圇	lyekc
崙	lyerc
掄	lyefc
淪	lyedc
綸	lyesc
論	lyeya
輪	lyeic
论	lyiyv
論	lyiya
䁖	lzaon
摟	lzafn
瞜	lzaon
楼	lzemn
髅	lzegn
喽	lzekn
娄	lzemn
蝼	lzein
偻	lzern
蒌	lzecn
耧	lzeln
僂	lzern
剅	lzeda
嘍	lzekn
婁	lzean
樓	lzemn
瞜	lzeon
耬	lzeln
蔞	lzecn
螻	lzein
髏	lzegn
搂	lzufn
篓	lzuvn
嵝	lzuen
嶁	lzuen
摟	lzufn
簍	lzuvn
露	lziyk
漏	lzidd
陋	lziev
镂	lzijn
瘘	lzibn
瘻	lzibn
鏤	lzijn
嘍	lzvkn
妈	maanm
嬷	maans
媽	maanm
嫲	maang
嬤	maand
嬤	maans
螞	maaim
麻	maegm
蟆	maeid
嫲	maeng
蟇	maeci
麼	maegs
马	mauva
码	mauum
玛	mauwm
蚂	mauim
嗎	maukm
獁	mauqm
瑪	mauwm
碼	mauum
螞	mauim
馬	mauah
骂	maimk
犸	maiqm
杩	maimm
唛	maikw
嘜	maikd
榪	maimm
祃	maipm
禡	maipm
罵	maims
螞	maiim
么	mavps
嘛	mavkm
麽	mavgs
蟆	mavid
嗎	mavkm
民	mbevq
玟	mbeww
珉	mbewq
岷	mbeeq
缗	mbeso
苠	mbecq
忞	mbewx
旻	mbeow
緡	mbeso
罠	mbesq
敏	mbuwr
抿	mbufq
悯	mbuxw
闵	mbumw
闽	mbumi
泯	mbudq
皿	mbuka
愍	mbuxv
鳘	mbuar
忞	mbuwx
憫	mbuxw
閔	mbumw
閩	mbumi
鰵	mbuar
黽	mbuav
猫	mcaqt
貓	mcavt
毛	mcepv
猫	mceqt
矛	mcesp
茅	mcecp
髦	mcema
锚	mcejt
牦	mcenm
蟊	mcesi
旄	mcefm
蝥	mceis
茆	mcece
犛	mcean
錨	mcejt
卯	mcuep
昴	mcuoe
泖	mcude
铆	mcuje
峁	mcuee
茆	mcuce
冇	mcuuk
鉚	mcuje
冒	mcioo
貌	mcive
贸	mcibp
帽	mcijo
宪	mcibe
茂	mcicp
袤	mciwy
瑁	mciwo
懋	mcixm
耄	mcitm
旄	mcifm
瞀	mcios
楙	mcimm
芼	mcicm
貿	mcibp
埋	mdeta
霾	mdeya
买	mduvd
荬	mducd
蕒	mducb
買	mdubs
卖	mdiud
脉	mdion
麦	mdifw
迈	mdiza
劢	mdial
勱	mdicl
売	mdiue
脈	mdion
賣	mdibu
邁	mdizc
麥	mdiad
么	mevps
没	mevdy
麽	mevgs
麼	mevgs
悶	mfamx
椚	mfamm
门	mfedg
扪	mfefm
钔	mfejm
亹	mfewq
捫	mfefm
鍆	mfejm
門	mfeaa
闷	mfimx
懑	mfixd
焖	mfihx
鞔	mfigv
悗	mfixv
悶	mfimx
懣	mfixd
燜	mfihx
們	mfvrm
蒙	mgacn
掹	mgafm
擝	mgafm
矇	mgaon
矇	mgaon
蒙	mgecn
盟	mgemo
朦	mgeon
氓	mgewq
萌	mgeco
檬	mgemn
虻	mgeiv
艨	mgevn
瞢	mgeco
礞	mgeun
甍	mgecw
㠓	mgeen
儚	mgerd
幪	mgejn
懞	mgexx
懞	mgexn
曚	mgeon
濛	mgedn
濛	mgedn
矇	mgeon
矇	mgeon
萠	mgeco
猛	mguqm
蒙	mgucn
懵	mguxo
蜢	mguim
锰	mgujm
勐	mguzl
蠓	mguin
艋	mguvm
獴	mguqn
錳	mgujm
梦	mgimd
孟	mgimz
夢	mgicd
牤	mhanv
忙	mhexv
芒	mhecv
茫	mhecv
盲	mhewo
氓	mhewq
邙	mheew
硭	mheuv
尨	mheud
杗	mhewm
杧	mhemw
鋩	mhejv
铓	mhejv
莽	mhucc
蟒	mhuic
漭	mhudc
咪	miakm
瞇	miaoz
迷	miezm
弥	miegx
谜	mieyz
靡	miega
祢	miepx
麋	mielm
猕	mieqx
縻	miegs
醚	mieyz
蘼	mieca
彌	miegx
瀰	miedx
瀰	miedx
獼	mieqx
禰	miepx
謎	mieyz
米	miubm
眯	miuom
靡	miuga
弭	miuge
敉	miuwm
芈	miuaa
脒	miuom
羋	miuaa
密	miibe
秘	miihp
蜜	miibi
觅	miivj
宓	miibd
泌	miidp
谧	miiym
汨	miido
幂	miibj
糸	miivx
糸	miiav
嘧	miike
冪	miibj
樒	miime
祕	miipp
覓	miivj
謐	miiym
颟	mjaca
顢	mjaca
埋	mjeta
蛮	mjewi
瞒	mjeod
蔓	mjecy
馒	mjeuy
鳗	mjeay
谩	mjeyy
鞔	mjegv
悗	mjexv
瞞	mjeor
蠻	mjeis
謾	mjeyy
饅	mjeuy
鬘	mjepy
鰻	mjeay
满	mjudd
螨	mjuid
屘	mjuuz
満	mjudk
滿	mjudr
蟎	mjuir
慢	mjixy
曼	mjioy
漫	mjidy
蔓	mjicy
幔	mjijy
缦	mjisy
熳	mjihy
墁	mjity
镘	mjijy
嫚	mjiny
縵	mjisy
謾	mjiyy
鏝	mjijy
明	mkeoo
名	mkepk
鸣	mkenk
冥	mkebb
铭	mkejk
茗	mkeck
溟	mkedb
瞑	mkeob
螟	mkeib
暝	mkeob
蓂	mkecb
銘	mkejk
鳴	mkenk
酩	mkuyk
命	mkire
绵	mmesj
眠	mmeoq
棉	mmemj
宀	mmedv
杣	mmeme
綿	mmesj
免	mmudv
勉	mmudl
缅	mmusa
冕	mmuov
腼	mmuoa
娩	mmunv
湎	mmuda
沔	mmudv
渑	mmudv
黾	mmukv
眄	mmuov
丏	mmuag
偭	mmura
勔	mmual
愐	mmuxa
緬	mmusa
靦	mmuaj
靦	mmuaj
面	mmiaa
眄	mmiov
麪	mmiag
麪	mmiag
麵	mmiaa
麺	mmifa
喵	mnakt
猫	mneqt
描	mneft
苗	mnect
瞄	mneot
鹋	mnenc
鶓	mnenc
秒	mnuhp
渺	mnudp
缈	mnusp
淼	mnudd
藐	mnuce
邈	mnuzv
眇	mnuop
杪	mnump
緲	mnusp
妙	mninp
庙	mniga
廟	mnigo
繆	mnisp
摸	moafd
么	moeps
魔	moegg
模	moemd
摸	moefd
摩	moegu
磨	moegu
膜	moeod
蘑	moecu
摹	moecu
谟	moeyd
馍	moeud
嫫	moend
藦	moecu
謨	moeyd
饃	moeud
麼	moegs
抹	moufn
麿	mougk
没	moidy
万	moiap
莫	moicd
默	moihq
磨	moigu
漠	moidd
末	moian
墨	moith
抹	moifn
蓦	moicm
陌	moieb
寞	moibd
沫	moidn
茉	moicn
袜	moipn
貉	moivk
秣	moihn
殁	moidy
貊	moivb
貘	moivd
镆	moijd
瘼	moibd
耱	moilu
歿	moidy
沒	moidy
狢	moiqk
獏	moiqd
脈	moion
鏌	moijd
靺	moign
驀	moicm
黙	moiha
咩	mpaky
乜	mpagv
灭	mpiah
蔑	mpicd
篾	mpivd
蠛	mpiic
搣	mpifa
滅	mpida
衊	mpixd
谬	mqiyp
謬	mqiyp
模	muemd
毪	muemn
呣	muekd
嘸	muekv
獏	mueqd
母	muuvd
姆	muund
姥	muunv
亩	muuwt
拇	muufd
牡	muunt
坶	muutd
畝	muuwn
目	muika
木	muian
慕	muicx
幕	muicj
牧	muiwn
穆	muihp
墓	muict
沐	muidm
暮	muico
牟	muisn
募	muicl
睦	muiot
苜	muico
坶	muitd
钼	muijo
仫	muirs
凩	muijm
呣	muikd
樢	muinm
鉬	muijo
霂	muiym
没	mwedy
眉	mwevo
梅	mwemd
枚	mwewm
媒	mwenm
玫	mweww
霉	mweyd
煤	mwehm
嵋	mweeo
楣	mwemo
湄	mwedo
糜	mwegm
莓	mwecd
酶	mweyd
坶	mwetd
镅	mwejo
鹛	mwenv
猸	mweqo
栂	mwemd
沒	mwedy
苺	mwecd
郿	mweev
鋂	mwejd
鎇	mwejo
鶥	mwenv
黴	mweyw
美	mwuyd
每	mwurd
镁	mwujd
浼	mwudv
媄	mwund
毎	mwura
燘	mwuhw
躾	mwuud
鎂	mwujd
妹	mwinn
媚	mwino
魅	mwign
昧	mwion
寐	mwibn
袂	mwipn
沬	mwidn
眛	mwion
哞	mzakn
谋	mzeym
眸	mzeon
缪	mzesp
牟	mzesn
侔	mzern
鍪	mzejs
蛑	mzein
繆	mzesp
謀	mzeym
踎	mzezk
鉾	mzejn
某	mzucm
厶	mzuvd
拿	naeru
镎	naeju
嗱	naeku
拏	naeun
鎿	naeju
那	nauev
哪	nauke
乸	nauxd
雫	nauyd
那	naiev
内	naiad
纳	naisd
娜	naine
呐	naikd
衲	naipd
捺	naifx
钠	naijd
肭	naiod
吶	naikr
妠	nainr
納	naisd
鈉	naijd
哪	navke
呐	navkd
吶	navkr
您	nbexr
恁	nbexr
囜	nbeks
孬	ncaaz
挠	ncefe
呶	nceky
猱	nceqm
铙	nceje
蛲	nceie
硇	nceux
峱	nceqe
撓	ncefe
蟯	nceie
鐃	nceje
脑	ncuok
恼	ncuxk
瑙	ncuwx
垴	ncutk
堖	ncutx
嫐	ncunn
悩	ncuxk
惱	ncuxx
脳	ncuok
腦	ncuox
闹	ncimj
淖	ncidu
臑	ncioa
鬧	nciaj
乃	ndugp
奶	ndunp
氖	nduqp
艿	nducp
迺	nduzx
奈	ndidx
耐	ndiac
鼐	ndigv
萘	ndicx
柰	ndimx
錼	ndijx
呐	neikd
讷	neiyd
訥	neiyd
呢	nevkv
嫩	nfinw
恁	nfixr
媆	nfind
能	ngesv
囔	nhaky
囊	nheay
馕	nheuy
饢	nheuy
攮	nhufy
曩	nhuoy
饢	nhuuy
齉	nhipy
呢	niakv
妮	nianv
呢	niekv
尼	nieuv
泥	niedv
倪	niere
霓	nieye
猊	nieqe
怩	niexv
鲵	nieae
坭	nietv
铌	niejv
籾	niemd
鈮	niejv
鯢	nieae
你	niurx
拟	niufr
旎	niufv
伲	niurv
妳	niunx
擬	niufr
薿	niucr
泥	niidv
逆	niizq
腻	niiod
匿	niikk
溺	niidd
睨	niioe
昵	niiov
伲	niirv
暱	niiok
暱	niiov
膩	niiod
囡	njakn
难	njeyf
南	njeuu
男	njetl
喃	njeku
楠	njemu
萳	njecu
難	njecf
赧	njuty
腩	njuou
蝻	njuiu
罱	njusu
萳	njucu
妠	njinr
婻	njinu
難	njicf
宁	nkebd
凝	nkedr
狞	nkeqd
拧	nkefd
咛	nkekd
柠	nkemd
甯	nkeba
甯	nkebd
聍	nkeed
嚀	nkekd
寧	nkebd
擰	nkefd
檸	nkemd
獰	nkeqd
聹	nkeed
薴	nkecd
擰	nkufd
宁	nkibd
泞	nkidd
佞	nkirn
寧	nkibd
擰	nkifd
濘	nkidd
娘	nlenn
嬢	nleny
孃	nleny
酿	nliyn
醸	nliyy
釀	nliyn
拈	nmafk
蔫	nmach
年	nmera
粘	nmemk
黏	nmehk
拈	nmefk
鲶	nmeax
鲇	nmeak
鮎	nmeak
鯰	nmeax
捻	nmufx
辗	nmuin
碾	nmuun
撵	nmufi
辇	nmuia
捵	nmufb
撚	nmufh
攆	nmufi
輦	nmuia
念	nmixr
廿	nmiaa
埝	nmitx
唸	nmikx
唸	nmikx
鸟	nnuna
袅	nnuny
茑	nnucn
嬲	nnunl
嫋	nnund
嬝	nnuny
樢	nnunm
蔦	nnucn
裊	nnuny
鳥	nnunh
尿	nniud
溺	nnidd
脲	nniod
娜	noene
挪	noefe
傩	noerf
儺	noerf
梛	noeme
诺	noiyk
呐	noikd
懦	noixa
糯	noima
搦	noifd
锘	noijk
諾	noiyk
鍩	noijk
捏	npaft
聂	npiey
孽	npicz
涅	npidt
蹑	npizy
嗫	npiky
啮	npikk
臬	npipm
镊	npijy
镍	npijm
蘖	npicm
颞	npiea
陧	npiet
埝	npitx
噛	npikk
嚙	npikv
囁	npike
嵲	npiem
惗	npixx
櫱	npiem
聶	npiee
菍	npicx
蘗	npicm
躡	npize
鎳	npijm
鑷	npije
隉	npieg
顳	npiea
齧	npifi
妞	nqana
牛	nqepa
扭	nqufa
纽	nqusa
钮	nquja
忸	nquxa
狃	nquqa
杻	nquma
紐	nqusa
鈕	nquja
鈕	nqusa
拗	nqifl
暖	nruoy
农	nsedn
浓	nsedn
哝	nsekn
侬	nsern
脓	nseon
㶶	nsehn
儂	nsern
噥	nsekn
濃	nsedn
燶	nsehn
秾	nsehn
穠	nsehn
膿	nseon
農	nsean
弄	nsiwc
虐	ntiha
疟	ntiba
瘧	ntiba
謔	ntiya
仅	nuery
奴	nueny
驽	nuemn
孥	nuezn
笯	nuevy
駑	nuemn
努	nuuln
弩	nuugn
胬	nuurn
怒	nuixn
傉	nuirc
女	nvuva
胬	nvurn
钕	nvujn
釹	nvujn
汉	nvidy
恧	nvixa
衄	nvixa
哪	nwuke
馁	nwuun
餒	nwuun
内	nwiad
內	nwiad
媆	nyind
耨	nzilc
啊	oaakk
阿	oaaek
呵	oaakk
腌	oaaov
吖	oaaka
锕	oaajk
錒	oaajk
啊	oaekk
吁	oaeku
嗄	oaekw
啊	oaukk
啊	oaikk
啊	oavkk
熬	ocahf
凹	ocaaa
敖	ocewf
熬	ocehf
嗷	ocekw
翱	oceby
鳌	oceaf
獒	oceqf
鏖	ocelj
遨	ocezf
螯	oceif
聱	oceef
廒	ocegw
嶅	ocefe
璈	oceww
鰲	oceaf
袄	ocupd
媪	ocunm
媼	ocunm
襖	ocupd
奥	ocipd
傲	ocirw
澳	ocidd
懊	ocixd
拗	ocifl
坳	ocitl
骜	ocimf
鏊	ocijf
岙	ocipe
墺	ocitd
奡	ociaa
奧	ocipd
嶅	ocife
嶴	ocipe
驁	ocimf
唉	odaku
哀	odawy
埃	odatu
哎	odakx
挨	odafu
嗳	odaky
锿	odajy
鎄	odajy
癌	odebe
皑	odebv
捱	odeft
捱	odefu
皚	odebd
磑	odeud
矮	oduun
蔼	oducv
霭	oduyv
佁	odurk
噯	odukw
欸	odusq
毐	oduup
藹	oducv
靄	oduyv
爱	odivy
艾	odicx
唉	odiku
碍	odiuc
暧	odioy
隘	odiem
嫒	odiny
瑷	odiwy
嗌	odikm
砹	odiux
叆	odiey
噯	odikw
嬡	odinw
愛	odivw
曖	odiow
璦	odiww
瞹	odiow
礙	odiur
鑀	odijw
靉	odiyw
阿	oeaek
婀	oeank
疴	oeabk
屙	oeauk
钶	oeajk
匼	oeakk
哦	oeekd
额	oeeba
俄	oeerd
峨	oeeed
鹅	oeenp
娥	oeend
蛾	oeeid
讹	oeeyv
莪	oeecd
硪	oeeud
蚵	oeeik
锇	oeejd
囮	oeekp
訛	oeeyv
鋨	oeejd
額	oeeba
鵝	oeenp
噁	oeukx
惡	oeuxa
恶	oeixa
愕	oeixg
饿	oeiud
呃	oeikv
厄	oeiiv
噩	oeiwk
遏	oeizo
扼	oeifv
鄂	oeiek
鳄	oeiag
萼	oeicg
颚	oeika
垩	oeita
鹗	oeink
锷	oeijg
谔	oeiyg
腭	oeiog
阏	oeimd
轭	oeiiv
苊	oeicv
咹	oeikn
堊	oeita
堨	oeitr
姶	oeink
崿	oeiev
悪	oeixa
惡	oeixa
詻	oeiyk
諤	oeiyg
軛	oeiiv
鍔	oeijg
閼	oeimd
阨	oeiev
顎	oeika
餓	oeiud
鰐	oeiag
鱷	oeiak
鶚	oeink
齶	oeivg
恩	ofaxk
嗯	ofakx
蒽	ofacx
奀	ofaad
嗯	ofikx
摁	ofifx
嗯	ofvkx
嗯	ogvkx
肮	ohaoj
腌	ohaov
骯	ohakj
昂	oheoe
卬	oheep
盎	ohima
安	ojabn
广	ojadi
鞍	ojagn
庵	ojagv
桉	ojamn
谙	ojayo
氨	ojaqn
鹌	ojand
盦	ojamr
菴	ojacv
諳	ojayo
鮟	ojaan
鵪	ojand
俺	ojurv
铵	ojujn
埯	ojutv
揞	ojufo
匼	ojukk
唵	ojukv
垵	ojutn
銨	ojujn
暗	ojioo
按	ojifn
案	ojibm
岸	ojieu
黯	ojiho
犴	ojiqu
胺	ojion
咹	ojikn
垾	ojitu
闇	ojimo
鮟	ojian
喔	ooakt
噢	ooakd
哦	ooekd
嚄	oouky
哦	ooikd
而	oreaa
儿	orepv
鸸	orena
児	oreae
兒	orepe
耏	oreap
鮞	oreaa
鲕	oreaa
鴯	orena
尔	orudx
耳	oruaa
饵	oruue
迩	oruzd
洱	orude
珥	oruwe
铒	oruje
爾	oruax
邇	oruza
鉺	oruje
餌	oruue
二	oriaa
贰	oriqb
佴	orire
咡	orike
弍	oried
弐	oriad
貳	oriqb
兒	orvpe
欸	owasq
誒	owayu
诶	oweyu
欧	ozakq
殴	ozaky
瓯	ozakw
鸥	ozank
讴	ozayx
沤	ozadx
區	ozakk
歐	ozakq
毆	ozaky
漚	ozadk
甌	ozakw
謳	ozayk
鴎	ozank
鷗	ozank
偶	ozurd
呕	ozukx
藕	ozucd
禺	ozuad
耦	ozuld
嘔	ozukk
怄	ozixx
慪	ozixk
漚	ozidk
啪	paakb
趴	paazb
葩	paacv
舥	paavb
爬	paevv
扒	paefb
琶	paewv
耙	paelv
杷	paemv
筢	paevv
㞎	paeub
鈀	paejv
怕	paixb
帕	paijb
拼	pbafc
拚	pbafc
姘	pbanc
贫	pbebb
频	pbeva
嫔	pbenb
颦	pbevu
嬪	pbenb
濵	pbedb
蘋	pbecb
貧	pbebb
頻	pbeva
顰	pbevu
品	pbukk
榀	pbumk
聘	pbieg
牝	pbinv
抛	pcafl
泡	pcadv
脬	pcaoz
拋	pcafl
脟	pcaoc
炮	pcehv
袍	pcepv
咆	pcekv
刨	pcedg
庖	pcegv
狍	pceqv
匏	pcedv
蚫	pceiv
鞄	pcegv
跑	pcuzv
炮	pcihv
泡	pcidv
疱	pcibv
奅	pcide
皰	pcipv
砲	pciiv
拍	pdafb
排	pdefa
牌	pdepu
徘	pdera
俳	pdera
箄	pdevu
派	pdidn
湃	pdidf
哌	pdikn
蒎	pdicn
喷	pfakb
噴	pfakb
盆	pfemb
湓	pfedm
瓫	pfebw
喯	pfikc
噴	pfikb
砰	pgauu
怦	pgaxu
烹	pgahw
嘭	pgakp
抨	pgafu
荓	pgacc
朋	pgeoo
庄	pgegt
鹏	pgeon
彭	pgeup
蓬	pgecz
篷	pgevz
棚	pgemo
膨	pgeop
澎	pgedp
蟛	pgeip
硼	pgeuo
堋	pgeto
搒	pgeff
芃	pgecd
鵬	pgeon
捧	pgufa
碰	pgiua
榜	pgimf
椪	pgima
踫	pgiza
膀	phaof
乓	phapd
滂	phadf
旁	phelf
庞	phegl
膀	pheof
彷	pherf
螃	pheif
逄	phezw
厖	pheip
尨	pheud
徬	pherf
雱	pheyf
龐	phegl
耪	phulf
胖	phioa
坏	piatd
批	piafv
匹	piake
劈	piadu
披	piafp
霹	piayu
丕	piaaa
噼	piaku
纰	piasv
坯	piata
邳	piaea
砒	piauv
铍	piajp
㨢	piafb
伾	piara
狉	piaqa
粃	piamp
紕	piasv
皮	pievy
疲	piebp
脾	pieou
啤	pieku
琵	piewv
毗	pietv
裨	piepu
貔	pievv
罴	piehs
陂	pieep
蚍	pieiv
鼙	pieuu
枇	piemv
芘	piecv
陴	pieeu
郫	pieep
埤	pietu
蜱	pieiu
羆	piehh
肶	pieop
鈹	piejp
否	piuak
匹	piuke
劈	piudu
痞	piubk
癖	piubu
疋	piuvr
圮	piutv
仳	piurv
庀	piugv
擗	piufu
嚭	piuuk
苉	piuce
扑	piifd
屁	piiuv
辟	piiuu
僻	piiru
譬	piiyu
媲	piinv
淠	piida
甓	piiwu
䴙	piinu
嚊	piikc
闢	piiuu
鷿	piinu
鸊	piinu
番	pjapt
攀	pjamu
潘	pjadt
扳	pjafy
般	pjevy
盘	pjemv
彦	pjelp
磐	pjeuv
蟠	pjeit
蹒	pjezd
爿	pjeap
柈	pjema
槃	pjemv
盤	pjemv
蹣	pjezr
判	pjidb
叛	pjiby
盼	pjiod
畔	pjita
拚	pjifc
袢	pjipa
泮	pjida
襻	pjipu
闆	pjimk
乒	pkapp
娉	pkang
俜	pkarg
平	pkeau
凭	pkejr
评	pkeyu
瓶	pkeqw
屏	pkeuc
萍	pkecu
苹	pkecu
坪	pketu
枰	pkemu
鲆	pkeau
呯	pkeku
塀	pketc
屛	pkeuu
岼	pkeeu
帡	pkejc
憑	pkexd
泙	pkedu
洴	pkedc
荓	pkecc
蘋	pkecb
蚲	pkeiu
評	pkeyu
馮	pkedm
鮃	pkeau
片	pmapv
偏	pmarc
篇	pmavc
翩	pmahy
扁	pmahc
犏	pmanc
萹	pmacc
便	pmern
骈	pmemc
蹁	pmezc
胼	pmeoc
㛹	pmenn
楩	pmemn
駢	pmemc
谝	pmuyc
諞	pmuyc
片	pmipv
骗	pmimc
騙	pmimc
飘	pnaxf
漂	pnadx
缥	pnasx
剽	pnadx
嘌	pnakx
螵	pnaix
慓	pnaxx
薸	pnacx
飄	pnaxf
朴	pnemd
瓢	pnexg
嫖	pnenx
漂	pnudx
瞟	pnuox
殍	pnudz
莩	pnucz
摽	pnufx
縹	pnusx
蔈	pnucx
漂	pnidx
票	pnixx
嘌	pnikx
慓	pnixx
驃	pnimx
颇	poapa
坡	poatp
泼	poadd
陂	poaep
钋	poajd
䥽	poajd
潑	poady
釙	poajd
鏺	poajy
頗	poapa
婆	poend
鄱	poeep
皤	poebt
扑	poufd
叵	poukk
笸	pouvk
钷	poujk
鉕	poujk
破	poiup
迫	poizb
魄	poibg
朴	poimd
珀	poiwb
粕	poimb
瞥	ppaox
撇	ppafw
氕	ppaqp
撇	ppufw
苤	ppuca
扑	puafd
仆	puard
剥	puade
噗	puakn
攵	puapx
攴	puaay
僕	puard
撲	puafd
鋪	puajd
朴	puemd
菩	pueck
蒲	puecd
葡	puecd
脯	pueod
璞	puewn
濮	puedn
匍	puegd
莆	puecd
镤	puejn
僕	puerd
墣	puetn
蒱	puecf
襆	puejn
鏷	puejn
普	puuqo
谱	puuyo
浦	puudd
圃	puukd
埔	puutd
溥	puudc
蹼	puuzn
氆	puumo
镨	puujo
樸	puumd
誧	puuyf
譜	puuyo
鐠	puujo
堡	puitr
铺	puijd
瀑	puidd
曝	puiod
鋪	puijd
呸	pwaka
胚	pwaoa
醅	pwayk
垺	pwatz
衃	pwaxa
坏	pwetd
陪	pweek
培	pwetk
赔	pwebk
裴	pweya
锫	pwejk
棓	pwemk
賠	pwebk
錇	pwejk
配	pwiyv
佩	pwirj
沛	pwidj
霈	pwiyj
辔	pwiks
帔	pwijp
旆	pwifj
珮	pwiwj
轡	pwiks
啪	pxakb
剖	pzadl
掊	pzefk
裒	pzewy
垺	pzetz
抔	pzefx
瓿	pzulw
掊	pzufk
哣	pzuka
棓	pzumk
扑	pzifd
亲	qbalm
侵	qbary
钦	qbajq
衾	qbary
嵚	qbaeq
嶔	qbaeq
欽	qbajq
親	qbalj
駸	qbamy
秦	qbefh
琴	qbewv
勤	qbecl
擒	qbefs
禽	qberd
芹	qbecj
螓	qbeih
噙	qbeks
覃	qbexu
芩	qbecv
嗪	qbekh
檎	qbemd
㩒	qbefx
鋟	qbejy
寝	qbuby
锓	qbujy
寢	qbuby
沁	qbidx
揿	qbifq
吣	qbikx
唚	qbiky
撳	qbifq
七	qiaav
期	qiaqo
妻	qiaan
欺	qiaqq
凄	qiadn
漆	qiadd
戚	qiagx
栖	qiamx
沏	qiadd
萋	qiacn
嘁	qiakx
柒	qiamd
槭	qiamx
桤	qiamv
悽	qiaxn
慼	qiaxp
棲	qiamn
榿	qiamd
淒	qiadn
渓	qiadn
緝	qiase
褄	qiapn
其	qieqb
奇	qiedk
期	qieqo
齐	qiewa
骑	qiemk
旗	qiefb
琪	qiewb
棋	qiemb
祈	qiepj
麒	qielb
琦	qiewk
歧	qievy
祺	qiepb
祁	qieep
崎	qieek
岐	qieey
淇	qiedb
颀	qieja
脐	qieoa
鳍	qieao
蕲	qiecj
耆	qieto
圻	qietj
骐	qiemb
畦	qiett
綦	qieqs
蜞	qieib
萁	qiecb
芪	qiecq
丌	qieaa
亓	qieea
蛴	qieia
䓫	qieck
埼	qietk
愭	qiexo
扺	qiefq
斉	qiewa
碁	qiequ
祇	qiepq
臍	qieoa
薺	qieca
蘄	qiecj
蠐	qieia
衹	qiepq
跂	qiezy
頎	qieja
騎	qiemk
騏	qiemb
鮨	qieao
鰭	qieao
齊	qiewa
起	qiuzv
气	qiurv
企	qiurv
岂	qiuev
启	qiuhk
绮	qiusk
乞	qiurg
稽	qiuho
杞	qiumv
芑	qiucv
屺	qiuev
綮	qiush
呇	qiudk
啓	qiukh
啟	qiuwh
婍	qiunk
棨	qiuhm
檵	qiumv
玘	qiuwv
綺	qiusk
豈	qiued
跂	qiuzy
气	qiirv
器	qiikk
弃	qiiwc
妻	qiian
企	qiirv
汽	qiidq
契	qiidf
泣	qiidl
砌	qiiud
迄	qiizr
憩	qiixp
亟	qiiva
忾	qiixq
讫	qiiyg
葺	qiice
趿	qiizn
碛	qiiub
槭	qiimx
謦	qiiyu
汔	qiidg
棄	qiiwm
気	qiiqx
氣	qiirm
磧	qiiub
訖	qiiyg
跂	qiizy
鏚	qiijx
轻	qkaig
清	qkado
亲	qkalm
青	qkafo
倾	qkara
卿	qkape
蜻	qkaio
氢	qkaqg
圊	qkako
鲭	qkaao
傾	qkara
氫	qkaqg
軽	qkait
輕	qkaig
頃	qkaaa
鯖	qkaao
鶄	qkanf
情	qkexo
晴	qkeoo
擎	qkeuc
氰	qkeqo
檠	qkemc
黥	qkehx
勍	qkewl
请	qkuyo
顷	qkuaa
㷫	qkuhh
庼	qkuga
廎	qkuga
檾	qkuhm
苘	qkuck
請	qkuyo
頃	qkuaa
声	qkiup
胜	qkiof
庆	qkigd
磬	qkiuu
箐	qkivo
罄	qkifu
慶	qkigw
親	qkilj
枪	qlamv
腔	qlaog
跄	qlazv
呛	qlakv
锵	qlajc
羌	qlayv
戗	qlarg
戕	qlavg
镪	qlaji
蜣	qlaiv
锖	qlajo
嗆	qlakk
將	qladc
戧	qlarg
搶	qlafk
槍	qlamk
玱	qlawv
瑲	qlawk
蹌	qlazk
錆	qlajo
鏘	qlajc
鏹	qlaji
强	qlegi
墙	qletk
蔷	qleck
嫱	qlenk
爿	qleap
樯	qlemk
嬙	qlenk
強	qlegi
彊	qlega
檣	qlemk
牆	qlepk
蔃	qleci
薔	qleck
强	qlugi
抢	qlufv
襁	qlupi
羟	qluyg
強	qlugi
彊	qluga
搶	qlufk
羥	qluyg
鏹	qluji
炝	qlihv
嗆	qlikk
熗	qlihk
蹌	qlizk
开	qmaac
千	qmapu
牵	qmadn
签	qmava
谦	qmayn
迁	qmazp
嵌	qmaeq
芊	qmacu
铅	qmajk
忏	qmaxu
佥	qmara
骞	qmabm
阡	qmaeu
钎	qmaju
搴	qmabu
仟	qmaru
褰	qmaby
悭	qmaxt
扦	qmafu
愆	qmaxr
岍	qmaec
僉	qmarr
圲	qmatu
慳	qmaxt
杄	qmamu
汧	qmadc
牽	qmawn
簽	qmavr
籤	qmavg
粁	qmamu
謙	qmayn
遷	qmazx
釺	qmaju
鉛	qmajk
韆	qmagz
騫	qmabm
前	qmeqd
钱	qmejg
赶	qmezu
潜	qmedo
乾	qmeug
乾	qmeau
虔	qmehw
钳	qmejc
黔	qmehv
箝	qmevc
掮	qmefo
钤	qmejv
墘	qmetg
拑	qmefc
潛	qmedo
蕁	qmecc
鈐	qmejv
鉗	qmejc
銭	qmejg
錢	qmejg
浅	qmudg
遣	qmuza
谴	qmuyz
忏	qmuxu
缱	qmusz
肷	qmuoq
撖	qmufw
淺	qmudg
繾	qmusz
譴	qmuyz
鑓	qmujz
歉	qmiqq
欠	qmidr
欠	qmifn
倩	qmiro
茜	qmicx
嵌	qmieq
堑	qmiti
慊	qmixn
芡	qmicq
椠	qmimi
塹	qmiti
槧	qmimi
縴	qmisn
蒨	qmico
敲	qnawy
雀	qnaxf
跷	qnaze
橇	qnamm
锹	qnajh
敫	qnawb
硗	qnaue
缲	qnasm
劁	qnadr
橾	qnamm
磽	qnaue
繰	qnasm
蹺	qnaze
鍬	qnajh
鞽	qnagk
瞧	qneoh
乔	qnepa
桥	qnema
憔	qnexh
樵	qnemh
侨	qnera
谯	qneyh
荞	qneca
鞒	qnega
僑	qnerk
喬	qnepk
橋	qnemk
硚	qneua
礄	qneuk
翹	qnety
蕎	qneck
譙	qneyh
鞽	qnegk
巧	qnugg
悄	qnuxo
雀	qnuxf
愀	qnuxh
俏	qniro
鞘	qnigo
翘	qniay
窍	qnibg
峭	qnieo
撬	qnifm
诮	qniyo
殻	qniuy
殼	qniuy
竅	qnibw
翹	qnity
誚	qniyo
譙	qniyh
切	qpaqd
茄	qpeck
且	qpuaa
切	qpiqd
妾	qpiln
窃	qpibd
怯	qpixs
惬	qpixn
趄	qpizq
锲	qpijd
挈	qpiuf
箧	qpivn
慊	qpixn
郄	qpiex
愜	qpixn
竊	qpibs
篋	qpivn
鍥	qpijd
业	qqaaa
秋	qqahh
丘	qqapa
邱	qqaep
邺	qqaea
鳅	qqaah
蚯	qqaia
楸	qqamh
萩	qqach
鞦	qqagh
鞧	qqaga
鰌	qqaay
鰍	qqaah
鶖	qqanh
鹙	qqanh
团	qqekp
求	qqead
球	qqewd
仇	qqerj
囚	qqekr
裘	qqeay
酋	qqeqa
虬	qqeiv
泅	qqedr
俅	qqerd
遒	qqezq
巯	qqevv
逑	qqeza
犰	qqeqj
蝤	qqeiy
艽	qqecj
鼽	qqepj
巰	qqeav
梂	qqemd
毬	qqemd
虯	qqeia
訄	qqejy
賕	qqebd
赇	qqebd
糗	qqumq
圈	qrakv
悛	qraxw
桊	qrabm
圏	qrakv
棬	qramv
全	qrerw
权	qremy
拳	qrebu
泉	qrebd
痊	qrebw
蜷	qreiv
荃	qrecw
诠	qreyw
颧	qreca
铨	qrejw
鬈	qreav
筌	qrevw
醛	qreyw
佺	qrerw
婘	qrenv
惓	qrexv
槫	qremc
権	qremf
權	qremf
詮	qreyw
踡	qrezv
輇	qreiw
辁	qreiw
銓	qrejw
顴	qreca
犬	qrudd
绻	qrusv
畎	qrutq
綣	qrusv
劝	qriyl
券	qribd
勧	qrirl
勸	qricl
芎	qsacg
銎	qsajg
穷	qsebl
琼	qsewx
穹	qsebg
茕	qsecu
邛	qseeg
蛩	qseig
芎	qsecg
跫	qsezg
筇	qseve
䓖	qsecl
煢	qsehu
瓊	qseww
窮	qsebg
藭	qsecg
缺	qtafn
阙	qtamq
炔	qtahn
闕	qtamq
瘸	qtebr
却	qtieu
确	qtiuj
猎	qtiqo
雀	qtixf
鹊	qtinc
榷	qtimf
阕	qtimd
郄	qtiex
攉	qtiff
悫	qtixu
卻	qtiek
埆	qtitj
塙	qtitk
愨	qtixu
敠	qtiyy
確	qtiuf
闋	qtimd
闕	qtimq
鵲	qtinc
区	quakx
曲	quaaa
躯	quaux
屈	quauk
驱	quamx
趋	quaze
麴	quaum
麴	quaaa
蛆	quaiq
岖	quaex
祛	quaps
黢	quahw
蛐	quaia
诎	quayk
㭕	quams
䓛	quace
區	quakk
坥	quatq
岨	quaeq
嶇	quaek
焌	quahw
胠	quaos
袪	quaps
詘	quayk
趨	quaze
軀	quauk
駆	quamx
駈	quama
驅	quamk
髷	quaaa
麹	quafm
渠	quemd
瞿	queof
衢	querd
癯	quebf
蠼	queiy
朐	queok
蕖	quecm
蘧	quecz
璩	quewn
鸲	queng
劬	quegl
磲	queum
氍	queom
佢	quera
鴝	queng
鼩	queuk
取	quuey
曲	quuaa
娶	quune
龋	quuid
弆	quutc
齲	quuid
去	quits
趣	quizy
觑	quihj
蜡	quiio
阒	quimq
覷	quihj
闃	quimq
掐	qxafa
葜	qxacd
拤	qxefd
卡	qxuad
峠	qxuen
鞐	qxugd
恰	qxixk
洽	qxidk
咭	qxikk
疴	qxibk
髂	qxigk
㓤	qxidu
逡	qyazw
群	qyevy
裙	qyepk
羣	qyevy
饶	rceue
娆	rcene
荛	rcece
桡	rceme
嬈	rcene
橈	rceme
蕘	rcece
饒	rceue
扰	rcufd
擾	rcufw
绕	rcise
繞	rcise
惹	reucx
喏	reukk
热	reihf
熱	reiht
人	rfepn
儿	rfepv
任	rferu
仁	rfere
壬	rfepu
忍	rfuxd
荏	rfucu
稔	rfuhx
綛	rfusx
腍	rfuox
菍	rfucx
任	rfiru
认	rfiyr
刃	rfidd
韧	rfiad
恁	rfixr
仞	rfird
饪	rfiuu
纫	rfisd
衽	rfipu
妊	rfinu
轫	rfiid
葚	rficv
紉	rfisd
紝	rfisu
纴	rfisu
袵	rfipu
認	rfiyx
讱	rfiyd
軔	rfiid
靭	rfigd
靱	rfigd
韌	rfiad
飪	rfiuu
扔	rgafp
仍	rgerp
瓤	rhewg
禳	rhepy
穰	rhehy
儴	rhery
穣	rhehy
蘘	rhecy
嚷	rhuky
壤	rhuty
攘	rhufy
壌	rhuty
让	rhiya
譲	rhiyy
讓	rhiyy
日	riika
囸	riikv
馹	riimo
驲	riimo
然	rjehp
燃	rjehh
髯	rjeaa
蚺	rjeia
染	rjumd
冉	rjuaa
苒	rjuca
䎃	rjuay
若	roick
弱	roigd
偌	roirk
箬	roivk
蒻	roicd
鰯	roiad
鶸	roing
堧	rretd
软	rruiq
阮	rruee
朊	rruoe
媆	rrund
軟	rruiq
容	rsebk
荣	rsecm
融	rseai
蓉	rseck
绒	rsesu
溶	rsedk
熔	rsehk
戎	rsegu
茸	rsece
榕	rsemk
嵘	rseem
蝾	rseim
肜	rseop
狨	rsequ
嶸	rseem
栄	rsexm
榮	rsehm
絨	rsesu
蠑	rseim
鎔	rsejk
鎹	rsejz
镕	rsejk
冗	rsubj
如	ruenk
儒	ruera
茹	rueck
蠕	rueia
孺	rueza
嚅	rueka
濡	rueda
襦	ruepa
颥	rueya
薷	rueca
铷	ruejk
銣	ruejk
顬	rueya
女	ruuva
辱	ruuic
乳	ruuvv
汝	ruudn
入	ruipn
褥	ruipc
缛	ruisc
蓐	ruicc
溽	ruidc
洳	ruidk
杁	ruimr
縟	ruisc
込	ruizr
鳰	ruinr
蕤	rveca
蕊	rvucx
蕋	rvucv
蘂	rvucm
内	rviad
瑞	rviwa
锐	rvije
兑	rvibe
芮	rvicr
睿	rviao
蚋	rviid
枘	rvimd
叡	rviay
汭	rvidd
銳	rvije
鋭	rvije
润	ryidw
闰	ryimw
潤	ryidw
閏	ryimw
柔	rzesm
揉	rzefm
蹂	rzezm
糅	rzemm
鞣	rzegm
肉	rziar
杀	saaxm
沙	saadp
刹	saadx
撒	saafw
莎	saacp
煞	saahd
纱	saasp
砂	saaup
鲨	saaad
裟	saayd
仨	saars
铩	saajm
痧	saabp
剎	saadx
唦	saakp
殺	saaxy
紗	saasp
鎩	saajy
鯊	saaad
啥	saekk
傻	saurw
撒	saufw
洒	saudx
唼	saukn
灑	saudl
靸	saugn
萨	saici
煞	saihd
霎	saiyn
厦	saiiw
飒	sailf
嗄	saikw
歃	saipq
卅	saiaa
檫	saimx
趿	saizn
脎	saiom
廈	saigw
薩	saicf
颯	sailf
稍	scaho
烧	scahe
骚	scami
梢	scamo
搔	scafi
臊	scaom
捎	scafo
裢	scapz
艄	scavo
缫	scasn
蛸	scaio
筲	scavo
掻	scafi
焼	scahe
燒	scahe
繅	scasm
繰	scasm
騒	scami
騷	scami
鮹	scaao
鰠	scaai
鰺	scaap
鳋	scaai
勺	scegd
韶	scelk
芍	scecd
苕	sceck
杓	scemd
柖	scemk
少	scuxp
扫	scufe
嫂	scuny
掃	scufj
少	scixp
绍	scisk
召	scidk
哨	sciko
邵	scied
劭	scidl
臊	sciom
瘙	scibi
潲	scido
埽	scitj
卲	scied
掃	scifj
柖	scimk
紹	scisk
塞	sdabt
腮	sdaox
筛	sdavj
鳃	sdaax
噻	sdakt
酾	sdayd
偲	sdarx
嘥	sdakr
篩	sdavj
鰓	sdaax
色	sdudv
骰	sdugy
赛	sdibb
塞	sdibt
晒	sdiox
嗮	sdiky
曬	sdiol
賽	sdibb
奢	seado
赊	seabx
猞	seaqk
畲	seart
奓	seadd
畬	seart
賒	seabx
閪	seamx
什	seeru
折	seefj
蛇	seeiv
舌	seepk
佘	seerx
揲	seefm
闍	seemo
捨	seufk
色	seidv
设	seiyy
射	seiuc
社	seipt
塞	seibt
舍	seirk
涉	seidp
摄	seify
瑟	seiwd
涩	seidv
圾	seitn
慑	seixy
赦	seiwt
啬	seiuk
麝	seilc
歙	seirq
穑	seihk
厍	seiii
铯	seijv
滠	seidy
㴔	seidx
厙	seiii
嗇	seiak
懾	seixy
摂	seifd
攝	seife
渉	seidp
渋	seidd
澀	seidv
澁	seidv
灄	seide
穡	seihk
舎	seirk
葉	seicm
設	seiyy
銫	seijv
身	sfapp
深	sfadm
伸	sfara
森	sfamm
申	sfaaa
呻	sfaka
绅	sfasa
莘	sfacu
诜	sfaye
娠	sfann
砷	sfaua
侁	sfare
參	sfasp
屾	sfaee
棽	sfamg
燊	sfahm
珅	sfawa
紳	sfasa
蔘	sfacp
詵	sfaye
鯵	sfaap
鰺	sfaap
什	sferu
神	sfepa
榊	sfema
鰰	sfeya
沈	sfudv
审	sfuba
洒	sfudx
婶	sfuna
哂	sfukx
渖	sfuda
谂	sfuyx
矧	sfuua
嬸	sfunt
審	sfubt
瀋	sfudt
瀋	sfudt
諗	sfuyx
讅	sfuyt
谉	sfuya
甚	sfiqv
慎	sfixb
渗	sfidp
肾	sfioa
蜃	sfiii
椹	sfimv
葚	sficv
胂	sfioa
愼	sfixb
滲	sfidp
脤	sfioy
腎	sfiok
生	sgapf
声	sgaup
胜	sgaof
升	sgapc
僧	sgaro
牲	sganf
笙	sgavf
甥	sganl
昇	sgaoc
昇	sgaoa
曻	sgaoa
聲	sgaue
绳	sgesv
澠	sgedv
縄	sgesv
繩	sgesv
省	sguxo
眚	sguno
胜	sgiof
盛	sgimg
剩	sgidp
乘	sgipn
晟	sgiov
垩	sgita
嵊	sgien
剰	sgidp
勝	sgiol
聖	sgiwe
伤	sharl
商	shalk
桑	shaym
殇	shadp
觞	shajp
墒	shatk
熵	shahk
傷	sharp
喪	shaun
殤	shadp
湯	shadp
觴	shajp
上	shuaa
赏	shubx
晌	shuok
嗓	shukm
搡	shufm
颡	shuya
垧	shutk
磉	shuum
埫	shutk
賞	shubx
顙	shuya
上	shiaa
尚	shixk
丧	shiun
绱	shisk
喪	shiun
緔	shisk
裳	shvxy
师	siaaj
斯	siaqj
思	siaxt
失	siapn
司	siagk
丝	siaav
施	siafv
尸	siavp
私	siahs
诗	siayc
湿	siada
狮	siaqj
撕	siafj
嘶	siakj
厮	siaij
嘘	siaka
咝	siaka
鸶	siavn
虱	siagi
厶	siavd
蛳	siaij
缌	siasx
蓍	siaco
锶	siajx
澌	siadj
菥	siacj
鲺	siaai
㟃	siaek
䴓	siana
俬	siars
俬	siars
偲	siarx
凘	siadj
噝	siaks
屍	siaup
師	siapj
廝	siagj
楒	siamx
浉	siadj
溮	siadj
溼	siadt
獅	siaqj
絲	siass
緦	siasx
虒	siapj
蝨	siavi
螄	siaij
詩	siayc
釃	siayl
鍶	siajx
鯴	siaai
鰤	siaaj
鳾	siana
鷉	sianp
鷥	sians
时	sieoc
什	sieru
十	sieaa
实	siebd
石	sieak
识	sieyb
食	siern
拾	siefk
蚀	sieui
炻	siehu
莳	siecc
埘	sietc
鲥	sieac
塒	sietc
実	siebn
寔	siebr
實	siebb
時	sieoc
湜	siedr
籮	sievf
蒔	siecc
蝕	sieui
識	sieyg
辻	siezu
鮖	sieau
鰣	sieac
鼫	sieuu
死	siudv
使	siurn
始	siunk
史	siuan
驶	siumn
矢	siurd
弛	siugv
屎	siuum
豕	siuan
駛	siumn
是	siior
事	siiaa
四	siike
世	siicv
似	siirr
士	siiua
势	siilf
视	siipj
市	siiwj
式	siiqd
台	siisk
示	siiex
试	siiyd
室	siitb
食	siirn
适	siizp
释	siipa
侍	siirc
氏	siipq
饰	siiuj
寺	siitc
誓	siiyf
逝	siizf
肆	siiaa
噬	siikr
伺	siirk
拭	siifd
嗜	siiko
祀	siipv
恃	siixc
巳	siivv
仕	siiru
饲	siiuk
嗣	siikk
弑	siixd
姒	siinr
柿	siimj
轼	siiid
俟	siiru
汜	siidv
泗	siids
舐	siipq
驷	siims
兕	siiae
谥	siiym
螫	siiit
筮	siivr
笥	siivk
耜	siilk
铈	siijj
贳	siibc
䏡	siiox
佁	siirk
勢	siilt
奭	siidb
弒	siixd
枱	siimk
栻	siimd
籮	siivf
蒔	siicc
襫	siipn
視	siipj
試	siiyd
諡	siiym
謚	siiym
識	siiyg
貰	siibc
軾	siiid
適	siizk
釈	siipn
釋	siipu
鈰	siijj
飼	siiuk
飾	siiuj
駟	siims
三	sjaae
山	sjaka
衫	sjapp
扇	sjahy
邓	sjaey
珊	sjawa
姗	sjana
杉	sjamp
栅	sjama
删	sjadp
煽	sjahy
叁	sjass
跚	sjaza
膻	sjaoa
潸	sjado
舢	sjave
苫	sjack
芟	sjacy
毵	sjasm
埏	sjatv
钐	sjajp
刪	sjada
參	sjasp
叄	sjass
姍	sjana
毿	sjasm
穇	sjahp
羶	sjaya
釤	sjajp
闪	sjumr
散	sjuwc
伞	sjuru
陕	sjuen
糁	sjump
馓	sjuuw
傘	sjuru
摻	sjufp
晱	sjuoh
睒	sjuoj
糝	sjump
閃	sjumr
陝	sjuen
饊	sjuuw
散	sjiwc
善	sjiyk
扇	sjihy
擅	sjifa
讪	sjiye
膳	sjiok
汕	sjide
缮	sjisk
赡	sjiby
鳝	sjiak
剡	sjidh
鄯	sjiey
嬗	sjina
骟	sjimy
蟮	sjiik
疝	sjibe
單	sjika
墡	sjitl
嶦	sjiek
掞	sjifh
禪	sjipa
繕	sjisk
訕	sjiye
贍	sjiby
騸	sjimy
鱔	sjiak
摔	skafu
衰	skawy
甩	skupv
率	skiwu
帅	skiaj
蟀	skiiu
帥	skipj
双	slayy
霜	slayo
孀	slano
瀧	sladl
礵	slaio
雙	slary
爽	sludx
塽	slutx
说	soaye
缩	soasb
莎	soacp
梭	soamw
嗦	soaks
唆	soakw
挲	soaud
娑	soand
蓑	soacy
桫	soamp
睃	soaow
嗍	soako
羧	soayw
簑	soavy
縮	soasb
說	soaye
説	soaye
所	soupj
索	souus
锁	soujb
琐	souwb
唢	soukb
嗩	soukb
瑣	souwb
葰	soucw
鎖	soujb
烁	soihd
硕	soiua
朔	soiqo
铄	soijd
槊	soimq
妁	soind
搠	soifo
嗍	soiko
蒴	soico
數	soiwa
爍	soihm
碩	soiua
鑠	soijm
酸	srayw
拴	srafw
栓	sramw
闩	srama
狻	sraqw
痠	srabw
閂	srama
算	srivc
蒜	sricx
涮	sridd
槫	srimc
腨	srioa
松	ssams
嵩	ssaek
淞	ssads
崧	ssaes
菘	ssacs
凇	ssads
娀	ssang
鬆	ssaas
耸	ssuer
悚	ssuxn
怂	ssuxr
竦	ssuln
㧐	ssufy
㩳	ssufy
慫	ssuxr
聳	ssuer
送	ssizq
宋	ssibm
颂	ssiba
诵	ssiya
讼	ssiys
吅	ssikk
訟	ssiys
誦	ssiya
頌	ssiba
餸	ssiiz
餸	ssiuz
𩠌	ssiuz
书	suavd
苏	suacd
叔	suaay
输	suaid
舒	suara
殊	suadn
疏	suavv
倏	suarq
淑	suady
梳	suamv
酥	suayh
枢	suamx
蔬	suacv
抒	suafa
稣	suaah
纾	suasa
姝	suann
殳	suajy
菽	suacy
毹	suarm
摅	suafx
囌	suakh
摴	suafv
攄	suafx
書	suavo
樞	suamk
橾	suamm
甦	suaaa
甦	suaaf
疎	suavn
穌	suaah
紓	suasa
蘇	suach
輸	suaid
术	suemd
熟	suehw
叔	sueay
俗	suerk
淑	suedy
赎	suebd
孰	suewd
塾	suetw
秫	suehd
婌	sueny
朮	suemd
贖	suebb
属	suuud
鼠	suupv
署	suuso
蜀	suusi
暑	suuoo
曙	suuoo
薯	suuco
黍	suuhd
屬	suuui
數	suuwa
藷	suuco
数	suiwm
术	suimd
速	suiza
诉	suiyd
树	suimc
权	suimy
素	suifs
束	suian
述	suiza
肃	suiva
宿	suibb
竖	suila
恕	suixn
塑	suitq
墅	suita
庶	suigh
簌	suivq
漱	suidq
粟	suixm
溯	suido
夙	suijd
戍	suigd
愫	suixs
谡	suiyw
澍	suidc
沭	suidd
嗉	suiks
蔌	suicq
涑	suidn
僳	suirm
腧	suiod
觫	suijn
傃	suirx
愬	suixb
數	suiwa
朮	suimd
樹	suimc
窣	suibu
竪	suilk
粛	suiva
肅	suiva
術	suird
訴	suiyd
謖	suiyw
豎	suidk
遡	suizo
虽	svaki
尿	svaud
睢	svaof
濉	svadf
眭	svaot
荽	svacn
葰	svacw
雖	svakf
随	sveez
谁	sveyf
隋	sveeo
绥	svesn
綏	svesn
誰	sveyf
隨	sveez
水	svuan
髓	svugz
氵	svuda
髄	svugz
睡	svioa
岁	svied
碎	sviuu
税	svihe
遂	svizq
祟	sviex
邃	svizb
隧	sviez
穗	svihx
燧	svihz
谇	sviyu
帨	svije
旞	svifz
歲	svivp
歳	svivx
砕	sviuu
稅	svihe
穂	svihx
繐	svihx
襚	svipz
說	sviye
誶	sviyu
誰	sweyf
刷	sxadu
唰	sxakd
耍	sxuan
刷	sxidu
孙	syazx
荪	syacx
狲	syaqx
飧	syapu
孫	syazs
猻	syaqs
蓀	syacs
损	syufb
吮	syuke
笋	syuvp
隼	syuur
榫	syumu
揗	syufo
損	syufb
楯	syumo
筍	syuvo
顺	syipa
瞬	syioa
舜	syiva
巛	syivv
順	syipa
收	szawv
搜	szafy
艘	szavy
嗖	szaky
飕	szafy
馊	szauy
溲	szady
锼	szajy
収	szavy
廋	szagy
捜	szafy
蒐	szacs
蒐	szacg
蒐	szacg
螋	szaiy
鎪	szajy
颼	szafy
餿	szauy
熟	szehw
手	szupa
首	szuqo
守	szubc
叟	szupy
擞	szufw
艏	szuvo
薮	szucw
嗾	szuku
瞍	szuoy
擻	szufw
籔	szuvw
藪	szucw
受	szivy
兽	szibk
授	szify
瘦	sziby
寿	szifc
售	szikr
嗽	szikq
狩	sziqc
绶	szisy
壽	sziuc
獣	szixq
獸	szikq
痩	sziby
綬	szisy
他	taarv
她	taanv
它	taabv
塌	taaty
趿	taazn
铊	taajv
溻	taady
牠	taanx
祂	taapx
褟	taapy
鉈	taajv
塔	tautk
獭	tauqb
鳎	tauay
獺	tauqb
鰨	tauay
达	taizd
踏	taizo
拓	taifk
榻	taimy
嗒	taikk
蹋	taizy
沓	taido
遢	taizo
挞	taifz
闼	taimz
漯	taids
㳠	taidz
撻	taifz
澾	taidz
跶	taizz
闥	taimz
鞳	taigk
涛	tcadc
掏	tcaff
滔	tcada
叨	tcakd
饕	tcauk
韬	tcaaa
绦	tcasm
弢	tcagy
慆	tcaxa
濤	tcadc
絛	tcars
韜	tcaaa
逃	tcezp
桃	tcemd
陶	tceef
淘	tcedf
萄	tcecf
啕	tcekf
洮	tcedd
鼗	tceey
梼	tcemc
檮	tcemc
綯	tcesf
鞀	tcegk
讨	tcuyc
討	tcuyc
套	tcids
台	tdask
胎	tdaok
苔	tdack
呔	tdakd
台	tdesk
抬	tdefk
苔	tdeck
跆	tdezk
邰	tdees
薹	tdect
薹	tdeck
炱	tdesh
鲐	tdeak
擡	tdeft
枱	tdemk
檯	tdemt
臺	tdetu
颱	tdefk
駘	tdemk
鮐	tdeak
太	tdidd
态	tdixd
泰	tdifd
汰	tdidd
钛	tdijd
肽	tdiod
酞	tdiyd
態	tdixs
鈦	tdijd
特	teinc
忑	teixa
忒	teiqd
慝	teixk
鋱	teijx
铽	teijx
腾	tgeom
疼	tgebd
藤	tgecd
滕	tgeod
誊	tgeby
䲢	tgeoy
僜	tgera
籐	tgevd
縢	tgeox
螣	tgeoi
謄	tgeby
騰	tgeom
鰧	tgeoy
汤	thadp
趟	thazk
镗	thajt
铴	thajp
羰	thayh
耥	thalk
㓥	thadx
㓥	thade
劏	thadx
嘡	thakt
湯	thadp
蹚	thazt
鏜	thajt
鐋	thajp
唐	thegk
堂	thetx
膛	theot
棠	thexm
糖	themk
塘	thetk
瑭	thewk
螳	theit
搪	thefk
樘	themt
溏	thedk
饧	theup
醣	theyk
螗	theik
䣘	theex
躺	thuuk
倘	thurk
淌	thudk
傥	thure
帑	thujn
惝	thuxk
耥	thulk
儻	thurh
鎲	thuje
钂	thujh
镋	thuje
趟	thizk
烫	thihd
燙	thihd
盪	thimd
鐋	thijp
踢	tiazp
梯	tiamp
剔	tiado
锑	tiajp
䏲	tiaop
䴘	tianp
擿	tiafz
銻	tiajp
鷈	tianp
鷉	tianp
提	tiefr
题	tieoa
蹄	tiezj
啼	tiekj
缇	tiesr
荑	tiecn
醍	tieyr
鹈	tienb
绨	tiesp
媂	tienj
媞	tienr
綈	tiesp
緹	tiesr
題	tieoa
鯷	tiear
鳀	tiear
鵜	tienb
躰	tiuua
體	tiugd
弟	tiibp
达	tiizd
替	tiioa
惕	tiixp
涕	tiidp
屉	tiiuv
剃	tiidb
嚏	tiikr
倜	tiirk
逖	tiizq
悌	tiixp
裼	tiipp
嚔	tiikr
屜	tiiuv
笹	tiivv
薙	tiicf
趯	tiizf
贪	tjabr
摊	tjaff
滩	tjadf
瘫	tjabf
坍	tjatw
嘽	tjaka
攤	tjaff
灘	tjadf
癱	tjabf
貪	tjabr
谈	tjeyh
胆	tjeoa
坛	tjets
谭	tjeyu
潭	tjedu
檀	tjema
昙	tjeos
痰	tjebh
澹	tjedy
覃	tjexu
郯	tjeeh
锬	tjejh
倓	tjerh
壇	tjeta
壜	tjets
彈	tjega
曇	tjeos
榃	tjemt
罈	tjefu
蕁	tjecc
談	tjeyh
譚	tjeyu
錟	tjejh
鐔	tjeju
胆	tjuoa
坦	tjuta
毯	tjumh
忐	tjuxa
袒	tjupa
钽	tjuja
菼	tjuch
鉭	tjuja
叹	tjiky
探	tjifm
炭	tjieh
碳	tjiuh
倓	tjirh
嘆	tjikn
歎	tjicq
听	tkakj
厅	tkaid
汀	tkadd
烃	tkahg
庁	tkagd
廳	tkagx
桯	tkamw
烴	tkahg
聴	tkaex
聽	tkaex
停	tkerd
庭	tkegz
廷	tkezp
亭	tkewd
婷	tkend
霆	tkeyz
蜓	tkeiu
莛	tkecu
葶	tkecd
䗴	tkeiz
聤	tkeed
挺	tkufz
艇	tkuvz
町	tkutd
梃	tkumz
侹	tkurz
圢	tkutd
鋌	tkujz
聽	tkiex
天	tmaad
添	tmadx
兲	tmawb
田	tmeku
甜	tmepc
填	tmetb
恬	tmexk
阗	tmemb
畋	tmewt
塡	tmetb
沺	tmedt
湉	tmedk
畑	tmeht
畠	tmebt
鈿	tmejt
闐	tmemb
鴫	tment
舔	tmupx
蚕	tmuai
腆	tmuob
殄	tmudp
忝	tmuax
捵	tmufb
晪	tmuob
掭	tmifx
挑	tnafd
佻	tnard
祧	tnapd
条	tnewm
迢	tnezd
苕	tneck
笤	tnevk
髫	tneak
蜩	tneik
龆	tneik
鲦	tneam
條	tnerm
調	tneyk
鰷	tneam
齠	tneik
挑	tnufd
窕	tnubd
嬥	tnunf
誂	tnuyd
跳	tnizd
眺	tniod
粜	tniem
朓	tniod
糶	tnief
覜	tnipj
脱	toaoe
托	toafq
拖	toafv
税	toahe
乇	toapv
侂	toarq
嘽	toaka
脫	toaoe
託	toayv
讬	toayv
陀	toeev
驼	toemv
佗	toerv
驮	toemd
鸵	toenv
沱	toedv
坨	toetv
酡	toeyv
砣	toeuv
橐	toeam
跎	toezv
鼍	toekv
柁	toemv
沲	toedv
詑	toeyv
迆	toezx
馱	toemd
駄	toemd
駝	toemv
鴕	toenv
鼉	toekv
妥	touvn
椭	toumo
庹	tougn
橢	toumo
拓	toifk
唾	toika
柝	toimd
箨	toiva
籜	toivu
萚	toica
蘀	toicu
贴	tpabk
帖	tpajk
萜	tpack
怗	tpaxk
貼	tpabk
铁	tpujn
帖	tpujk
鉄	tpujn
鐵	tpujg
帖	tpijk
餮	tpiud
湍	trada
猯	traqa
团	trekp
抟	trefd
団	trekc
團	trekc
摶	trefc
槫	tremc
糰	tremc
痪	trubn
疃	truta
税	trihe
彖	trivn
通	tsazs
嗵	tsakz
同	tsekk
童	tsela
铜	tsejk
瞳	tseoa
彤	tsepp
桐	tsemk
佟	tserd
峒	tseek
潼	tseda
僮	tsera
侗	tserk
仝	tserg
酮	tseyk
茼	tseck
垌	tsetk
砼	tseug
哃	tsekk
峂	tseed
曈	tseoa
橦	tsema
銅	tsejk
统	tsuse
筒	tsuvk
桶	tsuma
捅	tsufa
垌	tsutk
㛚	tsuna
樋	tsumz
統	tsuse
通	tsizs
痛	tsiba
恸	tsixl
慟	tsixl
衕	tsird
突	tuabq
秃	tuahj
凸	tuaaa
㻬	tuawv
梌	tuamh
禿	tuahe
突	tuebq
图	tuekd
徒	tuerr
途	tuezr
屠	tueuo
涂	tuedh
荼	tuech
酴	tueyh
図	tuekx
圖	tuekk
塗	tuetd
梌	tuemh
腯	tueoo
葖	tuecq
土	tuuua
吐	tuukt
钍	tuujt
釷	tuujt
吐	tuikt
兔	tuidd
菟	tuicd
堍	tuitv
兎	tuipd
推	tvaff
萑	tvacf
颓	tveha
頹	tveha
腿	tvuoz
退	tvizv
脱	tvioe
税	tvihe
蜕	tviie
煺	tvihz
蛻	tviie
忒	twaqd
吴	tyakd
吞	tyaak
暾	tyaow
吨	tyekv
臀	tyeou
屯	tyeav
囤	tyekv
豚	tyeon
饨	tyeuv
坉	tyetv
忳	tyexv
飩	tyeuv
吨	tyukv
氽	tyurd
褪	tyipz
偷	tzard
鍮	tzajd
头	tzedd
投	tzefy
骰	tzegy
頭	tzedb
钭	tzuju
鈄	tzuju
透	tzizh
頭	tzvdb
哇	waakt
挖	waafg
娲	waanr
蛙	waait
洼	waadt
媧	waank
搲	waafg
窊	waabg
窪	waadt
娃	waent
瓦	wauad
佤	waurw
搲	waufg
袜	waipn
腽	waiom
搲	waifg
膃	waiom
襪	waipn
歪	wdaav
㖞	wdakn
喎	wdakk
崴	wduen
外	wdipd
温	wfadm
瘟	wfabm
媪	wfanm
塭	wfatm
榅	wfamm
溫	wfadm
蕰	wfacm
鰛	wfaam
鰮	wfaam
文	wfewx
闻	wfeme
纹	wfesw
雯	wfeyw
蚊	wfeiw
玟	wfeww
阌	wfemy
匁	wfegn
炆	wfehw
紋	wfesw
聞	wfeme
芠	wfecw
閿	wfemy
馼	wfemw
稳	wfuhx
吻	wfukp
紊	wfuws
愠	wfuxm
刎	wfudg
殁	wfudy
忞	wfuwx
搵	wfufm
穏	wfuhx
穩	wfuhx
问	wfimk
汶	wfidw
璺	wfipw
問	wfimk
抆	wfifw
揾	wfifm
搵	wfifm
翁	wgaby
嗡	wgaky
鶲	wganb
蓊	wgucy
瓮	wgibw
蕹	wgicf
甕	wgiww
汪	whadw
尢	whauv
尪	whauw
尫	whaaw
王	wheat
亡	whewv
往	whurw
网	whukx
枉	whumw
冈	whukx
惘	whuxv
罔	whukv
魍	whugv
辋	whuiv
網	whusv
輞	whuiv
王	whiat
望	whiww
忘	whixw
妄	whiwn
旺	whiow
弯	wjawg
湾	wjadg
蜿	wjaiv
剜	wjadb
豌	wjadv
塆	wjatg
壪	wjatg
婠	wjank
彎	wjasg
灣	wjadg
完	wjebe
玩	wjewe
园	wjeke
顽	wjeea
丸	wjegd
纨	wjesd
烷	wjehe
芄	wjecd
汍	wjedd
紈	wjesd
頑	wjeea
晚	wjuov
婉	wjunv
宛	wjubv
碗	wjuuv
挽	wjufv
惋	wjuxv
莞	wjuce
琬	wjuwv
绾	wjusk
皖	wjube
娩	wjunv
菀	wjucv
畹	wjutv
箢	wjuvv
晩	wjuov
椀	wjumv
綰	wjusk
輓	wjuiv
万	wjiap
腕	wjiov
卍	wjixx
卐	wjixx
妧	wjine
萬	wjicd
窝	woabd
涡	woadr
倭	woarn
蜗	woaid
挝	woafz
莴	woacd
渦	woadk
窩	woabk
萵	woack
蝸	woaik
踒	woazn
我	woupd
握	woift
卧	woikd
沃	woidd
渥	woidt
龌	woiit
斡	woiuu
幄	woijt
嗌	woikm
硪	woiud
肟	woiog
偓	woirt
噁	woikx
臥	woikd
齷	woiit
喔	wovkt
屋	wuaut
乌	wuapa
巫	wuagr
污	wuadg
呜	wuaka
於	wuafd
诬	wuayr
邬	wuaep
钨	wuaja
圬	wuatg
嗚	wuakh
惡	wuaxa
汙	wuadu
汚	wuadg
烏	wuaph
誣	wuayr
鄔	wuaep
鎢	wuajh
无	wueav
吴	wuekd
吾	wuewk
唔	wuekk
梧	wuemk
毋	wuevp
芜	wuecv
蜈	wueid
浯	wuedk
鼯	wueuk
吳	wuekd
呉	wuekb
峿	wueek
廡	wuegh
無	wuerh
蕪	wuech
鵐	wuenr
五	wuuaa
武	wuuvd
舞	wuura
午	wuuru
伍	wuurw
捂	wuufk
侮	wuurd
妩	wuunv
鹉	wuuna
忤	wuuxu
仵	wuuru
庑	wuugv
怃	wuuxv
迕	wuuzr
牾	wuunk
嫵	wuunh
廡	wuugh
憮	wuuxh
旿	wuuou
碔	wuuud
鵡	wuunq
物	wuinp
务	wuiwl
误	wuiyd
雾	wuiyl
悟	wuixk
兀	wuiae
勿	wuigp
晤	wuiok
坞	wuita
骛	wuims
戊	wuigp
鹜	wuins
杌	wuime
鋈	wuijd
寤	wuibk
焐	wuihk
芴	wuicp
婺	wuins
痦	wuibk
阢	wuiee
務	wuisl
噁	wuikx
塢	wuith
屼	wuiee
惡	wuixa
揾	wuifm
旿	wuiou
誤	wuiyd
霧	wuiyl
靰	wuige
騖	wuims
鶩	wuins
微	wwarw
威	wwagn
危	wwadv
委	wwahn
薇	wwacw
巍	wwaeg
偎	wwarn
萎	wwacn
葳	wwacn
崴	wwaen
煨	wwahn
逶	wwazh
隈	wwaen
縅	wwasn
微	wwerw
围	wweka
维	wwesf
唯	wwekf
违	wweza
韦	wweaa
惟	wwexf
帷	wwejf
桅	wwemv
囗	wweaa
闱	wwema
嵬	wweeg
潍	wwedf
帏	wweja
圩	wwetu
沩	wwedd
涠	wweda
阢	wweee
囲	wweka
圍	wweka
峗	wweev
幃	wweja
潙	wwedh
潿	wweda
濰	wwedf
為	wwedh
維	wwesf
違	wweza
闈	wwema
韋	wweaa
鮠	wweav
委	wwuhn
唯	wwukf
伟	wwura
尾	wwuum
伪	wwurd
玮	wwuwa
萎	wwucn
纬	wwusa
苇	wwuca
猥	wwuqn
炜	wwuha
娓	wwunm
隗	wwueg
痿	wwubn
韪	wwuoa
诿	wwuyn
艉	wwuvm
洧	wwudo
鲔	wwuao
亹	wwuwq
偉	wwura
偽	wwurh
峗	wwuev
梶	wwumm
煒	wwuha
瑋	wwuwa
緯	wwusa
葦	wwuca
薳	wwucz
諉	wwuyn
韙	wwuoa
鮪	wwuao
为	wwild
位	wwirl
机	wwimj
未	wwian
卫	wwiea
味	wwikn
谓	wwiyo
慰	wwixu
喂	wwikn
魏	wwihg
畏	wwitn
尉	wwiuc
胃	wwito
蔚	wwicc
渭	wwido
猬	wwiqo
軎	wwiak
為	wwidh
瞶	wwiob
磑	wwiud
蝟	wwiio
螱	wwiui
衛	wwird
衞	wwird
褽	wwiyu
謂	wwiyo
霨	wwiyc
餵	wwiun
心	xbadd
新	xbalj
亲	xbalm
欣	xbajq
辛	xbalu
馨	xbauo
歆	xbalq
薪	xbacj
芯	xbacx
昕	xbaoj
鑫	xbajj
忻	xbaxj
莘	xbacu
锌	xbaju
䜣	xbaij
噺	xbakj
訢	xbaij
鋅	xbaju
伈	xburx
信	xbirk
衅	xbixa
芯	xbicx
囟	xbipx
釁	xbipd
西	xiaaa
息	xiaxp
希	xiaxj
吸	xiakn
惜	xiaxo
悉	xiaxp
嘻	xiakk
析	xiamj
猎	xiaqo
夕	xiapd
稀	xiahj
膝	xiaod
晰	xiaoj
牺	xianx
昔	xiaco
溪	xiadd
兮	xiabg
茜	xiacx
熙	xiahk
锡	xiajp
犀	xiaun
熄	xiahx
腊	xiaoo
蜥	xiaij
嬉	xiank
曦	xiaog
皙	xiabm
奚	xiavd
蹊	xiazd
唏	xiakj
羲	xiayg
卤	xiaax
僖	xiark
汐	xiadd
熹	xiahu
淅	xiadj
咭	xiakk
烯	xiahj
蟋	xiaix
樨	xiamn
矽	xiaud
醯	xiaym
螅	xiaix
浠	xiadj
硒	xiaux
欷	xiaxq
舾	xiavx
穸	xiabd
裼	xiapp
粞	xiamx
菥	xiacj
鼷	xiaud
㴔	xiadx
俙	xiarj
傒	xiard
噏	xiaky
嶲	xiaeg
巇	xiaeg
恓	xiaxx
扱	xiafn
攜	xiafk
晞	xiaoj
暿	xiaok
煕	xiahk
熈	xiaha
犠	xiand
犧	xiand
窸	xiaxb
觿	xiaja
譆	xiayk
谿	xiapk
豨	xiaaj
錫	xiajp
鯑	xiaaj
鱚	xiayk
息	xiexp
习	xiega
惜	xiexo
席	xiegj
袭	xiely
夕	xiepd
媳	xienx
褶	xiepb
檄	xiemw
觋	xiepj
隰	xieeh
嶍	xieeb
習	xieyb
蓆	xiecj
襲	xiely
覡	xiegj
錫	xiejp
喜	xiuuk
洗	xiude
洒	xiudx
玺	xiudw
禧	xiupk
徙	xiurr
铣	xiuje
屣	xiuur
葸	xiucx
蓰	xiucr
喺	xiuox
囍	xiuuk
憙	xiuux
暿	xiuok
枲	xiusm
璽	xiuaw
銑	xiuje
鱚	xiuyk
系	xiips
细	xiist
戏	xiiyg
隙	xiiex
翕	xiiry
舄	xiiph
矽	xiiud
阋	xiime
郄	xiiex
饩	xiiuq
禊	xiipd
係	xiirx
係	xiips
卌	xiiaa
咥	xiikt
嚊	xiikc
屃	xiibu
戯	xiihg
戱	xiihg
戲	xiihg
潟	xiidh
細	xiist
繋	xiixi
繫	xiisa
肸	xiiou
餼	xiium
鬩	xiiae
星	xkaof
胜	xkaof
腥	xkaoa
猩	xkaqf
惺	xkaxa
興	xkapb
行	xkerd
形	xkeap
型	xketa
刑	xkeda
邢	xkeea
荥	xkecd
陉	xkeeg
硎	xkeud
哘	xkekd
滎	xkedh
陘	xkeeg
餳	xkeup
醒	xkuyf
省	xkuxo
擤	xkufa
㨘	xkufo
行	xkird
性	xkixf
兴	xkixb
幸	xkitu
姓	xkinf
杏	xkimk
悻	xkixu
荇	xkicd
倖	xkiru
婞	xkinu
興	xkipb
相	xlamo
香	xlaho
乡	xlavp
箱	xlavo
湘	xlado
厢	xlaio
襄	xlawy
镶	xlajy
骧	xlamy
缃	xlaso
葙	xlaco
芗	xlacp
儴	xlary
廂	xlago
緗	xlaso
薌	xlace
郷	xlaev
鄉	xlaev
鑲	xlajy
驤	xlamy
降	xleea
翔	xleyy
祥	xlepy
详	xleyy
庠	xlegy
詳	xleyy
想	xluxm
响	xlukk
享	xluwz
饷	xluuk
飨	xluvu
鲞	xluba
響	xluso
餉	xluuk
饗	xluuv
鯗	xluay
鱶	xluan
向	xlipk
相	xlimo
像	xlirn
象	xlidn
项	xliga
巷	xlicv
橡	xlimn
蟓	xliin
嚮	xlivk
曏	xlioe
様	xlimd
項	xliga
先	xmane
仙	xmare
鲜	xmaay
纤	xmasu
掀	xmafq
暹	xmazo
祆	xmapd
跹	xmazz
锨	xmajq
酰	xmaye
籼	xmame
氙	xmaqe
莶	xmaca
孅	xmaig
忺	xmaxq
杴	xmamq
秈	xmame
繊	xmasa
纖	xmasg
薟	xmacr
躚	xmazz
銛	xmajk
鍁	xmajq
铦	xmajk
鮮	xmaay
闲	xmemm
贤	xmeba
嫌	xmenn
弦	xmegs
衔	xmerd
咸	xmegk
娴	xmenm
涎	xmedv
舷	xmevs
碱	xmeuk
痫	xmebm
鹇	xmenm
伭	xmerd
啣	xmeke
嫺	xmeno
嫻	xmenm
挦	xmefc
撏	xmefc
癇	xmebo
絃	xmess
賢	xmebk
銜	xmerd
閑	xmemm
閒	xmemo
鷳	xmenm
鷴	xmenm
鹹	xmeak
显	xmuoa
险	xmuea
洒	xmudx
藓	xmucy
筅	xmuve
冼	xmude
燹	xmuha
蚬	xmuij
跣	xmuzp
㬎	xmuho
尠	xmuqp
崄	xmuea
嶮	xmuer
狝	xmuqx
猃	xmuqa
獫	xmuqr
獮	xmuqx
蘚	xmucy
蜆	xmuij
銑	xmuje
険	xmuen
險	xmuer
顕	xmuoa
顯	xmuoa
鮮	xmuay
现	xmiwj
线	xmisg
限	xmien
陷	xmiea
县	xmiqs
献	xmiuq
羡	xmiyr
宪	xmibe
馅	xmiua
苋	xmicj
腺	xmiod
霰	xmiyw
岘	xmiej
伣	xmirj
俔	xmirj
僩	xmiro
峴	xmiej
憲	xmibx
獻	xmihq
現	xmiwj
県	xmiox
線	xmisd
縣	xmiqs
羨	xmiyr
莧	xmicj
見	xmioe
陥	xmieo
餡	xmiua
消	xnado
号	xnakg
萧	xnaca
销	xnajo
霄	xnayo
削	xnadx
逍	xnazx
潇	xnada
嚣	xnakk
哮	xnakz
宵	xnabo
箫	xnava
枭	xnanm
硝	xnauo
骁	xname
魈	xnago
绡	xnaso
哓	xnake
枵	xnamg
蛸	xnaio
啋	xnakm
嘐	xnakp
嘵	xnake
囂	xnakk
梟	xnanm
瀟	xnada
簫	xnava
綃	xnaso
蕭	xnaca
虓	xnajj
蟏	xnaia
蠨	xnaia
銷	xnajo
驍	xname
鴞	xnank
鸮	xnank
胶	xneof
淆	xnedo
小	xnuad
晓	xnuoe
筱	xnuvw
暁	xnuoe
曉	xnuoe
篠	xnuvm
笑	xnivd
关	xniqd
效	xniww
校	xnimf
啸	xnika
肖	xnixo
孝	xnitz
酵	xniyz
傚	xnirw
効	xniwl
咲	xnikd
嘯	xnika
恔	xnixf
敩	xnixw
斆	xniwp
澩	xnidp
薢	xnicn
詨	xniyf
些	xpaev
歇	xpaoq
蝎	xpaiv
楔	xpamd
揳	xpafd
蠍	xpaiq
叶	xpeku
邪	xpeea
协	xpeud
斜	xperu
胁	xpeod
鞋	xpegt
携	xpefp
挟	xpefn
谐	xpeyb
偕	xperb
撷	xpefa
勰	xpelx
缬	xpesa
㙦	xpetr
協	xpeul
挾	xpefn
揳	xpefd
擷	xpefa
攜	xpefk
纈	xpesa
脅	xpelo
脇	xpeol
諧	xpeyb
頡	xpeua
血	xpupm
写	xpuba
寫	xpubh
解	xpijn
谢	xpiyc
泄	xpidv
屑	xpiuo
械	xpimc
卸	xpier
懈	xpixn
泻	xpida
蟹	xpiij
亵	xpiwy
榭	xpimc
燮	xpiyh
邂	xpizj
獬	xpiqn
瀣	xpida
廨	xpign
绁	xpisv
骱	xpiga
躞	xpizy
渫	xpidm
榍	xpimo
薤	xpica
偰	xpird
塮	xpitc
屓	xpibu
揳	xpifd
檞	xpimn
洩	xpidp
瀉	xpidh
紲	xpisv
緤	xpism
褻	xpiwy
觟	xpijt
謝	xpiyc
修	xqarp
休	xqarm
羞	xqaya
咻	xqakm
貅	xqavm
馐	xqaua
庥	xqagm
髹	xqaam
鸺	xqarn
䗛	xqaij
脩	xqaro
脩	xqaro
饈	xqaua
鮴	xqaam
鵂	xqarn
宿	xqubb
朽	xqumg
秀	xqihp
袖	xqipa
宿	xqibb
臭	xqipq
绣	xqisp
嗅	xqikq
锈	xqijp
岫	xqiea
溴	xqidq
嚊	xqikc
琇	xqiwp
繍	xqisa
繡	xqisa
鏥	xqijb
鏽	xqija
宣	xraba
轩	xraiu
喧	xraka
萱	xraca
暄	xraoa
亘	xraaa
煊	xraha
揎	xrafa
谖	xrayy
儇	xrary
吅	xrakk
嬛	xrany
愃	xraxa
晅	xraoa
瑄	xrawa
諼	xrayy
軒	xraiu
玄	xrews
旋	xrefr
悬	xrexq
璇	xrewr
漩	xredr
痃	xrebs
䴉	xrens
懸	xrexq
暶	xreor
璿	xrewo
选	xruzn
癣	xruby
咺	xruka
暅	xruoa
烜	xruha
癬	xruby
選	xruzb
旋	xrifr
眩	xrios
炫	xrihs
绚	xriso
渲	xrida
泫	xrids
铉	xrijd
镟	xrijr
碹	xriua
楦	xrima
夐	xridw
昡	xriod
絢	xriso
衒	xrird
鉉	xrijd
鏇	xrijr
兄	xsake
胸	xsaok
凶	xsakx
汹	xsadk
匈	xsagk
芎	xsacg
兇	xsaxe
匂	xsagv
洶	xsadk
讻	xsayk
雄	xseuf
熊	xsehs
宪	xsibe
夐	xsidw
诇	xsiyk
薛	xtacu
削	xtadx
靴	xtagv
㗾	xtakb
学	xtexz
穴	xtebb
泶	xtexd
踅	xtezf
學	xtezp
峃	xtexe
嶨	xteep
敩	xtexw
斆	xtewp
澩	xtedp
茓	xtecb
鷽	xtenp
血	xtupm
雪	xtuye
鳕	xtuae
鱈	xtuae
血	xtipm
穴	xtibb
谑	xtiya
嚯	xtikf
謔	xtiya
需	xuaya
须	xuapa
虚	xuaha
吁	xuaku
嘘	xuaka
墟	xuata
顼	xuawa
胥	xuavo
戌	xuaga
盱	xuaou
砉	xuafu
噓	xuaka
媭	xuanp
嬃	xuanp
嬬	xuana
旴	xuaoa
歔	xuahq
繻	xuasa
虛	xuaha
裇	xuapx
訏	xuaya
谞	xuayo
須	xuapa
鬚	xuaaa
徐	xuerh
圩	xuetu
许	xuuyu
栩	xuumy
诩	xuuyy
醑	xuuyo
冔	xuuoa
糈	xuumo
許	xuuyu
詡	xuuyy
諝	xuuyo
续	xuisd
序	xuiga
绪	xuiso
蓄	xuict
叙	xuiry
旭	xuijo
畜	xuiwt
絮	xuisn
婿	xuino
煦	xuiho
恤	xuixx
酗	xuiyx
勖	xuikl
肷	xuioq
溆	xuidy
洫	xuidx
㳚	xuidd
勗	xuiol
卹	xuixe
垿	xuita
壻	xuito
敍	xuiry
敘	xuiwr
昫	xuiok
漵	xuidw
続	xuise
緒	xuiso
續	xuisb
聟	xuieu
頊	xuiwa
魆	xuigg
蓿	xuvcb
瞎	xxaok
虾	xxaid
呷	xxaka
岈	xxaep
煆	xxahy
蝦	xxaiy
谺	xxaby
鰕	xxaay
侠	xxern
霞	xxeyy
峡	xxeen
暇	xxeoy
狭	xxeqn
辖	xxeik
匣	xxeka
瑕	xxewy
遐	xxezv
黠	xxehk
狎	xxeqa
柙	xxema
硖	xxeun
俠	xxern
峽	xxeen
烚	xxehk
狹	xxeqn
硤	xxeun
祫	xxepk
轄	xxeik
下	xxiad
吓	xxikd
夏	xxiaw
罅	xxifu
嚇	xxikv
嚇	xxikd
圷	xxitn
廈	xxigw
梺	xximd
勋	xyakl
熏	xyahp
薰	xyach
醺	xyayh
埙	xyatb
窨	xyabo
曛	xyaoh
獯	xyaqh
勛	xyakl
勲	xyahp
勳	xyapl
塤	xyatb
壎	xyath
燻	xyahh
燻	xyahh
葷	xyaci
薫	xyach
寻	xyeec
询	xyeyo
巡	xyezv
循	xyero
旬	xyego
驯	xyema
荀	xyeco
洵	xyedo
峋	xyeeo
鲟	xyeac
恂	xyexo
郇	xyeeg
浔	xyedc
荨	xyecc
尋	xyeec
栒	xyemo
潯	xyedc
珣	xyewo
蕁	xyecc
蟫	xyeiu
詢	xyeyo
鱘	xyeac
训	xyiya
迅	xyizv
讯	xyiyu
洒	xyidx
逊	xyizz
殉	xyido
汛	xyidu
巽	xyivb
徇	xyiro
蕈	xyicu
噀	xyikc
瞓	xyioa
訊	xyiyu
訓	xyiya
遜	xyizz
馴	xyima
压	yaaid
丫	yaaba
押	yaafa
鸦	yaana
鸭	yaana
桠	yaama
垭	yaata
啞	yaaka
圧	yaait
壓	yaait
曱	yaaka
椏	yaama
煆	yaahy
鴉	yaana
鴨	yaana
牙	yaeap
崖	yaeet
涯	yaedt
衙	yaerd
芽	yaecp
伢	yaerp
睚	yaeot
琊	yaewe
岈	yaeep
蚜	yaeip
堐	yaett
釾	yaejp
雅	yauaf
哑	yauka
痖	yauba
亞	yauaa
唖	yauka
啞	yauka
瘂	yauba
亚	yaiaa
讶	yaiyp
娅	yaina
轧	yaiiv
迓	yaiza
揠	yaifn
氩	yaiqa
砑	yaiup
亜	yaiaa
亞	yaiaa
埡	yaita
壓	yaiit
姶	yaink
婭	yaina
氬	yaiqa
訝	yaiyp
軋	yaiiv
錏	yaiya
呀	yavkp
因	ybakd
音	ybalo
阴	ybaeo
烟	ybahd
殷	ybapy
茵	ybacd
姻	yband
荫	ybaco
湮	ybadt
氤	ybaqd
喑	ybako
洇	ybadd
铟	ybajd
堙	ybatt
愔	ybaxo
慇	ybapx
歅	ybaxq
銦	ybajd
陰	ybaes
众	yberr
银	ybejn
吟	ybekv
淫	ybedu
寅	ybebb
垦	ybetv
垠	ybetn
夤	ybepb
狺	ybeqk
鄞	ybeec
霪	ybeyu
嚚	ybekk
婬	ybenu
崟	ybeej
珢	ybewy
蟫	ybeiu
訚	ybemk
銀	ybejn
齦	ybein
听	ybukj
引	ybuga
隐	ybuex
饮	ybuur
尹	ybuvp
殷	ybupy
瘾	ybubx
蚓	ybuia
廴	ybuvn
吲	ybuka
癮	ybubx
隠	ybuex
隱	ybuex
飲	ybuur
印	ybiep
币	ybipj
胤	ybipv
窨	ybibo
廴	ybivn
䲟	ybiae
廕	ybigs
慭	ybiax
憖	ybixa
茚	ybice
蔭	ybics
隱	ybiex
鮣	ybiae
要	ycaxn
么	ycaps
妖	ycand
腰	ycaon
邀	ycazb
夭	ycapd
吆	ycaks
幺	ycavs
㙘	ycatn
約	ycasd
摇	yceff
遥	ycezv
瑶	ycewf
尧	yceae
姚	ycend
谣	yceyf
肴	ycexo
窑	ycebf
淆	ycedo
繇	ycevs
爻	ycexx
徭	ycerf
鳐	yceaf
崤	yceeo
轺	yceik
珧	ycewd
垚	ycett
堯	yceae
媱	ycenf
尭	yceue
峣	yceee
嶢	yceee
揺	yceff
搖	yceff
榣	ycemf
瑤	ycewf
窯	ycebh
謠	yceyf
謡	yceyf
軺	yceik
遙	ycezd
銚	ycejd
餚	yceuo
鰩	yceaf
咬	ycukf
窈	ycubl
杳	ycumo
舀	ycuva
崾	ycuen
要	ycixn
药	ycicd
耀	ycigf
钥	ycijo
曜	yciof
鹞	ycinv
燿	ycihf
瘧	yciba
葯	ycicd
薬	ycicm
藥	ycicm
鑰	ycijc
靿	ycigl
鷂	ycinv
崖	ydeet
睚	ydeot
耶	yeaee
噎	yeakd
椰	yeame
掖	yeafn
倻	yeare
吔	yeakx
爷	yeefe
耶	yeeee
椰	yeeme
揶	yeefe
铘	yeeje
䥺	yeejp
爺	yeefe
釾	yeejp
鋣	yeeje
也	yeuvv
野	yeuaa
冶	yeudk
吔	yeukx
嘢	yeuka
业	yeiaa
夜	yeiwd
射	yeiuc
液	yeidn
咽	yeikd
页	yeiba
拽	yeifp
曳	yeiap
烨	yeihu
靥	yeiia
邺	yeiea
腋	yeiod
谒	yeiyv
晔	yeiou
掖	yeifn
㐖	yeigv
曄	yeioa
業	yeian
燁	yeiha
葉	yeicm
謁	yeiyv
鄴	yeiea
靨	yeiia
頁	yeiba
鵺	yeiwn
央	yhaan
殃	yhadn
鸯	yhaan
泱	yhadn
秧	yhahn
鞅	yhagn
咉	yhakn
鴦	yhana
样	yhemy
阳	yheeo
杨	yhemp
扬	yhefp
洋	yhedy
羊	yheba
炀	yhehp
佯	yhery
徉	yhery
烊	yhehy
疡	yhebp
蛘	yheiy
垟	yhety
揚	yhefp
旸	yheop
暘	yheop
楊	yhemp
煬	yhehp
瘍	yhebp
鍚	yhejp
钖	yhejp
陽	yheep
颺	yhefp
飏	yhefp
养	yhuya
仰	yhure
痒	yhuby
氧	yhuqy
咉	yhukn
癢	yhubu
養	yhuyn
样	yhimy
漾	yhidn
恙	yhixy
怏	yhixn
様	yhimd
樣	yhimn
一	yiaaa
衣	yiawy
依	yiary
医	yiaku
伊	yiarp
揖	yiafe
漪	yiadk
壹	yiaud
噫	yiakx
咿	yiakp
欹	yiadq
黟	yiahd
猗	yiaqk
铱	yiajy
壱	yiauv
祎	yiapa
禕	yiapa
辷	yiaza
醫	yiayk
銥	yiajy
一	yieaa
听	yiekj
异	yievc
台	yiesk
疑	yiepr
移	yiehd
遗	yieza
宜	yiebq
仪	yierd
姨	yienn
夷	yiean
咦	yiekn
怡	yiexk
羡	yieyr
颐	yieka
沂	yiedj
贻	yiebk
彝	yievc
荑	yiecn
迤	yiezr
痍	yiebn
嶷	yieer
饴	yieuk
胰	yieon
眙	yieok
圯	yietv
诒	yieyk
儀	yierd
匜	yieky
宧	yieba
扅	yiehd
栘	yiemd
椸	yiemv
洟	yiedn
詒	yieyk
貽	yiebk
迆	yiezx
遺	yieza
酏	yieyv
頤	yieka
飴	yieuk
以	yiuvr
已	yiuvv
叹	yiuky
尾	yiuum
椅	yiumk
矣	yiusu
倚	yiurk
乙	yiugg
蚁	yiuid
旖	yiufk
迤	yiuzr
苡	yiucr
硪	yiuud
舣	yiuvd
钇	yiujg
佁	yiurk
偯	yiury
叕	yiuyy
扆	yiuhy
礒	yiuud
艤	yiuvd
蟻	yiuid
迆	yiuzx
釔	yiujg
一	yiiaa
意	yiixl
衣	yiiwy
易	yiiop
异	yiivc
义	yiixd
议	yiiyd
射	yiiuc
医	yiiku
亦	yiiwd
益	yiimq
翼	yiiyb
艺	yiicg
逸	yiizd
亿	yiirg
忆	yiixg
液	yiidn
毅	yiily
役	yiiry
抑	yiife
芸	yiics
芸	yiicg
溢	yiidm
译	yiiya
隶	yiivn
谊	yiiyq
奕	yiiwd
疫	yiiby
熠	yiihb
驿	yiima
诣	yiiyo
蜴	yiiip
裔	yiiyk
懿	yiiux
邑	yiikv
羿	yiiyc
屹	yiieg
绎	yiisa
翊	yiily
翌	yiiyl
弋	yiiqd
弈	yiiwc
呓	yiikg
臆	yiiox
轶	yiiin
翳	yiiky
挹	yiifv
悒	yiixv
缢	yiism
峄	yiiea
佚	yiirn
肄	yiipa
镒	yiijm
癔	yiibx
刈	yiidx
嗌	yiikm
薏	yiicx
埸	yiitp
佾	yiiro
劓	yiidp
怿	yiixa
仡	yiirg
瘗	yiibt
镱	yiijx
殪	yiidd
㑊	yiird
㴔	yiidx
乂	yiipn
億	yiirx
勚	yiicl
勩	yiicl
囈	yiiks
嫕	yiinx
嶧	yiieu
帟	yiiwj
廙	yiigc
憶	yiixx
懌	yiixu
杙	yiimd
枍	yiimv
浥	yiidv
異	yiitb
瘞	yiibt
睪	yiisu
縊	yiism
繹	yiisu
義	yiiyd
苅	yiicd
藝	yiics
螠	yiiim
裛	yiiwy
訳	yiiyn
詣	yiiyo
誼	yiiyq
譯	yiiyu
議	yiiyd
軼	yiiin
鎰	yiijm
鐿	yiijx
駅	yiimn
驛	yiimu
鯣	yiiap
鷁	yiinq
烟	yjahd
燕	yjahc
咽	yjakd
嫣	yjanh
殷	yjapy
焉	yjaah
淹	yjadv
奄	yjadv
湮	yjadt
胭	yjaod
阉	yjamv
鄢	yjaea
腌	yjaov
恹	yjaxq
洇	yjadd
菸	yjacd
菸	yjahd
崦	yjaev
剦	yjadd
啱	yjaou
懨	yjaxq
煙	yjaht
醃	yjayv
閹	yjamv
言	yjewk
严	yjeai
研	yjeuc
颜	yjela
延	yjezp
沿	yjedk
炎	yjehh
岩	yjeeu
阎	yjema
妍	yjenc
盐	yjemt
檐	yjemy
蜒	yjeiv
癌	yjebe
筵	yjevv
埏	yjetv
阽	yjeek
厳	yjexw
嚴	yjekw
塩	yjetm
巌	yjeew
巖	yjeew
羨	yjeyr
薟	yjecr
虤	yjehj
閆	yjems
閻	yjema
顏	yjewa
顔	yjela
鹽	yjemk
眼	yjuon
广	yjudi
演	yjudb
掩	yjufv
衍	yjurd
奄	yjudv
俨	yjuri
兖	yjuwe
魇	yjuig
偃	yjurn
琰	yjuwh
覃	yjuxu
鼹	yjuun
剡	yjudh
厣	yjuia
罨	yjusv
郾	yjuek
埯	yjutv
䶮	yjuld
儼	yjurw
兗	yjuwe
匽	yjukn
厴	yjuia
弇	yjurc
惔	yjuxh
戭	yjubg
扊	yjuhh
棪	yjumh
沇	yjude
蝘	yjuik
魘	yjuig
黡	yjuvi
黶	yjuih
鼴	yjuun
龑	yjuld
验	yjima
燕	yjihc
焰	yjiha
艳	yjifv
沿	yjidk
厌	yjiiq
咽	yjikd
宴	yjibn
雁	yjiif
彦	yjilp
砚	yjiuj
晏	yjion
焱	yjihh
堰	yjitn
滟	yjidv
谚	yjiyp
唁	yjikk
赝	yjiib
闫	yjims
酽	yjiyi
餍	yjiiu
谳	yjiyq
厭	yjiiq
嚥	yjikh
墕	yjith
嬿	yjinh
彥	yjiwp
灧	yjidv
灩	yjidm
焔	yjiho
硯	yjiuj
艶	yjiav
艷	yjifv
觃	yjijz
諺	yjiyp
讌	yjiyh
讞	yjiyq
豔	yjifm
贋	yjiib
贗	yjiib
釅	yjiyw
饜	yjiiu
験	yjimn
驗	yjimr
鴈	yjiin
应	ykaga
英	ykacn
鹰	ykagn
婴	ykanb
樱	ykamn
莺	ykacn
瑛	ykawn
缨	ykasn
膺	ykago
鹦	ykanb
嘤	ykakn
罂	ykafb
璎	ykawn
撄	ykafn
䓨	ykacf
嚶	ykakn
媖	ykann
嬰	ykanb
應	ykagx
攖	ykafn
桜	ykamn
櫻	ykamn
瓔	ykawn
纓	ykasn
罃	ykafh
罌	ykafb
霙	ykayb
鴬	ykanx
鶯	ykahn
鷹	ykagn
鸚	ykanb
营	ykeck
迎	ykezp
盈	ykemg
赢	ykewd
莹	ykecw
蝇	ykeiv
萤	ykeci
滢	ykedw
荧	ykech
萦	ykecs
嬴	ykewd
瀛	ykedd
楹	ykemm
茔	ykect
潆	ykeds
蓥	ykecj
営	ykexk
塋	ykeht
瀅	ykedw
瀠	ykeds
熒	ykehh
營	ykehk
瑩	ykehw
縈	ykehs
蛍	ykexi
蝿	ykeiv
螢	ykehi
蠅	ykeiv
贏	ykewb
鎣	ykejh
影	ykuop
颖	ykupa
颍	ykupa
郢	ykuek
瘿	ykubn
潁	ykupa
癭	ykubn
穎	ykupa
頴	ykupa
硬	ykiun
映	ykion
媵	ykion
応	ykigx
應	ykigx
哟	yoakd
唷	yoako
喲	yovkd
渊	yrada
冤	yrabd
鸳	yranp
鸢	yranq
眢	yraop
箢	yravv
淵	yrada
渕	yradd
蜎	yraio
鳶	yranq
鴛	yrand
原	yreix
元	yreee
员	yrebk
备	yrewt
源	yredx
圆	yrekb
园	yreke
缘	yresn
援	yrefy
袁	yrety
辕	yreiy
猿	yreqy
媛	yreny
垣	yreta
沅	yrede
圜	yreky
螈	yreix
鼋	yreev
芫	yrece
爰	yrevy
橼	yremn
塬	yretx
円	yreaa
員	yrebk
園	yreky
圓	yrekb
妧	yrene
嫄	yrenx
櫞	yremn
緣	yresn
縁	yresn
薗	yrecy
轅	yreiy
黿	yreev
远	yruze
遠	yruzt
院	yriee
愿	yriix
乡	yrivp
怨	yrixp
媛	yriny
苑	yricv
瑗	yriwy
掾	yrifn
垸	yrite
遠	yrizt
願	yriia
拥	ysafa
庸	ysaga
雍	ysawf
慵	ysaxa
邕	ysavv
臃	ysaof
镛	ysaja
墉	ysata
痈	ysaba
壅	ysatw
饔	ysawu
鳙	ysaaa
傭	ysara
擁	ysaff
癰	ysabf
鏞	ysaja
鱅	ysaaa
喁	ysekd
鱅	yseaa
永	ysudn
勇	ysusl
涌	ysuda
泳	ysudn
咏	ysukn
甬	ysusa
蛹	ysuia
俑	ysura
恿	ysuxs
踊	ysuza
㛚	ysuna
埇	ysuta
栐	ysumn
湧	ysudl
詠	ysukn
踴	ysuzl
鯒	ysuaa
用	ysipa
佣	ysira
㶲	ysiha
约	ytasd
曰	ytaka
曱	ytaka
約	ytasd
块	ytetn
噦	ytekp
月	ytipe
越	ytizv
跃	ytizd
岳	ytipe
悦	ytixe
阅	ytime
蜕	ytiie
粤	ytipg
钺	ytijd
樾	ytimv
刖	ytido
龠	ytirc
瀹	ytidc
嶽	ytieq
悅	ytixe
楽	ytimd
樂	ytimv
玥	ytiwo
籥	ytiva
粵	ytipg
趯	ytizf
躍	ytizf
鈅	ytijo
鉞	ytijd
鑰	ytijc
閱	ytime
迂	yuaza
淤	yuadd
瘀	yuabd
纡	yuasu
菸	yuacd
菸	yuahd
紆	yuasu
込	yuazr
于	yueau
余	yuerh
鱼	yueda
亏	yueeg
予	yuesa
予	yuesn
愚	yuexa
俞	yuerd
愉	yuexd
吁	yueku
於	yuefd
渔	yueda
瑜	yuewd
虞	yuehd
娱	yuend
逾	yuezr
舆	yuepb
渝	yuedd
馀	yueuh
臾	yuepn
隅	yueed
榆	yuemd
盂	yuema
妤	yuena
揄	yuefd
觎	yuerj
禺	yuead
腴	yueon
谀	yueyn
雩	yueyg
竽	yuevu
圩	yuetu
蝓	yueid
狳	yueqh
欤	yueaq
嵛	yueed
萸	yuecn
舁	yuepc
窬	yuebd
㺄	yueqd
娛	yuend
嵎	yueed
楡	yuemv
歟	yuepq
漁	yueda
玙	yuewa
璵	yuewb
畬	yuert
畭	yueth
與	yuepb
艅	yuevh
褕	yuepd
覦	yuerj
諛	yueyn
輿	yuepb
餘	yueuh
魚	yuedh
鯲	yuead
与	yuuaa
语	yuuyk
雨	yuuad
宇	yuubu
羽	yuuga
予	yuusa
予	yuusn
禹	yuupd
屿	yuuea
圉	yuuku
窳	yuubg
圄	yuukk
瘐	yuubn
庾	yuugn
龉	yuuik
俣	yuurd
伛	yuurx
㺄	yuuqd
俁	yuurd
傴	yuurk
嶼	yuuea
敔	yuuww
與	yuupb
語	yuuyk
齬	yuuik
玉	yuiwd
遇	yuiza
欲	yuibq
奥	yuipd
域	yuitk
谷	yuibk
预	yuisa
育	yuiwo
御	yuire
愈	yuixr
狱	yuiqq
郁	yuieu
豫	yuisn
誉	yuixy
尉	yuiuc
浴	yuidk
吁	yuiku
裕	yuipk
喻	yuikd
钰	yuijw
寓	yuibd
驭	yuimy
蔚	yuicc
粥	yuimg
谕	yuiyd
昱	yuiol
煜	yuihl
聿	yuiva
毓	yuirv
昙	yuios
妪	yuinx
芋	yuicu
禺	yuiad
峪	yuiek
熨	yuihu
蜮	yuiik
阈	yuima
鹬	yuins
鬻	yuiga
蓣	yuica
饫	yuiud
燠	yuihn
鹆	yuinb
肀	yuiva
喐	yuiek
喩	yuikv
圫	yuitq
堉	yuito
嫗	yuink
彧	yuikd
悆	yuirx
慾	yuixb
棫	yuimg
欝	yuimc
滪	yuidb
澦	yuida
獄	yuiqq
癒	yuibx
硲	yuiuk
禦	yuixr
籲	yuiva
與	yuipb
蕷	yuica
薁	yuicd
語	yuiyk
諭	yuiyd
譽	yuipy
鈺	yuijw
閾	yuima
隩	yuied
預	yuisa
飫	yuiud
馭	yuimy
鬱	yuimp
鵒	yuinb
鷸	yuins
晕	yyaoi
氲	yyaqm
暈	yyaoi
氳	yyaqm
縕	yyasm
缊	yyasm
贇	yyabw
赟	yyabw
云	yyees
芸	yyecs
芸	yyecg
匀	yyega
筠	yyeva
昀	yyeod
氲	yyeqm
耘	yyels
纭	yyess
郧	yyeek
伝	yyers
伝	yyers
勻	yyega
妘	yyens
榲	yyemm
沄	yyeds
涢	yyedb
溳	yyedb
筼	yyevb
紜	yyess
蕓	yyecs
蕓	yyecs
鄖	yyeek
雲	yyeys
运	yyuze
允	yyuse
陨	yyueb
殒	yyudb
愠	yyuxm
狁	yyuqe
殞	yyudb
隕	yyueb
运	yyize
温	yyidm
韵	yyila
蕴	yyicm
孕	yyigz
匀	yyiga
酝	yyiys
愠	yyixm
熨	yyihu
恽	yyixi
韫	yyiam
郓	yyieb
惲	yyixi
慍	yyixm
暈	yyioi
榅	yyimm
縕	yyism
蕰	yyicm
薀	yyicm
蘊	yyicm
運	yyizb
鄆	yyieb
醞	yyiym
韞	yyiam
韻	yyilb
优	yzard
奥	yzapd
幽	yzaev
忧	yzaxd
悠	yzaxr
攸	yzarw
呦	yzakl
優	yzarw
憂	yzawa
耰	yzamy
由	yzeaa
游	yzedz
优	yzerd
尤	yzeud
犹	yzeqd
油	yzeda
邮	yzeea
猷	yzeqq
繇	yzevs
莜	yzecw
铀	yzeja
鱿	yzead
蝣	yzeiz
蚰	yzeia
疣	yzebd
莸	yzecd
楢	yzemy
猶	yzeqy
甴	yzeka
蕕	yzecq
遊	yzezf
郵	yzeep
鈾	yzeja
魷	yzead
有	yzuuo
友	yzuuy
黝	yzuhl
酉	yzuxa
莠	yzucp
牖	yzupd
卣	yzuaa
铕	yzujo
槱	yzumh
銪	yzujo
又	yzivn
右	yziuk
叹	yziky
犹	yziqd
忧	yzixd
扰	yzifd
诱	yziyp
幼	yzivl
佑	yzirk
釉	yzipa
鼬	yziua
囿	yziko
柚	yzima
宥	yzibo
侑	yziro
蚴	yziil
祐	yzipk
誘	yziyp
查	zaama
扎	zaafv
渣	zaada
吒	zaakq
咂	zaakj
匝	zaakj
楂	zaama
揸	zaafa
哳	zaakj
囃	zaakf
挓	zaafq
柤	zaamq
紮	zaasm
臜	zaaob
臢	zaaob
齄	zaaph
齇	zaapq
咱	zaeko
杂	zaejm
扎	zaefv
炸	zaeha
砸	zaeuj
札	zaemv
闸	zaema
铡	zaejd
籴	zaerm
劄	zaedv
拃	zaefa
甴	zaeka
軋	zaeiv
鍘	zaejd
閘	zaema
雑	zaejf
雜	zaewf
霅	zaeyy
眨	zauon
咋	zauka
砟	zauua
䃎	zauud
囃	zaukf
拃	zaufa
鮓	zauaa
炸	zaiha
册	zaipa
诈	zaiya
乍	zaira
蜡	zaiio
咋	zaika
栅	zaima
吒	zaikq
榨	zaima
咤	zaikq
蚱	zaiia
痄	zaiba
膪	zaiol
䃎	zaiud
奓	zaidd
拃	zaifa
搾	zaifa
柵	zaima
詐	zaiya
着	zcayo
朝	zcauo
招	zcafk
遭	zcazc
糟	zcamo
嘲	zcako
昭	zcaok
钊	zcadj
蹧	zcazo
釗	zcadj
着	zceyo
著	zceco
著	zceyo
凿	zceau
鑿	zceaj
找	zcufg
早	zcuou
爪	zcupn
澡	zcudm
沼	zcudk
枣	zcuad
藻	zcucm
蚤	zcuyi
棗	zcuan
照	zciho
造	zcizn
赵	zcizx
召	zcidk
罩	zcisu
兆	zcipd
躁	zcizm
燥	zcihm
噪	zcikm
诏	zciyk
皂	zcibq
灶	zciht
肇	zciha
濯	zcidf
笊	zcivv
唣	zcikq
慥	zcixz
旐	zcifd
曌	zciog
櫂	zcimf
皁	zcibu
竃	zcibp
竈	zcibe
詔	zciyk
譟	zciym
趙	zcizo
灾	zdabh
摘	zdafk
栽	zdamg
斋	zdawa
哉	zdakg
甾	zdavt
側	zdard
斎	zdawa
災	zdavh
粂	zdadm
齋	zdawa
宅	zdebq
翟	zdeyf
擇	zdefu
仔	zdurz
宰	zdubu
窄	zduba
崽	zduxe
載	zduig
在	zdiut
再	zdiaa
载	zdiig
祭	zdipx
寨	zdibm
债	zdirb
砦	zdivu
瘵	zdibx
膪	zdiol
債	zdirb
載	zdiig
折	zeafj
遮	zeazg
蜇	zeaif
螫	zeait
嗻	zeakh
则	zeedb
责	zeebf
折	zeefj
择	zeefa
泽	zeeda
哲	zeekf
乙	zeegg
啧	zeekb
咋	zeeka
辙	zeeiw
辄	zeeiv
蛰	zeeif
谪	zeeyk
摺	zeefb
摺	zeefj
蜇	zeeif
磔	zeeum
笮	zeeva
赜	zeekb
乇	zeepv
帻	zeejb
箦	zeevb
舴	zeeva
迮	zeezr
則	zeedb
喆	zeeuk
嘖	zeekb
幘	zeejb
択	zeefn
擇	zeefu
晢	zeeof
沢	zeedn
澤	zeedu
簀	zeevb
粍	zeemm
蟄	zeeit
詟	zeely
謫	zeeyk
責	zeebf
賾	zeekb
輒	zeeiv
轍	zeeiw
怎	zeuxr
者	zeuto
褶	zeupb
赭	zeuto
锗	zeujo
啫	zeuko
鍺	zeujo
这	zeizw
浙	zeidj
鹧	zeing
蔗	zeich
仄	zeiir
昃	zeior
柘	zeimu
䗪	zeigi
嗻	zeikh
這	zeizy
鷓	zeing
着	zevyo
著	zevco
著	zevyo
嗻	zevkh
真	zfaub
亲	zfalm
唇	zfaik
针	zfaju
珍	zfawp
贞	zfaba
侦	zfarb
甄	zfaxw
斟	zfaqu
臻	zfaah
祯	zfapb
桢	zfamb
蓁	zfach
砧	zfauk
箴	zfavk
榛	zfamh
溱	zfadh
胗	zfaop
浈	zfadb
偵	zfarb
幀	zfajb
楨	zfamb
槇	zfamb
湞	zfadb
眞	zfapb
禎	zfapb
葴	zfacg
貞	zfaba
針	zfaju
鉆	zfajk
鍼	zfajk
怎	zfuxr
枕	zfumv
诊	zfuyp
缜	zfusb
稹	zfuhb
轸	zfuip
疹	zfubp
畛	zfutp
姫	zfuna
抌	zfufe
昣	zfuop
槇	zfumb
縝	zfusb
袗	zfupp
診	zfuyp
軫	zfuip
阵	zfiei
震	zfiyn
镇	zfijb
唇	zfiik
振	zfifn
朕	zfiod
圳	zfita
赈	zfibn
鸩	zfind
谮	zfiyo
䟴	zfizy
揕	zfifv
譖	zfiyo
賑	zfibn
鎮	zfijb
陣	zfiei
鴆	zfind
正	zgaav
曾	zgabo
争	zgada
增	zgato
征	zgarv
睁	zgaoa
怔	zgaxv
挣	zgafa
蒸	zgach
铮	zgaja
狰	zgaqa
憎	zgaxo
筝	zgava
峥	zgaea
徵	zgarw
诤	zgaya
钲	zgajv
缯	zgaso
罾	zgaso
䎖	zgaby
凧	zgajj
増	zgato
崢	zgaea
徴	zgarw
掙	zgafa
烝	zgahv
爭	zgava
猙	zgaqa
癥	zgabw
睜	zgaoa
箏	zgava
繒	zgaso
踭	zgaza
鉦	zgajv
錚	zgaja
整	zguav
拯	zgufa
掟	zgufr
正	zgiav
政	zgiwa
证	zgiyv
郑	zgieq
怔	zgixv
挣	zgifa
症	zgibv
赠	zgibo
帧	zgijb
锃	zgijw
甑	zgibw
幀	zgijb
憕	zgixa
掙	zgifa
癥	zgibw
綜	zgisx
繒	zgiso
証	zgiyv
諍	zgiya
證	zgiyd
贈	zgibo
鄭	zgieq
鋥	zgijw
张	zhagn
章	zhalu
彰	zhalp
璋	zhawu
赃	zhabt
臧	zhaga
漳	zhadu
蟑	zhaiu
樟	zhamu
獐	zhaqu
嫜	zhanu
鄣	zhael
張	zhagn
暲	zhaou
臢	zhaob
贓	zhabd
髒	zhagc
鱆	zhaau
长	zhupn
掌	zhuxu
涨	zhudn
仉	zhurj
驵	zhumq
漲	zhudn
長	zhuan
鞝	zhusk
駔	zhumq
藏	zhica
丈	zhian
帐	zhijn
仗	zhirn
障	zhieu
脏	zhiot
杖	zhimn
葬	zhicc
胀	zhion
账	zhibn
瘴	zhibu
奘	zhida
嶂	zhieu
幛	zhiju
帳	zhijn
漲	zhidn
脹	zhion
臓	zhioa
賬	zhibn
之	ziadn
只	ziakb
知	ziauk
支	ziauy
资	ziabd
织	ziasb
仔	ziarz
姿	ziand
枝	ziamy
滋	ziads
芝	ziacn
兹	ziaqs
肢	ziaoy
吱	ziaky
吱	ziaky
汁	ziadu
脂	ziaoo
蜘	ziaik
孜	ziawz
咨	ziakd
辎	ziait
呲	ziakv
龇	ziaiv
祗	ziapd
淄	ziadt
髭	ziaav
訾	ziayv
觜	ziajv
缁	ziast
孳	ziaqz
锱	ziajt
谘	ziayk
栀	ziamv
赀	ziabv
卮	ziapv
胝	ziaod
趑	ziazq
嵫	ziaes
粢	ziamd
鲻	ziaat
嗞	ziakd
孖	ziazz
梔	ziamv
榰	ziamo
緇	ziast
織	ziasg
茲	ziacs
諮	ziakd
諮	ziayk
貲	ziabv
資	ziabd
跂	ziazy
輜	ziait
錙	ziajt
隻	ziary
鯔	ziaat
鶿	zianq
齜	ziaiv
直	zieuq
值	zierq
职	zieeb
执	ziefd
植	ziemq
侄	ziert
殖	ziedq
跖	ziezk
絷	ziesf
踯	zieze
摭	ziefh
埴	zietq
値	zierv
執	zietd
姪	zient
擲	ziefe
縶	ziest
職	zieeg
質	ziebj
躑	zieze
子	ziuva
只	ziukb
指	ziufo
止	ziuaa
紫	ziusv
积	ziuhb
纸	ziusq
仔	ziurz
姊	ziunp
旨	ziupo
芷	ziucv
址	ziutv
趾	ziuzv
咫	ziuub
梓	ziumu
徵	ziurw
籽	ziumz
滓	ziudu
祉	ziupv
訾	ziuyv
笫	ziuvp
耔	ziulz
枳	ziumb
秭	ziuhp
茈	ziucv
酯	ziuyo
黹	ziuad
轵	ziuib
夂	ziupn
凪	ziujv
扺	ziufq
沚	ziudv
祇	ziupq
紙	ziusq
茝	ziuck
虸	ziuiz
衹	ziupq
軹	ziuib
自	ziipo
至	ziita
制	ziidp
字	ziibz
治	ziidk
置	ziisq
质	ziipb
志	ziixu
致	ziiwa
智	ziiou
滞	ziidj
掷	ziife
秩	ziihn
稚	ziihf
窒	ziibt
帜	ziijb
挚	ziiuf
峙	ziiec
炙	ziiph
渍	ziidb
眦	ziiov
贽	ziibf
恣	ziixd
痣	ziibx
雉	ziiuf
豸	ziivp
蛭	ziiit
栉	ziime
鸷	ziinf
轾	ziiit
桎	ziimt
痔	ziibc
骘	ziime
陟	ziiep
彘	ziivv
膣	ziiot
觯	ziija
郅	ziiea
踬	ziizb
帙	ziijn
忮	ziixy
嚔	ziikr
幟	ziijg
庤	ziigc
摯	ziiut
擲	ziife
擿	ziifz
晊	ziiot
梽	ziimx
櫛	ziime
滯	ziidj
漬	ziidb
畤	ziitc
眥	ziiov
緻	ziisw
製	ziiyp
觶	ziija
誌	ziiyx
識	ziiyg
質	ziibj
贄	ziibt
跱	ziizc
躓	ziizb
輊	ziiit
騭	ziime
鷙	ziint
子	zivva
占	zjaak
沾	zjadk
粘	zjamk
詹	zjady
瞻	zjaoy
毡	zjamk
簪	zjavo
旃	zjafw
谵	zjayy
糌	zjamo
嶦	zjaek
栴	zjamd
氈	zjawm
覘	zjaaj
譫	zjayy
邅	zjaza
鉆	zjajk
霑	zjayk
鵤	zjajn
咱	zjeko
偺	zjero
展	zjuun
斩	zjuij
盏	zjumg
攒	zjufb
崭	zjuej
昝	zjuwo
拶	zjufd
趱	zjuzb
搌	zjufn
䁪	zjuoj
寁	zjubr
嶄	zjuej
拃	zjufa
攢	zjufb
斬	zjuij
盞	zjugm
趲	zjuzb
輾	zjuin
战	zjiag
站	zjilk
占	zjiak
赞	zjibn
暂	zjioi
绽	zjisr
栈	zjimg
湛	zjidv
瓒	zjiwb
蘸	zjich
錾	zjiji
㜺	zjinb
佔	zjirk
偡	zjirv
嵁	zjiev
戦	zjidg
戰	zjikg
暫	zjioi
暫	zjioi
桟	zjimd
棧	zjimg
瓚	zjiwb
綻	zjisr
讃	zjiyb
讚	zjiyb
賛	zjiba
贊	zjibn
鏨	zjiji
拽	zkafp
拽	zkifp
装	zlayd
庄	zlagt
妆	zladn
桩	zlamt
妝	zladn
樁	zlama
荘	zlacu
莊	zlacu
裝	zlayd
奘	zluda
状	zlidq
撞	zlifa
壮	zlidu
幢	zlija
僮	zlira
壯	zlidu
戇	zlixl
狀	zlidq
桌	zoaam
捉	zoafz
拙	zoafk
涿	zoadn
嘬	zoaky
焯	zoahu
倬	zoaru
棹	zoamu
䦃	zoajo
着	zoeyo
著	zoeco
著	zoeyo
昨	zoeoa
卓	zoeau
灼	zoehd
琢	zoewn
浊	zoedi
镯	zoeji
酌	zoeyd
啄	zoekn
斫	zoeuj
茁	zoeck
濯	zoedf
擢	zoeff
焯	zoehu
诼	zoeyn
浞	zoedz
䓬	zoecu
叕	zoeyy
捽	zoefu
晫	zoeou
梲	zoeme
椓	zoemn
汋	zoedd
濁	zoedi
禚	zoeph
諑	zoeyn
鐯	zoejo
鐲	zoeji
左	zouug
佐	zourg
作	zoira
做	zoirw
坐	zoitr
座	zoigt
座	zoitr
祚	zoipa
柞	zoima
酢	zoiya
胙	zoioa
唑	zoikt
怍	zoixa
阼	zoiea
岞	zoiea
蓙	zoict
鑿	zoiaj
咗	zovkg
专	zraad
钻	zrajk
砖	zraud
颛	zraea
躜	zrazb
䏝	zraod
専	zraac
專	zraac
磚	zrauc
耑	zraea
膞	zraoc
躦	zrazb
鑽	zrajb
顓	zraea
转	zruid
纂	zruvs
缵	zrusb
纘	zrusb
膞	zruoc
転	zruis
轉	zruic
赚	zribn
沌	zridv
撰	zrifb
篆	zrivn
攥	zrifs
馔	zriub
啭	zrikd
傳	zrirc
僎	zrirc
囀	zrikc
賺	zribn
賺	zribn
轉	zriic
鑽	zrijb
饌	zriub
中	zsaaa
终	zsasd
钟	zsaja
宗	zsabx
踪	zsazx
忠	zsaxa
衷	zsawy
综	zsasx
棕	zsamx
锺	zsaja
盅	zsama
鬃	zsaax
忪	zsaxs
螽	zsawi
枞	zsamr
鸲	zsang
舯	zsava
腙	zsaox
倧	zsarx
柊	zsamd
橦	zsama
終	zsasd
綜	zsasx
蹤	zsazr
鈡	zsaja
鍾	zsaja
鐘	zsaja
种	zsuha
总	zsuxb
肿	zsuoa
冢	zsubn
踵	zsuza
偬	zsurx
傯	zsurx
塚	zsutn
惣	zsuxn
種	zsuha
総	zsuxx
總	zsusx
腫	zsuoa
中	zsiaa
种	zsiha
重	zsipa
众	zsirr
纵	zsisr
仲	zsira
粽	zsimx
從	zsirr
狆	zsiqa
眾	zsisr
種	zsiha
糉	zsimw
縦	zsisr
縱	zsisr
茽	zsica
衆	zsixn
朱	zuapn
珠	zuawn
诸	zuayo
猪	zuaqo
租	zuahq
蛛	zuain
株	zuamn
诛	zuayn
茱	zuacn
侏	zuarn
铢	zuajm
洙	zuadn
槠	zuamo
菹	zuacq
邾	zuaep
潴	zuado
橥	zuamq
櫧	zuamo
櫫	zuama
瀦	zuado
硃	zuaun
誅	zuayn
諸	zuayo
豬	zuaao
跦	zuazn
銖	zuajn
足	zuekr
术	zuemd
族	zuefu
逐	zueza
竹	zuepa
筑	zuevd
烛	zuehi
卒	zuewu
竺	zueve
镞	zueju
躅	zuezi
舳	zueva
瘃	zuebn
卆	zueuj
崒	zueei
捽	zuefu
朮	zuemd
燭	zuehi
蠋	zueii
鏃	zueju
主	zuudw
组	zuusq
祖	zuupq
阻	zuueq
嘱	zuukd
煮	zuuht
诅	zuuyq
褚	zuupo
瞩	zuuod
拄	zuufw
俎	zuurq
渚	zuudo
麈	zuulw
囑	zuuki
屬	zuuui
矚	zuuoi
組	zuusq
詛	zuuyq
貯	zuubd
住	zuirw
注	zuidw
助	zuiql
著	zuico
著	zuiyo
宁	zuibd
筑	zuivd
驻	zuimw
祝	zuipe
柱	zuimw
铸	zuijc
伫	zuira
贮	zuiba
泞	zuidd
炷	zuihw
柠	zuimd
蛀	zuiiw
箸	zuivo
杼	zuima
翥	zuity
苎	zuica
疰	zuibw
佇	zuird
嗻	zuikh
柷	zuime
竚	zuild
築	zuivm
簗	zuivm
紵	zuisa
纻	zuisa
苧	zuicd
苧	zuica
註	zuiyw
貯	zuibd
鋳	zuijc
鑄	zuijc
駐	zuimw
追	zvazp
锥	zvajf
椎	zvamf
骓	zvamf
萑	zvacf
隹	zvarf
錐	zvajf
騅	zvamf
嘴	zvukj
觜	zvujv
最	zvioy
罪	zviss
醉	zviyu
坠	zvite
缀	zvisy
赘	zvibf
惴	zvixa
缒	zvisz
蕞	zvicy
倕	zvira
墜	zvite
槜	zvimg
綴	zvisy
縋	zvisz
贅	zvibf
酔	zviyu
贼	zwebu
賊	zwebu
抓	zxafv
撾	zxafk
爪	zxupn
尊	zyaqc
遵	zyazq
屯	zyaav
谆	zyayz
樽	zyamc
鳟	zyaac
肫	zyaov
窀	zyabv
䐃	zyaok
圫	zyatq
嶟	zyaec
忳	zyaxv
衠	zyard
諄	zyayz
迍	zyazv
鱒	zyaac
准	zyudf
撙	zyufc
僔	zyurc
凖	zyuud
噂	zyukc
準	zyuuf
拵	zyifz
周	zzapk
州	zzada
洲	zzada
舟	zzapd
邹	zzaed
粥	zzamg
诌	zzaye
驺	zzame
鲰	zzaay
啁	zzakk
诹	zzayy
陬	zzaey
鄹	zzaee
婤	zzank
諏	zzayy
謅	zzaye
譸	zzayc
诪	zzayc
賙	zzabk
賙	zzabk
赒	zzabk
週	zzazk
鄒	zzagd
騶	zzame
鯫	zzaay
轴	zzeia
妯	zzena
軸	zzeia
走	zzutr
肘	zzuoc
帚	zzuej
箒	zzuvj
皱	zzidp
咒	zzijk
奏	zzifd
骤	zzimn
宙	zziba
揍	zzifd
昼	zziua
胄	zziao
纣	zzisc
绉	zzise
繇	zzivs
酎	zziyc
楱	zzimd
籀	zzivt
㑇	zzire
㑳	zzire
㤘	zzixe
㥮	zzixe
冑	zziyo
冑	zziao
呪	zzike
晝	zziva
棁	zzime
甃	zziwh
皺	zzigp
紂	zzisc
縐	zzise
荮	zzicc
葤	zzicc
驟	zzimn
驟	zzimn
