的	dbd
一	yaa
了	lva
是	uor
不	bad
我	wpd
人	rpn
在	zut
這	vzy
他	trv
有	yuo
来	lan
道	dzq
你	nrx
個	grk
大	dan
到	dda
上	uaa
說	uye
說	yye
們	mrm
着	vyo
出	iek
中	vaa
地	dtv
那	nev
就	jwd
也	yvv
下	xad
要	yxn
子	zva
時	uoc
為	wdh
然	rhp
可	kdk
她	tnv
過	gzk
之	vdn
以	yvr
看	kuo
会	hrs
会	krs
得	drc
天	tad
去	qts
自	zpo
好	hnz
心	xdd
和	hhk
没	mdy
能	nsv
対	ddc
還	hzy
裏	lwy
小	xad
手	upa
而	eaa
起	qzv
隻	vry
身	upp
想	xxm
都	det
頭	tdb
如	rnk
無	mrh
無	wrh
麺	mfa
多	dpd
已	yvv
発	fvv
事	uaa
生	upf
知	vuk
傢	jrn
前	qqd
声	uup
開	kmk
方	fwp
経	jst
現	xwj
笑	xvd
什	uru
力	lgp
点	dha
両	lak
法	fds
国	gkw
様	ymd
所	spj
成	igv
意	yxl
見	joe
但	dra
老	ltv
用	ypa
又	yvn
情	qxo
噹	dkt
動	dpl
己	jvv
些	xev
行	hrd
行	xrd
此	cvv
眼	yon
気	qqx
把	bfv
迴	hzk
話	hyk
将	jdc
真	vub
長	ian
長	van
三	sae
間	jmo
進	jzf
年	nra
神	upa
明	moo
十	uaa
辻	uzu
女	nva
嚮	xvk
定	dbr
正	vav
実	ubn
本	baa
很	hrn
衕	trd
従	crr
従	trr
高	gwk
問	wmk
纔	csd
全	qrw
被	bpp
被	ppp
主	vdw
再	zaa
走	ztr
卻	qek
児	eae
分	fbd
口	kaa
其	qqb
作	zra
種	iha
種	vha
幾	jsg
外	wpd
打	dfd
最	zoy
門	maa
与	yaa
給	gsk
給	jsk
光	gxe
白	bpo
等	dvc
聴	tex
因	ykd
重	ipa
重	vpa
少	uxp
風	fji
相	xmo
住	vrw
次	cdr
何	hrk
譲	ryy
色	sdv
色	udv
二	eaa
公	gbs
日	rka
怎	zxr
名	mpk
死	sdv
便	brn
便	prn
位	wrl
部	bel
果	gan
応	ygx
体	tra
感	gxg
太	tdd
內	nad
覚	jxj
水	uan
先	xne
難	ncf
王	wat
比	bav
別	bdk
入	rpn
辺	bzd
第	dvp
直	vuq
機	jmj
理	lwa
快	kxn
更	gan
做	zrw
処	iwj
者	vto
並	bqa
接	jfn
西	xaa
馬	mah
軽	qit
四	ske
関	gmd
山	uka
月	ype
放	fwf
連	lzi
加	jlk
目	mka
臉	lor
飛	fvd
使	urn
竜	llv
強	jgi
強	qgi
張	vgn
由	yaa
金	jrb
立	lla
叫	jka
安	abn
師	upj
吧	bkv
剣	jdd
信	xrk
学	xxz
軍	jbi
望	www
算	svc
原	yix
美	myd
像	xrn
平	pau
東	dan
場	itp
嗎	mkm
戦	vdg
特	tnc
万	wap
数	uwm
雲	yys
清	qdo
今	jrv
変	bww
任	rru
空	kbg
錶	bjy
完	wbe
閤	gmk
閤	hmk
帯	dfj
常	ixj
量	loa
海	hdd
受	uvy
解	jjn
解	xjn
文	wwx
命	mre
転	vis
斯	sqj
通	tzs
冷	lds
思	sxt
黒	hhh
世	ucv
該	gyr
双	uyy
利	ldh
至	vta
非	faa
林	lmm
呢	nkv
新	xlj
歩	bvp
候	hru
五	waa
李	lmz
度	dgy
雖	skf
路	lzk
驚	jcm
微	wrw
跟	gzn
似	urr
物	wnp
許	xyu
化	hrv
製	vyp
火	hdr
性	xxf
反	fpy
武	wvd
総	zxx
指	vfo
係	jps
係	jrx
係	xps
係	xrx
結	jsk
花	hcv
親	qlj
教	jwt
功	ggl
剛	gdk
提	dfr
提	tfr
殺	uxy
竟	jle
士	uua
遠	yzt
百	bab
紅	hsg
它	tbv
離	lwf
満	mdk
找	vfg
落	lck
容	rbk
必	bdp
深	udm
城	itv
拉	lfl
奇	jdk
奇	qdk
若	rck
各	gwk
失	upn
爾	eax
言	ywk
伝	irs
伝	vrs
且	qaa
形	xap
青	qfo
石	dak
石	uak
幹	guu
半	bba
近	jzj
認	ryx
怕	pxb
隊	den
電	dyv
伕	fan
伕	frd
往	wrw
突	tbq
吃	ikg
啊	akk
倒	drd
活	hdk
件	jrn
随	sez
絕	jsv
刻	kdw
息	xxp
即	jev
工	gaa
早	zou
極	jma
乎	hpu
界	jta
記	jyv
緊	jks
怪	gxt
流	ldv
報	bty
車	iaa
車	jaa
管	gvk
音	ylo
衣	ywy
保	brm
闇	amo
弟	dbp
及	jpn
交	jwf
影	yop
華	hca
愛	avw
精	jmo
傷	urp
勢	ult
民	mvq
令	lrs
計	jyu
決	jdn
玉	ywd
服	foy
条	twm
衆	vxn
領	lra
哥	gdk
南	nuu
般	bvy
元	yee
羅	lsf
収	uvy
未	wan
始	unk
辦	bll
題	toa
星	xof
剋	kdu
剋	kud
根	gmn
誰	uyf
陣	vei
則	zdb
象	xdn
男	ntl
達	dzy
告	gnk
展	vun
撃	jui
霊	lya
血	xpm
整	vav
員	ybk
兵	bpb
急	jxd
韆	qgz
切	qqd
越	yzv
喜	xuk
語	yyk
站	vlk
請	qyo
徳	drx
幫	btj
敢	gwv
消	xdo
業	yan
姐	jnq
週	vzk
視	upj
字	zbz
八	bpn
毎	mra
苦	kck
房	fhf
忙	mxv
雷	lyt
団	tkc
片	ppv
哪	nke
儘	jrm
書	uvo
備	bra
求	qad
司	sgk
北	bav
静	jfa
錯	cjo
断	dmj
準	vuf
江	jdg
刀	dgp
建	jzv
兄	xke
終	vsd
足	zkr
興	xpb
衝	ird
陽	yep
代	drd
或	hga
楚	imr
底	dgd
夜	ywd
術	urd
格	gmk
識	uyg
識	vyg
持	ifc
答	dvk
哈	hkk
留	ltp
確	quf
易	yop
七	qav
論	lya
父	fbx
拿	nru
程	ihw
阿	aek
阿	eek
害	hbk
族	zfu
破	pup
孩	hzr
魔	mgg
官	gbk
沉	idj
顕	xoa
夠	gdk
宝	bbw
取	qey
単	dxa
単	ixa
単	uxa
掌	vxu
務	wsl
低	drd
雪	xye
響	xso
佈	brj
市	uwj
揺	yff
依	yry
久	jpn
級	jsn
首	uqo
運	yzb
朝	iuo
朝	vuo
待	drc
嬢	nny
客	kbk
統	tse
忽	hxg
速	sza
復	frw
脩	xro
歓	hrq
異	ytb
式	uqd
護	hyc
爺	yfe
況	kde
腳	joe
招	vfk
九	jpg
集	jmr
区	okx
区	qkx
晩	wov
鉄	tjn
黃	hcb
友	yuy
亜	yaa
除	ieh
銭	qjg
送	szq
蘭	lcn
聯	lea
政	vwa
義	yyd
古	guk
六	lwb
器	qkk
甚	uqv
照	vho
基	jtq
閃	umr
院	yee
装	vyd
居	juk
産	ilf
產	iwf
呼	hku
楊	ymp
露	lyk
句	ggk
句	jgk
乱	lpv
舉	jpa
敵	dwl
鬥	daa
香	xho
停	trd
檯	tmt
羣	qvy
嘴	zkj
希	xxj
酒	jdy
巴	bvv
懐	hxy
議	yyd
類	lma
支	vuy
慢	mxy
陳	ied
仙	xre
段	dpy
調	dyk
調	tyk
頓	daa
派	pdn
英	ycn
喝	hkv
期	qqo
威	wgn
另	lkl
府	fgc
改	gwv
旁	plf
資	zbd
続	xse
造	zzn
楽	lmd
楽	ymd
攻	gwg
左	zug
願	yia
囲	wka
疑	ypr
唸	nkx
引	yga
熱	rht
怒	nxn
退	tzv
緩	hsy
線	xsd
註	vyw
細	xst
図	tkx
揹	bfo
需	xya
痛	tba
観	grj
組	zsq
雨	yad
曽	cbo
曽	zbo
約	ysd
包	bgv
木	man
技	jfy
示	uex
皇	hbw
拠	jfj
差	cyg
差	iyg
設	uyy
密	mbe
謝	xyc
鬼	gps
穿	ibp
脳	nok
趕	gzu
莫	mcd
麗	lal
品	pkk
葉	xcm
葉	ycm
既	jvv
存	cuz
睛	joo
宮	gbk
烈	lhd
訴	syd
追	vzp
推	tff
您	nxr
右	yuk
商	ulk
争	vda
角	jda
淡	ddh
止	vaa
談	tyh
厳	yxw
悪	exa
悪	wxa
狂	kqw
揮	hfi
亮	lwj
衛	wrd
聞	wme
忍	rxd
態	txs
漢	hdn
継	jsv
模	mmd
銀	yjn
仍	rrp
跑	pzv
否	fak
君	jvk
妹	mnn
隠	yex
母	mvd
科	khu
淩	ldw
選	xzb
夢	mcd
劉	ldp
寒	hbd
侷	jrk
冰	bdd
禁	jmx
境	jte
掉	dfu
究	jbj
查	ima
激	jdw
号	hkg
防	fef
費	fbv
恐	kxg
楼	lmn
導	dcv
肯	kvo
故	gwu
遊	yzf
球	qwd
樹	umc
嘆	tkn
救	jwa
施	ufv
帝	dlj
仏	frs
簡	jvo
料	lmu
際	jex
顧	gha
斉	qwa
抓	vfv
玩	wwe
猛	mqm
份	frd
米	mbm
僅	jrf
具	jqb
勝	uol
治	vdk
章	vlu
険	xen
守	ubc
散	swc
須	xpa
眉	mvo
抱	bfv
権	qmf
試	uyd
独	dqi
震	vyn
索	sus
証	vyv
礼	lpv
助	vql
聖	uwe
股	goy
跳	tzd
波	bdp
負	fbd
虎	hhj
練	lsn
姑	gnk
唐	tgk
室	utb
沙	udp
媽	mnm
陰	yes
称	ihx
投	tfy
柔	rsm
揚	yfp
規	gaj
毫	hwm
溫	wdm
較	jif
毒	dfd
耳	eaa
座	zgt
座	ztr
射	uuc
厲	lid
層	cuo
副	fda
担	dfa
蔘	ccp
蔘	ucp
置	vsq
暦	lio
初	ipd
卡	kad
卡	qad
承	ivn
質	vbj
属	uud
属	vud
漸	jdj
藍	lcm
船	ivk
逃	tzp
皮	pvy
薬	ycm
呀	ykp
靠	kna
充	iwe
標	bmx
堅	jtk
貴	gba
共	gcb
趙	vzo
維	wsf
陸	let
塊	ktg
吸	xkn
刺	cda
堂	ttx
醒	xyf
考	ktg
鬆	sas
排	pfa
劃	hdv
換	hfn
河	hdk
環	hwy
土	tua
誌	vyx
責	zbf
緻	vsw
圧	yit
素	sfs
湖	hdo
睡	uoa
蘇	sch
京	jwx
効	xwl
朋	poo
宇	ybu
順	upa
紫	zsv
伸	ura
賽	sbb
超	izk
忘	wxw
倖	xru
遇	yza
孫	szs
頂	dda
拍	pfb
警	jyc
按	afn
察	ibx
広	ggs
蔵	cca
蔵	zca
鬍	hao
秘	bhp
秘	mhp
凡	fjd
型	xta
尚	uxk
恩	exk
脫	toe
営	yxk
増	zto
価	jrx
史	uan
節	jve
鞦	qgh
翻	fpy
迷	mzm
州	vda
付	frc
項	xga
蕭	xca
狀	vdq
尼	nuv
雅	yaf
鳳	fjh
秦	qfh
草	ccu
敗	bwb
著	vco
著	vyo
咱	zko
硃	vun
呆	dkm
封	ftc
普	pqo
景	jox
専	vac
味	wkn
舞	wra
弄	nwc
虛	xha
畢	bta
講	jya
福	fpt
紀	jsv
握	wft
習	xyb
社	upt
永	ydn
尋	xec
黙	mha
洞	ddk
控	kfg
騎	qmk
徐	xrh
輩	bia
仮	jry
病	bbn
胸	xok
慾	yxb
伯	brb
峯	fef
肉	rar
歲	svp
医	yku
野	yaa
值	vrq
職	veg
尊	zqc
恨	hxn
狠	hqn
田	tku
魂	heg
毛	mpv
免	mdv
短	dud
秀	xhp
麻	mgm
壊	hty
印	yep
良	ldn
迎	yzp
槍	qmk
弾	tga
骨	gko
探	tfm
啦	lkl
研	yuc
妖	ynd
勁	jal
臨	lkk
寧	nbd
屋	wut
案	abm
傑	jrm
欧	okq
飯	fuy
村	cmc
昇	uoa
昇	uoc
擡	tft
矇	mon
略	ltk
丹	dpa
源	ydx
紛	fsd
雄	xuf
煙	yht
危	wdv
優	yrw
写	xba
牀	idm
罪	zss
網	wkv
食	srn
食	urn
食	yrn
闆	bmk
校	jmf
校	xmf
某	mcm
妙	mnp
休	xrm
珠	vwn
列	ldd
盤	pmv
透	tzh
春	ifo
委	whn
移	yhd
呵	hkk
偷	trd
奥	apd
吳	wkd
験	ymn
牙	yap
涙	ldd
宗	zbx
擺	bfv
善	uyk
浪	ldn
羽	yga
肩	jho
智	vou
擁	yff
弱	rgd
柳	lme
硬	yun
納	nsd
洛	ldk
範	fvv
混	hdv
玄	xws
買	mbs
済	jda
徒	trr
煩	fha
配	pyv
適	uzk
端	dla
娜	nne
哭	kqk
凝	ndr
鎮	vjb
率	lwu
率	uwu
避	bzu
拳	qbu
創	idr
採	cfm
暁	xoe
託	tyv
森	smm
哼	hka
惜	xxo
束	uan
熟	uhw
帰	gaj
抗	kfj
邪	xea
邪	yea
荘	vcu
喊	hkk
梅	mmd
韓	hua
罷	bsp
罷	psp
奔	bdc
亡	wwv
富	fbt
限	xen
嚇	hkd
嚇	hkv
嚇	xkd
嚇	xkv
養	yyn
庁	tgd
貝	bob
嬌	jnk
省	uxo
省	xxo
佔	vrk
橫	hmb
飄	pxf
戯	xhg
画	hak
暴	bod
滅	mda
域	ytk
瞧	qoh
軟	riq
摸	mfd
蓆	xcj
穏	whx
緑	lsd
伊	yrp
討	tyc
釈	upn
獲	hqy
店	dgk
敬	jwc
丈	van
姓	xnf
挑	tfd
祖	zpq
套	tds
睏	kok
睏	kom
牆	qpk
冒	moo
夏	xaw
叔	uay
架	jml
魚	ydh
織	vsg
尖	jxd
丁	daa
牛	npa
旧	jao
撲	pfd
綵	csm
降	jea
降	xea
燕	yhc
巻	jbv
臂	bou
桌	vam
売	mue
嘿	hkh
罵	mms
鮮	xay
幽	yev
訓	xya
演	ydb
閉	bmp
巧	qgg
奮	fdt
雑	zjf
亦	ywd
預	ysa
尤	yud
偏	prc
替	toa
箭	jvd
残	cdg
拝	bff
拝	pff
腿	toz
婆	pnd
唯	wkf
跡	jzd
班	bdw
諸	vyo
吉	juk
諾	nyk
狼	lqn
洋	ydy
慮	lhx
盃	bma
袋	dyr
策	cvn
腰	yon
殿	duy
番	fpt
番	ppt
測	cdd
輸	uid
杜	dmt
惨	cxp
盟	mmo
魯	lao
豪	hwn
積	jhb
趣	qzy
円	yaa
午	wru
戶	hpu
執	vtd
婦	fnj
登	ddv
懂	dxa
含	hrk
猶	yqy
互	haa
律	lra
鋒	fjf
搶	ifk
搶	qfk
厚	hiz
聚	jen
屍	uup
鬧	naj
縦	zsr
憑	pxd
迅	xzv
財	cbp
搞	gfk
嘛	mkm
側	crd
側	vrd
側	zrd
農	nan
稍	uho
介	jra
宣	xba
抽	ifa
顔	yla
躲	dum
舒	ura
供	grb
傲	arw
勇	ysl
階	jeb
犯	fqv
益	ymq
塵	ilt
甲	jaa
皺	vgp
街	jrd
孤	gzg
協	xul
獣	uxq
碰	pua
偉	wra
塔	ttk
批	pfv
蓋	gcm
監	jmk
労	lxl
砕	suu
撞	vfa
阻	zeq
操	cfm
概	gmv
胆	doa
輪	lic
婚	hno
遅	izy
兇	xxe
党	dxe
爸	bfv
劇	jdh
棄	qwm
奈	ndx
逐	vza
瘋	fbf
距	jza
附	fec
謂	wyo
歌	gdq
哦	ekd
哦	okd
構	gma
咬	ykf
誤	wyd
塞	sbt
慕	mcx
筆	bva
孔	kzv
牌	ppu
陪	pek
窗	ibd
逼	bza
材	cmp
擋	dft
島	dne
択	vfn
択	zfn
襲	xly
掛	gfd
倫	lrc
遍	bzh
芒	mcv
触	iji
瞪	dod
蕩	dcp
牴	dnd
郎	led
滾	gdy
憐	lxa
乃	ngp
幻	hvg
臣	ika
判	pdb
焼	uhe
焼	yhe
翼	yyb
騰	tom
欣	xjq
灯	dhd
庫	kgi
妻	qan
俬	srs
栄	rxm
奪	ddc
園	yky
壁	btu
賊	zbu
顆	kaa
累	lts
宋	sbm
狗	gqk
悄	qxo
顫	iwa
顫	vwa
吟	ykv
伏	frq
瞬	uoa
舍	urk
補	bpd
掃	sfj
躍	yzf
芸	ycg
芸	ycs
挺	tfz
岳	ype
悲	bxa
圏	jkv
圏	qkv
旋	xfr
瑞	rwa
惑	hxg
竹	vpa
蛋	dvi
艾	acx
艾	ycx
紮	vsm
莉	lcd
損	sfb
迫	pzb
盛	img
盛	umg
企	qrv
縁	ysn
純	isv
儁	jrg
努	nln
逸	yzd
菲	fca
抖	dfu
烏	wph
油	yda
錬	ljn
脣	iio
幕	mcj
康	kgn
吐	tkt
汗	hdu
館	guk
昨	zoa
賛	zba
茶	icm
蒼	cck
恢	hxh
裂	lyd
育	ywo
央	yan
閒	xmo
吼	hkv
爆	bhd
鼓	guy
鄉	xev
陥	xeo
曼	moy
泰	tfd
蹤	zzr
灰	huh
赤	itd
薩	scf
寛	kbj
豈	qed
伴	bra
猜	cqo
額	eba
遺	yza
謀	mym
浮	fdz
昏	hpo
融	rai
妮	nnv
菜	ccm
例	lrd
盯	dod
涌	yda
遭	zzc
洲	vda
潜	qdo
拼	pfc
勒	lgl
博	buc
蛇	uiv
港	gdv
貌	mve
紹	usk
抜	bfy
洗	xde
徹	iwr
針	vju
紙	vsq
萊	lcn
県	xox
剰	udp
扶	ffn
憤	fxb
鏡	jje
爵	jvc
晶	joo
佩	prj
訊	xyu
憂	ywa
鼻	bpa
禦	yxr
均	jtd
楓	fmf
沢	zdn
凱	kej
浩	hdk
奶	nnp
怨	yxp
毀	hpy
壮	vdu
誠	iyv
忠	vxa
洪	hdb
霧	wyl
糊	hmo
固	gkk
轟	hii
坦	tta
睜	voa
佳	jrt
爹	dfd
蒂	dcj
丟	dps
慶	qgw
億	yrx
詞	cyk
辛	xlu
豊	fad
縮	ssb
吹	ikq
仰	yre
迪	dza
晃	hog
庭	tgz
蓮	lcz
樑	lmm
仔	zrz
俠	xrn
閣	gmk
検	jmn
暫	zoi
読	dye
郭	gew
繞	rse
挿	ifa
涼	ldx
浄	jda
召	udk
召	vdk
減	jdk
侍	urc
慌	hxv
敏	mwr
伍	wrw
鷹	ygn
朗	ldo
訝	yyp
詩	uyc
貨	hbr
掩	yfv
碼	mum
渾	hdi
隔	gea
傅	frc
疾	jbu
鳥	dnh
鳥	nnh
賞	ubx
摩	mgu
池	idv
氏	upq
振	vfn
途	tzr
悶	mmx
童	tla
朵	djm
傻	urw
粗	cmq
旦	doa
悉	xxp
鳴	mnk
径	jrg
旅	lfn
赫	htd
穴	xbb
延	yzp
慣	gxb
喚	hkn
皆	jba
盗	dmd
琴	qwv
帳	vjn
戴	dtg
憶	yxx
仁	rre
宜	ybq
甘	gca
炸	vha
戒	jgc
琳	lwm
濃	ndn
吻	wkp
季	jhz
疼	tbd
桑	sym
侯	hru
堡	btr
珍	vwp
貼	tbk
符	fvc
芳	fcf
嗯	ekx
嗯	okx
羞	xya
典	dab
劫	jtl
騙	pmc
旗	qfb
嘯	xka
堆	dtf
覇	bxo
廷	tzp
促	crz
懼	jxf
耐	nac
龐	pgl
荒	hcv
序	xga
躺	tuk
粉	fmd
慧	hxf
餐	cua
喃	nku
踏	tzo
呂	lkk
孟	mmz
撫	ffh
匆	cgd
漫	mdy
乗	ipn
乗	upn
啓	qkh
脈	mon
儀	yrd
絡	lsk
拒	jfa
潔	jds
鄭	veq
奉	ffa
漂	pdx
癒	ybx
倍	brk
拖	tfv
怔	vxv
映	yon
訪	fyf
奴	nny
喬	qpk
頗	ppa
愣	lxf
献	xuq
編	bsa
健	jrz
扭	nfa
纏	ist
覈	hxw
評	pyu
享	xwz
尾	wum
碧	buw
瓦	wad
尺	iun
票	pxx
瑪	mwm
川	ipa
彼	brp
焰	yha
酔	zyu
述	uza
痕	hbn
晨	ion
薄	bcc
胖	poa
恭	gcx
輝	hgi
緒	xso
傾	qra
虧	khg
軀	quk
磨	mgu
隆	lef
岸	aeu
括	kfk
廃	fgv
狐	hqg
吞	tak
丫	yba
鎖	sjb
忌	jxv
悟	wxk
滑	hdg
椅	ymk
賭	dbo
垂	ipa
糧	lma
廠	iiw
辰	iin
曹	cao
霍	hyf
遙	yzd
痴	ibk
款	kuq
貧	pbb
拡	kfs
督	doa
乖	gpv
欺	qqq
聊	lee
悠	yxr
豔	yfm
奨	jdd
帥	upj
估	grk
爬	pvv
匹	pke
録	ljd
截	jrg
牢	lbn
銳	rje
逓	dzp
唱	iko
唉	aku
嘻	xkk
董	dca
剎	idx
剎	udx
鋼	gje
惹	rcx
焦	jhr
窮	qbg
援	yfy
慰	wxu
措	cfo
悔	hxd
革	gca
陵	lew
姿	znd
扯	ifv
泉	qbd
築	vvm
勾	ggs
授	ufy
罩	vsu
埋	mta
熊	xhs
潮	ido
漠	mdd
軒	xiu
殊	udn
哀	awy
鶏	jnv
掠	lfx
肚	dot
聰	cex
斬	vij
獄	yqq
倆	lrr
炮	bhv
炮	phv
俱	jrb
掙	vfa
邦	bef
袖	xpa
氾	fdv
沿	ydk
辞	cpu
卓	vau
悩	nxk
航	hvj
零	lys
盈	ymg
載	zig
擾	rfw
末	man
恋	lxw
粛	sva
粛	xva
鵬	pon
姆	mnd
屈	quk
眸	mon
冥	mbb
輛	lir
勧	qrl
刃	rdd
炎	yhh
姬	jna
攔	lfn
堪	ktv
劈	pdu
墨	mth
培	ptk
霜	uyo
斜	xru
審	ubt
甜	tpc
撒	sfw
駕	jml
耀	ygf
脆	cov
袍	ppv
駐	vmw
霞	xyy
厭	yiq
嘗	ixo
彎	wsg
宏	hbs
滴	ddk
牧	mwn
鍵	jjz
耶	yee
銷	xjo
膀	bof
膀	pof
寂	jby
媚	mno
枝	vmy
牽	qwn
喪	sun
祝	vpe
趁	izp
舌	upk
課	kyn
麦	mfw
抹	mfn
玲	lws
噴	pkb
染	rmd
跪	gzv
擦	cfx
翔	xyy
幣	bjx
埃	atu
鑽	zjb
貫	gbv
盾	dpo
災	zvh
溜	ldt
詢	xyo
腹	fow
渡	ddy
燃	rhh
眨	von
撤	ifw
敲	qwy
侵	qry
喘	ika
柄	bmn
悅	yxe
嫁	jnn
巌	yew
頼	lab
爛	lhs
嘉	juk
拾	ufk
泥	ndv
夾	gan
夾	jan
版	bpy
捜	sfy
匯	hkd
鼕	dud
俗	srk
僧	sro
競	jle
餵	wun
駭	hmr
搭	dfk
暖	noy
茫	mcv
返	fzp
莎	ucp
擠	jfa
賓	bbb
冠	gbc
析	xmj
鬱	ymp
允	yse
療	lbx
繁	fsr
橋	qmk
葛	gcv
祥	xpy
痩	uby
仲	vra
聳	ser
仗	vrn
弓	gvg
違	wza
予	ysa
予	ysn
幅	fjt
脅	xlo
瓶	pqw
愧	kxg
暈	yoi
柱	vmw
飾	uuj
翠	cyu
勉	mdl
矮	aun
宿	sbb
宿	xbb
偶	ord
湯	tdp
刑	xda
濤	tdc
黎	lhd
煞	uhd
賢	xbk
姊	znp
衫	upp
錦	jjj
拋	pfl
虫	iad
昂	aoe
恰	qxk
咐	fkc
鋪	pjd
琪	qwb
衡	hrd
飲	yur
捉	vfz
繊	qsa
繊	vsa
繊	xsa
袁	yty
猟	lqa
贏	ywb
購	gba
盧	lhm
礎	iur
亭	twd
娃	wnt
慈	cxq
晴	qoo
咒	vjk
羊	yba
籤	qvg
貓	mvt
薇	wcw
覆	frw
覆	fxw
禍	hpk
罰	fsd
艦	jvm
魏	whg
耗	hlm
寸	cad
跌	dzn
俄	erd
蝶	dim
詳	xyy
撐	ifp
闖	imm
箱	xvo
弗	fva
扮	bfd
誘	yyp
障	veu
怖	bxj
屁	puv
彌	mgx
歉	qqq
砍	kuq
歯	ivk
踢	tzp
寺	stc
爪	vpn
貿	mbp
臓	zoa
棋	qmb
賀	hbl
邁	mzc
捕	bfd
籠	lvl
浅	qdg
釦	kjk
撥	bfy
扇	uhy
臭	ipq
臭	xpq
篇	pvc
豬	vao
鄧	dev
泄	xdv
辱	ric
膚	fho
懶	lxb
裁	cyg
僕	prd
穆	mhp
崑	kev
醜	ivg
愁	ixh
淵	yda
勤	qcl
懸	xxq
鈴	ljs
韋	waa
崇	iex
井	jaa
帕	pjb
昌	ioo
鞭	bgn
叛	pby
殭	jda
紋	wsw
鴻	hdn
瑤	ywf
鵰	dnk
灑	sdl
馮	fdm
馮	pdm
蛮	mwi
爽	udx
跨	kzg
饒	rue
矛	msp
縫	fsz
湾	wdg
稅	uhe
渉	udp
銅	tjk
屠	tuo
麼	mgs
麼	ygs
乾	gau
乾	gug
乾	qau
乾	qug
瑩	yhw
塗	ttd
姦	jnn
梯	tmp
邀	yzb
誉	yxy
詭	gyv
慎	uxb
夕	xpd
婉	wnv
吩	fkd
鏢	bjx
摔	ufu
魄	pbg
臥	wkd
酷	kyk
叢	cay
巡	xzv
祭	jpx
崖	yet
誓	uyf
描	mft
奏	zfd
肖	xxo
礙	aur
曰	yka
霄	xyo
糟	zmo
麟	lla
枚	mwm
肌	joj
欠	qdr
欠	qfn
稀	xhj
闊	kmk
液	ydn
笨	bva
勃	bul
毅	yly
礦	kub
溼	udt
桃	tmd
疲	pbp
荷	hck
汽	qdq
薑	jya
摂	nfd
摂	ufd
哎	akx
植	vmq
艱	jcn
脖	boz
催	crf
虹	hig
巫	wgr
屏	puc
嚥	ykh
馳	imv
蓉	rck
湊	cdd
愕	exg
肥	fov
績	jsb
壇	tta
悽	qxn
搬	bfy
扔	rfp
瑟	swd
杖	vmn
芙	fcn
畏	wtn
頻	pva
潤	rdw
痠	sbw
割	gdb
綿	msj
披	pfp
滋	zds
秒	mhp
戈	gad
貪	tbr
捷	jfr
瞞	mor
播	bft
逆	nzq
咳	kkr
申	uaa
卑	bpu
摟	lfn
寇	kby
魅	mgn
恵	hxa
宛	wbv
宛	ybv
喉	hku
幼	yvl
卿	qpe
齢	lis
賜	cbp
駛	umn
瓜	gpn
氛	fqd
腕	wov
污	wdg
諒	lyx
籌	ivc
寵	ibl
碗	wuv
妃	fnv
筋	jvl
甩	upv
駆	qmx
寨	vbm
蕾	lct
兼	jqn
婷	tnd
捏	nft
妥	tvn
拓	tfk
斥	ipd
吵	ikp
訂	dyd
糾	jsa
璃	lws
届	jua
餓	eud
誇	kyg
倩	qro
薛	xcu
竄	cbu
崔	cef
尉	wuc
尉	yuc
恒	hxa
後	hrw
宴	ybn
晌	uok
艘	svy
辣	lln
哇	wkt
櫃	gmb
櫃	jmb
斤	jpa
儲	iro
豹	bvv
雁	yif
吾	wwk
挖	wfg
飽	buv
彭	bup
彭	pup
役	yry
瓊	qww
遮	vzg
舟	vpd
傭	yra
獅	uqj
寿	ufc
陶	tef
患	hxa
砸	zuj
頰	jaa
励	lil
愚	yxa
腐	fgr
牲	unf
唖	yka
恍	hxg
褲	kpi
俏	qro
鼠	upv
嵐	lef
狄	dqh
妄	wwn
丘	qpa
抑	yfe
呈	ikw
驀	mcm
尹	yvp
坡	ptp
契	qdf
契	xdf
嫌	xnn
津	jda
售	ukr
棒	bma
郡	jev
撕	sfj
驟	vmn
疆	jga
頸	gva
頸	jva
賈	gbx
賈	jbx
咕	gkk
歇	xoq
漏	ldd
脾	pou
窩	wbk
嫣	ynh
盼	pod
恥	iex
蜜	mbi
姨	ynn
廚	igc
珊	uwa
鏈	ljz
裹	gwy
汪	wdw
靖	qlo
殷	ypy
擬	nfr
淫	ydu
嗚	wkh
韻	ylb
柯	kmk
巾	jaa
廟	mgo
紗	usp
娶	qne
棍	gmv
晉	jao
伐	frg
縄	usv
漲	vdn
添	tdx
陛	bet
嘲	iko
嘲	vko
捧	pfa
宅	vbq
鼎	dov
謹	jya
乏	fpn
黛	dhr
倉	crk
崗	gek
掏	tff
削	xdx
詫	iyq
灌	gdf
旨	vpo
刷	udu
頁	yba
泡	pdv
俞	yrd
嬰	ynb
盒	hmr
嚷	rky
沾	vdk
漆	qdd
蠢	ifi
甫	fad
膝	xod
墓	mct
逢	fzw
嫩	nnw
墜	vte
雀	qxf
枯	kmk
償	irb
陌	meb
屑	xuo
暢	iap
陡	der
輓	wiv
鶴	hnd
涵	hdk
署	uso
沃	wdd
叉	iyd
搏	bfc
逝	uzf
趟	tzk
鞋	xgt
赴	fzd
謙	qyn
砰	puu
驕	jmk
遂	szq
泣	qdl
檔	dmt
攤	tff
慨	kxv
籍	jvo
擒	qfs
苗	mct
浴	ydk
鑑	jjm
尷	gum
遷	qzx
疏	uvv
尬	gja
賺	vbn
賺	zbn
逗	dza
豆	daq
孝	xtz
芬	fcd
湘	xdo
訣	jyn
晰	xoj
廉	lgn
馨	xuo
遼	lzx
械	xmc
弔	dga
弔	dva
炉	lhh
串	iaa
裸	lpn
哲	vkf
凜	ldh
渇	kdv
柏	bmb
蕓	ycs
拱	gfb
妨	fnf
揉	rfm
桜	ymn
寄	jbk
宙	vba
宰	zbu
媒	mnm
眯	mom
貢	gbg
崩	beo
綁	bse
斧	ffj
惶	hxw
嘶	skj
溝	gda
禅	ipa
禅	upa
騒	smi
荊	jcd
歪	wav
涯	ydt
耍	uan
遵	zzq
偽	wrh
冤	ybd
悍	hxu
耿	geh
翅	iuy
循	xro
聶	nee
猴	hqu
払	ffs
裙	qpk
蓬	pcz
芝	vcn
昭	vok
倏	urq
艙	cvk
肆	saa
帽	mjo
嶺	lea
叮	dkd
柺	gml
儒	rra
嫂	sny
瞥	pox
廊	lge
賠	pbk
鄙	bek
哩	lka
遜	xzz
愉	yxd
摘	vfk
淋	ldm
犠	xnd
俯	frc
譚	tyu
蔣	jcc
劣	lxl
玫	mww
籲	xva
籲	yva
腸	iop
押	yfa
昔	xco
攀	pmu
乳	rvv
鹿	lgv
潘	pdt
婭	yna
藤	tcd
躬	gug
蔡	ccx
粒	lml
澀	sdv
掲	jfv
掲	qfv
嗓	skm
啪	pkb
翎	lry
撼	hfx
豎	udk
遣	qza
囊	nay
眠	moq
掀	xfq
旺	wow
弘	hgs
慼	qxp
爍	uhm
逍	xzx
坤	kta
憾	hxx
侖	lrc
租	zhq
咯	gkk
咯	kkk
咯	lkk
蔔	bct
凰	hjw
鬨	hab
匪	fka
膛	tot
淑	udy
忖	cxc
堵	dto
夷	yan
柴	imv
撇	pfw
歹	dad
辜	guu
沐	mdm
綻	vsr
輔	fid
萍	pcu
敖	awf
拆	ifd
磊	luu
罕	hbu
凍	ddd
賦	fbd
趨	qze
瞳	toa
桿	gmu
燦	chm
葬	zcc
籃	lvm
胞	bov
顛	dua
黯	aho
峡	xen
頑	wea
朕	vod
兆	vpd
擅	ufa
陀	tev
龜	gpx
龜	jpx
龜	qpx
蜂	fif
貞	vba
閻	yma
咦	ykn
惟	wxf
竭	jlv
廂	xgo
懲	ixr
謊	hyv
腔	qog
裴	pya
玻	bwp
璇	xwr
渓	xdn
銘	mjk
鄰	lem
樸	pmd
衷	vwy
簾	lvn
攏	lfl
魁	kgu
譁	hka
侄	vrt
茵	ycd
盆	pmb
閱	yme
絃	xss
兮	xbg
翁	wby
賤	jbg
債	vrb
斌	bwd
坑	ktj
邏	lzs
踩	czm
瞎	xok
躁	zzm
諷	fyf
釘	djd
蓄	xct
丸	wgd
丐	gag
矣	ysu
册	cpa
兔	tdd
潰	kdb
隙	xex
畳	dtq
畳	ttq
瞄	mot
倚	yrk
轎	jik
舅	jpl
欽	qjq
祈	qpj
燭	vhi
怡	yxk
茲	ccs
茲	zcs
肢	voy
綜	zsx
稟	bwh
於	wfd
於	yfd
壺	hua
雯	wyw
欄	lmd
覧	ljk
斑	bww
蹲	dzc
紐	nsa
践	jzg
棠	txm
洶	xdk
胎	tok
妾	qln
篷	pvz
腥	xoa
廝	sgj
鍋	gjk
楞	lmf
澳	add
窃	qbd
霆	tyz
桂	gmt
艇	tvz
軌	gij
哨	uko
寡	gbd
挪	nfe
翰	huy
堯	yae
咧	lkd
怯	qxs
瑰	gwg
滄	cdk
寞	mbd
敘	xwr
彷	frf
彷	prf
佐	zrg
吶	nkr
卒	cwu
卒	zwu
栽	zmg
煥	hhn
塌	tty
繍	xsa
駱	lmk
斂	lwr
攜	xfk
蹄	tzj
頴	ypa
棵	kmn
廖	lgp
呻	uka
癢	ybu
駁	bmx
裳	ixy
裳	uxy
睹	doo
潑	pdy
溢	ydm
狡	jqf
倘	trk
胳	gok
羨	xyr
婢	bnu
枕	vmv
妒	dnu
綺	qsk
噬	ukr
呃	ekv
喔	okt
喔	wkt
狸	lqa
縷	lsn
訳	yyn
泊	bdb
芷	vcv
咪	mkm
颳	gfk
咖	gkk
咖	kkk
恕	uxn
煌	hhw
嘱	vkd
蚩	iei
棟	dmd
錘	ija
逛	gzq
暇	xoy
桟	vmd
濺	jdg
巷	hcv
巷	xcv
填	ttb
膊	boc
詐	vya
昧	mon
乞	qrg
叱	ikq
姚	ynd
漁	yda
摧	cff
遁	dzp
焚	fhm
糕	gmh
襯	ipj
倦	jrv
轅	yiy
啡	fka
啥	ukk
乙	ygg
彥	ywp
郝	het
履	luw
匕	bav
瀟	xda
茜	qcx
茜	xcx
嘟	dke
汝	rdn
耽	dev
旭	xjo
浸	jdy
畜	iwt
畜	xwt
碩	uua
蘊	ycm
偵	vrb
佑	yrk
灼	vhd
嗤	iki
峻	jew
菊	jcm
彤	tpp
焉	yah
敦	dww
喲	ykd
筒	tvk
棉	mmj
黴	myw
衰	uwy
烤	khg
麒	qlb
鉤	gjk
犬	qdd
庸	yga
灘	tdf
姥	lnv
桶	tma
榜	bmf
茅	mcp
狭	xqn
剝	bdv
癥	vbw
誕	dyv
乍	vra
翩	phy
輯	jie
棺	gmk
潭	tdu
歆	xlq
滞	vdj
抄	ifp
譜	pyo
枉	wmw
趴	pzb
獰	nqd
隷	lun
嗔	ikb
斃	bxv
誼	yyq
淮	hdf
笛	dva
縛	fsc
剪	jqd
囚	qkr
蔽	bcw
闢	buu
闢	puu
碌	lud
塑	stq
刊	kda
瀾	ldd
捂	wfk
禿	the
擲	vfe
桐	tmk
霎	uyn
擱	gfk
帆	fjd
矢	urd
膩	nod
函	hvk
址	vtv
弩	ngn
邱	qep
孽	ncz
藉	jco
藉	jro
脹	von
兀	wae
囂	xkk
雍	ywf
巍	weg
匠	jkj
冉	raa
窺	kbj
蛛	vin
狽	bqb
瑜	ywd
妍	ync
衍	yrd
邵	ued
朽	xmg
噗	pkn
苟	gck
鮑	bav
胃	wto
殻	kuy
殻	quy
暮	mco
蘿	lcf
懇	kxv
渠	qmd
挟	jfn
挟	xfn
琉	lwv
熙	xhk
噢	okd
僱	grf
碑	buu
駝	tmv
俺	arv
絵	hss
喀	kkk
撿	jfr
斐	fwa
阮	ree
嘎	gkg
吱	vky
熾	ihb
鑰	yjc
妝	vdn
杏	xmk
桓	hma
昊	hod
擎	quc
貸	dbr
磁	cus
憲	xbx
沸	fda
衙	yrd
匙	iov
匙	uov
鞘	qgo
鞘	ugo
剤	jdw
撹	jfj
猿	yqy
贈	zbo
徽	hrw
裕	ypk
禱	dpc
株	vmn
蜀	usi
樁	vma
賬	vbn
巣	cdn
巣	idn
堕	dte
堕	hte
梭	smw
兜	dep
敞	iwx
腫	voa
骷	kgk
髏	lgn
娟	jno
茂	mcp
窄	vba
菱	lcw
噸	dka
絮	xsn
坎	ktq
琦	qwk
蘆	lcm
滲	udp
拘	jfk
梵	fmd
脊	jdo
澡	zdm
窟	kbk
姻	ynd
捐	jfo
盞	vgm
孕	ygz
滔	tda
挫	cft
伺	crk
伺	srk
販	fby
扁	bhc
扁	phc
墅	uta
寝	qby
侮	wrd
垃	ltl
郊	jew
眶	kow
莽	mcc
俘	frz
蟬	iia
卦	gtd
喧	xka
圾	jtn
誅	vyn
澄	ddd
澄	idd
妞	nna
彪	bhp
淳	idz
淳	vdz
唔	kkm
唔	wkk
攬	lfj
廈	ugw
廈	xgw
嗡	wky
勲	xhp
歧	qvy
鴉	yna
聘	peg
瓏	lwl
哮	xkz
嗦	sks
虞	yhd
慚	cxj
熬	ahf
迭	dzp
塩	ytm
嘖	zkb
搗	dfe
梳	umv
漿	jdd
燙	thd
虐	nha
鈞	jjd
掘	jfk
忿	fxb
畔	pta
樊	fdm
倪	nre
畝	mwn
嚨	lkl
郵	yep
襄	xwy
禽	qrd
鱗	laa
勿	wgp
煬	yhp
嫉	jnu
杭	hmj
嚎	hkn
銜	xrd
菁	jco
眩	xos
慄	lxm
蹦	bzo
喻	ykd
盲	mwo
虜	lhl
茹	rck
覷	qhj
佘	urx
蔓	mcy
蔓	wcy
陋	lev
蘋	pcb
娛	ynd
堤	dtr
彬	bmp
繃	bso
鋳	vjc
酬	iya
絞	jsf
渺	mdp
淘	tdf
卸	xer
蛟	jif
朦	mon
帖	tjk
菩	pck
坊	ftf
曠	kob
襟	jpx
汁	vdu
僻	pru
翹	qty
盔	kmu
噓	uka
噓	xka
峨	eed
疚	jbn
懾	uxy
粋	cmu
粋	tmu
醋	cyo
飢	juj
秩	vhn
沫	mdn
肺	foj
咆	pkv
磚	vuc
嘀	dkk
弧	hgg
錫	xjp
頃	qaa
迦	jzl
拚	pfc
朧	lol
妓	jny
撈	lfl
蹈	dza
墳	ftb
幢	ija
幢	vja
湛	vdv
亨	hwa
媳	xnx
薦	jch
奕	ywd
吏	lan
磕	kum
皓	hbk
婿	xno
跋	bzd
鈺	yjw
罡	gsv
扳	bfy
屢	lun
犀	xun
稿	ghk
蟻	yid
咚	dkd
耕	gla
鍛	djy
奢	udo
診	vyp
祺	qpb
泳	ydn
拭	ufd
蝕	uui
塁	ltt
岡	gkk
竅	qbw
龔	glb
戟	jug
萱	xca
綽	isu
脂	voo
宵	xbo
釣	djd
衊	mxd
嵌	qeq
戮	lyg
叩	kek
迸	bzq
淹	ydv
丞	iva
喇	lkd
哧	ikd
叨	dkd
叨	tkd
瓷	cwd
炯	jhk
蠍	xiq
揪	jfh
沛	pdj
斎	vwa
侶	lrk
撓	nfe
蝠	fit
逞	izk
疫	yby
眷	jbo
姍	una
懈	xxn
癱	tbf
餅	buc
嗅	xkq
豁	hbk
棚	pmo
煤	mhm
框	kmw
綢	isk
殖	vdq
券	qbd
券	xbd
蒸	vch
熄	xhx
疤	bbv
蒲	pcd
稚	vhf
鶯	yhn
冀	jab
稲	dho
葡	pcd
侃	krv
捆	kfm
澈	idw
毯	tmh
傍	brf
旬	xgo
嘔	okk
梧	wmk
寓	ybd
粘	nmk
粘	vmk
薪	xcj
阱	jea
撩	lfx
舔	tpx
轄	xik
舜	uva
梨	lmh
猾	hqg
抿	mfq
禹	ypd
啼	tkj
炭	teh
硯	yuj
璣	jwd
掐	qfa
夭	ypd
榻	tmy
哉	zkg
逮	dzv
旱	hou
驢	lmm
甄	vxw
煮	vht
憋	bxx
繳	jsw
繳	vsw
蕊	rcx
稽	jho
緋	fsa
嘍	lkn
渦	gdk
渦	wdk
濫	ldm
搓	cfg
頹	tha
瞅	ioh
錚	vja
綱	gsk
揍	zfd
鵝	enp
氓	mwq
瑾	jwa
肝	gou
踉	lzn
訕	uye
簫	xva
臘	lov
臘	xov
霓	nye
憊	bxr
淌	idk
淌	tdk
霹	pyu
墊	dtu
蹌	qzk
茨	ccr
刁	dga
祿	lpd
膜	mod
詛	zyq
擂	lft
軸	via
厥	jiq
譏	jyd
厄	eiv
膠	jop
扛	gfg
扛	kfg
惕	txp
瞟	pox
凸	taa
肘	voc
媛	yny
擰	nfd
浙	vdj
奎	kdt
薰	xch
沁	qdx
駿	jmw
笙	uvf
岔	ibe
沮	jdq
顱	lha
酥	syh
冶	ydk
嗽	skq
舵	dvv
燥	zhm
拙	vfk
蠱	gmi
吭	hkj
吭	kkj
綾	lsw
蝴	hio
糖	tmk
蹙	cgz
琢	vwn
漾	ydn
紳	usa
怠	dxs
嗷	akw
淪	ldc
鴨	yna
涅	ndt
馭	ymy
詠	ykn
窒	vbt
槐	hmg
凳	dvj
臀	tou
傘	sru
懊	axd
靂	lyv
逾	yzr
唬	hkh
葫	hco
閨	gmt
鹹	xak
鑲	xjy
萄	tcf
梢	umo
嗜	uko
戳	iyg
鏟	ijf
繆	msp
猩	xqf
跺	dzm
蟒	mic
詹	vdy
曬	uol
浦	pdd
鄒	zgd
黝	yhl
筷	kvn
猙	vqa
霖	lym
炫	xhs
凹	aaa
凹	waa
伶	lrs
揣	ifa
揣	tfa
揣	vfa
窘	jbk
悸	jxz
垮	ktg
嚕	lko
頷	hra
嚼	jkc
尿	nud
沼	vdk
塘	ttk
肋	lol
簇	cvu
哆	dkd
兢	jue
瑣	swb
頒	bba
瀉	xdh
鞠	jgm
匿	nkk
膨	pop
醸	nyy
頌	sba
癮	ybx
棲	qmn
棲	xmn
蔚	wcc
楠	nmu
幟	vjg
剔	tdo
靴	xgv
萌	mco
棘	jan
娥	end
沌	ddv
謎	myz
覓	mvj
砂	uup
脯	fod
脯	pod
諱	hya
螺	lis
暉	hoi
韌	rad
瞻	voy
蝋	lia
瀑	pdd
璧	bwu
蚕	cai
聾	lle
灕	ldf
踱	dzy
謡	yyf
敷	fwa
偎	wrn
絹	jso
噩	ewk
掻	sfi
晏	yon
匣	xka
倔	jrk
蹬	dzd
苑	ycv
嬸	snt
殲	jdd
緝	jse
彰	vlp
拇	mfd
寥	lbp
昼	vua
弊	bcx
坪	ptu
敝	bwx
裘	qay
呸	pka
憎	zxo
鑌	bjb
憫	mxw
輿	ypb
誦	sya
拎	lfs
唾	tka
瑛	ywn
枢	umx
叭	bkb
摯	vut
揖	yfe
兌	dbe
蜘	vik
秉	bpn
蔭	ycs
釁	xpd
壌	rty
勻	yga
馴	xma
濁	vdi
惚	hxx
牟	msn
嗆	qkk
祁	qep
嫺	xno
蜥	xij
炒	ihp
婕	jnr
甸	dgt
憚	dxa
碟	dum
諧	xyb
叟	spy
猝	cqu
僥	jre
僥	yre
斟	vqu
啤	pku
髄	sgz
寰	hby
峙	uec
峙	vec
赦	uwt
譟	zym
梟	xnm
澆	jde
腮	sox
遏	ezo
哽	gkn
芽	ycp
婪	lnm
倭	wrn
卵	lpd
曖	aow
闕	qmq
詔	vyk
炙	vph
祟	sex
揀	jfd
邸	dep
骸	hgr
謬	myp
磋	cug
涕	tdp
瀚	hdy
邢	xea
捶	ifa
袱	fpq
洽	qdk
峭	qeo
鞏	ggg
檀	tma
贖	ubb
祀	spv
滕	tod
柬	jan
嵩	sek
嬉	xnk
僚	lrx
睬	com
蔥	ccx
嬤	mnd
嬤	mns
缸	gfg
杉	ump
虔	qhw
媧	wnk
拽	vfp
廓	kge
瑋	wwa
薔	qck
恃	uxc
竿	gvu
恙	yxy
絨	rsu
瑚	hwo
漪	ydk
鵑	jnk
睫	jor
鴿	gnr
陝	uen
鈔	ijp
蝙	bic
攙	ifd
嫋	nnd
蠅	yiv
佬	lrv
螞	mim
蚊	wiw
翡	fya
朔	uqo
踹	iza
嗖	sky
芊	qcu
崎	qek
啃	kko
璋	vwu
慷	kxn
咋	vka
咋	zka
檐	ymy
鞍	agn
剿	idv
剿	jdv
腑	foc
悚	sxn
緞	dsy
匈	xgk
廁	cgd
廁	sgd
鷲	jnw
漣	ldz
蝦	xiy
漩	xdr
聆	les
柵	cma
柵	uma
柵	vma
搐	ift
鸞	lws
蓓	bck
扒	bfb
扒	pfb
穹	qbg
瑕	xwy
珀	pwb
錐	vjf
矯	juk
廬	lgm
暑	uoo
溶	rdk
靡	mga
晦	hod
喳	ika
喳	vka
咄	dkk
巔	dea
墟	xta
煎	jhq
芯	xcx
亢	kwj
擄	lfl
屯	tav
屯	vav
嘰	jkd
曦	xog
獠	lqx
釐	laa
釐	xaa
懦	nxa
渣	vda
桀	jmp
恬	txk
綴	vsy
褪	tpz
嵋	meo
箏	vva
穢	hhd
庇	bgv
絆	bsa
褚	ipo
褚	vpo
拯	vfa
衲	npd
眺	tod
悴	cxu
駒	jmk
鈍	djv
酋	qqa
珂	kwk
禰	mpx
狙	jqq
汰	tdd
鐲	vji
賄	hbo
鎧	kjd
粥	vmg
佟	trd
芮	rcr
奄	ydv
悵	ixn
剖	pdl
伽	grk
伽	jrk
伽	qrk
忡	ixa
萎	wcn
鑿	zaj
鬟	hay
奠	dqd
熠	yhb
憔	qxh
鈕	nja
鈕	nsa
嫵	wnh
掄	lfc
崆	keg
弛	igv
褐	hpv
勘	kql
妲	dna
唰	ukd
惺	xxa
膏	gwo
筠	jva
貶	bbn
絢	xso
嗨	hkd
怦	pxu
晤	wok
俐	lrd
竇	dbb
駅	ymn
棱	lmw
竺	vve
烙	lhk
睿	rao
鑼	ljf
溺	ndd
愷	kxd
締	dsj
牡	mnt
鬢	bab
藩	fct
諭	yyd
菴	acv
憨	hxv
瘟	wbm
釵	ijd
昕	xoj
徊	hrk
偌	rrk
髯	raa
繮	jsa
庶	ugh
札	vmv
繚	lsx
徘	pra
曙	uoo
閥	fmg
殆	ddk
巳	svv
緯	wsa
緘	jsk
澎	pdp
掣	iup
惘	wxv
槽	cmo
詣	yyo
曳	yap
婁	lan
胤	ypv
惋	wxv
虯	qia
倡	iro
芭	bcv
琛	iwm
餚	yuo
蹭	czo
庚	ggn
飆	bqf
仕	uru
貂	dvk
嚓	ikx
蜴	yip
募	mcl
昱	yol
圳	vta
氧	yqy
悻	xxu
佯	yry
鏘	qjc
隋	deo
隋	seo
篤	dvm
筱	xvw
忑	txa
捅	tfa
捺	nfx
茉	mcn
蛍	yxi
佗	trv
睨	noe
邃	szb
譴	qyz
霏	fya
屎	uum
乒	ppp
諜	dym
緬	msa
忐	txa
暄	xoa
簌	svq
鯨	jax
涎	xdv
矚	voi
攢	cfb
攢	zfb
蟹	xij
茄	jck
茄	qck
漱	udq
飼	suk
嗣	skk
誡	jyd
闡	ima
瑭	twk
熔	rhk
冽	ldd
棕	zmx
醤	jyd
辮	bsu
轍	viw
閔	mmw
殴	oky
蛙	wit
瀅	ydw
晁	iod
刪	uda
裔	yyk
膳	uok
殃	ydn
藹	acv
茱	vcn
苛	kck
蹺	qze
痊	qbw
樵	qmh
烘	hhb
癲	dba
懿	yux
扼	efv
吆	yks
鳩	jnj
繭	jci
孜	zwz
僑	qrk
幡	fjt
咎	jwk
蔬	ucv
酣	hyc
褻	xwy
噥	nkn
隧	sez
禾	hpm
紡	fsf
黏	nhk
湃	pdf
絳	jsa
崛	jek
嘈	cko
眈	dov
皙	xbm
礁	juh
琅	lwn
睦	mot
薫	xch
璐	lwk
躥	czu
邑	ykv
躇	izo
菌	jch
棗	zan
躊	izc
迢	tzd
贓	zbd
臻	vah
葦	wca
篝	gva
襪	wpn
嶄	vej
嶼	yea
嬈	rne
靳	jgj
煜	yhl
聿	yva
隕	yeb
鴛	ynd
榴	lmt
帷	wjf
鉢	bja
毋	wvp
橙	imd
雌	cvf
丙	ban
琥	hwh
匡	kkw
狩	uqc
蕪	wch
羿	yyc
璀	cwf
鯊	uad
冕	mov
訥	nyd
蠕	ria
砌	qud
戻	lhd
摻	ifp
摻	ufp
摻	xfp
拈	nfk
酌	vyd
殤	udp
忒	tqd
鉛	qjk
戎	rgu
躡	nze
嘮	lkl
栩	xmy
燁	yha
吝	lwk
啜	iky
渙	hdn
甬	ysa
莞	gce
莞	wce
惻	cxd
雛	igf
窖	jbk
傀	grg
傀	krg
蜷	qiv
岱	der
疙	gbg
颯	slf
袞	gwy
謔	xya
乓	ppd
棣	dmn
棣	tmn
磅	buf
磅	puf
焱	yhh
猖	iqo
簿	bvc
譬	pyu
羈	jsm
戩	jag
拗	afl
拗	nfl
煦	xho
燼	jhm
佇	vrd
葵	kcd
鐮	ljn
瘩	dbk
笠	lvl
趾	vzv
攸	yrw
剌	lda
唧	jke
睽	kod
壩	bto
紊	wws
漬	zdb
逕	jza
靶	bgv
糙	cmz
宦	hba
吮	uke
勺	ugd
禎	vpb
邯	hec
鄂	eek
窯	ybh
圭	gtt
侈	ird
糞	fmb
槓	gmb
鴦	yna
炬	jha
瀏	ldd
橡	xmn
孰	uwd
琶	pwv
儼	yrw
泓	hds
澗	jdo
唄	bkb
麾	hgm
暱	nok
暱	nov
屹	yeg
卹	xxe
寐	mbn
婧	jno
閘	vma
韶	ulk
菇	gck
靚	jfj
靚	lfj
椒	jmy
荀	xco
癸	gvd
饕	tuk
啐	cku
啐	qku
瘡	ibk
岑	cev
輜	zit
攘	rfy
琵	pwv
稷	jhw
骯	akj
矜	gsv
矜	jsv
矜	qsv
楣	mmo
瀆	ddb
熒	yhh
噎	ykd
呱	gkn
崽	zxe
餌	eue
拷	kfg
錠	djr
縹	psx
癟	bbc
瞠	iot
滬	hdv
奚	xvd
籟	lvb
湮	ydt
縈	yhs
劭	udl
鐺	djt
鐺	ijt
茗	mck
弒	uxd
痹	bba
颼	sfy
鏗	kjt
璨	cwm
贅	vbf
纓	ysn
疇	itc
儡	lrt
冢	vbn
輻	fit
蜈	wid
珞	lwk
韃	dgz
咻	xkm
笈	jvn
扈	hhv
壑	hta
骰	tgy
撰	vfb
鯤	kav
噤	jkx
煽	uhy
璽	xaw
炳	bhn
捻	nfx
誒	eyu
嗒	dkk
嗒	tkk
鋸	jjk
浣	hde
窿	lbf
塢	wth
鑫	xjj
磷	lua
蜒	yiv
噔	dkd
繹	ysu
咔	kkd
扉	fha
闔	hmm
穂	shx
叄	sss
茸	rce
踞	jzk
皁	zbu
璞	pwn
垢	gtk
枷	jmk
珏	jww
騁	img
矗	iua
緹	tsr
蹊	qzd
蹊	xzd
粟	sxm
呦	ykl
駙	fmc
唆	skw
饅	muy
寅	ybb
撮	cfy
撮	zfy
羹	gyd
楮	imo
巒	les
竈	zbe
餮	tud
靨	yia
嬴	ywd
遐	xzv
胭	yod
頊	xwa
榕	rmk
胯	kog
迂	yza
惦	dxk
伎	jry
誣	wyr
癌	abe
槳	jmd
黠	xhk
逵	kzt
韜	taa
嫡	dnk
悼	dxu
喏	nkk
喏	rkk
帛	bbj
倹	jrn
啄	vkn
咣	gke
銬	kjg
咫	vub
鉗	qjc
骼	ggk
舷	xvs
祠	cpk
箍	gvj
櫥	imc
鱷	eak
袂	mpn
溟	mdb
鏽	xja
籬	lvf
緲	msp
淤	ydd
鐸	dju
囔	nky
蚣	gis
痞	pbk
迄	qzr
稼	jhn
汀	tdd
檻	jmm
檻	kmm
漉	ldl
椎	imf
椎	vmf
輾	nin
輾	vin
輾	zin
沪	hdh
沪	hdx
沪	ldh
沪	ldx
窪	wdt
醇	iyz
瘤	lbt
桅	wmv
喵	mkt
亥	hwr
渝	ydd
愜	qxn
淼	mdd
嚀	nkd
蛾	eid
篩	uvj
髻	jak
幌	hjg
箋	jvg
憧	ixa
梗	gmn
潁	ypa
瓢	pxg
余	yrh
殉	xdo
翟	dyf
翟	vyf
翟	zyf
盎	ama
瀕	bda
簧	hvb
饋	kub
孺	rza
伢	yrp
閩	mmi
楷	jmb
楷	kmb
亙	gaa
惴	vxa
瓚	zwb
筍	svo
咀	jkq
幺	yvs
蒜	scx
掂	dfk
杵	imu
瞑	mob
兗	ywe
峒	dek
峒	tek
頤	yka
曜	yof
螂	lie
毗	ptv
颶	jfb
纜	lsj
芥	jca
繽	bsb
蜿	wiv
翊	yly
卉	huc
屜	tuv
翱	aby
拴	ufw
湄	mdo
稠	ihk
樺	hma
鵲	qnc
咂	zkj
燎	lhx
諫	jyn
貯	vbd
猥	wqn
崢	vea
溯	sdo
佼	jrf
喋	dkm
喋	vkm
詡	xyy
渥	wdt
曝	bod
剃	tdb
鄴	yea
羔	ghy
匾	bkc
汲	jdn
鄔	wep
賂	lbk
煒	wha
錮	gjk
吠	fkq
鋤	ijl
蛤	gik
蛤	hik
藻	zcm
烹	phw
蹋	tzy
墾	ktv
迥	jzk
岐	qey
耷	dde
隘	aem
淬	cdu
嚅	rka
慵	yxa
烽	fhf
誨	hyd
橘	jmk
翌	yyl
濮	pdn
蟾	iiy
垣	yta
鍾	vja
抉	jfn
茬	ict
啷	lke
淇	qdb
硝	xuo
瀝	ldv
褥	rpc
踝	hzn
磯	jud
驍	xme
醞	yym
梓	zmu
唷	yko
玎	dwd
憬	jxx
靄	ayv
蕉	jch
眥	zov
墩	dtw
氈	vwm
蕃	bct
蕃	fct
弼	bag
肇	vha
闌	lmd
壟	ltl
晟	iov
晟	uov
呲	ckv
呲	zkv
毓	yrv
瘓	hbn
隴	lel
鰲	aaf
袒	tpa
諦	dyj
懺	ixd
拌	bfa
拌	pfa
臾	ypn
瀛	ydd
簪	zvo
懵	mxo
綸	gsc
綸	lsc
跤	jzf
胴	dok
浚	jdw
唏	xkj
筏	fvg
甥	unl
蝗	hiw
癩	lbb
甕	www
馱	dmd
馱	tmd
滌	ddm
捍	hfu
膺	ygo
銃	ije
芹	qcj
嘭	pkp
驥	jmb
炕	khj
匐	fgt
羌	qyv
娓	wnm
壕	htn
宓	fbd
宓	mbd
隼	sur
泌	bdp
泌	mdp
囁	nke
桔	jmk
圃	pkd
抒	ufa
穌	sah
甌	okw
鯉	laa
磐	puv
萃	ccu
魃	bgd
儂	nrn
訟	sys
萼	ecg
皎	jbf
簸	bvy
姒	snr
叼	dkp
茎	jcg
瞿	jof
瞿	qof
剁	ddj
篆	vvn
羲	xyg
騾	lms
鸚	ynb
蕙	hcx
隅	yed
瘸	qbr
炊	ihq
餉	xuk
輒	viv
嚶	ykn
頜	gra
頜	hra
腆	tob
嫖	pnx
惆	ixk
媲	pnv
餒	nun
娉	png
褒	bwy
旖	yfk
饞	iud
噘	jkq
呤	lks
縝	vsb
荃	qcw
捋	lfc
胥	xvo
潺	idz
卯	mep
嬋	ina
撅	jfq
涔	cdv
舫	fvf
柿	umj
偕	xrb
汩	gdo
汩	ydo
榨	vma
苞	bcv
冑	vao
冑	vyo
坍	ttw
麓	llm
鴎	onk
掬	jfm
礴	buc
軋	giv
軋	viv
軋	yiv
紂	vsc
澱	ddy
糜	mgm
曇	tos
壱	yuv
埔	btd
埔	ptd
訶	hyk
魘	yig
凋	ddk
蹂	rzm
荼	tch
鎊	bjf
鵡	wnq
臧	zga
褂	gpd
筐	kvw
紈	wsd
筵	yvv
軾	uid
蘑	mcu
潞	ldk
榆	ymd
灃	fdd
黔	qhv
玟	mww
玟	www
婊	bny
旌	jfa
痙	jbg
魑	igd
嫦	inj
卞	bdd
瘴	vbu
丕	paa
贄	vbt
襖	apd
礫	lum
攣	lus
麹	qfm
腋	yod
雋	jrg
躪	lzf
撂	lfk
偃	yrn
餡	xua
醺	xyh
嗥	hku
渭	wdo
閹	ymv
蟆	mid
盅	vma
沓	ddo
沓	tdo
榭	xmc
睞	lon
婀	enk
噠	dkz
嗇	sak
郢	yek
噼	pku
琬	wwv
栓	umw
冗	rbj
睚	yot
硫	luv
癖	pbu
霈	pyj
甭	baa
侏	vrn
皚	abd
拄	vfw
夙	sjd
渲	xda
秤	ihu
攫	jfy
岌	jen
遽	jzh
蛆	qiq
赧	nty
踵	vza
汴	bdd
鴇	bnp
剮	gdk
窈	ybl
潼	tda
靼	dga
瞼	jor
霽	jya
沅	yde
滷	lax
掰	bbu
攥	zfs
鷺	lnz
藕	ocd
顎	eka
蟄	vit
幔	mjy
靦	maj
篡	cvs
恣	zxd
蟠	pit
噌	cko
嬪	pnb
襠	dpt
哺	bkd
跚	uza
馥	fhw
孚	fzv
僖	xrk
窕	tbd
盂	yma
釗	vdj
囤	dkv
囤	tkv
喟	kko
跛	bzp
刨	bdg
刨	pdg
槌	imz
臊	som
苜	mco
渤	bdl
螳	tit
腎	uok
葷	hci
捎	ufo
鐳	ljt
糗	qmq
薯	uco
徨	hrw
蛻	tie
瑙	nwx
噫	ykx
鱉	bax
妤	yna
謫	vyk
賁	bbu
隗	keg
隗	weg
裟	uyd
擻	sfw
瀬	lda
絝	ksg
鰍	qah
戍	ugd
摹	mcu
塹	qti
綰	wsk
捱	aft
捱	afu
旎	nfv
諂	iya
謁	yyv
謐	mym
嚏	tkr
莧	xcj
慟	txl
粵	ypg
姣	jnf
姣	xnf
碳	tuh
殞	ydb
哂	ukx
齷	wit
啾	jkh
蹣	pzr
螻	lin
齪	iiz
娼	ino
揩	kfb
沂	ydj
舶	bvb
濘	ndd
啻	ilk
阜	fpu
弋	yqd
恪	kxk
蜃	uii
搪	tfk
轆	lil
挲	uud
娑	snd
嗝	gka
餃	juf
桉	amn
嶇	qek
杳	ymo
碾	nun
嫗	ynk
袈	jyl
賑	vbn
摒	bfc
孵	fpz
菡	hck
哐	kkw
羚	lys
撬	qfm
頡	jua
頡	xua
曄	yoa
罔	wkv
倜	trk
倌	grk
藐	mce
髦	mma
猊	nqe
汐	xdd
顰	pvu
臌	goy
獒	aqf
粼	lmv
杞	qmv
蚌	bif
鄲	dek
揄	yfd
竣	jlw
嗲	dkd
瞌	kom
胚	poa
慍	yxm
諳	ayo
恁	nxr
齜	ziv
啵	bkp
匍	pgd
膿	non
攆	nfi
痰	tbh
蛹	yia
覦	yrj
畿	jvt
殛	jda
泯	mdq
訛	eyv
潦	ldx
犁	lnh
苓	lcs
獷	gqb
俟	qru
俟	sru
鄺	keg
弈	ywc
囈	yks
汛	xdu
螓	qih
覬	jej
玷	dwk
瞰	kow
檳	bmb
椰	yme
垠	ytn
邕	yvv
臆	yox
鈦	tjd
挎	kfg
粱	lmd
涸	hdk
糯	nma
霾	mya
禧	xpk
俸	fra
箕	jvb
坷	ktk
祗	vpd
熹	xhu
俑	yra
慫	sxr
噙	qks
湍	tda
贛	glb
芋	ycu
噝	sks
瀲	ldw
噶	gkv
巽	xvb
汕	ude
仞	rrd
釜	ffa
鬃	zax
嗵	tkz
頎	qja
錨	mjt
螭	iid
洵	xdo
獁	mqm
珈	jwk
魍	wgv
摁	efx
疵	cbv
忤	wxu
汾	fdd
汜	sdv
琰	ywh
褸	lpn
惰	dxo
蚯	qia
斕	lwd
覲	jcj
梆	bme
漳	vdu
鐐	ljx
貽	ybk
粲	cma
恿	yxs
譎	jyk
咿	ykp
吒	vkq
簍	lvn
飈	bfh
簣	kvb
憩	qxp
橢	tmo
睥	bou
睥	pou
沽	gdk
犄	jnk
怏	yxn
魎	lgr
鼾	hpu
堰	ytn
齏	jwa
帚	vej
亟	jva
鍍	djy
驃	bmx
驃	pmx
苯	bca
宸	ibn
僮	tra
僮	vra
闐	tmb
欖	lmj
輦	nia
豺	ivp
翦	jqy
紕	bsv
紕	psv
閡	hmr
旃	vfw
犖	lhn
蚓	yia
趄	jzq
趄	qzq
蝟	wio
劾	hwl
趔	lzd
蜻	qio
嶸	rem
鋁	ljk
滇	ddb
呷	xka
暹	xzo
蠡	lvi
淄	zdt
圇	lkc
撣	dfa
撣	ufa
溉	gdv
坳	atl
軻	kik
皋	gbu
驁	amf
螃	pif
幀	vjb
蘅	hcd
剽	pdx
涓	jdo
魈	xgo
愴	ixk
袤	mwy
噯	akw
踊	yza
鐗	jjo
濡	rda
昀	yod
鷂	ynv
氳	yqm
廄	jgy
徙	xrr
瑁	mwo
籮	lvf
斡	wuu
摳	kfk
褶	vpb
痣	vbx
晾	lox
廿	naa
揶	yfe
燉	dhw
氤	yqd
蹩	bzx
芍	ucd
愫	sxs
玳	dwd
嗬	hkk
臼	jpa
淅	xdj
嘣	bko
檜	gmo
檜	hmo
腺	xod
壬	rpu
瘁	cbu
堇	jca
侗	drk
侗	trk
賃	lbr
匝	zkj
孱	iuz
灸	jph
襤	lpm
鏤	ljn
畸	jtk
碴	iua
羯	jyv
暨	jva
謗	byf
彝	yvc
嘹	lkx
雹	byv
忱	ixv
蔫	nch
荔	lcl
鮫	jaf
硅	gut
劊	gdr
悖	bxz
臍	qoa
驤	xmy
夥	had
盹	dov
孿	ljs
諄	vyz
殯	bdb
謅	vye
琊	ywe
勅	cal
勅	ial
禺	yad
罌	yfb
犢	dnb
灩	ydm
藜	lcd
蟑	viu
酈	lea
酈	vea
綏	ssn
訌	hyg
潢	gdb
潢	hdb
夔	kqw
橄	gmw
楨	vmb
酆	fee
淆	xdo
涮	udd
蝸	wik
垛	dtm
啕	tkf
孬	naz
臃	yof
澹	ddy
澹	tdy
耘	yls
徴	vrw
鑾	ljs
豚	ton
薊	jcd
汶	mdw
汶	wdw
皿	mka
遑	hzb
倨	jrk
燧	shz
佻	trd
詰	jyk
碉	duk
摞	lfs
鎬	gjk
鎬	hjk
誹	fya
掖	yfn
峋	xeo
戛	gag
戛	jag
蒯	kdc
叵	pkk
泗	sds
鄢	yea
鏖	alj
邋	lzv
舐	upq
獗	jqq
酉	yxa
煊	xha
嗟	jkg
忻	xxj
泱	ydn
蔻	kcy
蓁	vch
琮	cwx
遢	tzo
庖	pgv
幗	gja
璉	lwz
詆	dyd
驪	lml
荻	dch
遨	azf
儷	lrl
秧	yhn
怵	ixd
瘠	jbo
詮	qyw
忪	sxs
忪	vxs
鵠	hnn
卟	bkd
腴	yon
嶙	lea
犒	knk
撻	tfz
焊	hhu
鹸	jan
儻	trh
邇	eza
餿	suy
摺	ufb
摺	ufj
摺	vfb
摺	vfj
珩	hwd
葳	wcn
縐	vse
斫	vuj
跆	tzk
珉	mwq
泠	lds
忸	nxa
閂	uma
鴕	tnv
彗	hef
麝	ulc
耙	blv
耙	plv
岷	meq
鷥	sns
糉	zmw
蟈	gia
閎	hms
騖	wms
佝	grk
蜓	tiu
笆	bvv
怩	nxv
奐	hdn
掇	dfy
艮	gvn
舀	yva
膘	box
踮	dzk
匱	gkb
匱	kkb
濠	hdn
狒	fqa
宕	dbu
皖	wbe
燮	xyh
邙	mew
喙	hkn
莓	mcd
顓	vea
椿	imo
陲	iea
恫	dxk
鈸	bjd
檄	xmw
綃	xso
鰭	qao
槨	gme
僂	lrn
紓	usa
鷓	vng
弭	mge
漕	cdo
荑	tcn
荑	ycn
弐	ead
槿	jma
牒	dpm
鳶	ynq
礪	lud
雉	vuf
鴣	gnu
綹	lsk
橇	qmm
躋	jza
軼	yin
戊	wgp
猷	yqq
鍬	qjh
衾	qry
鉞	yjd
祚	zpa
閭	lmk
澇	ldl
滎	xdh
滎	ydh
逅	hzp
肪	fof
囪	cpx
洱	ede
峪	yek
鄱	pep
箬	rvk
嬡	anw
繇	yvs
莆	pcd
阪	bey
鑣	bjh
浹	jdn
佞	nrn
麋	mlm
搡	sfm
蘸	vch
撾	vfk
撾	wfk
岈	yep
唳	lkq
娣	dnp
愾	kxm
愾	xxm
戌	xga
幄	wjt
氫	qqg
霰	xyw
藺	lcf
驊	hma
蚱	via
諛	yyn
儔	irc
昶	ido
擼	lfo
狻	sqw
荏	rcu
磬	quu
昴	moe
杈	imd
閏	rmw
繕	usk
諺	yyp
龕	krl
鴆	vnd
讒	iyd
砥	dud
俎	zrq
瘀	ybd
邂	xzj
沏	qdd
邈	mzv
埠	btu
坯	pta
咭	jkk
咭	kkk
縉	jso
蹇	jbz
俾	bru
蜚	fia
箐	jvo
箐	qvo
籽	zmz
闞	hmw
闞	kmw
嗄	akw
嗄	ukw
鈉	njd
涇	jdg
腓	foa
駑	nmn
輟	iiy
鞅	ygn
蹶	jzq
迤	yzr
誚	qyo
嗶	bka
赳	jza
刎	wdg
聒	gek
抨	pfu
醃	ayv
醃	yyv
僉	qrr
炷	vhw
淙	cdx
餞	jug
堊	eta
磺	hub
鰻	may
釧	ija
氅	imx
胛	joa
遛	lzp
涿	vdn
酪	lyk
糠	kmn
翕	xry
姝	unn
佶	jrk
茴	hck
呔	dkd
呔	tkd
檬	mmn
衩	ipd
柩	jmn
懨	yxq
翳	yky
纂	zvs
奼	inq
滸	hdu
滸	xdu
跖	vzk
琨	kwv
鑠	ujm
鐫	jjg
佃	drt
佃	trt
鉅	jja
鉅	jjk
蒞	lcl
嗑	kkm
沱	tdv
羶	dya
羶	uya
楔	xmd
徇	xro
懣	mxd
豸	vvp
儆	jrw
貉	hvk
貉	mvk
潸	udo
仨	srs
訖	qyg
圜	hky
圜	yky
孀	uno
秣	mhn
蜍	iih
汨	mdo
檸	nmd
唁	ykk
舄	xph
呶	nky
戧	qrg
瓔	ywn
莜	ycw
瀘	ldm
謨	myd
椋	lmx
捫	mfm
聃	dea
轡	pks
逖	tzq
玀	lqf
剜	wdb
佰	brb
摑	gfa
綬	usy
茁	vck
罄	qfu
町	dtd
町	ttd
齙	biv
蛀	viw
誑	kyw
顴	qca
嵇	jhe
謾	myy
砝	fus
殮	ldr
脛	jog
螟	mib
玖	jwn
蛭	vit
祛	qps
裨	bpu
裨	ppu
贗	yib
氐	dpd
湫	qdh
葆	bcm
蒺	jcu
睇	dop
樽	zmc
絛	trs
涪	fdk
噛	nkk
鍥	qjd
懍	lxh
囡	nkn
蹴	czd
篙	gvk
葩	pcv
濯	vdf
矍	joy
溥	pdc
蘚	xcy
銓	qjw
盥	gmp
黜	ihk
覃	qxu
覃	txu
煅	dhy
謖	syw
坨	ttv
淞	sds
鋌	djz
鋌	tjz
犟	jng
璜	hwb
鈾	yja
駟	sms
樟	vmu
獼	mqx
菠	bcy
魷	yad
瘌	lbd
誥	gyk
滂	pdf
葭	jcy
槁	gmk
獐	vqu
欒	lms
飪	ruu
殄	tdp
櫛	vme
酵	jyz
噱	jkn
噱	xkn
醐	hyo
銼	cjt
崧	ses
砧	vuk
蔗	vch
犛	lan
犛	man
榷	qmf
泵	bud
嬙	qnk
槊	umq
醍	tyr
逡	qzw
贍	uby
鎏	ljd
鷙	vnt
灞	bdo
蓀	scs
騅	vmf
酗	xyx
咩	mky
箴	vvk
嘵	xke
蚤	zyi
罹	lsf
饃	mud
滓	zdu
鶚	enk
釉	ypa
櫺	lmk
賒	ubx
熨	yhu
塾	utw
瑗	ywy
錕	kjv
挹	yfv
夯	hdl
囫	hkp
詼	hyh
酡	tyv
痍	ybn
痿	wbn
絀	isk
莘	ucu
莘	xcu
歿	mdy
兕	sae
芻	ige
奘	vda
獬	xqn
箸	vvo
鍔	ejg
崴	wen
紜	yss
騫	qbm
鋥	zjw
蝮	fiw
柑	gmc
稈	ghu
圉	yku
馗	kjo
嶂	veu
莒	jck
臏	bob
薈	hco
豢	hbn
灝	hda
腡	lok
衢	qrd
仄	zir
鶻	gng
鶻	hng
痘	dbq
嚯	hkf
碇	dur
晷	gok
渚	vdo
磣	iup
蠣	lid
隍	hew
砣	tuv
諤	eyg
泅	qdr
駢	pmc
懋	mxm
仝	trg
稔	rhx
泫	xds
哞	mkn
乜	mgv
乜	ngv
誆	kyw
蓿	xcb
椏	yma
耒	lan
糅	rmm
烯	xhj
鐙	djd
貅	xvm
猱	nqm
犴	aqu
犴	hqu
紉	rsd
褓	bpm
蘄	qcj
偈	jrv
溧	ldm
訇	hgy
媾	gna
榛	vmh
郟	jea
葺	qce
鎩	ujy
蚨	fin
掾	yfn
靛	dfr
螯	aif
耦	old
萋	qcn
儈	kro
惲	yxi
徉	yry
枰	pmu
鶩	wns
褫	iph
琚	jwk
蜮	yik
抻	ifa
襁	qpi
遴	lzm
蓑	scy
皈	gby
娩	mnv
蝨	uvi
菟	tcd
閾	yma
觴	ujp
嚦	lkv
箝	qvc
狎	xqa
邳	pea
輊	vit
冪	mbj
阡	qeu
忝	tax
窳	ybg
貔	pvv
炅	goh
炅	joh
舢	uve
銖	vjn
糨	jmi
髭	zav
摶	tfc
沆	hdj
銑	xje
腩	nou
燴	hho
鍇	kjb
殫	dda
秸	jhk
碭	dup
氮	dqh
孑	jva
愎	bxw
睢	sof
邐	lza
薜	bcu
嘞	lkl
狴	bqt
悌	txp
猢	hqo
爻	yxx
牘	dpb
羸	lwd
囗	waa
攛	cfu
鶉	inw
緗	xso
餑	buz
嶷	yer
蒿	hck
蠑	rim
稹	vhb
雒	lwf
仃	drd
俅	qrd
狍	pqv
梏	gmk
橐	tam
韙	woa
櫓	lmo
鱈	xae
軫	vip
黢	qhw
徜	irk
桎	vmt
鬣	laa
擢	vff
肓	hwo
滝	ldv
滝	udv
鎦	ljt
咼	gkk
咼	hkk
咼	wkk
璺	wpw
鍘	vjd
碘	dub
鎂	mjd
倀	irn
琺	fws
輅	lik
嶗	lel
熗	qhk
祉	vpv
猻	sqs
榔	lme
鈣	gjg
媼	anm
琿	hwi
肛	gog
濂	ldn
芩	qcv
諉	wyn
鏃	zju
鼬	yua
臬	npm
岫	xea
氯	lqd
閬	lmn
箔	bvb
貊	mvb
澧	ldd
飩	tuv
蜇	vif
餛	huv
蜢	mim
鏞	yja
寮	lbx
蛔	hik
諢	hyi
酊	dyd
璁	cwx
驄	cmx
砒	puv
纛	dfs
楸	qmh
蟊	msi
煲	bhr
爿	pap
諶	iyv
諶	uyv
狷	jqo
聵	keb
媸	ini
摜	gfb
蛐	qia
莠	ycp
鎢	wjh
鏑	djk
懟	dxa
旮	gjo
酩	myk
韞	wam
韞	yam
詬	gyk
硭	muv
擯	bfb
蚋	rid
赭	vto
縶	vst
歃	upq
黷	dhb
耆	qto
闈	wma
嘬	zky
饗	xuv
茯	fcq
邴	bea
縟	rsc
騶	zme
訾	zyv
軲	gik
卅	saa
祆	xpd
鯀	gas
甯	nba
甯	nbd
蹉	czg
氨	aqn
遒	qzq
僭	jro
譙	qyh
倥	krg
孢	bzv
嵬	weg
謄	tby
旯	loj
妁	und
岬	jea
孛	buz
泖	mde
裾	jpk
櫚	lmk
莢	jcn
跎	tzv
囿	yko
悒	yxv
檑	lmt
諡	uym
讖	iyg
蚺	ria
痂	jbk
虺	hai
牯	gnk
鏜	tjt
煨	whn
飴	yuk
獾	hqf
眇	mop
閆	yms
伉	krj
祧	tpd
臚	lom
啖	dkh
鈷	gjk
揆	kfd
苻	fcc
鏨	zji
鼴	yun
闃	qmq
笞	ivk
豕	uan
耄	mtm
擷	xfa
欏	lmf
痔	vbc
菀	wcv
菀	ycv
嫫	mnd
蟋	xix
拮	jfk
暝	mob
巋	kej
闋	qmd
滁	idh
弁	bsc
弁	byu
荇	xcd
逶	wzh
蚪	diu
喑	yko
蟀	uiu
嘁	qkx
糸	mav
糸	mvx
糸	sav
糸	svx
煢	qhu
壎	xth
獺	tqb
觥	gje
晗	hok
蝌	kiu
俚	lra
磔	vum
墒	utk
搽	ifm
灤	ldm
姘	pnc
湎	mda
螫	uit
螫	vit
畹	wtv
笮	zva
飭	iul
菅	jck
肱	gos
徠	lrn
傈	lrm
汞	ggd
蓐	rcc
徭	yrf
鱔	uak
巰	qav
鰈	dam
鉚	mje
剡	udh
剡	ydh
猁	lqd
柚	yma
逑	qza
捭	bfu
臠	lwr
鬈	qav
噲	kko
鉑	bjb
挈	quf
綣	qsv
躚	xzz
璦	aww
鋮	ijv
炻	uhu
癬	xby
顥	hoa
裱	bpy
蕤	rca
悱	fxa
猞	uqk
賅	gbr
楹	ymm
恚	hxt
濰	wdf
衽	rpu
貘	mvd
釺	qju
凼	dkd
蜉	fiz
粕	pmb
鈿	djt
鈿	tjt
淶	ldn
雩	yyg
鯽	jae
儺	nrf
蒔	ucc
斛	hju
珙	gwb
紇	gsg
紇	hsg
筅	xve
胰	yon
蓽	bca
燾	dhu
燾	thu
慪	oxk
櫟	lmm
櫟	ymm
謳	oyk
洌	ldd
觜	zjv
瘙	sbi
唿	hkx
繯	hsy
戕	qvg
鍀	djc
埂	gtn
拊	ffc
訐	jyu
螈	yix
鋅	xju
郗	xex
仵	wru
烊	yhy
篁	hvw
搴	qbu
獍	jqe
杷	pmv
膾	koo
醴	lyd
鸝	lna
邰	tes
郜	gen
纊	ksb
堞	dtm
鷸	yns
牝	pnv
湟	hdw
酃	ley
冼	xde
氦	hqr
鋃	ljn
篾	mvd
縵	msy
杌	wme
硌	guk
硌	luk
騮	lmt
碣	juv
碣	yuv
鏊	ajf
虻	miv
膂	lof
咴	hkh
縞	gsk
蕎	qck
傯	zrx
暾	tow
窨	xbo
窨	ybo
鼐	ngv
幃	wja
洮	tdd
胱	goe
鉉	xjd
鱘	xac
竦	sln
虢	gvh
椽	imn
韭	jaa
佤	wrw
蕨	jcq
獪	kqo
屐	juy
癯	qbf
鰓	sax
萇	icn
侔	mrn
腚	dor
腱	joz
圻	qtj
圻	ytj
癆	lbl
眙	iok
眙	yok
竽	yvu
縊	ysm
轔	lia
尜	gxx
趺	fzn
塋	yht
蝰	kit
囹	lks
洇	ydd
黿	yev
芫	yce
齎	jwa
宥	ybo
樘	tmt
酶	myd
墉	yta
嘌	pkx
恂	xxo
罅	xfu
鑷	nje
椴	dmy
彀	guy
洹	hda
盱	xou
噻	skt
旄	mfm
犍	jnz
犍	qnz
庹	tgn
欹	qdq
珥	ewe
吡	bkv
吡	pkv
攖	yfn
狃	nqa
褳	lpz
鏍	ljs
圩	wtu
圩	xtu
鉻	gjk
饈	xua
嶧	yeu
餾	lut
搠	ufo
炔	qhn
踟	izk
鼉	tkv
仟	qru
鵪	and
戡	kqg
苫	uck
襦	rpa
擀	gfu
孌	lns
昃	zor
蕘	rce
齦	kin
齦	yin
燜	mhx
諍	vya
嶠	jek
嶠	qek
犰	qqj
蟥	hib
蹼	pzn
殳	ujy
妣	bnv
楫	jme
燹	xha
繾	qsz
厴	yia
傣	drd
狁	yqe
帔	pjp
錳	mjm
圄	ykk
痢	lbd
嵯	ceg
樨	xmn
紆	ysu
畲	urt
瘐	ybn
齶	evg
瓴	lrw
蠹	dai
襝	lpr
鄆	yeb
柞	vma
砦	vvu
杼	vma
闥	tmz
鞽	qgk
芨	jcn
蛉	lis
騏	qmb
吖	aka
吖	yka
癭	ybn
笳	jvk
鄖	yek
黟	yhd
舛	ipa
鉀	jja
憷	ixr
稞	khn
頦	kwa
佚	drn
佚	yrn
苡	ycr
勐	mzl
淖	idu
淖	ndu
淖	vdu
澍	udc
澍	vdc
勖	xkl
鉸	jjf
褡	dpk
詵	uye
薨	hcv
濉	sdf
檫	imx
郇	heg
郇	xeg
騭	vme
鳧	fnj
埡	yta
罨	ysv
邗	hea
鈀	bjv
搦	nfd
薺	jca
薺	qca
喁	ykd
枋	fmf
潯	xdc
煸	bhc
矽	xud
苕	tck
苕	uck
謇	jby
垓	gtr
沔	mdv
粑	bmv
蝓	yid
躅	vzi
杴	xmq
瀣	xda
迓	yza
杓	bmd
杓	umd
喈	jkb
烷	whe
礬	fum
緇	zst
蜊	lid
陘	xeg
堠	htu
鄯	uey
幛	vju
愀	qxh
瓤	rwg
蕈	xcu
躑	vze
鯢	nae
剄	jda
怫	fxa
羆	phh
坩	gtc
焙	bhk
氰	qqo
澠	mdv
澠	udv
疥	jba
肜	rop
厶	svd
氟	fqa
鯫	zay
瘧	nba
瘧	yba
笫	zvp
褰	qby
痼	gbk
鮭	gat
鮭	xat
黍	uhd
沭	udd
緡	mso
菸	ycd
菸	yhd
慳	qxt
皰	ppv
衿	jpv
艏	uvo
裎	ipw
孳	zqz
庠	xgy
旒	lfv
栳	lmv
蘢	lcl
鬮	jav
亳	bwq
艨	mvn
邛	qeg
麂	jlj
尻	kuj
檣	qmk
豌	wdv
踽	jzd
鱸	lam
艄	uvo
眭	got
眭	sot
陂	bep
陂	pep
櫸	jma
氖	nqp
笏	hvp
廩	lgh
怛	dxa
蚍	piv
鐃	nje
殍	pdz
澩	xdp
淝	fdv
菘	scs
蒹	jcn
忉	dxd
桁	hmd
疹	vbp
蝣	yiz
喱	lka
妊	rnu
萑	hcf
擘	buu
逋	bza
堝	gtk
苒	rca
鍺	vjo
嗩	skb
讕	lyd
歙	urq
歙	xrq
焯	ihu
焯	vhu
矬	cut
疽	jbq
艟	iva
躉	dcz
躕	izc
藎	jcm
縻	mgs
亍	iea
佧	krd
叻	lkl
趿	tzn
勰	xlx
嘏	guy
桫	smp
儕	ira
痾	ebk
痾	kbk
痾	obk
痾	vbk
翥	vty
蠔	hin
鯁	gan
雎	jqf
穀	guy
蔦	ncn
觚	gjg
鬩	xae
洄	hdk
焓	hhk
跗	fzc
猗	yqk
胺	aon
鶘	hnu
笤	tvk
蹕	bza
鈥	hjh
鏹	qji
饢	nuy
瘍	ybp
篦	bvv
鵜	tnb
踅	xzf
棼	fmd
睾	gpu
鸛	gnc
漭	mdc
烴	thg
瞽	gou
逄	pzw
鋶	ljv
哚	dkm
砬	lul
蝥	mis
鉦	vjv
陟	vep
耋	dtt
酮	tyk
塄	ltf
癇	xbo
蚧	jia
塒	utc
枸	gmk
枸	jmk
柢	dmd
柢	imd
瀠	yds
笄	jvc
醮	jyh
彖	tvn
稗	bhu
窠	kbn
萘	ncx
郯	teh
掮	qfo
尢	yuv
鮎	nak
鼙	puu
畦	qtt
舸	gvk
帑	njn
帑	tjn
睃	sow
蚜	yip
溘	kdm
蠃	lwd
岢	kek
矸	guu
鴟	inp
狳	yqh
祜	hpk
囟	xpx
扦	qfu
櫪	lmv
庾	ygn
菔	fcy
蟛	pip
嗉	sks
擤	xfa
莪	ecd
覡	xgj
醪	lyp
倬	vru
爰	yvy
蚰	yia
轤	lim
錙	zjt
鬻	yga
鰥	gad
栲	kmg
淥	ldd
蛄	gik
嬗	una
諮	zkd
諮	zyk
鋈	wjd
閽	hmo
杲	gom
柘	vmu
毖	bad
禳	rpy
饌	vub
鰩	yaf
鱒	zac
耔	zlz
輥	giv
鎳	njm
侑	yro
娠	unn
槎	img
芾	fcj
豳	bea
鈐	qjv
錒	ajk
孥	nzn
綦	qqs
銻	tjp
洙	vdn
榫	smu
疣	ybd
砭	bun
筮	uvr
釅	yyw
愆	qxr
梔	vmv
耪	plf
薅	hcc
蜞	qib
崤	xeo
櫝	dmb
糝	ump
茇	bcd
啁	tkk
啁	vkk
氪	kqe
萁	qcb
齟	jiq
墀	itn
芪	qcq
莰	kcq
菏	hck
嵊	uen
蛩	qig
韉	jgh
楂	ima
楂	vma
縋	vsz
乩	jav
捌	bfd
毽	jmz
愍	mxv
瘢	bby
鉍	bjp
鏵	hja
髖	kgd
鶿	cnq
儋	dry
奩	ldk
樾	ymv
滹	hda
穡	shk
茌	icu
骶	dgd
刖	ydo
嫜	vnu
溏	tdk
螽	vwi
囝	jkz
戽	hhu
橛	jmq
舂	ifa
遄	ize
坭	ntv
澶	ida
熵	uhk
鑊	hjy
飧	spu
樅	cmr
樅	zmr
柙	xma
硎	xud
繒	zso
蔌	scq
魴	faf
冱	hda
嶴	ape
殂	cdq
艉	wvm
蠼	qiy
匏	pdv
癰	ybf
鹺	cag
尕	ggx
攮	nfy
樗	img
皸	jbp
髡	kae
坻	dtd
坻	itd
傖	crk
傖	irk
剴	kde
椐	jmk
瓠	hdg
訃	fyd
髁	kgn
齬	yik
彘	vvv
棹	vmu
癘	lbd
藪	scw
隈	wen
齲	qid
朐	iok
朐	qok
櫞	ymn
芰	jcy
壙	ktb
敉	mwm
暌	kod
餳	xup
泔	gdc
賾	zkb
黧	lhh
篳	bva
蓖	bcv
鸕	lnh
蜆	xij
醯	xym
鈧	kjj
饜	yiu
鴰	gnp
哏	gkn
哏	hkn
甑	zbw
疋	pvr
膣	vot
螅	xix
錁	kjn
髫	tak
宄	gbj
摭	vfh
檠	qmc
盍	hmt
紱	fsd
騸	umy
棰	ima
縭	lss
苷	gcc
蹁	pzc
鋏	jjn
鞣	rgm
圯	ytv
涑	sdn
箜	kvg
芎	xcg
蔟	ccu
觶	vja
鍪	mjs
鏇	xjr
夤	ypb
嬀	gnh
熘	lht
硼	puo
秫	uhd
閼	emd
颮	bfv
囀	vkc
枳	vmb
礅	duw
耨	nlc
茭	jcf
鋇	bjb
捩	lfq
柁	dmv
柁	tmv
苴	icq
苴	jcq
鉈	tjv
寤	wbk
牖	ypd
貲	zbv
醚	myz
檉	imw
櫨	lmm
肄	ypa
脘	woe
酎	vyc
鯧	iao
柒	qmd
浠	xdj
螄	sij
壅	ytw
枇	pmv
楱	zmd
焐	whk
秭	zhp
笥	svk
茈	ccv
茈	zcv
蔞	lcn
譫	vyy
跏	jzk
鏌	mjd
怙	hxk
枵	xmg
痱	fba
膈	goa
卮	vpv
圊	qko
圮	ptv
堀	kte
氚	iqa
皴	csp
紿	dsk
蟮	uik
邡	fef
廡	wgh
廨	xgn
鈄	dju
觳	huy
閌	kmj
檗	bmu
漯	lds
漯	tds
瓿	blw
眚	uno
芴	hcp
芴	wcp
詁	gyk
郴	ime
鰳	lal
俁	yrd
徼	jrw
橈	nme
橈	rme
楗	jmz
莨	lcn
酰	xye
讎	iyf
讎	qyf
嚳	kpk
撳	qfq
笊	vvv
苧	nca
苧	ncd
苧	vca
苧	vcd
黥	qhx
僳	srm
芏	dct
菖	ico
蓊	wcy
袢	ppa
饉	juf
巹	jvv
壚	ltm
旆	pfj
曛	xoh
汊	idd
硒	xux
穣	rhy
粳	jmn
釃	uyl
鯛	dak
鶼	jnq
塬	ytx
曩	noy
萵	wck
蕞	zcy
櫱	nem
憮	wxh
歟	ypq
玢	bwd
玢	fwd
蕖	qcm
鎰	yjm
厝	cio
坶	mtd
屣	xur
揎	xfa
榧	fma
芑	qcv
鎣	yjh
鈑	bjy
鬲	gaa
鰾	bax
鞀	tgk
仂	lrl
婺	wns
嫠	lan
憒	kxb
癍	bbw
癔	ybx
碓	duf
篋	qvn
缶	fff
缶	frk
缶	gff
缶	grk
蘧	qcz
妗	jnv
襆	fjn
漚	odk
痦	wbk
蛑	min
詈	lsy
鈈	bjd
鐋	tjp
鋯	gjk
丌	jaa
峴	xej
梘	jmj
柰	nmx
浜	bdb
蓼	lcp
蛞	kik
鄣	vel
僨	frb
藿	hcf
酢	cya
酢	zya
銦	yjd
錛	bjc
閶	imo
驂	cmp
鮃	pau
檁	lmh
燔	fht
猓	gqm
蘼	mca
趵	bzd
酲	iyw
鷯	lna
乇	tpv
乇	vpv
屙	euk
揸	vfa
磧	qub
笸	pvk
賡	ggb
鄄	jex
銥	yjy
黻	fad
伲	nrv
緙	ksg
蜣	qiv
蜩	tik
諞	pyc
鈹	pjp
傴	yrk
儐	brb
揠	yfn
昝	zwo
溽	rdc
胙	zoa
萏	dca
隹	vrf
麈	vlw
妯	vna
孓	jvn
溱	qdh
溱	vdh
碚	buk
蕺	jca
鋝	ljc
鑭	ljd
髀	bgu
坫	dtk
崍	len
戢	jkg
糌	zmo
纈	xsa
邶	bea
坼	itd
梃	tmz
瞢	mco
縲	lss
菽	ucy
豉	idy
仳	prv
堙	ytt
忭	bxd
砷	uua
筌	qvw
簞	dva
艿	ncp
郅	vea
鰱	laz
鰨	tay
厙	uii
噦	hkp
噦	ykp
廑	jga
廑	qga
敫	jwb
櫳	lml
癜	dby
碹	xua
磙	guy
籩	bvz
篪	ivh
緦	ssx
苣	jca
苣	qca
蕁	qcc
蕁	xcc
諏	zyy
諑	vyn
釩	fjd
嗍	sko
櫧	vmo
欷	xxq
淦	gdj
甏	bwu
胝	vod
蓍	uco
蛺	jin
裉	kpn
輳	cid
顳	nea
麩	fan
娌	lna
椹	umv
椹	vmv
繅	ssm
翮	hay
詒	dyk
詒	yyk
郾	yek
銫	sjv
鋰	lja
鞫	jgy
卣	yaa
圬	wtg
尥	ljd
槲	hmu
氘	dqa
瘻	lbn
耩	jla
軔	rid
迨	dzs
饊	suw
啉	lkm
圪	gtg
廴	tvn
濼	ldm
熳	mhy
璩	qwn
胗	vop
蓯	ccr
薹	tck
薹	tct
鍩	njk
閿	wmy
鯿	bac
唑	zkt
溻	tdy
瘰	lbs
硨	iui
砩	fua
羝	dyd
茺	ice
蘺	lcf
俳	pra
刳	kdd
唣	zkq
悝	kxa
悝	lxa
慊	qxn
瘳	ibp
茼	tck
麇	jlh
麇	qlh
黽	mav
嗾	sku
嵛	yed
榪	mmm
狨	rqu
狺	yqk
痧	ubp
碸	fuf
綞	dsa
芡	qcq
蕷	yca
頇	haa
槭	qmx
槭	smx
溲	sdy
痤	cbt
眄	mov
餈	csd
餈	cud
葚	ucv
鄶	ger
鄶	ker
酹	lyc
钁	jjy
隳	dex
隳	hex
鶓	mnc
嘜	mkd
嬖	bnu
怍	vxa
朊	roe
涫	gdk
緄	gsv
胼	poc
腧	uod
葑	fcc
蠓	min
躓	vzb
韝	gaa
飫	yud
刈	ydx
塏	ktd
嵴	jeo
幘	zjb
旰	gou
旰	hou
畚	bst
葒	hcg
萸	ycn
蘩	fcs
頏	hwa
顢	mca
鴝	qng
龠	yrc
嘸	okv
嗌	akm
嗌	ykm
疸	dba
硤	xun
紲	xsv
耬	lln
蚴	yil
蛸	xio
裰	dpy
謦	qyu
跣	xzp
踺	jzz
逯	lzv
陔	ger
凇	sds
堋	bto
堋	pto
屨	jun
峁	mee
廛	igt
栝	gmk
栝	kmk
栝	tmk
磴	dud
篌	hvu
芘	bcv
芘	pcv
葸	xcx
薏	ycx
踔	izu
鄞	yec
醢	hym
鉺	eje
鑔	ijx
鯪	law
仉	vrj
侉	krg
桄	gme
泮	pda
燠	yhn
皤	pbt
糲	lmd
蹀	dzm
顙	sya
鯗	xay
唪	fka
嗪	qkh
掭	tfx
畈	fty
簦	dvd
綈	tsp
胍	gog
胲	hor
艫	lvm
鋣	yje
錈	jjv
鮒	fac
崮	gek
庋	ggy
毳	cmm
箅	bva
縑	jsn
菹	zcq
蠆	ici
誶	syu
貺	kbe
隉	neg
隰	xeh
僬	jrh
匭	gkj
垧	utk
疔	dbd
肭	nod
蝤	qiy
諼	xyy
趑	zzq
軛	eiv
酐	gyu
醅	pyk
醑	xyo
醛	qyw
錟	tjh
劂	jdi
壠	ltl
悛	qxw
戥	dog
拶	zfd
礆	jua
筧	jvj
簟	dvu
蓴	icc
蒴	uco
藁	gcm
詿	gyt
讜	dyh
讞	yyq
邾	vep
陴	peu
鬏	jah
齔	iiv
剞	jdd
劬	qgl
埸	ytp
嬲	nnl
嶁	len
搿	gru
柝	tmd
桴	fmz
洧	wdo
浯	wdk
疝	ube
笱	gvk
肽	tod
舯	vva
艋	mvm
芤	kcv
葙	xco
鮪	wao
鴯	ena
佾	yro
墁	mty
嫘	lns
櫬	imj
煳	hho
硪	wud
礞	mun
菰	gcg
蚵	eik
趲	zzb
躦	zzb
鉬	mjo
鯡	faa
匚	kav
呋	fkn
媵	yon
崦	yev
楝	lmn
潲	udo
獯	xqh
瘵	vbx
紺	gsc
紼	fsa
莩	fcz
觫	sjn
輞	wiv
鐔	iju
鐔	tju
鐔	xju
髂	qgk
鬯	ikv
鷚	lny
亓	qea
劓	ydp
埕	itw
曷	hov
洚	jda
碲	duj
磲	qum
糶	tef
鞝	usk
芄	wcd
酚	fyd
鉿	hjk
鉿	kjk
髕	bgb
鰣	uac
俜	prg
劌	gdv
唚	qky
垤	dtt
枘	rmd
氽	trd
溷	hdn
甍	mcw
笪	dva
胬	nrn
舨	bvy
芟	ucy
蒽	ecx
銎	qjg
銨	ajn
鍶	sjx
骱	jga
鵒	ynb
岣	gek
岵	hek
懌	yxu
慝	txk
撟	jfk
掎	jfk
毹	urm
汆	crd
沲	ddv
湔	jdd
甙	dcq
罟	gsk
羼	iuy
菝	bcd
詎	jya
詘	qyk
譖	zyo
賚	lba
郄	qex
郄	xex
鐾	bju
鱟	hpa
啶	dkr
塍	iot
屺	qev
庥	xgm
掊	pfk
撙	zfc
柃	lms
檎	qmd
毿	ssm
瀋	udt
砘	duv
窶	jbn
肟	wog
蔸	dce
蚶	hic
蟶	iiw
躞	xzy
酯	vyo
鍰	hjy
餼	xum
勱	mcl
嘧	mke
嵫	zes
擐	hfy
湓	pdm
蝻	niu
蠖	hiy
觖	jjn
跬	kzt
鱖	gaq
鱖	jaq
仡	grg
仡	yrg
垌	dtk
垌	ttk
氆	pmo
氌	lmo
汔	qdg
篼	dve
緱	gsu
舾	xvx
蕕	ycq
蟯	nie
蠛	mic
蠲	jqi
褊	bpc
醣	tyk
駘	tmk
倮	lrn
僦	jrd
崾	yen
渫	xdm
瘞	ybt
簀	zvb
肼	joa
膃	wom
臁	lon
舳	vva
羋	maa
荽	scn
蕢	kcb
蠐	qia
袼	gpk
跫	qzg
遘	gza
儇	xry
埽	stj
庀	pgv
戇	gxl
戇	vxl
扃	jhk
搛	jfn
杪	mmp
浼	mdv
滏	fda
瓞	dgn
疃	tta
砟	vua
磽	que
禊	xpd
篥	lvm
簋	gvm
綮	qsh
苤	pca
踣	bzk
躐	lzv
酴	tyh
鉭	tja
鍤	ija
鎪	sjy
閫	kmm
鞔	mgv
鯖	qao
鷦	jnr
黲	chp
黼	fad
榀	pmk
榘	jmu
榘	jua
氵	uda
澮	hdo
澮	kdo
炱	tsh
煺	thz
犋	jnb
礱	llu
秕	bhv
秈	xme
耜	slk
肀	yva
肫	iov
肫	vov
肷	qoq
胂	uoa
莛	tcu
襉	jpo
逭	hzb
釙	pjd
釕	lja
鈽	bjj
髑	dgi
鰒	faw
鼯	wuk
佴	ere
佴	nre
吲	yka
幬	cjc
幬	djc
幬	ijc
搌	vfn
擗	pfu
桷	jmj
氡	dqd
氬	yqa
溴	xdq
畋	twt
硐	duk
餱	hmu
腠	cod
葶	tcd
袷	qpk
陬	zey
黌	hdb
齠	tik
嚌	jka
埴	vtq
岜	bev
徂	cra
惝	ixk
惝	txk
烀	hha
眢	yop
瞵	loa
筇	qve
簏	lvl
薌	xce
蝽	iio
蟪	hix
郫	pep
釹	njn
鈁	fjf
鎘	gja
鏝	mjy
顬	rya
黹	vad
壢	ltv
埤	ptu
廾	gaa
彳	ipa
楦	xma
氙	xqe
澌	sdj
畛	vtp
疳	gbc
癉	dba
砉	hfu
砉	xfu
砹	aux
碡	vud
穸	xbd
纘	zsb
羥	qyg
膦	loa
菪	dcu
虼	gig
蛘	yiy
蟎	mir
裼	tpp
裼	xpp
迕	wzr
鈰	ujj
鋨	ejd
鋦	jjk
鍃	hjx
鎵	jjn
鐓	djw
鐿	yjx
霪	yyu
騍	kmn
鵓	bnu
囅	ikn
哿	glk
噍	jkh
埝	ntx
弳	jgg
攉	hff
浞	vdz
瀦	vdo
畀	bta
糴	drf
罱	lsu
羰	tyh
腖	don
胩	kod
舴	zva
苊	ecv
茆	mce
茛	gcn
蕆	icb
蟣	jid
蠊	lin
裒	pwy
襞	byu
覘	iaj
軺	yik
鎄	ajy
髹	xam
鶇	dna
哌	pkn
垸	hte
垸	yte
埏	utv
埏	ytv
墼	jta
帙	vjn
悃	kxm
揲	ufm
晡	bod
榍	xmo
榱	cmy
殪	ydd
淠	pda
漤	ldn
癧	lbv
砑	yup
繰	qsm
繰	ssm
罘	fsd
藶	lcv
萆	bcu
諗	uyx
鄹	zee
酞	tyd
鍆	mjm
銩	djs
鎇	mjo
髟	bap
鱺	lal
鰷	tam
鰉	haw
鷳	xnm
鸌	hny
埒	ltc
崬	den
愨	qxu
攵	wpx
桊	jbm
桕	jma
槔	gmu
漵	xdw
漶	hdx
牾	wnk
畎	qtq
癤	jbe
矧	uua
稂	lhn
窀	vbv
籀	vvt
腈	joo
苄	bcd
薷	rca
褙	bpo
賻	fbc
跽	jzx
釤	ujp
錆	qjo
鎿	nju
饔	ywu
驏	imz
鱅	yaa
坌	btb
宀	bdv
氍	qom
潙	wdh
洫	xdx
澉	gdw
瀹	ydc
爨	cph
珧	ywd
瘊	hbu
瞍	soy
硇	nux
筘	kvk
粢	cmd
粢	zmd
聹	ned
舁	ypc
艚	cvo
荸	bcz
蜱	piu
釷	tjt
銱	djj
銚	djd
銚	tjd
銚	yjd
骺	hgk
鱝	fab
劐	hdc
哳	vkj
唼	ukn
忮	vxy
恝	jxf
戔	jgg
槧	qmi
瘕	jby
瘕	xby
瘛	ibx
瘼	mbd
祓	fpd
窆	bbn
窬	ybd
篚	fva
粞	xmx
羧	syw
脬	poz
艽	jcj
艽	qcj
葜	qcd
蓰	xcr
覿	duj
豇	jdg
軹	vib
醵	jyn
鈮	njv
鐨	fjb
阼	zea
鞴	bga
鮁	bad
鮚	jak
垵	atn
夂	wpn
恧	nxa
憝	dxw
搋	ifh
氕	pqp
洳	rdk
湞	vdb
濞	bda
濞	pda
礤	cux
聱	aef
艹	caa
蟓	xin
襻	ppu
趼	jzc
迮	zzr
釓	gjv
銣	rjk
鐠	pjo
駔	zmq
鰹	jat
鰵	mar
鵂	xrn
嚆	hkk
堍	ttv
嶝	ded
巛	vvv
廒	agw
榿	qmd
櫫	vma
爝	jhc
甾	zvt
痄	vba
癀	hbb
筲	uvo
籜	tvu
罾	zso
耵	ded
艤	yvd
蕒	mcb
蕹	wcf
誄	lyn
贐	jbm
蹯	fzt
釔	yjg
鈳	kjk
銪	yjo
鏷	pjn
鱭	jaa
鯔	zat
鱧	lad
鶥	mnv
塥	gta
庳	bgu
怊	ixk
捃	jfk
揞	afo
揞	yfo
洎	jdo
潿	wda
灄	ude
猸	mqo
甓	pwu
瘃	vbn
瞀	mos
砼	tug
礓	jua
綆	gsn
耱	mlu
脎	som
脒	mom
脞	cot
萜	tck
蕻	hcb
薤	xca
躒	lzm
轢	lim
鐦	kjc
鋟	qjy
餷	iua
鮐	tak
鯇	hae
仫	mrs
垡	ftr
堖	ntx
岍	qec
崞	gez
棖	imn
毪	mmn
牮	jnr
癃	lba
瞘	kok
眵	iod
稃	fhz
筢	pvv
腙	zox
舭	bvv
菥	xcj
蜾	gin
螬	cio
螵	pix
衄	nxa
譾	jyy
躔	izt
郛	fev
酤	gyk
鉕	pjk
錇	pjk
鑹	cju
阢	wee
鼷	xud
劁	qdr
埭	dtn
墚	ltm
攄	ufx
撖	hfw
泐	ldl
潷	bda
牿	gnk
犏	pnc
猹	iqa
猹	vqa
疰	vbw
痃	xbs
瘂	yba
瘥	cbg
瘥	ibg
磉	sum
箢	yvv
籪	dvj
繢	hsb
緶	bsn
耥	tlk
脲	nod
膪	iol
膪	vol
苠	mcq
茳	jcg
薟	lcr
薟	xcr
蒎	pcn
蒡	bcf
虍	haq
螗	tik
貰	ubc
軎	iak
醌	kyv
醭	byn
鐒	ljl
錸	ljn
鑥	ljo
阽	dek
馘	gqk
鯴	uai
鵯	bnp
鼽	qpj
傺	irx
勹	bpv
喹	kkt
戤	ggg
攴	vay
瀵	fdb
#level1
#level2
#other
○	lvv
⺕	jga
〇	loo
㐖	jgv
㑇	vre
㑊	yrd
㑩	lrd
㑳	vre
㓤	jdu
㓥	tde
㓥	tdx
㕮	fkx
㕮	tkx
㕵	wkw
㖞	wkn
㗎	gkm
㗎	jkm
㗾	xkb
㘎	hkw
㘚	hkw
㙍	dty
㙘	ytn
㙦	xtr
㚻	jtn
㛃	jnf
㛚	tna
㛹	pnn
㜺	znb
㞎	bub
㞹	kek
㟃	sek
㠇	jed
㠓	men
㤘	vxe
㥄	lxw
㥮	vxe
㧐	sfy
㧑	wfd
㧟	kfk
㨃	dfz
㨃	ifz
㨘	xfo
㨢	bfb
㩒	qfx
㩧	bfu
㩳	sfy
㫰	lon
㬊	hoy
㬎	xho
㬚	iow
㭎	gmx
㭕	qms
㮾	lmd
㰀	lmd
㳇	fdx
㳘	ide
㳚	ydd
㳠	ddz
㴔	sdx
㴔	ydx
㵐	jdq
㶲	yha
㶶	nhn
㷫	hhh
㸆	kha
㸌	hha
㹢	jqk
㹴	gqn
㺄	yqd
㻬	twv
㽏	gdc
㿠	hbg
䁖	lon
䁪	voj
䂮	lfu
䃅	duu
䃎	vud
䅟	chp
䌹	jsk
䎃	ray
䎖	zby
䏝	vod
䏡	uox
䏲	dop
䏲	top
䐃	jok
䓖	qcl
䓛	fce
䓛	gce
䓛	qce
䓨	ycf
䓫	qck
䓬	vcu
䗖	dij
䗛	xij
䗪	vgi
䗴	tiz
䜣	xij
䜣	yij
䝙	ivk
䟴	vzy
䢛	jzk
䢺	iee
䢼	gec
䣘	tex
䥺	yjp
䥽	pjd
䦃	vjo
䲟	yae
䲠	iyo
䲢	toy
䴉	hns
䴓	una
䴔	jnw
䴕	lnd
䴖	jnf
䴗	jno
䴘	tnp
䴙	pnu
䶮	yld
丏	mag
丑	iva
专	vad
业	yaa
丛	car
东	dad
丝	sav
丢	dps
两	lad
严	yai
丧	sun
个	gra
丰	faa
临	laa
为	wld
丼	dad
丽	lad
举	jxa
乂	ypn
么	mps
么	yps
义	yxd
乌	wpa
乐	lpd
乐	ypd
乔	qpa
乘	ipn
乘	upn
习	xga
乡	xvp
书	uvd
买	mvd
乸	nxd
亂	lvv
于	yau
亏	keg
云	yes
亘	gaa
亚	yaa
亞	yaa
产	ilp
亩	mwt
亲	qlm
亵	xwy
亶	dwa
亸	dwa
亹	mwq
亹	wwq
亿	yrg
仅	jry
仆	prd
仇	irj
仇	qrj
从	crr
仑	lrv
仓	crv
仪	yrd
们	mrm
价	jra
仿	frf
伈	xrx
伋	jrn
众	vrr
优	yrd
伙	hrh
伛	yrx
伞	sru
伟	wra
传	ird
传	vrd
伣	qrj
伤	url
伥	irn
伦	lrv
伧	crv
伧	irv
伪	wrd
伫	vra
伭	xrd
伾	pra
佁	irk
佁	yrk
佖	brp
佛	fra
佢	qra
佣	yra
佥	qra
併	brc
佸	hrk
佺	qrw
佽	crq
侁	ure
侂	trq
來	lan
侘	irq
侠	xrn
侣	lrk
侥	jre
侥	yre
侦	vrb
侧	crd
侧	vrd
侧	zrd
侨	qra
侩	krs
侪	ira
侬	nrn
侴	hrd
侹	trz
俊	jrw
俍	lrn
俔	qrj
俙	xrj
俣	yrd
俥	iri
俦	irc
俨	yri
俩	lrd
俪	lrd
俫	lrn
俭	jra
修	xrp
俵	bry
俶	iry
俶	try
倈	lrn
倓	trh
倕	ira
倞	jrx
倞	lrx
借	jro
倣	frw
値	vrv
倧	zrx
倴	brc
债	vrb
倻	yre
倾	qra
偁	ira
假	jry
偓	wrt
偡	vrv
偬	zrx
偭	mra
偯	yry
偰	xrd
偲	srx
偺	zro
偻	lrn
偾	frb
偿	irs
傃	srx
傉	nrc
傒	xrd
傕	jrf
傕	qrf
傚	xrw
傥	tre
傧	brb
储	iro
傩	nrf
傳	irc
傳	vrc
僇	lrp
僎	vrc
僔	zrc
僜	dra
僩	xro
僰	bra
僵	jra
價	jrb
儅	drt
儉	jrr
儦	brh
儳	ird
儴	rry
儴	xry
儸	lrf
儿	epv
克	kue
兑	dbe
兒	epe
兖	ywe
兩	lar
兰	lqe
兲	twb
关	gqd
兴	xxb
兹	cqs
兹	zqs
养	yya
兽	ubk
冁	ibn
内	nad
冇	muk
冈	gkx
冊	caa
冏	jkk
冔	xoa
冚	kbe
军	jbi
农	ndn
冧	lbm
冬	dwd
冮	gdg
冯	fdm
冯	pdm
冲	ida
决	jdn
况	kde
冻	ddd
净	jda
凄	qdn
准	vdf
凉	ldx
凌	ldw
减	jdk
凑	cdd
凓	ldm
凘	sdj
凛	ldx
几	jpg
凤	fjy
凫	fnj
凭	pjr
凯	kej
凶	xkx
齣	ivk
击	jak
凿	zau
刍	ide
划	hdg
刘	ldw
则	zdb
刚	gdk
创	idr
删	udp
别	bdk
刬	idg
刭	jdv
刮	gdp
制	vdp
刹	idx
刹	udx
刽	gdr
刿	gde
剀	kde
剂	jdw
剅	lda
剐	gdk
剑	jdr
剒	cdc
剕	fda
剗	idg
剟	ddy
剥	bde
剦	ydd
剧	jdu
剩	udp
剷	idl
劄	vdv
劍	jdr
劏	tdx
劑	jdw
劝	qyl
办	bld
务	wwl
劢	mal
动	del
劲	jvl
劳	lcl
劻	kkl
劼	jul
势	ulf
勋	xkl
勍	qwl
勔	mal
勗	xol
勚	ycl
勛	xkl
勞	lhl
勠	lyl
勣	jfl
勦	ivl
勦	jvl
勩	ycl
勳	xpl
勵	lil
勸	qcl
匀	yga
匜	yky
匦	gkj
匮	gkb
匮	kkb
匼	kkk
匼	qkk
匽	ykn
區	okk
區	qkk
千	qpu
升	upc
卌	xaa
卍	wxx
华	hur
协	xud
卐	wxx
单	dba
单	iba
单	uba
卖	mud
卜	bad
占	vak
卢	lau
卤	lax
卧	wkd
卫	wea
卬	aep
卬	yep
卲	ued
却	qeu
卷	jbv
卺	jvv
厂	iap
厅	tid
历	lil
厉	lip
压	yid
厌	yiq
厍	uii
厕	cid
厕	sid
厖	mip
厘	lia
厢	xio
厣	yia
厦	uiw
厦	xiw
厨	iic
厩	jiv
厮	sij
厾	dgs
县	xqs
叁	sss
参	csp
参	usp
參	csp
參	usp
叆	aey
叇	dez
发	fvd
叕	jyy
叕	lyy
叕	vyy
叕	yyy
变	bwy
叙	xry
叚	jvy
叚	xvy
叠	dyq
只	vkb
台	tsk
叶	xku
叶	yku
叹	tky
叽	jkj
吁	xku
吁	yku
吅	skk
吅	xkk
合	grk
合	hrk
吊	dkj
吋	ckv
同	tkk
后	hpk
向	xpk
吓	hkd
吓	xkd
吔	ykx
吕	lkk
吗	mkm
吣	qkx
吨	dkv
听	tkj
启	qhk
吴	wkd
吽	hkn
呇	qdk
呎	ikn
呐	nkd
呒	okv
呓	ykg
呕	okx
呖	lkl
呗	bkb
员	ybk
呙	gkd
呙	hkd
呙	wkd
呛	qkv
呜	wka
呣	mkd
呣	okd
呣	vkd
周	vpk
呪	vke
呯	pku
咁	gka
咇	bkx
咈	fka
咉	ykn
咍	hkk
咏	ykn
咑	dkd
咗	zkg
咙	lkl
咛	nkd
咝	ska
咡	eke
咤	vkq
咥	dkt
咨	zkd
咲	gkd
咸	xgk
咹	akn
咹	ekn
咹	vkn
咺	xka
咽	ykd
哃	tkk
哄	hkb
哋	dkx
响	xkk
哑	yka
哒	dkz
哓	xke
哔	bku
哕	hkd
哕	ykd
哗	hku
哙	kks
哜	jka
哝	nkn
哟	ykd
哢	lkc
哣	dka
哣	pka
哱	bkz
哱	pkz
哷	lkc
唇	iik
唎	lkd
唓	iki
唛	mkw
唝	gkb
唝	hkb
唞	dku
唞	tku
唠	lkl
唡	lkr
唢	skb
唤	hkn
唥	lks
唦	ukp
唵	akv
唶	cko
啋	ckm
啗	dka
啞	yka
啟	qwh
啢	lkr
啣	xke
啧	zkb
啩	gkd
啫	uko
啫	vko
啬	suk
啭	vkd
啮	nkk
啯	gkw
啰	lkd
啱	nou
啱	you
啲	dkd
啴	ika
啴	tka
啸	xka
啹	kkk
喂	wkn
喆	vuk
喎	wkk
喐	yek
喤	hkw
喨	lkj
喫	ikd
單	dka
單	ika
單	uka
喯	bkc
喷	pkb
喺	xox
喽	lkn
喾	kxk
嗊	gkb
嗊	hkb
嗐	hkk
嗞	zkd
嗫	nky
嗮	sky
嗰	gkk
嗱	nku
嗳	aky
嗹	lkz
嗻	vkh
嘅	gke
嘐	xkp
嘓	gka
嘘	uka
嘘	xka
嘚	dkc
嘡	tkt
嘢	yka
嘤	ykn
嘥	skr
嘩	hku
嘽	ika
嘽	tka
噀	xkc
噁	ekx
噁	wkx
噂	zkc
噃	bkt
噇	ika
噉	dkw
噏	hky
噏	xky
噜	lko
噪	zkm
嚄	hky
嚄	oky
嚐	iko
嚙	nkv
嚚	ykk
嚟	lkd
嚣	xkk
嚭	puk
嚲	dwa
嚴	ykw
囃	zkf
囉	lkf
囌	skh
囍	xuk
囑	vki
囜	nks
回	hkk
团	tkp
囧	jkk
园	yke
困	kkm
囱	cpd
围	wka
囵	lkv
囷	qkh
囸	rkv
图	tkd
圆	ykb
圈	jkv
圈	qkv
國	gka
圌	ika
圍	wka
圐	kkf
圓	ykb
圖	tkk
團	tkc
圙	lka
圢	ttd
圣	uty
圫	vtq
圫	ytq
圲	qtu
圹	ktg
场	itp
坂	bty
坉	dtv
坉	ttv
坋	btd
坋	ftd
坏	htd
坐	ztr
坒	bat
块	ktn
坚	jta
坛	tts
坜	ltl
坝	btb
坞	wta
坟	ftw
坠	vte
坥	qtq
坬	gtg
坰	jtk
坽	lts
垄	ltl
垅	ltl
垆	ltu
垈	dtr
垍	jto
垎	htk
垏	lta
垒	lts
垕	hpt
垙	gtg
垚	ytt
垞	itq
垟	yty
垦	ktv
垩	eta
垫	dtf
垭	yta
垯	dtz
垱	dte
垲	ktv
垴	ntk
垺	ftz
垺	ptz
垾	htu
垿	xta
埆	jtj
埆	qtj
埇	yta
埌	ltn
埗	btp
埘	utc
埙	xtb
埚	gtd
埞	dtr
埪	ktg
埫	itk
埫	utk
埯	atv
埵	dta
埼	qtk
堃	ktf
堉	yto
堌	gtk
堎	ltw
堐	ytt
堑	qti
堧	rtd
堨	atr
堨	etr
堨	vtr
堨	ytr
堲	jtv
堼	ftt
堽	gtv
堾	ito
塀	ptc
塃	htv
塅	dty
塆	wtg
塈	jtv
塚	vtn
塝	btf
塤	xtb
塭	wtm
塮	xtc
塱	ltd
塽	utx
墈	ktl
墐	jta
墑	dtk
墕	yth
墘	qtg
墙	qtk
增	zto
墡	utl
墣	ptn
墦	ftt
墮	dte
墮	hte
墶	dtz
壋	dtt
壓	yit
壗	jtm
壘	ltt
壞	hty
壤	rty
壪	wtg
壯	vdu
壳	kuj
壳	quj
壶	hua
壸	kua
壹	yud
壼	kua
壽	uuc
处	iwd
备	bwt
复	frw
夐	xdw
够	ggd
夫	fan
夬	gvn
头	tdd
夸	kdg
夹	gan
夹	jan
夺	ddc
夼	kda
奀	ead
奀	nad
奁	ldx
奂	hdn
奅	pde
奋	fdt
奓	idd
奓	udd
奓	vdd
奖	jdd
奡	aaa
奧	apd
奭	udb
奸	jnu
妆	vdn
妇	fne
妈	mnm
妘	yns
妠	nnr
妧	wne
妧	yne
妩	wnv
妪	ynx
妫	gnd
妭	bnd
妳	nnx
姅	bna
姈	lns
姗	una
姜	jyn
姞	jnk
姤	dnk
姤	gnk
姪	vnt
姮	hna
姱	hnv
姱	knv
姶	enk
姶	ynk
姹	inq
姽	gnv
娀	sng
娄	lmn
娅	yna
娆	rne
娇	jna
娈	lwn
娘	nnn
娱	ynd
娲	wnr
娴	xnm
娵	jny
婌	uny
婍	qnk
婘	jnv
婘	qnv
婞	xnu
婠	wnk
婤	ink
婤	vnk
婥	inu
婫	hnv
婫	knv
婳	hnk
婴	ynb
婵	ina
婶	sna
婻	nnu
婼	rnk
媂	dnj
媂	tnj
媄	mnd
媆	nnd
媆	rnd
媓	hnw
媖	ynn
媞	tnr
媪	anm
媭	xnp
媯	gnh
媱	ynf
嫄	ynx
嫐	nnn
嫑	ban
嫑	man
嫒	any
嫔	pnb
嫕	ynx
嫚	mny
嫪	lnp
嫭	hnu
嫱	qnk
嫲	mng
嫻	xnm
嫽	lnx
嫿	hna
嬃	xnp
嬛	hny
嬛	qny
嬛	xny
嬝	nny
嬥	tnf
嬬	rna
嬷	mns
嬿	ynh
孃	nny
孅	qig
孅	xig
孖	mzz
孖	zzz
孙	szx
孪	lwz
學	xzp
宁	nbd
实	ubd
宠	ibl
审	uba
宧	yba
宪	xbe
宫	gbk
宬	ibv
家	jbn
宽	kbj
宾	bbb
寀	cbm
寁	zbr
寢	qby
實	ubb
寫	xbh
寬	kbd
寶	bbb
对	dyc
寻	xec
导	dvc
將	jdc
專	vac
對	dac
尐	dxn
尔	edx
尘	itx
尝	ixs
尧	yae
尨	lud
尨	mud
尨	pud
尪	wuw
尫	waw
尴	gjm
尸	uvp
尽	jud
局	juk
层	cus
屃	xbu
屄	bub
屆	jua
屉	tuv
屌	duj
屓	xbu
屘	muz
屝	fua
屡	lun
屦	jun
屬	uui
屬	vui
屮	iva
屼	wee
屾	uee
屿	yea
岁	sed
岂	qev
岊	jve
岖	qex
岗	gex
岘	xej
岙	ape
岚	lef
岛	dne
岞	zea
岠	jek
岨	jeq
岩	yeu
岭	les
岽	ded
岿	kee
峂	ted
峃	xxe
峄	yea
峗	wev
峘	hea
峛	led
峣	yee
峤	jea
峤	qea
峥	vea
峦	lwe
峧	jef
峰	fef
峱	nqe
峽	xen
峿	wek
崀	len
崁	keq
崂	lel
崃	len
崄	xea
崌	jek
崒	cei
崒	zei
崙	lrc
崚	lew
崟	yej
崡	hek
崭	vej
崶	fec
崿	eev
嵁	kev
嵁	vev
嵅	heg
嵎	yed
嵖	iea
嵘	rem
嵚	qeq
嵝	len
嵲	nem
嶅	afe
嶍	xeb
嶒	ceo
嶓	bet
嶔	qeq
嶟	zec
嶢	yee
嶦	uek
嶦	vek
嶨	xep
嶮	xer
嶲	geg
嶲	jeg
嶲	xeg
嶽	yeq
巅	dea
巇	xeg
巉	iev
巖	yew
巢	ivn
巨	jka
巩	ggd
巯	qvv
币	bpj
布	buj
帅	uaj
师	uaj
帏	wja
帐	vjn
帘	lbj
帜	vjb
帟	ywj
帡	pjc
带	dfj
帧	vjb
帨	uje
席	xgj
帮	bjf
帱	cjc
帱	djc
帱	ijc
帶	dfj
帻	zjb
帼	gjw
幂	mbj
幖	bjx
幞	fjn
幪	mjn
干	gau
并	bqc
幸	xtu
广	gdi
庄	vgt
庆	qgd
床	igm
庐	lgh
庑	wgv
库	kgi
应	yga
庙	mga
庞	pgl
废	fgd
庤	vgc
庱	igw
庵	agv
庼	qga
廆	ggg
廆	hgg
廆	wgg
廋	sgy
廎	qga
廕	ygs
廙	ygc
廢	fgy
廣	ggb
廪	lgx
廳	tgx
开	kac
异	yvc
弃	qwc
弆	jtc
弇	yrc
弍	eed
弑	uxd
张	vgn
弢	tgy
弥	mgx
弦	xgs
弨	igk
弪	jgg
弯	wwg
弶	jgx
弸	pgo
弹	dga
弹	tga
强	jgi
强	qgi
彆	bgx
彈	dga
彈	tga
彊	jga
彐	jva
归	gae
当	dxe
彔	lvd
录	lvd
彙	hvn
彟	hey
彠	hey
彦	ylp
彧	ykd
彩	cvp
彻	ird
彿	fpa
彿	fra
征	vrv
徑	jrg
徕	lrn
徛	jrk
從	crr
御	yre
徬	prf
徵	vrw
德	drx
忆	yxg
忏	ixu
志	vxu
忞	mwx
忞	wwx
忧	yxd
忳	dxv
忳	txv
忳	vxv
念	nxr
忺	xxq
忾	kxq
忾	xxq
怀	hxd
态	txd
怂	sxr
怃	wxv
怄	oxx
怅	ixn
怆	ixv
怗	txk
怜	lxs
总	zxb
怼	dxy
怿	yxa
恆	hxa
恓	qxx
恓	xxx
恔	jxf
恔	xxf
恤	xxx
恳	kxv
恶	exa
恶	wxa
恸	txl
恹	yxq
恺	kxv
恻	cxd
恼	nxk
恽	yxi
悆	urx
悆	yrx
悈	jxg
悈	kxg
悗	mxv
悢	lxn
悦	yxe
悫	qxu
悬	xxq
悭	qxt
悯	mxw
悰	cxx
惇	dxz
惊	jxx
惎	jqx
惓	qxv
惔	dxh
惔	txh
惗	nxx
惙	ixy
惛	hxo
惛	mxo
惠	hxa
惡	exa
惡	wxa
惧	jxb
惩	ixr
惫	bxw
惬	qxn
惭	cxj
惮	dxa
惯	gxb
惱	nxx
愃	xxa
愈	yxr
愐	mxa
愒	kxv
愔	yxo
愠	yxm
愤	fxb
愦	kxb
愬	sxb
愭	qxo
愿	yix
慆	txa
慇	ypx
慑	uxy
慓	pxx
慘	cxp
慥	zxz
慬	jxa
慬	qxa
慭	yax
憕	dxa
憕	ixa
憕	vxa
憖	yxa
憙	xux
憭	lxx
憺	dxk
應	ygx
懑	mxd
懒	lxb
懔	lxx
懞	mxn
懞	mxx
懷	hxy
戀	lxs
戆	gxl
戆	vxl
戋	jad
戏	xyg
戗	qrg
战	vag
戙	dkg
戚	qgx
戣	kvg
戬	jag
戭	ybg
戰	vkg
戱	xhg
戲	xhg
户	hdu
戾	lhq
扂	dhk
扅	yhd
扆	yhy
扊	yhh
才	cap
扎	vfv
扑	pfd
托	tfq
扞	hfu
扣	kfk
执	vfd
扩	kfg
扪	mfm
扫	sfe
扬	yfp
扰	rfd
扱	xfn
扺	vfq
扽	dfv
抃	bfd
抆	mfw
抆	wfw
抌	vfe
抔	pfx
折	ufj
折	vfj
抚	ffv
抛	pfl
抟	tfd
抠	kfx
抡	lfv
抢	ifv
抢	qfv
护	hfh
报	bfy
抦	bfr
抬	tfk
抵	dfd
拂	ffa
拃	vfa
拏	nun
拐	gfl
拑	qfc
拔	bfd
拜	buf
拟	nfr
拢	lfl
拣	jfd
拤	qfd
拥	yfa
拦	lfs
拧	nfd
拨	bfd
择	vfa
择	zfa
挂	gft
挓	vfq
挙	jxu
挚	vuf
挛	lwu
挝	vfz
挝	wfz
挞	tfz
挠	nfe
挡	dfe
挢	jfa
挣	vfa
挤	jfa
挥	hfi
挦	xfc
挨	afu
挽	wfv
挾	jfn
挾	xfn
捞	lfl
损	sfb
捡	jfa
换	hfn
捣	dfe
捨	ufk
据	jfk
捯	dfd
捲	jbv
捲	jfv
捵	dfb
捵	nfb
捽	zfu
掞	ufh
掞	yfh
掤	bfo
掳	lfl
掴	gfw
掷	vfe
掸	dfa
掸	ufa
掹	mfm
掺	ifp
掺	ufp
掺	xfp
掼	gfb
插	ifa
揕	vfv
揗	ufo
揭	jfv
揭	qfv
揳	xfd
揼	dfd
揽	lfj
揾	wfm
揿	qfq
搀	ifd
搁	gfk
搂	lfn
搅	jfj
搆	gfa
搊	ife
搒	bff
搒	pff
搔	sfi
搖	yff
搜	sfy
搣	mfa
搲	wfg
搵	wfm
携	xfp
搾	vfa
摄	nfy
摄	ufy
摅	ufx
摆	bfs
摇	yff
摈	bfb
摊	tff
摏	ifa
摛	ifs
摴	ifv
摽	bfx
撄	yfn
撏	xfc
撑	ifu
撚	nfh
撝	wfh
撢	dfu
撵	nfi
撷	xfa
撸	lfo
撺	cfa
擇	vfu
擇	zfu
擊	jui
擓	kfk
擔	dfk
據	jfn
擝	mfm
擞	sfw
擣	dfc
擭	hfy
擴	kfb
擽	lfm
擿	tfz
擿	vfz
攒	cfb
攒	zfb
攝	nfe
攝	ufe
攪	jfj
攰	gul
攰	lul
收	uwv
攽	bbw
效	xww
敌	dwp
敔	yww
敕	iwa
敛	lwr
敠	vyy
敩	xxw
數	uwa
斆	xwp
斋	vwa
斓	lwd
斗	ddu
斝	jku
斠	jcu
斩	vij
斶	iji
斷	dsj
旐	vfd
旞	sfz
无	mav
无	wav
旴	xoa
旵	ioe
时	uoc
旷	kog
旸	yop
旻	mow
旿	wou
昄	boy
昆	kov
昈	hoh
昉	fof
昒	hop
昙	tos
昡	xod
昣	vop
昤	los
昪	boc
昫	xok
昳	don
昳	yon
昵	nov
昺	bor
昽	lol
显	xoa
晅	xoa
晊	vot
晋	jao
晐	gor
晒	uox
晓	xoe
晔	you
晕	yoi
晖	hoi
晙	jow
晚	wov
晝	vva
晞	xoj
晢	vof
晪	tob
晫	vou
晱	uoh
暂	zoi
暅	xoa
暍	hov
暕	jon
暕	lon
暗	aoo
暘	yop
暧	aoy
暲	vou
暵	hod
暶	xor
暸	lox
暿	xok
曆	lio
曈	toa
曉	xoe
曌	vog
曏	xoe
曚	mon
曨	lol
曱	gka
曲	qaa
曾	cbo
曾	zbo
會	hro
會	kro
朏	foe
朏	koe
朓	tod
朘	jow
朮	umd
术	umd
朱	vpn
朳	bmb
朴	pmd
朸	lml
机	jmj
杀	uxm
杂	zjm
权	qmy
杄	qmu
杆	gmu
杕	dmd
杗	mwm
杙	ymd
杠	gmg
杧	mmw
杨	ymp
杩	mmm
杯	bmd
杰	jhm
杻	ima
杻	nma
松	sms
板	bmy
极	jmn
构	gms
枅	jmc
枍	ymv
枓	dmu
枞	cmr
枞	zmr
枣	zad
枥	lml
枧	jmj
枨	imn
枪	qmv
枫	fmf
枭	xnm
枱	cmk
枱	smk
枱	tmk
枲	xsm
枹	bmv
柈	bma
柈	pma
柊	vmd
柖	umk
柜	gma
柜	jma
柠	nmd
柤	vmq
柮	vme
柷	ime
柷	vme
柽	imt
栀	vmv
栅	cma
栅	uma
栅	vma
标	bmx
栈	vmg
栉	vme
栊	lml
栋	dmd
栌	lmi
栎	lmd
栎	ymd
栏	lms
栐	ymn
树	umc
栒	xmo
栖	qmx
栖	xmx
栗	lxm
栘	ymd
栟	bmc
栴	vmd
样	ymy
核	hmr
栻	umd
栾	lwm
桝	jma
桠	yma
桡	nme
桡	rme
桢	vmb
档	dme
桤	qmv
桥	qma
桦	hmu
桧	gms
桧	hms
桨	jmd
桩	vmt
桯	tmw
桯	ymw
桲	bmz
桹	lmn
梁	lmd
梂	qmd
梌	imh
梌	tmh
條	trm
梠	lmk
梡	kme
梣	img
梦	mmd
梱	kmm
梲	vme
梴	imz
梴	ymz
梹	bmb
梼	dmc
梼	imc
梼	tmc
梽	vmx
梾	lmn
梿	lmz
检	jma
棁	vme
棂	lmh
棐	fam
棓	bmk
棓	pmk
棡	gmk
棤	qmo
棧	vmg
棨	qhm
棪	ymh
棫	ymg
棬	jmv
棬	qmv
棶	lmn
棻	fcm
棽	img
棽	umg
椀	wmv
椁	gmz
椆	dmk
椆	imk
椆	vmk
椑	bmu
椓	vmn
椟	dmd
椠	qmi
椤	lmd
椪	pma
椭	tmo
椸	ymv
楒	smx
楙	mmm
楛	hmk
楛	kmk
楩	pmn
楪	dmm
楪	ymm
楯	dmo
楯	umo
榃	tmt
榄	lmj
榅	wmm
榇	imm
榈	lmk
榉	jma
榑	bmc
榑	fmc
榖	guy
榣	ymf
榮	rhm
榰	vmo
榲	wmm
槃	pmv
槚	jmb
槛	jmm
槛	kmm
槜	zmg
槟	bmb
槠	vmo
槤	lmz
槥	hme
槫	qmc
槫	tmc
槫	umc
槱	imh
槱	ymh
樂	lmv
樂	ymv
樓	lmn
樞	umk
樢	wnm
樣	ymn
横	hmb
樫	jmt
樯	qmk
樱	ymn
橑	lmx
橞	hmx
橥	vmq
橦	ima
橦	tma
橱	imc
橹	lmo
橼	ymn
橾	qmm
橾	umm
檞	jmn
檟	jmb
檢	jmr
檩	lmx
檮	dmc
檮	imc
檮	tmc
檵	jmv
檾	qhm
櫂	vmf
櫂	ymf
櫆	kmu
櫈	dmj
櫻	ymn
欂	bmc
權	qmf
欐	lml
欞	lmr
欢	hyq
欤	yaq
欲	ybq
欸	asq
欸	esq
欸	vsq
欻	ihq
欻	xhq
歅	yxq
歎	tcq
歐	okq
歔	xhq
歜	isq
歡	hcq
步	bvp
歴	liv
歷	liv
歸	gpe
歼	jdu
殁	mdy
殇	udp
殒	ydb
殓	lda
殘	cdg
殚	dda
殡	bdb
殣	jdf
殼	kuy
殼	quy
毁	hpy
毂	guy
毆	oky
毌	gvu
毌	wvu
每	mrd
毐	aup
毕	bua
毙	bav
毚	idd
毡	vmk
毬	qmd
毵	ssm
氇	lmo
气	qrv
氢	qqg
氣	qrm
氩	yqa
氲	yqm
氹	ddg
氹	tdg
氿	gdj
氿	jdj
汇	hdk
汈	dda
汉	hdy
汋	qdd
汋	vdd
汍	wdd
汎	fdd
汙	wdu
汤	tdp
汧	qdc
汫	jda
汭	rdd
汹	xdk
沄	yds
沇	yde
沈	udv
沊	ddd
沍	hda
沒	mdy
沖	ida
沘	bdp
沚	vdv
沟	gds
沣	fdf
沤	odx
沥	ldl
沦	ldv
沧	cdv
沨	fdx
沩	wdd
沬	mdn
沺	tdt
泂	jdk
泃	jdk
泇	jdk
泙	pdu
泛	fdn
泞	ndd
注	vdw
泪	ldo
泶	xxd
泷	ldl
泷	udl
泸	ldu
泺	ldd
泻	xda
泼	pdd
泽	zda
泾	jdg
洁	jdk
洑	fdq
洒	sdx
洩	xdp
洴	pdc
洸	gde
洼	wdt
浃	jdn
浆	jdd
浇	jde
浈	vdb
浉	udj
浊	vdi
测	cdd
浍	hds
浍	kds
济	jda
浏	ldd
浐	idi
浑	hdi
浒	hdu
浒	xdu
浓	ndn
浔	xdc
浛	hdk
浥	ydv
浬	ldt
涂	tdh
涉	udp
涛	tdc
涝	ldl
涞	ldn
涟	ldz
涠	wda
涡	gdr
涡	wdr
涢	ydb
涣	hdn
涤	ddm
润	rdw
涧	jdo
涨	vdn
涩	sdv
淀	ddr
淒	qdn
淚	ldq
淨	jda
淴	hdx
淺	qdg
渊	yda
渋	sdd
渌	ldd
渍	zdb
渎	ddd
渐	jdj
渑	mdv
渑	udv
渔	yda
渖	uda
渗	udp
渢	fdf
温	wdm
渴	kdv
游	ydz
湉	tdk
湜	udr
湧	ydl
湿	uda
溃	kdb
溅	jdg
溆	xdy
溈	wdh
溪	xdd
溮	udj
溳	ydb
滉	hdg
滗	bdm
滚	gdy
滟	ydv
滠	udy
满	mdd
滢	ydw
滤	ldx
滥	ldm
滦	ldm
滨	bdb
滩	tdf
滪	ydb
滯	vdj
滻	idf
滿	mdr
漓	lds
潆	yds
潇	xda
潋	ldw
潍	wdf
潛	qdo
潴	vdo
澜	ldd
澤	zdu
澦	yda
澾	ddz
濆	fdb
濑	ldb
濒	bda
濛	mdn
濟	jda
濬	jdo
濱	bdb
濾	ldx
瀍	idt
瀧	ldl
瀧	udl
瀨	ldb
瀰	mdx
灏	hda
灠	ldj
灣	wdg
灧	ydv
灭	mah
灵	leh
灶	zht
灾	zbh
灿	che
炀	yhp
炆	whw
炖	dhv
炜	wha
炝	qhv
炼	lhd
炽	ihb
烁	uhd
烂	lhs
烃	thg
烚	xhk
烛	vhi
烜	xha
烝	vhv
烟	yhd
烦	fha
烧	uhe
烨	yhu
烩	hhs
烫	thd
烬	jhd
热	rhf
烱	jhk
焌	jhw
焌	qhw
焕	hhn
焖	mhx
焗	jhk
焘	dhf
焘	thf
焜	khv
焠	chu
煆	xhy
煉	lhd
熏	xhp
燈	dhd
燊	uhm
燒	uhe
營	yhk
燬	hhy
燶	nhn
燻	xhh
爐	lhm
爟	ghf
爭	vva
爱	avy
爷	yfe
牍	dpd
牠	tnx
牤	mnv
牦	mnm
牵	qdn
牺	xnx
犇	bnn
犊	dnd
犧	xnd
状	vdq
犷	gqg
犸	mqm
犹	yqd
犺	kqj
狈	bqb
狉	pqa
狝	xqx
狞	nqd
狮	uqj
狯	kqs
狰	vqa
狱	yqq
狲	sqx
狹	xqn
猃	xqa
猎	lqo
猕	mqx
猡	lqd
猪	vqo
猫	mqt
猬	wqo
獎	jdq
獨	dqi
獫	xqr
獭	tqb
獮	xqx
獴	mqn
獵	lqv
獸	ukq
獻	xhq
玑	jwj
玕	gwu
玘	qwv
玙	ywa
玛	mwm
玠	jwa
玥	ywo
玦	jwn
玮	wwa
环	hwd
现	xwj
玱	cwv
玱	qwv
玺	xdw
珅	uwa
珐	fws
珑	lwl
珢	kwy
珢	ywy
珣	xwo
珮	pwj
珰	dwe
珲	hwi
珺	jwk
琇	xwp
琍	lwd
琏	lwz
琐	swb
琤	iwa
琭	lwd
琼	qwx
瑄	xwa
瑲	cwk
瑲	qwk
瑶	ywf
瑷	awy
璈	aww
璎	ywn
璟	jwx
璠	fwt
璫	dwt
璵	ywb
璿	xwo
瓒	zwb
瓣	bgu
瓫	pbw
瓮	wbw
瓯	okw
甦	saa
甦	saf
甴	zka
电	dav
畅	iap
畑	tht
畫	haa
畬	urt
畬	yrt
畴	itc
當	dxt
疊	dtq
疖	jbe
疗	lba
疟	nba
疟	yba
疠	lbp
疡	ybp
疬	lbl
疮	ibv
疯	fbf
疱	pbv
疴	kbk
症	vbv
痈	yba
痉	jbg
痒	yby
痖	yba
痨	lbl
痪	hbn
痫	xbm
痺	bbu
痺	pbu
瘅	dba
瘗	ybt
瘘	lbn
瘦	uby
瘪	bbv
瘫	tbf
瘭	bbx
瘾	ybx
瘿	ybn
癞	lbb
癣	xby
癫	dba
發	fvy
皂	zbq
皑	abv
皕	bab
皱	vdp
皲	jbp
盉	hmh
盏	vmg
盐	ymt
监	jma
盖	gmy
盘	pmv
盜	dmd
盡	jmv
盦	amr
盪	dmd
眍	kox
眛	mon
眦	zov
眾	vsr
睁	voa
睐	lon
睑	joa
睒	uoj
睪	gsu
睺	hou
瞇	moz
瞒	mod
瞓	foa
瞓	xoa
瞜	lon
瞩	vod
瞭	lox
瞶	kob
矩	jua
矫	jua
矶	juj
矻	kug
矾	fud
矿	kug
砀	dup
码	mum
砆	fun
砖	vud
砗	iui
砚	yuj
砜	fuf
砢	luk
砲	piv
砵	bia
砺	lup
砻	llu
砾	lud
础	iuk
硕	uua
硖	xun
硗	que
硚	qua
确	quj
硵	lux
硷	jua
碁	qqu
碍	auc
碎	suu
碔	wud
碛	qub
碜	iup
碥	buc
碱	juk
磑	wud
磠	lux
磡	kul
磾	dua
礄	quk
礌	lut
礒	yud
礵	uio
祂	tpx
祃	mpm
祇	qpq
祇	vpq
祊	bpf
祎	ypa
祐	ypk
祕	bpp
祕	mpp
祢	mpx
祫	xpk
祯	vpb
祷	dpc
祸	hpd
禀	bwx
禄	lpd
禕	ypa
禘	dpj
禚	vph
禡	mpm
禪	ipa
禪	upa
禮	lpd
离	lwd
私	shs
秃	thj
秆	ghu
秋	qhh
种	iha
种	vha
积	jhb
秽	hhd
秾	nhn
稆	lhk
税	uhe
稖	phk
稜	lmw
稣	sah
稱	iha
稳	whx
稻	dha
穇	chp
穎	ypa
穑	shk
穗	shx
穠	nhn
穩	whx
穫	hhy
穭	lho
穰	rhy
穷	qbl
窍	qbg
窑	ybf
窜	cba
窝	wbd
窣	sbu
窥	kbj
窦	dbd
窭	jbn
窸	xxb
竊	qbs
竑	hls
竖	ula
竚	vld
竞	jle
笃	dvm
笋	svp
笔	bvm
笕	jvj
笺	jvg
笼	lvl
笾	bvz
筊	jvx
筑	vvd
筚	bvu
筛	uvj
筝	vva
筴	jvn
筹	ivc
筻	gvn
签	qva
简	jvo
箇	gvk
箓	lvd
箦	zvb
箧	qvn
箨	tva
箩	lvd
箪	dva
箫	xva
篑	kvb
篓	lvn
篠	xvm
篮	lvm
篱	lvs
簖	dvj
簽	qvr
籁	lvb
籔	uvw
籙	lvd
籴	drm
类	lmd
籼	xme
粃	bmp
粃	pmp
粜	tem
粝	lmp
粤	ypg
粦	lma
粪	fmb
粮	lmn
粹	cmu
粽	zmx
糁	ump
糇	hmu
糈	xmo
糍	cms
糰	tmc
糺	jsv
系	jps
系	xps
紘	hss
紝	rsu
紧	jas
紬	ysa
紵	vsa
絅	jsk
絎	hsd
絰	dst
絲	sss
絷	vsf
經	jsg
綟	lsq
綠	lsd
綯	tsf
綳	bso
緔	usk
緣	ysn
緤	xsm
緤	ysm
縕	wsm
縕	ysm
縣	xqs
縱	zsr
縴	qsn
縴	xsn
縺	lsz
總	zsx
繐	shx
繡	xsa
繩	usv
繪	hso
繫	jsa
繫	xsa
繻	xsa
繼	jsv
繿	lsm
續	xsb
纖	qsg
纖	xsg
纠	jsa
纡	ysu
红	hsg
纣	vsc
纤	qsu
纤	xsu
纥	gsg
纥	hsg
约	ysd
级	jsn
纨	wsd
纩	ksg
纪	jsv
纫	rsd
纬	wsa
纭	yss
纯	isv
纰	bsv
纰	psv
纱	usp
纲	gsx
纳	nsd
纴	rsu
纵	zsr
纶	gsv
纶	lsv
纷	fsd
纸	vsq
纹	wsw
纺	fsf
纻	vsa
纽	nsa
纾	usa
线	xsg
绀	gsc
绁	xsv
绂	fsd
练	lsd
组	zsq
绅	usa
细	xst
织	vsb
终	vsd
绉	vse
绊	bsa
绋	fsa
绌	isk
绍	usk
绎	ysa
经	jsg
绐	dsk
绑	bse
绒	rsu
结	jsk
绔	ksg
绕	rse
绖	dst
绗	hsd
绘	hss
给	gsk
给	jsk
绚	xso
绛	jsa
络	lsk
绝	jsv
绞	jsf
统	tse
绠	gsn
绡	xso
绢	jso
绣	xsp
绥	ssn
绦	tsm
继	jsv
绨	tsp
绩	jsb
绪	xso
绫	lsw
续	xsd
绮	qsk
绯	fsa
绰	isu
绱	usk
绲	gsv
绳	usv
维	wsf
绵	msj
绶	usy
绷	bso
绸	isk
绺	lsk
绻	qsv
综	zsx
绽	vsr
绾	wsk
绿	lsd
缀	vsy
缁	zst
缂	ksg
缃	xso
缄	jsk
缅	msa
缆	lsj
缇	tsr
缈	msp
缉	jse
缊	wsm
缊	ysm
缋	hsb
缌	ssx
缍	dsa
缎	dsy
缏	bsn
缑	gsu
缒	vsz
缓	hsy
缔	dsj
缕	lsn
编	bsc
缗	mso
缘	ysn
缙	jso
缚	fsc
缛	rsc
缜	vsb
缝	fsz
缟	gsk
缠	isa
缡	lss
缢	ysm
缣	jsn
缤	bsb
缥	psx
缦	msy
缧	lss
缨	ysn
缩	ssb
缪	msp
缫	ssn
缬	xsa
缭	lsx
缮	usk
缯	zso
缰	jsa
缱	qsz
缲	qsm
缲	ssm
缳	hsy
缴	jsw
缴	vsw
缵	zsb
缹	fhf
缺	qfn
罂	yfb
罃	yfh
罈	tfu
罉	cru
罐	gff
网	wkx
罗	lsd
罚	fsd
罢	bss
罢	pss
罴	phs
羁	jsm
羓	byv
羟	qyg
羡	xyr
群	qvy
翀	iya
翘	qay
翚	hyi
翬	hyi
耇	gtk
耏	eap
耏	nap
耑	dea
耖	ilp
耠	hlk
耢	lll
耤	jlo
耧	lln
耮	lll
耰	ymy
耲	hly
耸	ser
耻	iev
聂	ney
聋	lle
职	veb
聍	ned
联	led
聤	ted
聩	keb
聪	cex
聲	uue
聽	tex
肃	sva
肅	sva
肏	crr
肠	iop
肤	fon
肮	aoj
肴	yxo
肶	bop
肸	xou
肾	uoa
肿	voa
胀	von
胁	xod
胄	vao
胈	boy
背	boa
胜	uof
胠	qos
胡	huo
胣	ioy
胧	lol
胨	dod
胪	lou
胫	jog
胶	jof
脉	mon
脍	kos
脏	zot
脐	qoa
脑	nok
脓	non
脔	lwr
脚	joe
脟	loc
脤	uoy
脰	doa
脱	toe
脶	lod
脷	lod
脸	loa
脿	boy
腊	loo
腊	xoo
腌	aov
腌	yov
腍	rox
腒	jok
腘	gow
腦	nox
腨	uoa
腭	eog
腯	too
腻	nod
腼	moa
腽	wom
腾	tom
膑	bob
膕	goa
膙	joi
膞	voc
膻	doa
膻	uoa
膽	dok
臑	noa
臜	zob
臢	zob
致	vwa
臺	ttu
舆	ypb
與	ypb
舊	jca
舠	dvd
舡	gvg
舣	yvd
舥	pvb
舰	jvj
舱	cvv
舲	lvs
舻	lvi
艅	yvh
艎	hvw
艰	jyn
艳	yfv
艴	fvv
艷	yfv
艺	ycg
节	jce
芃	pcd
芈	maa
芗	xcp
芜	wcv
芠	wcw
芣	fcx
芦	lch
芼	mcm
苁	ccr
苇	wca
苈	lcl
苉	pce
苋	xcj
苌	icn
苍	ccv
苎	vca
苏	scd
苔	tck
苘	qck
苳	dcd
苹	pcu
苾	bcp
茀	fca
范	fcv
茋	vcd
茏	lcl
茑	ncn
茓	xcb
茔	yct
茕	qcu
茚	yce
茝	ick
茧	jci
茽	vca
荁	hca
荄	gcr
荆	jdc
荐	jcz
荓	pcc
荖	lcp
荙	dcz
荚	jcn
荛	rce
荜	bcu
荞	qca
荟	hcs
荠	jca
荠	qca
荡	dcp
荣	rcm
荤	hci
荥	xcd
荥	ycd
荦	lcn
荧	ych
荨	qcc
荨	xcc
荩	jcd
荪	scx
荫	yco
荬	mcd
荭	hcg
荮	vcc
药	ycd
莅	lcl
莊	vcu
莖	jcg
莙	jck
莝	cct
莱	lcn
莲	lcz
莳	ucc
莴	wcd
莶	lca
莶	xca
获	hcq
莸	ycd
莹	ycw
莺	ycn
莼	icv
莿	ccd
菂	dcd
菉	lcd
菍	ncx
菍	rcx
菼	tch
萚	tca
萝	lcd
萣	dcr
萤	yci
营	yck
萦	ycs
萧	xca
萨	sci
萩	qch
萬	wcd
萳	ncu
萹	bcc
葎	lca
葓	hcb
葖	tcq
葤	vcc
葧	bcl
葯	ycd
葰	jcw
葱	ccx
葴	vcg
蒄	gcc
蒇	icb
蒈	kcb
蒉	kcb
蒋	jcc
蒌	lcn
蒐	scg
蒐	scs
蒗	lcn
蒙	mcn
蒟	jck
蒨	qco
蒭	ice
蒱	pcf
蒻	rcd
蓂	mcb
蓇	gco
蓏	lcg
蓝	lcm
蓟	jcd
蓠	lcs
蓢	lco
蓣	yca
蓥	ycj
蓦	mcm
蔀	bce
蔃	qci
蔆	lcw
蔈	bcx
蔊	hcu
蔑	mcd
蔷	qck
蔹	lcw
蔺	lcf
蔼	acv
蕗	lck
蕰	ycm
蕲	qcj
蕴	ycm
薀	ycm
薁	ycd
薘	dcz
薢	xcn
薮	scw
薳	wcz
薳	ycz
薴	ncd
薴	vcd
薸	pcx
薿	ncr
藏	cca
藏	zca
藓	xcy
藝	ycs
藟	lct
藠	jcb
藥	ycm
藦	mcu
藨	bch
藨	pch
藭	qcg
藷	uco
藷	vco
蘀	tcu
蘖	ncm
蘗	ncm
蘘	rcy
蘞	lcw
虏	lhl
虑	lhx
虒	spj
虓	xjj
處	ihj
虚	xha
號	hkj
虤	yhj
虬	qiv
虮	jij
虱	ugi
虷	hiu
虸	ziz
虽	ski
虾	xid
虿	iai
蚀	uui
蚁	yid
蚂	mim
蚄	bif
蚄	fif
蚆	biv
蚝	him
蚬	xij
蚲	piu
蛃	bir
蛊	gmi
蛎	lip
蛏	iit
蛰	vif
蛱	jin
蛲	nie
蛳	sij
蛴	qia
蜅	pzd
蜎	yio
蜐	jil
蜕	tie
蜗	wid
蜡	lio
蜰	xio
蝇	yiv
蝈	giw
蝉	iia
蝎	xiv
蝘	yik
蝲	lid
蝼	lin
蝾	rim
螋	siy
螠	yim
螢	yhi
螣	toi
螨	mid
螮	dij
螱	wui
蟏	xia
蟫	xiu
蟫	yiu
蟲	iii
蠋	vii
蠟	liv
蠨	xia
蠶	cai
蠻	mis
衃	pxa
衅	xxa
衎	krd
衒	xrd
衔	xrd
衚	hrd
衠	vrd
补	bpd
表	bfy
衬	ipc
衮	gwy
衹	vpq
袄	apd
袅	nny
袆	hpa
袗	vpp
袜	wpn
袪	qps
袭	xly
袯	bpy
裆	dpe
裇	spx
裈	kpi
裊	nny
裛	ywy
裝	vyd
裡	lpt
裢	lpz
裣	lpa
裤	kpi
裥	jpo
裯	ipk
複	fpw
褌	kpi
褔	fpt
褕	ypd
褘	hpa
褛	lpn
褟	tpy
褴	lpm
襇	jpo
襏	bpy
襬	byv
襴	lpn
覯	gaj
覺	jpj
覽	ljk
觀	gyj
见	jkv
观	gyj
规	gaj
觅	mvj
视	upj
觇	iaj
览	lja
觉	jxj
觊	jej
觋	xpj
觌	duj
觎	yrj
觏	gcj
觐	jcj
觑	qhj
觞	ujp
觯	vja
觸	iji
訢	xij
訢	yij
詑	iyv
誂	dyd
誂	tyd
誊	tby
諝	xyo
謚	uym
謠	yyf
證	vyd
譭	hyy
譯	yyu
譸	uyc
譽	ypy
讀	dyb
讅	uyt
變	bws
讌	yyh
讓	ryy
讚	zyb
计	jyu
订	dyd
讣	fyd
认	ryr
讥	jyj
讦	jyu
讧	hyg
讨	tyc
让	rya
讪	uye
讫	qyg
讬	tyv
训	xya
议	yyd
讯	xyu
记	jyv
讲	jya
讳	hya
讴	oyx
讵	jya
讶	yyp
讷	nyd
许	xyu
讹	eyv
论	lyv
讼	sys
讽	fyf
设	uyy
访	fyf
诀	jyn
证	vyv
诂	gyk
诃	hyk
评	pyu
诅	zyq
识	uyb
识	vyb
诈	vya
诉	syd
诊	vyp
诋	dyd
诌	vye
词	cyk
诎	qyk
诏	vyk
译	yya
诒	dyk
诒	yyk
诓	kyw
诔	lyn
试	uyd
诖	gyt
诗	uyc
诘	jyk
诙	hyh
诚	iyv
诛	vyn
诜	uye
话	hyk
诞	dyv
诟	gyk
诠	qyw
诡	gyv
询	xyo
诣	yyo
诤	vya
该	gyr
详	xyy
诧	iyq
诨	hyi
诩	xyy
诪	uyc
诫	jyd
诬	wyr
语	yyk
诮	qyo
误	wyd
诰	gyk
诱	yyp
诲	hyd
诳	kyw
说	uye
说	yye
诵	sya
诶	eyu
请	qyo
诸	vyo
诹	zyy
诺	nyk
读	dyd
诼	vyn
诽	fya
课	kyn
诿	wyn
谀	yyn
谁	uyf
谂	uyx
调	dyk
调	tyk
谄	iya
谅	lyx
谆	vyz
谇	syu
谈	tyh
谉	uya
谊	yyq
谋	mym
谌	iyv
谌	uyv
谍	dym
谎	hyv
谏	jyn
谐	xyb
谑	xya
谒	yyv
谓	wyo
谔	eyg
谕	yyd
谖	xyy
谗	iyd
谘	zyk
谙	ayo
谚	yyp
谛	dyj
谜	myz
谝	pyc
谞	xyo
谟	myd
谠	dye
谡	syw
谢	xyc
谣	yyf
谤	byf
谥	uym
谦	qyn
谧	mym
谨	jya
谩	myy
谪	vyk
谫	jyd
谬	myp
谭	tyu
谮	zyo
谯	qyh
谰	lyd
谱	pyo
谲	jyk
谳	yyq
谴	qyz
谵	vyy
谶	iyg
谷	gbk
豐	fad
豫	ysn
貍	lpt
貙	ivk
貳	eqb
賕	qbd
賙	vbk
賣	mbu
賧	dbh
賴	lab
贇	ybw
贊	zbn
贋	yib
贔	bbb
贝	bkr
贞	vba
负	fbd
贡	gbg
财	cbp
责	zbf
贤	xba
败	bwb
账	vbn
货	hbr
质	vpb
贩	fby
贪	tbr
贫	pbb
贬	bbn
购	gbs
贮	vba
贯	gbv
贰	eqb
贱	jbg
贲	bbu
贳	ubc
贴	tbk
贵	gba
贶	kbe
贷	dbr
贸	mbp
费	fbv
贺	hbl
贻	ybk
贼	zbu
贽	vbf
贾	gbx
贾	jbx
贿	hbo
赀	zbv
赁	lbr
赂	lbk
赃	zbt
资	zbd
赅	gbr
赆	jbd
赇	qbd
赈	vbn
赉	lba
赊	ubx
赋	fbd
赌	dbo
赍	jbu
赎	ubd
赏	ubx
赐	cbp
赑	bbb
赒	vbk
赓	ggb
赔	pbk
赕	dbh
赖	lab
赘	vbf
赙	fbc
赚	vbn
赚	zbn
赛	sbb
赜	zkb
赝	yib
赞	zbn
赠	zbo
赡	uby
赢	ywd
赣	glb
赵	vzx
赶	gzu
趋	qze
趱	zzb
趷	kzv
趸	daz
跂	qzy
跃	yzd
跄	qzv
跞	lzd
跶	dzz
跷	qze
跸	bzu
跹	xzz
跻	jza
跼	jzk
踄	uzp
踌	izc
踎	bzk
踐	jzg
踡	qzv
踦	qzk
踪	zzx
踬	vzb
踯	vze
踴	yzl
蹑	nzy
蹒	pzd
蹓	lzt
蹚	tzt
蹟	jzb
蹧	zzo
蹰	izc
蹿	cza
躂	dzz
躏	lzf
躜	zzb
躝	lzj
躝	lzn
躯	qux
軚	tid
軤	hia
輇	qiw
輕	qig
轂	guy
轉	vic
轗	kix
轣	liv
车	iaa
车	jaa
轧	giv
轧	viv
轧	yiv
轨	gij
轩	xiu
轫	rid
转	vid
轭	eiv
轮	liv
软	riq
轰	hiy
轱	gik
轲	kik
轳	liu
轴	via
轵	vib
轶	yin
轷	hia
轸	vip
轹	lid
轺	yik
轻	qig
轼	uid
载	zig
轾	vit
轿	jia
辁	qiw
辂	lik
较	jif
辄	viv
辅	fid
辆	lid
辇	nia
辈	bia
辉	hgi
辊	giv
辋	wiv
辍	iiy
辎	zit
辏	cid
辐	fit
辑	jie
输	uid
辔	pks
辕	yiy
辖	xik
辗	nin
辗	vin
辗	zin
辘	lil
辙	viw
辚	lia
辟	buu
辟	puu
辨	bdu
辩	byu
辫	bsu
辭	cvu
辯	byu
边	bzl
辽	lzv
达	dzd
迁	qzp
迆	tzx
迆	yzx
过	gzc
迈	mza
迍	vzv
运	yze
还	hza
这	vzw
进	jza
远	yze
违	wza
连	lzi
迟	izu
迩	ezd
迳	jzv
迹	jzw
迺	nzx
适	uzp
选	xzn
逊	xzz
递	dzb
逦	lza
逻	lzs
遗	yza
遞	dzp
遥	yzv
遲	izu
邅	vza
邊	bzp
邓	dey
邝	keg
邠	beb
邨	cua
邬	wep
邮	yea
邹	zed
邺	yea
邻	ler
郁	yeu
郃	her
郏	jea
郐	ger
郐	ker
郑	veq
郓	yeb
郦	lea
郦	vea
郧	yek
郷	xev
郸	deb
郿	mev
酏	yyv
酝	yys
酱	jyd
酸	syw
酽	yyi
酾	uyd
酿	nyn
醉	zyu
醫	yyk
醬	jyd
釀	nyn
采	cvm
释	upa
釋	upu
里	laa
里	lat
釟	bjb
釾	yjp
鈅	yjo
鈡	vja
鉆	zjk
鉋	bjv
鉋	pjv
鉱	gjs
鉳	pjv
鉴	jja
鉾	mjn
銛	gjk
銛	tjk
銛	xjk
銠	ljv
銮	lwj
鋂	mjd
鋩	mjv
鋱	tjx
錄	lvd
錏	yya
錢	qjg
錩	ijo
錼	njx
錾	zji
鍁	xjq
鍄	ljx
鍅	fjs
鍊	ljn
鍚	xjp
鍠	hjw
鍮	tjd
鍼	vjk
鎅	gja
鎌	jjn
鎌	ljn
鎔	rjk
鎲	tje
鏐	ljp
鏚	qjx
鏥	xjb
鏺	pjy
鐇	fjt
鐘	vja
鐝	jjq
鐧	jjo
鐯	vjo
鐵	tjg
鐶	hjy
鑀	ajw
鑄	vjc
鑒	jjk
鑞	ljv
钂	tjh
钆	gjv
钇	yjg
针	vju
钉	djd
钊	vdj
钋	pjd
钌	lja
钍	tjt
钎	qju
钏	ija
钐	ujp
钒	fjd
钓	djd
钔	mjm
钕	njn
钖	yjp
钗	ijd
钙	gjg
钚	bjd
钛	tjd
钜	jja
钝	djv
钞	ijp
钟	vja
钠	njd
钡	bjb
钢	gjx
钣	bjy
钤	qjv
钥	yjo
钦	qjq
钧	jjd
钨	wja
钩	gjs
钪	kjj
钫	fjf
钬	hjh
钭	dju
钮	nja
钯	bjv
钰	yjw
钱	qjg
钲	vjv
钳	qjc
钴	gjk
钵	bja
钶	kjk
钷	pjk
钸	bjj
钹	bjd
钺	yjd
钻	zjk
钼	mjo
钽	tja
钾	jja
钿	djt
钿	tjt
铀	yja
铁	tjn
铂	bjb
铃	ljs
铄	ujd
铅	qjk
铆	mje
铈	ujj
铉	xjd
铊	tjv
铋	bjp
铌	njv
铍	pjp
铎	dja
铐	kjg
铑	ljv
铒	eje
铓	mjv
铕	yjo
铖	ijv
铗	jjn
铘	yje
铙	nje
铛	dje
铛	ije
铜	tjk
铝	ljk
铞	djj
铟	yjd
铠	kjv
铡	vjd
铢	vjm
铣	xje
铤	djz
铤	tjz
铥	djs
铦	gjk
铦	tjk
铦	xjk
铧	hju
铨	qjw
铩	ujm
铪	hjk
铪	kjk
铫	djd
铫	tjd
铫	yjd
铬	gjk
铭	mjk
铮	vja
铯	sjv
铰	jjf
铱	yjy
铲	iji
铳	ije
铴	tjp
铵	ajn
银	yjn
铷	rjk
铸	vjc
铹	ljl
铺	pjd
铼	ljn
铽	tjx
链	ljz
铿	kjt
销	xjo
锁	sjb
锂	lja
锃	zjw
锄	ijl
锅	gjd
锆	gjk
锇	ejd
锈	xjp
锉	cjt
锊	ljc
锋	fjf
锌	xju
锍	ljv
锎	kjc
锏	jjo
锐	rje
锑	tjp
锒	ljn
锓	qjy
锔	jjk
锕	ajk
锖	qjo
锗	vjo
锘	njk
错	cjo
锚	mjt
锛	bjc
锝	djc
锞	kjn
锟	kjv
锠	ijo
锡	xjp
锢	gjk
锣	ljd
锤	ija
锥	vjf
锦	jjj
锨	xjq
锩	jjv
锪	hjx
锫	pjk
锬	tjh
锭	djr
键	jjz
锯	jjk
锰	mjm
锱	zjt
锲	qjd
锴	kjb
锵	qjc
锶	sjx
锷	ejg
锸	ija
锹	qjh
锺	vja
锻	djy
锼	sjy
锽	hjw
锾	hjy
锿	ajy
镀	djy
镁	mjd
镂	ljn
镄	fjb
镅	mjo
镆	mjd
镇	vjb
镉	gja
镊	njy
镋	tje
镌	jjp
镍	njm
镎	nju
镏	ljt
镐	gjk
镐	hjk
镑	bjf
镒	yjm
镓	jjn
镔	bjb
镕	rjk
镖	bjx
镗	tjt
镘	mjy
镙	ljs
镛	yja
镜	jje
镝	djk
镞	zju
镟	xjr
镡	iju
镡	tju
镡	xju
镢	jjq
镣	ljx
镤	pjn
镥	ljo
镦	djw
镧	ljd
镨	pjo
镩	cja
镪	qji
镫	djd
镬	hjy
镭	ljt
镮	hjy
镯	vji
镰	ljn
镱	yjx
镲	ijx
镳	bjh
镶	xjy
长	ipn
长	vpn
閑	xmm
閪	hmx
闍	dmo
闍	umo
闘	imc
關	gma
闠	gmb
门	mdg
闩	uma
闪	umr
闫	yms
闭	bmp
问	wmk
闯	imm
闰	rmw
闱	wma
闲	xmm
闳	hms
间	jmo
闵	mmw
闶	kmj
闷	mmx
闸	vma
闹	nmj
闺	gmt
闻	wme
闼	tmz
闽	mmi
闾	lmk
阀	fmg
阁	gmk
阂	hmr
阃	kmm
阄	jmv
阅	yme
阆	lmn
阈	yma
阉	ymv
阊	imo
阋	xme
阌	wmy
阍	hmo
阎	yma
阏	emd
阐	ima
阑	lmd
阒	qmq
阓	gmb
阔	kmk
阕	qmd
阖	hmm
阗	tmb
阙	qmq
阚	hmw
阚	kmw
队	der
阳	yeo
阴	yeo
阵	vei
阶	jea
际	jex
陆	lek
陇	lel
陈	ied
陉	xeg
陕	uen
陧	net
陨	yeb
险	xea
陷	xea
隐	yex
隨	sez
隩	aed
隩	yed
險	xer
隱	yex
隶	lvn
隸	lmn
隽	jrp
难	nyf
雇	ghf
雏	idf
雕	dpf
雙	ury
雜	zwf
雞	jnv
雠	iyf
雳	lyl
雾	wyl
霁	jya
霂	mym
霉	myd
霭	ayv
霸	byo
靆	dyz
靈	lya
靉	ayw
靓	jfj
靓	lfj
靜	jfa
面	maa
靥	yia
鞑	dgz
鞒	qga
鞬	jgz
鞯	jgz
鞲	gga
韦	waa
韧	rad
韩	hua
韪	woa
韫	wam
韫	yam
韬	taa
韵	yla
顏	ywa
顯	xoa
页	yba
顶	dda
顷	qaa
顸	haa
项	xga
顺	upa
须	xpa
顼	xwa
顽	wea
顾	gia
顿	daa
颀	qja
颁	bba
颂	sba
颃	hwa
预	ysa
颅	laa
领	lra
颇	ppa
颈	gva
颈	jva
颉	jua
颉	xua
颊	jaa
颌	gra
颌	hra
颍	ypa
颏	kwa
颐	yka
频	pva
颓	tha
颔	hra
颖	ypa
颗	kaa
题	toa
颚	eka
颛	vea
颜	yla
额	eba
颞	nea
颟	mca
颠	dua
颡	sya
颢	hoa
颤	iwa
颤	vwa
颥	rya
颦	pvu
颧	qca
颱	tfk
颺	yfp
风	fjx
飏	yfp
飑	bfv
飒	slf
飓	jfb
飕	sfy
飘	pxf
飙	bqf
飚	bfh
飞	fvd
飣	dud
飨	xvu
餍	yiu
餎	guk
餎	luk
餔	bud
餘	yuh
餬	huo
餸	siz
餸	suz
饑	jud
饤	dud
饥	juj
饧	xup
饨	tuv
饩	xuq
饪	ruu
饫	yud
饬	iul
饭	fuy
饮	yur
饯	jug
饰	uuj
饱	buv
饲	suk
饴	yuk
饵	eue
饶	rue
饷	xuk
饹	guk
饹	luk
饺	juf
饼	buc
饽	buz
饿	eud
馀	yuh
馁	nun
馄	huv
馅	xua
馆	guk
馇	iua
馈	kub
馊	suy
馋	iud
馍	mud
馏	lut
馐	xua
馑	jua
馒	muy
馓	suw
馔	vub
馕	nuy
馹	rmo
馼	wmw
駸	qmy
駻	hmu
騷	smi
驅	qmk
驗	ymr
驛	ymu
驫	bmm
马	mva
驭	ymy
驮	dmd
驮	tmd
驯	xma
驰	imv
驱	qmx
驲	rmo
驳	bmx
驴	lmh
驵	zmq
驶	umn
驷	sms
驸	fmc
驹	jmk
驺	zme
驻	vmw
驼	tmv
驽	nmn
驾	jml
驿	yma
骀	tmk
骁	xme
骂	mmk
骄	jma
骅	hmu
骆	lmk
骇	hmr
骈	pmc
骉	bmm
骊	lmd
骋	img
验	yma
骏	jmw
骐	qmb
骑	qmk
骒	kmn
骓	vmf
骖	cmp
骗	pmc
骘	vme
骚	smi
骛	wms
骜	amf
骝	lmt
骞	qbm
骟	umy
骠	bmx
骠	pmx
骡	lms
骢	cmx
骣	imz
骤	vmn
骥	jmb
骧	xmy
骻	kgg
髅	lgn
髋	kgj
髌	bgb
髒	zgc
髓	sgz
體	tkd
髪	fvy
鬓	bab
鬚	xaa
魆	xgg
魇	yig
魉	lgd
鮊	bab
鮓	vaa
鮞	eaa
鮟	aan
鮣	yae
鯆	bad
鯆	pad
鯒	yaa
鯝	gak
鯰	nax
鯱	hyj
鯷	tar
鰆	iyo
鰌	qay
鰕	xay
鰛	wam
鰠	sai
鰤	uaj
鰧	toy
鰮	wam
鰺	uap
鱆	vau
鱇	kyx
鱠	kao
鱼	yda
鱿	yad
鲁	lao
鲂	faf
鲅	bad
鲆	pau
鲇	nak
鲈	lau
鲋	fac
鲌	bab
鲍	bav
鲎	hxa
鲐	tak
鲑	gat
鲑	xat
鲒	jak
鲔	wao
鲕	eaa
鲚	jaa
鲛	jaf
鲜	xay
鲞	xba
鲟	xac
鲠	gan
鲡	lad
鲢	laz
鲣	jat
鲤	laa
鲥	uac
鲦	tam
鲧	gas
鲨	uad
鲩	hae
鲫	jae
鲭	qao
鲮	law
鲰	zay
鲱	faa
鲲	kav
鲳	iao
鲴	gak
鲵	nae
鲶	nax
鲷	dak
鲸	jax
鲺	uai
鲻	zat
鲼	fab
鲽	dam
鳀	tar
鳃	sax
鳄	eag
鳅	qah
鳆	faw
鳇	haw
鳊	bac
鳋	sai
鳌	aaf
鳍	qao
鳎	tay
鳏	gad
鳐	yaf
鳓	lal
鳔	bax
鳕	xae
鳖	bax
鳗	may
鳘	mar
鳙	yaa
鳜	gaq
鳜	jaq
鳝	uak
鳞	laa
鳟	zac
鳢	lad
鳾	una
鴃	jnn
鴒	lnr
鴞	xnk
鴷	lnd
鵁	jnw
鵐	wnr
鶄	jnf
鶊	gng
鶖	qnh
鶪	jno
鶬	cnr
鶲	wnb
鶹	lnp
鶺	jnd
鷁	ynq
鷈	tnp
鷉	tnp
鷗	onk
鷴	xnm
鷽	xnp
鷿	pnu
鸊	pnu
鸟	dna
鸟	nna
鸠	jnj
鸡	jny
鸢	ynq
鸣	mnk
鸥	onk
鸦	yna
鸧	cnr
鸨	bnp
鸩	vnd
鸪	gnu
鸫	dna
鸬	lna
鸭	yna
鸮	xnk
鸯	yan
鸰	lnr
鸱	inp
鸲	qng
鸳	ynp
鸵	tnv
鸶	svn
鸷	vnf
鸸	ena
鸹	gnp
鸺	xrn
鸽	gnr
鸾	lwn
鸿	hdn
鹁	bnu
鹂	lna
鹃	jnk
鹄	hnn
鹅	enp
鹆	ynb
鹇	xnm
鹈	tnb
鹉	wna
鹊	qnc
鹋	mnc
鹌	and
鹎	bnp
鹏	pon
鹑	inw
鹒	gng
鹕	hun
鹗	enk
鹘	gng
鹘	hng
鹙	qnh
鹚	cnq
鹛	mnv
鹜	wns
鹞	ynv
鹠	lnp
鹣	jnq
鹤	hnd
鹦	ynb
鹧	vng
鹨	lny
鹩	lnu
鹪	jnr
鹫	jnw
鹬	yns
鹭	lnz
鹮	hns
鹰	ygn
鹱	hny
鹳	gnc
鹵	lax
鹼	jar
鹽	ymk
鹾	cag
麥	mad
麪	mag
麴	qaa
麴	qum
麵	maa
麸	ffn
麽	mgs
黄	hcb
黉	hxb
黐	ips
黑	hha
默	mhq
點	dhk
黡	yvi
黨	dxh
黩	dhd
黪	chp
黶	yih
黾	mkv
鼋	yev
鼍	tkv
鼗	tey
鼢	fud
鼹	yun
齄	vph
齇	vpq
齊	qwa
齋	vwa
齐	qwa
齑	jwa
齒	ivk
齕	hig
齡	lis
齧	nfi
齿	ivk
龀	iiv
龁	hig
龃	jiq
龄	lis
龅	biv
龆	tik
龇	ziv
龈	kin
龈	yin
龉	yik
龊	iiz
龋	qid
龌	wit
龍	lla
龑	yld
龙	lud
龚	glb
龛	krl
龟	gdv
龟	jdv
龟	qdv
𠝹	jdt
𠮶	gku
𣈶	xoa
𦼖	lch
𨅬	lzn
𩠌	suz
𪠳	iki
	wkn
	ddz
	chp
	yjp
剢	dda
揈	ffy
揿	gmf
㞗	gun
嚿	gka
嶋	dne
戸	hau
査	imq