的	d
一	y
了	l
是	u
不	b
我	w
人	r
在	z
这	v
他	t
有	yz
来	ld
你	n
个	g
大	da
到	dc
上	uh
说	uo
们	mf
着	ve
出	i
中	vs
地	di
那	na
就	j
也	ye
下	xx
要	yc
么	me
时	ui
为	ww
然	rj
可	k
她	ta
过	go
以	yi
看	kj
会	hv
得	de
得	dw
天	tm
去	q
好	hc
和	h
没	m
能	ng
对	dv
后	hz
还	hd
里	li
小	x
只	vi
想	xl
都	dz
头	tz
如	ru
无	wu
面	mm
多	do
生	ug
前	qm
开	kd
经	jk
笑	xn
点	dm
两	ll
法	fa
样	yh
所	so
成	ig
但	dj
老	lc
用	ys
当	dh
动	ds
些	xp
行	hh
行	xk
把	ba
话	hx
将	jl
真	vf
长	ih
长	vh
三	s
间	jm
进	jb
年	nm
明	mk
女	nv
定	dk
正	vg
本	bf
很	hf
同	ts
从	cs
高	gc
问	wf
才	c
全	qr
被	bw
主	vu
再	zd
走	zz
却	qt
分	ff
口	kz
其	qi
几	ji
外	wd
最	zv
与	yu
给	gw
光	gl
白	bd
等	dg
听	tk
因	yb
少	uc
风	fg
次	ci
何	he
让	rh
色	se
二	e
日	ri
怎	zf
部	bu
应	yk
体	ti
太	td
内	nw
水	uv
先	xm
难	nj
王	wh
比	bi
别	bp
边	bm
快	kk
更	gg
做	zo
处	iu
并	bk
接	jp
四	si
关	gr
山	uj
月	yt
放	fh
连	lm
加	jx
目	mu
龙	ls
强	ql
叫	jn
安	an
学	xt
算	sr
平	p
吗	am
吗	ma
特	te
数	uu
云	yy
任	rf
空	ks
表	bn
完	wj
受	uz
转	vr
冷	lg
黑	hw
该	gd
双	ul
非	f
林	lb
呢	ne
新	xb
路	lu
跟	gf
反	fj
总	zs
系	xi
亲	qb
刚	gh
红	hs
找	vc
落	lo
容	rs
深	uf
拉	la
若	ro
各	ge
言	yj
传	ir
且	qp
干	gj
怕	pa
吃	ii
啊	a
早	zc
怪	gk
报	bc
车	ie
爱	ai
民	mb
元	yr
办	bj
谁	uw
则	ze
请	qk
帮	bh
周	vz
字	zi
每	mw
忙	mh
团	tr
片	pm
求	qq
错	co
冲	is
代	dd
或	ho
哈	ha
论	ly
阿	aa
破	po
够	gz
久	jq
娘	nl
修	xq
况	kl
区	qu
黄	hl
亚	ya
送	ss
古	gu
装	vl
产	ij
乱	lr
群	qy
类	lw
慢	mj
陈	if
段	dr
调	dn
调	tn
顿	dy
另	lk
旁	ph
乐	le
热	re
怒	nu
图	tu
需	xu
组	zu
曾	cg
据	ju
差	ia
设	ue
品	pb
追	vv
推	tv
您	nb
谈	tj
仍	rg
跑	pc
否	fz
科	ke
选	xr
梦	mg
刘	lq
费	fw
楼	lz
肯	kf
佛	fo
料	ln
抓	vx
米	mi
散	sj
副	fu
参	cj
卡	ka
靠	kc
贵	gv
共	gs
排	pd
换	hr
苏	su
顺	uy
赛	sd
超	ic
藏	ch
藏	zh
恩	en
增	zg
草	cc
普	pu
弄	ns
握	wo
肉	rz
岁	sv
毛	mc
坏	hk
宁	nk
欧	ou
村	cy
某	mz
列	lp
盘	pj
奥	ao
浪	lh
混	hy
买	md
配	pw
率	lv
托	to
森	sf
抗	kh
占	vj
横	hg
灭	mp
软	rr
套	tc
困	ky
牛	nq
卷	jr
桌	vo
杂	za
测	ce
户	hu
含	hj
闹	nc
凭	pk
抽	iz
碰	pg
批	pi
凶	xs
哦	o
窗	il
挂	gx
滚	gy
腾	tg
贼	zw
扫	sc
扎	va
纯	iy
宽	kr
菜	cd
均	jy
丢	dq
吹	iv
读	du
绕	rc
鸟	nn
粗	cu
桑	sh
贴	tp
嗯	og
票	pn
亏	kv
扩	ko
帅	uk
穷	qs
末	mo
撒	sa
擦	ca
泥	ni
搜	sz
僧	sg
暖	nr
桥	qn
汤	th
昂	ah
恰	qx
跌	dp
拨	bo
酷	ku
催	cv
凑	cz
秒	mn
捏	np
夸	kx
窜	cr
挖	wa
刷	ux
嫩	nf
囊	nh
撇	pp
拆	id
盆	pf
坑	kg
挪	no
喔	oo
啥	ua
哟	yo
嘎	ga
虐	nt
蹦	bg
滨	bb
戳	io
晒	ud
揣	ik
窘	js
拽	vk
剖	pz
岑	cf
诶	ei
拴	ur
呒	om
安放	af
爱护	ah
安静	aj
拗口	ak
案例	al
澳门	am
安排	ap
安全	aq
爱人	ar
暗算	as
凹凸	at
暗示	au
安装	av
安慰	aw
爱心	ax
安逸	ay
暗自	az
保留	bl
本来	bl
并且	bq
不然	br
比赛	bs
标准	bv
必须	bx
不要	by
参考	ck
从来	cl
层面	cm
才能	cn
存盘	cp
从前	cq
从头	ct
此外	cw
错误	cw
才行	cx
采用	cy
代表	db
地方	df
到了	dl
带来	dl
代替	dt
东西	dx
第一	dy
恩赐	ec
而非	ef
而且	eq
而已	ey
而言	ey
儿子	ez
分别	fb
服从	fc
讽刺	fc
反对	fd
反而	fe
方法	ff
返回	fh
非常	fi
分开	fk
法律	fl
方面	fm
烦恼	fn
分配	fp
放弃	fq
否认	fr
放松	fs
繁体	ft
反正	fv
发现	fx
反应	fy
根本	gb
过程	gi
干嘛	gm
功能	gn
股票	gp
过去	gq
沟通	gt
更新	gx
关于	gy
何必	hb
好处	hi
号码	hm
湖南	hn
害怕	hp
回去	hq
后天	ht
互相	hx
欢迎	hy
成本	ib
充满	im
承诺	in
产品	ip
重启	iq
冲突	it
成为	iw
出现	ix
成员	iy
骄傲	ja
精彩	jc
简单	jd
金额	je
解放	jf
结果	jg
几乎	jh
解决	jj
奇偶	jo
及其	jq
加入	jr
今天	jt
简直	jv
几位	jw
节奏	jz
恐怖	kb
看出	ki
科目	km
可能	kn
恐怕	kp
况且	kq
开通	kt
尅	kw
科学	kx
可以	ky
浪费	lf
了解	lj
论坛	lt
联系	lx
漫画	mh
目录	ml
每年	mn
默认	mr
貌似	ms
明天	mt
每天	mt
每周	mv
明显	mx
难道	nd
那些	nx
偶尔	oe
欧陆	ol
偶然	or
呕吐	ot
偶像	ox
欧阳	oy
普洱	pe
配额	pe
脾气	pq
骗人	pr
破碎	ps
平台	pt
普通	pt
配置	pv
培训	px
前后	qh
期间	qj
其中	qv
前往	qw
千万	qw
认可	rk
人类	rl
人们	rm
热闹	rn
人品	rp
日期	rq
如同	rt
认为	rw
思考	sk
算了	sl
什么	sm
随你	sn
索赔	sp
所谓	sw
思想	sx
搜寻	sx
所以	sy
讨论	tl
天天	tt
统一	ty
顺便	ub
事情	uq
神色	us
身体	ut
准备	vb
这么	vm
指南	vn
照片	vp
中心	vx
这样	vy
为此	wc
无法	wf
完成	wi
唯恐	wk
为了	wl
网络	wl
我们	wm
无奈	wn
未能	wn
网盘	wp
完全	wq
无私	ws
问题	wt
唯一	wy
西安	xa
下次	xc
相当	xd
喜欢	xh
现金	xj
西欧	xo
协助	xv
现在	xz
一定	yd
月份	yf
应该	yg
要求	yq
一直	yv
因为	yw
一下	yx
总部	zb
自己	zj
走开	zk
走了	zl
怎么	zm
怎能	zn
作品	zp
最新	zx
而	er
恶	ee
寻	xy
尊	zy
侧	vd
瑞	rv
钻	zr
润	ry
翁	wg
谬	mq
盎	ag
耨	nz
氹	tf
道	dcb
子	zil
之	vid
自	zip
心	xbd
手	uzs
起	qiz
身	ufp
已	yik
发	fav
事	uih
知	viu
家	jxg
声	ugu
方	fhd
现	xmw
什	ufr
什	uir
力	liv
国	gow
意	yil
见	jmk
又	yzv
情	qkx
于	yue
己	jik
此	civ
眼	yjm
气	qir
回	hvw
神	ufu
向	xlp
实	uig
儿	erp
作	zor
种	ish
种	vsh
打	daf
门	mfd
重	isp
重	vsp
相	xla
住	vur
公	gsb
名	mkx
死	sih
便	bmr
便	pmr
位	wwr
果	goo
感	gjw
觉	jnx
觉	jtx
入	rup
第	div
机	jia
理	liw
者	vet
西	xih
马	mav
轻	qki
脸	lmo
飞	fwv
张	vhg
由	yzo
金	jbr
立	lil
师	uiu
吧	bak
信	xbr
军	jyg
望	whw
原	yri
美	mwb
像	xlr
东	dsq
场	iht
战	vjb
万	wjh
清	qkd
变	bmy
合	ger
合	her
带	ddc
常	ihx
量	llo
海	hdd
解	jpd
解	xpd
文	wfw
命	mkr
斯	siq
通	tss
思	sit
世	uin
利	lih
至	vih
步	buv
候	hzr
五	wuh
李	lia
度	dog
度	dug
虽	svk
惊	jkx
物	wun
许	xuy
化	hxr
制	vin
火	hod
性	xkx
指	vif
结	jps
花	hxc
教	jnt
功	gsg
提	dif
提	tif
杀	uai
竟	jkl
百	bde
它	tag
满	mjd
必	bix
城	igt
奇	qid
失	uip
尔	erd
形	xkk
青	qkf
石	dje
石	uie
半	bjb
近	jbj
认	rfy
队	dve
电	dmo
夫	fue
往	whr
突	tux
倒	dcr
件	jmr
随	sve
绝	jts
刻	kew
息	xiz
即	jig
工	gsh
乎	hup
界	jpt
记	jiy
紧	jbu
流	lqd
管	grv
音	ybl
衣	yiw
保	bcr
暗	ano
弟	dib
及	jip
交	jnl
影	yko
精	jkm
伤	uhr
势	uif
决	jtd
服	fuo
条	tnw
众	vsr
领	lkr
哥	gek
南	nju
般	bjv
罗	los
收	uzv
题	tio
星	xko
克	keg
根	gfa
阵	vfe
象	xld
男	njt
达	dad
告	gcn
展	vju
灵	lkx
血	xpp
血	xtp
整	vgh
员	yrk
兵	bkq
千	qmp
切	qpq
越	ytz
喜	xiu
语	yuy
站	vjl
德	der
敢	gjv
消	xnd
业	yeu
姐	jpn
八	bap
苦	kuc
房	fhh
雷	lwy
哪	nak
书	uuv
备	bww
司	siv
北	bwu
静	jkf
断	drm
准	vyd
江	jld
刀	dcv
建	jmy
兄	xsk
终	vss
足	zuk
阳	yhe
楚	iua
底	dig
夜	yew
术	uua
术	vua
格	gea
识	uiy
识	viy
持	iif
答	dav
留	lqp
确	qte
易	yio
七	qih
父	fub
拿	nar
程	igh
害	hdg
族	zuf
孩	hdz
魔	mog
官	grg
沉	ifd
显	xmo
宝	bcg
取	que
单	djb
单	ijb
单	ujb
掌	vhx
务	wuw
低	dir
雪	xty
响	xlk
布	buu
市	uiw
摇	ycf
依	yir
级	jis
首	uzb
运	yye
朝	icu
朝	vcu
待	ddr
忽	hub
速	suh
复	fur
欢	hry
式	uiq
护	huf
爷	yeb
脚	jno
招	vcf
九	jqp
集	jiv
晚	wjo
铁	tpj
友	yzu
除	iue
钱	qmj
兰	ljb
联	lme
义	yid
丝	sis
六	lqw
六	luw
器	qik
甚	ufq
照	vco
基	jiq
闪	ujm
院	yre
呼	huk
杨	yha
露	luy
露	lzy
句	gzb
句	jub
举	jux
敌	diq
斗	dzd
香	xlh
停	tkr
台	tds
嘴	zvk
希	xii
酒	jqd
怀	hkx
议	yiy
仙	xmr
派	pdd
英	ykc
喝	hek
期	qiq
威	www
府	fug
改	gdk
资	zid
续	xus
造	zcn
左	zou
疑	yib
念	nmr
引	ybg
退	tvg
缓	hrs
线	xms
注	vud
细	xis
背	bwb
痛	tsb
观	gry
雨	yuh
约	ycs
约	yts
包	bcb
木	muu
技	jif
皇	hlb
密	mig
谢	xpy
鬼	gvb
穿	irx
脑	nco
赶	gjz
莫	moc
叶	xpk
叶	yek
存	cyu
烈	lph
诉	suy
商	uhl
争	vgd
角	jnd
淡	djd
严	yjh
狂	klq
挥	hvf
亮	llw
卫	wwe
闻	wfm
忍	rfd
态	tdd
汉	hjd
模	moa
模	mua
银	ybj
君	jyx
妹	mwn
隐	ybe
母	muv
凌	lkd
寒	hjg
局	juu
冰	bkd
禁	jba
境	jkt
掉	dnf
究	jqx
余	yur
查	iaa
号	hck
防	fhe
恐	ksg
导	dck
故	gug
球	qqw
叹	tjk
救	jqh
帝	dil
简	jmv
际	jie
顾	gui
齐	qiw
玩	wjw
猛	mgq
份	ffr
具	juj
胜	ugo
章	vhl
巨	juk
险	xme
守	uzg
须	xup
眉	mwm
抱	bcf
权	qra
独	duq
震	vfy
索	sou
证	vgy
礼	liu
助	vuq
圣	ugy
股	guo
跳	tnz
波	bod
负	fud
虎	huh
练	lms
姑	gun
唐	thg
伙	hor
沙	uad
妈	man
称	ifh
投	tzf
柔	rzy
扬	yhf
规	gve
毫	hcw
温	wfd
较	jni
毒	duf
耳	erh
座	zog
层	cgu
担	djf
置	vis
历	lii
初	iuy
承	igl
质	vip
属	uuu
属	vuu
渐	jmd
蓝	ljc
船	irv
逃	tcv
皮	piv
药	ycc
呀	yak
充	isw
标	bna
坚	jmu
赵	vcz
维	wws
陆	lqe
陆	lue
块	kkt
吸	xik
刺	cic
堂	thx
醒	xky
考	kct
松	ssa
划	hxg
河	hed
环	hrw
土	tuu
责	zef
压	yai
素	suf
湖	hud
睡	uvm
京	jkw
效	xnl
朋	pgo
宇	yug
紫	ziv
幸	xkt
遇	yuo
孙	syz
顶	dkd
拍	pdf
警	jkc
按	anf
察	iag
广	gld
胡	hug
秘	bih
秘	mih
凡	fjj
尚	uhx
脱	too
价	jpr
价	jxr
史	uik
节	jpc
秋	qqh
翻	fjp
迷	mim
州	vzd
项	xlg
萧	xnc
状	vld
尼	niu
雅	yay
凤	fgj
秦	qbs
败	bdb
咱	zjk
朱	vup
呆	ddk
封	fgt
景	jko
专	vre
味	wwk
舞	wur
虚	xuh
毕	bib
讲	jly
福	fuu
习	xiv
社	ueu
永	ysd
默	moh
洞	dsd
控	ksf
骑	qim
钟	vsj
徐	xur
辈	bwf
病	bkb
胸	xso
欲	yub
伯	bdr
伯	bor
峰	fgu
野	yeo
值	vir
职	vie
恨	hfx
狠	hfq
田	tmw
魂	hye
免	mmd
短	dru
秀	xqh
麻	mag
印	ybp
良	lld
迎	ykp
枪	qla
弹	djg
弹	tjg
骨	guk
探	tjf
啦	lak
研	yje
妖	ycn
劲	jbs
劲	jks
临	lbu
屋	wuu
案	ang
杰	jpa
饭	fju
升	ugp
抬	tdf
蒙	mgc
略	ltt
丹	djk
源	yrd
纷	ffs
雄	xsu
危	wwd
优	yzr
写	xpg
床	ilg
罪	zvs
网	whk
食	sir
板	bja
校	jna
校	xna
妙	mnn
休	xqr
珠	vuw
透	tzh
春	iys
委	wwh
移	yih
偷	tzr
吴	wuk
牙	yah
泪	lwd
宗	zsg
摆	bdf
善	ujy
羽	yux
肩	jmh
拥	ysf
弱	rog
柳	lqa
硬	yke
纳	nas
洛	lod
范	fjc
玄	xrw
济	jid
徒	tur
烦	fjh
端	drl
娜	nan
娜	non
哭	kuk
凝	nkd
镇	vfj
避	biu
拳	qrb
创	ilr
采	cda
晓	xno
哼	hgk
惜	xix
束	uuh
熟	uuw
熟	uzw
归	gvu
邪	yey
庄	vlg
喊	hjk
梅	mwa
韩	hju
罢	bas
罢	pis
仇	izr
仇	qqr
奔	bfd
吓	xxk
养	yhy
厅	tki
贝	bwk
娇	jnn
省	ugx
飘	pnx
戏	xiy
画	hxh
暴	bco
域	yut
瞧	qnm
摸	mof
席	xig
稳	wfh
绿	lus
绿	lvs
讨	tcy
获	hoc
店	dmg
谷	gub
仿	fhr
丈	vhh
姓	xkn
挑	tnf
祖	zuu
墙	qlt
冒	mco
夏	xxe
架	jxl
鱼	yud
尖	jmx
丁	dkh
旧	jqu
扑	puf
降	jle
降	xle
燕	yjn
卖	mdu
嘿	hwk
骂	mak
鲜	xmy
幽	yzy
训	xyy
演	yjd
闭	bim
巧	qng
奋	ffd
替	tie
残	cjh
腿	tvo
婆	pod
班	bjw
诸	vuy
吉	jiu
诺	noy
狼	lhq
洋	yhd
虑	lvh
杯	bwa
策	cev
腰	yco
殿	dmu
番	pjp
输	uui
杜	dua
惨	cjx
盟	mgo
积	jih
趣	quz
圆	yrw
妇	fun
沈	ufd
登	dgd
懂	dsx
犹	yzq
律	lvr
抢	igf
抢	qlf
厚	hzi
聚	jue
纵	zss
迅	xyv
财	cdb
搞	gcf
侧	cer
侧	zdr
农	nsg
稍	uch
宣	xrg
颜	yjl
躲	dou
舒	uur
供	gsr
傲	aor
勇	yss
阶	jpe
犯	fjq
尘	ifx
甲	jxo
孤	guz
协	xpu
塔	tat
盖	gdb
劳	lcc
撞	vlf
阻	zue
操	ccf
概	gda
曲	quo
胆	djo
轮	lyi
婚	hyn
迟	iiu
党	dhx
爸	bab
奈	ndd
疯	fgb
距	juz
谓	wwy
构	gza
咬	yck
误	wuy
塞	sdg
塞	seg
慕	muc
笔	biv
孔	ksz
牌	pdp
陪	pwe
折	uef
折	vef
挡	dhf
岛	dcn
择	vdf
伦	lyr
遍	bmh
芒	mhc
征	vgr
触	iud
瞪	dgm
荡	dhc
郎	lhl
怜	lmx
乃	ndv
臣	ifk
判	pjb
翼	yix
欣	xbj
灯	dgh
库	kug
荣	rsc
夺	dod
颗	keo
累	lwt
宋	ssg
狗	gzq
悄	qnx
颤	ijw
颤	vjw
吟	ybk
瞬	uym
舍	uer
补	buy
艺	yic
挺	tkf
岳	ytq
圈	jrw
圈	qrw
旋	xrf
惑	hog
蛋	djp
艾	aic
莉	lic
损	syf
迫	pdb
迫	pob
盛	igw
盛	ugw
缘	yrs
俊	jyr
努	nun
菲	fwc
抖	dzf
乌	wub
油	yzd
炼	lmh
唇	iyi
康	khg
吐	tuk
馆	gru
昨	zoo
赞	zjn
茶	iac
苍	chc
恢	hvx
育	yuw
央	yhk
闲	xmm
吼	hzk
爆	bch
鼓	guu
乡	xls
曼	mjo
踪	zsz
灰	hvu
赤	iit
萨	sac
缺	qtp
岂	qiu
伴	bjr
猜	cdq
额	eeg
遗	yiv
谋	mzy
昏	hyu
融	rsh
妮	nin
例	lir
盯	dkm
遭	zch
潜	qmd
拼	pbf
勒	leg
勒	lwg
博	bou
蛇	uei
港	ghd
貌	mcp
绍	ucs
拔	baf
洗	xid
彻	ier
莱	ldc
县	xmq
剩	ugq
扶	fuf
愤	ffx
镜	jkj
爵	jta
佩	pwr
忧	yzx
鼻	biz
枫	fga
泽	zed
凯	kdu
浩	hcd
奶	ndn
怨	yrx
毁	hvj
诚	igy
忠	vsv
洪	hsd
糊	hum
固	guw
轰	hsi
坦	tjt
睁	vgm
爹	dpb
蒂	dic
庆	qkg
词	ciy
辛	xbl
丰	fgs
缩	sos
仰	yhr
迪	diy
晃	hlo
庭	tkg
莲	lmc
仔	zir
侠	xxr
阁	gem
检	jma
暂	zji
插	iaf
净	jkd
召	ucd
召	vcd
慌	hlx
敏	mbr
鹰	ykg
掩	yjf
码	mae
浑	hyd
隔	gee
疾	jib
池	iid
振	vff
闷	mfm
童	tsl
朵	doj
傻	uar
悉	xip
鸣	mkk
径	jkr
旅	lvf
赫	het
穴	xtg
延	yjp
惯	grx
唤	hrk
皆	jpb
盗	dcd
琴	qbw
帐	vhj
戴	ddt
仁	rfr
宜	yig
甘	gjn
炸	vah
戒	jpg
琳	lbw
浓	nsd
吻	wfk
疼	tgb
珍	vfw
符	fuv
芳	fhc
羞	xqy
典	dmk
骗	pmm
旗	qif
啸	xnk
堆	dvt
霸	bay
廷	tkq
促	cur
耐	nde
庞	phg
荒	hlc
序	xug
躺	thu
粉	ffm
餐	cjb
喃	njk
踏	taz
吕	lvk
孟	mgz
匆	csb
乘	igq
脉	mdo
脉	moo
络	lcs
拒	juf
郑	vgb
漂	pnd
倍	bwr
拖	tof
怔	vgx
访	fhy
乔	qnp
颇	pop
愣	lgx
献	xmu
编	bms
扭	nqf
缠	ijs
核	hea
核	hua
评	pky
享	xlw
尾	wwu
碧	biw
瓦	wah
玛	maw
川	irp
彼	bir
醉	zvy
痕	hfb
晨	ifo
薄	bcc
薄	boc
胖	pho
胖	pjo
倾	qkr
躯	quu
隆	lse
岸	anu
括	kof
废	fwg
狐	huq
吞	tyt
丫	yab
锁	soj
悟	wux
滑	hxd
椅	yia
赌	dub
垂	ivp
粮	llm
厂	ihh
辰	ifi
曹	cch
霍	hoy
遥	yca
痴	iib
款	kru
督	duu
乖	gkq
聊	lne
估	gur
爬	pap
匹	pik
录	lux
牢	lcg
锐	rvj
唱	ihk
唉	aik
董	dsc
刹	iai
钢	ghj
惹	rec
焦	jnv
援	yrf
措	cof
革	gen
陵	lke
扯	ief
予	yus
筑	vuv
授	uzf
罩	vcs
埋	mdt
埋	mjt
熊	xss
潮	icd
漠	mod
轩	xri
哀	aiw
掠	ltf
肚	duo
聪	cse
斩	vji
狱	yuq
俩	llr
俩	lxr
炮	pch
俱	jur
挣	vgf
邦	bhf
泛	fjd
辞	ciq
卓	vob
恼	ncx
航	hhv
零	lky
盈	ykn
载	zdt
扰	rcf
恋	lmy
肃	sux
姆	mun
眸	mzm
冥	mkg
辆	lli
劝	qry
姬	jin
拦	ljf
堪	kjt
劈	piu
培	pwt
霜	uly
斜	xpr
审	ufg
甜	tmq
耀	ycx
脆	cvo
袍	pcy
驻	vum
霞	xxy
厌	yji
弯	wjy
宏	hsg
滴	did
键	jmj
耶	yee
销	xnj
膀	bho
枝	via
丧	sht
趁	ifz
舌	ueq
课	key
麦	mdf
抹	maf
玲	lkw
喷	pfk
染	rjd
跪	gvz
翔	xly
币	bip
埃	ait
贯	grm
盾	dyp
灾	zdg
渡	dud
燃	rjh
眨	vam
敲	qnw
侵	qbr
喘	irk
柄	bka
悦	ytx
嫁	jxn
岩	yju
赖	ldh
烂	ljh
嘉	jxu
夹	gah
夹	jxh
版	bjp
汇	hvd
冬	dsw
俗	sur
骇	hdm
莎	uac
宾	bbg
析	xia
郁	yuu
允	yys
疗	lnb
繁	fjr
葛	gec
祥	xlu
耸	ssr
仗	vhr
弓	gsk
幅	fuj
胁	xpo
瓶	pkb
愧	kvx
晕	yyo
翠	cvx
矮	aiu
宿	sug
宿	xqg
偶	our
涛	tcd
姊	zin
抛	pcf
虫	isk
咐	fuk
铺	puj
衡	hgr
饮	ybu
捉	vof
纤	qms
袁	yrt
猎	lpq
赢	ykw
卢	lub
亭	tkw
娃	wan
慈	cib
晴	qko
咒	vzk
羊	yhb
签	qmv
猫	mcq
覆	fux
祸	hou
罚	fas
耗	hcl
寸	cyh
俄	eer
蝶	dpi
闯	ilm
箱	xlv
扮	bjf
障	vhe
怖	bux
歉	qmb
砍	kje
齿	iiv
踢	tiz
爪	vcp
爪	vxp
脏	zho
棋	qia
贺	hel
迈	mdw
捕	buf
笼	lsv
扣	kzf
扇	ujh
臭	izz
臭	xqz
篇	pmv
邓	dgy
辱	rui
懒	ljx
裁	cdt
仆	pur
穆	muh
昆	kyo
丑	izv
愁	izh
勤	qbn
悬	xrq
铃	lkj
崇	isu
井	jke
帕	paj
昌	iho
鞭	bmg
僵	jlr
纹	wfs
瑶	ycw
雕	dnk
洒	sad
冯	fgd
冯	pkd
蛮	mjy
爽	uld
跨	kxz
饶	rcu
矛	mcy
湾	wjd
税	uvh
涉	ued
铜	tsj
涂	tud
奸	jmn
梯	tia
邀	ycb
诡	gvy
慎	ufx
婉	wjn
吩	ffk
镖	bnj
摔	ukf
卧	wok
丛	csr
祭	jix
崖	yau
描	mnf
奏	zzs
肖	xnx
碍	aie
曰	ytw
霄	xny
糟	zcm
麟	lbg
肌	jio
阔	kom
液	yed
笨	bfv
矿	kle
湿	uid
桃	tca
疲	pib
荷	hec
姜	jlb
摄	npf
脖	boo
巫	wug
屏	pku
咽	yjk
驰	iim
愕	eex
肥	fwo
扔	rgf
瑟	sew
杖	vha
芙	fuc
畏	wwt
频	pbv
酸	sry
割	geg
绵	mms
披	pif
戈	geq
贪	tjr
捷	jpf
瞒	mjm
播	bof
咳	kek
申	ufo
搂	lzf
寇	kzg
惠	hvh
宛	wjg
宛	yrg
卿	qkp
龄	lkv
驶	uim
瓜	gxp
氛	ffq
污	wud
谅	lly
宠	isg
碗	wje
妃	fwn
筋	jbv
甩	uko
驱	qum
寨	vdg
蕾	lwc
兼	jmb
婷	tkn
妥	toa
拓	taf
斥	iij
吵	ick
订	dky
纠	jqs
届	jpu
饿	eeu
薛	xtc
崔	cvu
恒	hgx
宴	yjg
晌	uho
艘	szv
辣	lal
哇	wak
柜	gva
柜	jua
斤	jbp
储	iur
挨	aif
豹	bcp
饱	bcu
彭	bhu
彭	pgu
琼	qsw
遮	veg
舟	vzp
佣	ysr
陶	tce
砸	zae
颊	jxj
牲	ugn
裤	kuy
俏	qnr
鼠	uuj
丘	qqj
抑	yif
呈	igk
尹	ybx
坡	pot
契	xpf
嫌	xmn
津	jbd
棒	bha
撕	sif
骤	vzm
疆	jlg
颈	ggs
贾	gux
贾	jxx
漏	lzd
脾	pio
窝	wox
盼	pjm
耻	iie
姨	yin
厨	iui
珊	ujw
链	lmj
汪	whd
靖	qkl
拟	nif
淫	ybd
韵	yyl
柯	kea
巾	jbk
庙	mng
纱	uas
棍	gya
晋	jbh
伐	far
绳	ugs
涨	vhd
添	tmd
陛	bie
嘲	vck
捧	pgf
谨	jby
乏	fap
仓	chr
岗	ghu
掏	tcf
削	xtx
诧	iay
灌	grd
旨	vib
泡	pcd
辩	bml
婴	ykb
嚷	rhk
沾	vjd
膝	xio
逢	fgw
坠	vve
雀	qtx
枯	kua
偿	ihr
陌	moe
陡	dze
挽	wjf
鹤	heg
署	uus
沃	wod
趟	thz
赴	fuz
谦	qmy
砰	pge
骄	jnm
遂	svb
档	dha
慨	kdx
擒	qbf
苗	mnc
尴	gjy
迁	qmq
疏	uup
尬	gay
赚	vrb
赚	zjb
豆	dzh
孝	xnt
芬	ffc
诀	jty
廉	lmg
馨	xbu
辽	lnl
械	xpa
炉	luh
裸	loy
凛	lbd
渴	ked
柏	bda
柏	boa
拱	gsf
妨	fhn
揉	rzf
樱	yka
宙	vzg
崩	bgu
绑	bhs
嘶	sik
沟	gzd
禅	uju
骚	scm
歪	wdb
涯	yad
耍	uxe
遵	zyb
悍	hjx
耿	gge
循	xyr
聂	npe
猴	hzq
裙	qyy
蓬	pgc
芝	vic
舱	chv
肆	sii
帽	mcj
岭	lku
叮	dkk
拐	gkf
儒	rur
嫂	scn
瞥	ppb
廊	lhg
赔	pwb
鄙	bik
哩	lik
逊	xyz
牺	xin
谭	tjy
蒋	jlc
劣	lpx
玫	mww
吁	xuk
吁	yuk
押	yaf
攀	pja
乳	rua
鹿	lug
潘	pjd
藤	tgc
躬	gsu
蔡	cdc
粒	lim
涩	sed
嗓	shk
啪	pak
撼	hjf
眠	mmm
掀	xmf
旺	who
烁	uoh
坤	kyt
租	zuh
咯	kak
咯	lok
凰	hlj
哄	hsk
匪	fwk
膛	tho
淑	uud
忖	cyx
堵	dut
柴	idv
歹	ddh
沐	mud
绽	vjs
辅	fui
萍	pkc
敖	aof
磊	lwe
瞳	tsm
杆	gja
葬	zhc
篮	ljv
黯	anh
峡	xxu
朕	vfo
兆	vce
擅	ujf
陀	toe
龟	gvd
龟	jyd
龟	qqd
蜂	fgi
贞	vfb
惟	wwx
竭	jpl
厢	xli
惩	igr
谎	hly
腔	qlo
裴	pwf
玻	bow
铭	mkj
邻	lbr
朴	pna
朴	poa
朴	pua
衷	vsw
拢	lsf
魁	kvg
哗	hxk
茵	ybc
阅	ytm
弦	xmg
兮	xib
债	vdr
斌	bbw
踩	cdz
瞎	xxm
躁	zcz
讽	fgy
钉	dkj
蓄	xuc
丸	wjj
丐	gdx
矣	yis
册	cek
溃	kvd
隙	xie
叠	dpy
瞄	mnm
舅	jqj
钦	qbj
烛	vuh
兹	zib
肢	vio
综	zgs
禀	bkw
壶	huu
雯	wfy
栏	lja
览	lju
蹲	dyz
纽	nqs
践	jmz
汹	xsd
胎	tdo
妾	qpl
篷	pgv
锅	goj
楞	lga
澳	aod
窃	qpx
霆	tky
艇	tkv
轨	gvi
哨	uck
寡	gxg
尧	ycq
咧	lpk
瑰	gvw
沧	chd
彷	phr
呐	nek
卒	cuw
卒	zuw
焕	hrh
绣	xqs
骆	lom
敛	lmr
廖	lng
呻	ufk
驳	bom
睹	dum
狡	jnq
倘	thr
胳	gao
胳	geo
羡	xmb
婢	bin
枕	vfa
妒	dun
绮	qis
狸	liq
咪	mik
刮	gxq
咖	gak
恕	uun
煌	hlh
嘱	vuk
蚩	iic
栋	dsa
锤	ivj
逛	glq
暇	xxo
栈	vja
巷	hhg
填	tmt
诈	vay
昧	mwo
叱	iik
摧	cvf
焚	ffa
糕	gcm
衬	ify
倦	jrr
郝	hct
履	lvu
嘟	duk
汝	rud
旭	xuj
畜	iuw
畜	xuw
硕	uoe
蕴	yyc
侦	vfr
灼	voh
峻	jyu
菊	juc
彤	tsk
敦	dyw
筒	tsv
棉	mma
霉	mwy
衰	ukw
烤	kch
麒	qig
钩	gzj
犬	qrd
庸	ysg
滩	tjd
姥	lcn
桶	tsa
茅	mcc
狭	xxq
剥	bcx
剥	box
诞	djy
乍	var
辑	jii
棺	gra
抄	icf
谱	puy
枉	wha
趴	paz
狞	nkq
隶	lix
淮	hkd
缚	fus
蔽	bic
塑	sun
刊	kjg
澜	ljd
捂	wuf
秃	tuh
霎	uay
搁	gef
腻	nio
函	hjl
址	vit
邱	qqq
孽	npc
藉	jic
胀	vho
雍	ysw
匠	jlk
冉	rjk
蛛	vui
狈	bwq
衍	yjr
朽	xqa
噗	puk
苟	gzc
鲍	bcy
壳	keu
壳	qnu
萝	loc
恳	kfg
渠	qud
挟	jxf
噢	ook
雇	guh
碑	bwe
驼	tom
俺	anr
绘	hvs
捡	jmf
斐	fwf
阮	rre
吱	vik
炽	iih
钥	ycj
钥	ytj
杏	xka
桓	hra
昊	hco
擎	qkc
磁	cie
沸	fwd
衙	yar
匙	iio
匙	uio
鞘	ucg
剂	jiw
搅	jnf
猿	yrq
赠	zgb
徽	hvr
祷	dcu
桩	vla
账	vhb
巢	icv
堕	doe
堕	hve
梭	soa
兜	dzp
肿	vso
髅	lzg
娟	jrn
窄	vdx
菱	lkc
吨	dyk
絮	xun
芦	luc
澡	zcd
窟	kux
姻	ybn
捐	jrf
盏	vjj
孕	yyn
伺	cir
贩	fjb
扁	pmh
墅	uuo
寝	qbg
垃	lat
眶	klm
蝉	iji
卦	gxt
喧	xrk
圾	jit
澄	igd
妞	nqn
彪	bnh
淳	iyd
厦	xxi
嗡	wgk
勋	xyk
歧	qiv
聘	pbe
珑	lsw
迭	dpp
盐	yjt
捣	dcf
烫	thd
钧	jyj
掘	jtf
忿	fff
畔	pjt
樊	fja
倪	nir
亩	muw
咙	lsk
鳞	lby
杭	hha
眩	xrm
盲	mhw
茹	ruc
蔓	mjc
蔓	wjc
陋	lze
娱	yun
堤	dit
彬	bba
绷	bgs
铸	vuj
酬	izy
绞	jns
渺	mnd
卸	xpw
菩	puc
坊	fht
旷	klo
僻	pir
翘	qnq
盔	kvu
疚	jqb
慑	uex
粹	cvm
醋	cuy
咆	pck
嘀	dik
锡	xij
顷	qkb
胧	lso
捞	lcf
蹈	dcz
坟	fft
幢	ilj
幢	vlj
亨	hgw
荐	jmc
磕	kee
皓	hcb
跋	baz
稿	gch
蚁	yii
咚	dsk
耕	ggl
锻	drj
垒	lws
冈	ghk
龚	gsy
萱	xrc
绰	ics
绰	ios
宵	xng
钓	dnj
蔑	mpc
嵌	qmu
叩	kzk
迸	bgb
叨	tck
瓷	cid
炯	jsh
蝎	xpi
揪	jqf
沛	pwd
斋	vdw
挠	ncf
眷	jrb
姗	ujn
懈	xpx
瘫	tjb
饼	bku
嗅	xqk
棚	pga
煤	mwh
框	kla
绸	izs
券	xrb
蒸	vgc
稻	dch
侃	kjr
捆	kyf
澈	ied
毯	tjm
傍	bhr
旬	xyb
呕	ouk
梧	wua
粘	nmm
粘	vjm
薪	xbc
撩	lnf
舜	uya
猾	hxq
抿	mbf
禹	yup
啼	tik
炭	tju
掐	qxf
夭	ycp
榻	taa
逮	ddx
旱	hjo
驴	lvm
甄	vfx
煮	vut
憋	bpb
缴	vos
蕊	rvc
喽	lzk
涡	god
颓	tvh
瞅	izm
铮	vgj
纲	ghs
揍	zzf
鹅	eep
氓	mgw
瑾	jbw
肝	gjo
箫	xnv
腊	lao
霓	niy
淌	ihd
霹	piy
垫	dmf
刁	dnv
禄	luu
诅	zuy
擂	lwf
轴	vzi
厥	jti
厄	eei
扛	ghf
扛	khf
惕	tix
瞟	pnm
肘	vzo
媛	yrn
拧	nkf
浙	ved
熏	xyp
沁	qbd
骏	jym
笙	ugv
沮	jud
嗽	szk
舵	dov
瓣	bjl
吭	hhk
吭	kgk
绫	lks
蝴	hui
罐	grw
糖	thm
琢	vow
绅	ufs
怠	dds
嗷	aok
沦	lyd
鸭	yao
涅	npd
驭	yum
咏	ysk
窒	vix
槐	hka
臀	tyu
伞	sjr
懊	aox
葫	huc
闺	gvm
镶	xlj
萄	tcc
梢	uca
铲	ijj
缪	mns
缪	mqs
猩	xkq
跺	doz
蟒	mgi
蟒	mhi
浦	pud
邹	zzd
黝	yzh
筷	kkv
狰	vgq
炫	xrh
凹	aou
凹	wau
垮	kxt
噜	luk
颔	hjr
嚼	jnk
嚼	jtk
尿	nnu
塘	tht
肋	leo
肋	lwo
簇	cuv
哆	dok
兢	jkg
琐	sow
鞠	jug
匿	nik
酿	nly
颂	ssb
瘾	ybb
蔚	wwc
楠	nja
帜	vij
娥	een
沌	dyd
谜	miy
觅	mia
砂	uae
脯	puo
讳	hvy
螺	loi
韧	rfw
蜡	lai
蚕	cjt
聋	lsy
漓	lid
谣	ycy
绢	jrs
噩	eew
搔	scf
晏	yjo
倔	jtr
蹬	dgz
苑	yrc
婶	sfn
拇	muf
昼	vzu
坪	pkt
呸	pwk
憎	zgx
悯	mbx
诵	ssy
拎	lbf
唾	tok
兑	dvb
蜘	vii
秉	bkp
衅	xbp
壤	rht
匀	yyb
驯	xym
浊	vod
惚	hux
牟	mus
牟	mzs
呛	qlk
炒	ich
甸	dmb
惮	dax
惮	djx
碟	dpe
叟	szj
侥	jnr
侥	ycr
斟	vfq
髓	svg
赦	uet
噪	zck
枭	xnn
腮	sdo
遏	eeo
哽	ggk
芽	yac
倭	wor
卵	lrp
暧	aio
阙	qtm
诏	vcy
祟	svi
邸	diu
磋	coe
涕	tid
捶	ivf
袱	fuy
洽	qxd
檀	tja
赎	uub
滕	tgo
嵩	ssu
僚	lnr
睬	cdm
葱	csc
嬷	mon
缸	ghw
杉	uaa
杉	uja
廓	kog
蔷	qlc
恃	uix
绒	rss
瑚	huw
鹃	jrk
睫	jpm
陕	uje
钞	icj
蝙	bmi
搀	ijf
袅	nnn
蝇	yki
佬	lcr
蚂	mai
蚊	wfi
朔	uon
踹	ikz
啃	kfk
璋	vhw
慷	khx
咋	vak
咋	zak
咋	zek
檐	yja
悚	ssx
缎	drs
匈	xsb
厕	cei
涟	lmd
漩	xrd
栅	cea
栅	vaa
搐	iuf
蓓	bwc
扒	paf
穹	qsx
瑕	xxw
珀	pow
锥	vvj
矫	jnu
溶	rsd
晦	hvo
喳	iak
墟	xut
亢	khw
掳	luf
屯	tyh
屯	vyh
懦	nox
渣	vad
桀	jpx
恬	tmx
缀	vvs
褪	tvy
褪	tyy
筝	vgv
庇	big
绊	bjs
褚	vey
眺	tnm
驹	jum
钝	dyj
酋	qqb
狙	juq
镯	voj
贿	hvb
伽	gar
伽	qpr
凿	zcy
钮	nqj
抡	lyf
崆	ksu
弛	iig
褐	hey
勘	kjq
膏	gcw
筠	jyv
贬	bmb
绚	xrs
嗨	hdk
晤	wuo
窦	dzx
驿	yim
棱	lka
烙	lch
烙	loh
睿	rvb
锣	loj
溺	nid
溺	nnd
缔	dis
鬓	bbi
憨	hjv
瘟	wfb
钗	idj
昕	xbo
徊	hkr
偌	ror
髯	rji
缰	jls
庶	uug
缭	lns
徘	pdr
阀	fam
缄	jms
澎	pgd
掣	ien
惘	whx
槽	cca
娄	lzm
惋	wjx
芭	bac
琛	ifw
肴	yci
蹭	cgz
庚	ggg
飙	bnq
貂	dnp
圳	vft
氧	yhq
锵	qlj
笃	duv
捅	tsf
捺	naf
佗	tor
睨	nim
邃	svx
乒	pkq
暄	xro
簌	suv
鲸	jky
涎	xmd
攒	crf
攒	zjf
茄	jxc
茄	qpc
饲	siu
诫	jpy
阐	ijm
瑭	thw
冽	lpd
棕	zsa
辙	vei
蛙	wai
晁	ico
删	ujk
膳	ujo
殃	yhh
茱	vuc
苛	kec
跷	qnz
烘	hsh
扼	eef
孜	ziz
咎	jqw
蔬	uuc
酣	hjy
哝	nsk
禾	hep
纺	fhs
黏	nmh
崛	jtu
嘈	cck
礁	jne
琅	lhw
睦	mum
薰	xyc
蹿	crz
躇	iuz
菌	jyc
枣	zcc
迢	tnd
赃	zhb
臻	vfh
袜	way
娆	rcn
靳	jbg
帷	wwj
钵	boj
毋	wuv
橙	iga
丙	bkh
匡	klk
狩	uzq
芜	wuc
璀	cvw
冕	mmo
讷	ney
砌	qie
拈	nmf
酌	voy
殇	uhh
戎	rsg
蹑	npz
唠	lck
苔	tdc
栩	xua
啜	ikk
啜	iok
涣	hrd
莞	grc
恻	cex
傀	gvr
傀	kvr
蜷	qri
疙	geb
飒	sal
衮	gyl
乓	phq
棣	dda
棣	dia
磅	bhe
磅	phe
猖	ihq
煦	xuo
葵	kvc
瘩	dab
趾	viz
剌	lah
睽	kvm
坝	bat
靶	bag
糙	ccm
宦	hrg
吮	uyk
勺	ucb
祯	vfu
鄂	eek
圭	gvt
侈	iir
杠	gha
炬	juh
琶	paw
麾	hvg
屹	yiu
恤	xux
寐	mwg
韶	ucl
菇	guc
靓	llf
疮	ilb
辎	zii
攘	rhf
琵	piw
肮	aho
矜	qby
饵	eru
拷	kcf
缥	pns
籁	ldv
铛	dhj
铛	igj
茗	mkc
弑	uii
铿	kgj
璨	cjw
赘	vvf
缨	yks
畴	izt
儡	lwr
冢	vsg
珞	low
鞑	dag
壑	heb
骰	tzg
撰	vrf
嗒	dak
嗒	tak
窿	lsx
坞	wut
磷	lbe
扉	fwh
穗	svh
叁	sjs
皂	zcb
垢	gzt
枷	jxa
骋	igm
矗	iuu
缇	tis
驸	fum
唆	sok
馒	mju
撮	zof
羹	ggb
峦	lry
餮	tph
靥	yei
榕	rsa
胯	kxo
惦	dmx
伎	jir
癌	aib
黠	xxh
逵	kvt
韬	tcw
嫡	din
悼	dcx
帛	bob
啄	vok
铐	kcj
舷	xmv
祠	ciu
箍	guv
锈	xqj
蚣	gsi
汀	tkd
槛	kja
椎	iva
椎	vva
辗	nmi
滤	lvd
洼	wad
醇	iyy
瘤	lqb
桅	wwa
亥	hdw
咛	nkk
筛	udv
憧	isx
梗	gga
殉	xyh
翟	dix
翟	zdx
濒	bbd
簧	hlv
孺	ruz
闽	mbm
楷	kda
亘	gfh
惴	vvx
瓒	zjw
笋	syv
幺	ycv
蒜	src
瞑	mkm
峒	dsu
峒	tsu
螂	lhi
毗	pit
缆	ljs
缤	bbs
蜿	wji
屉	tiu
翱	aob
湄	mwd
桦	hxa
鹊	qtg
燎	lnh
贮	vub
猥	wwq
峥	vgu
溯	sud
喋	dpk
剃	tib
羔	gcb
匾	bmk
锢	guj
锄	iuj
蛤	gei
蛤	hai
烹	pgw
迥	jsk
淬	cvd
嚅	ruk
慵	ysx
烽	fgh
硝	xne
褥	ruy
踝	hkz
骁	xnm
酝	yyy
梓	zia
唷	yok
霭	aiy
蕉	jnc
墩	dyt
肇	vch
阑	ljm
痪	hrb
忏	ijx
拌	pjf
臾	yuj
瀛	ykd
簪	zjv
懵	mgx
纶	grs
纶	lys
跤	jnz
胴	dso
蝗	hli
癞	ldb
瓮	wgb
驮	dom
芹	qbc
骥	jim
炕	khh
羌	qly
娓	wwn
泌	bid
泌	mid
圃	puw
抒	uuf
鲤	liy
磐	pjv
萃	cvc
侬	nsr
萼	eec
皎	jnb
姒	sin
篆	vrv
蕙	hvc
瘸	qtb
炊	ivh
嘤	ykk
腆	tmo
嫖	pnn
惆	izx
媲	pin
馁	nwu
娉	pkn
褒	bcw
馋	iju
缜	vfs
捋	lof
潺	ijd
婵	ijn
涔	cfd
舫	fhv
柿	uia
麓	lua
轧	gai
轧	vai
纣	vzs
淀	dmd
昙	tjo
埔	but
埔	put
凋	dnd
蹂	rzz
荼	tuc
镑	bhj
臧	zhw
褂	gxy
筐	klv
筵	yjv
潞	lud
榆	yua
黔	qmh
玟	mbw
婊	bnn
痉	jkb
嫦	ihn
卞	bmd
袄	aoy
砾	lie
隽	jrv
躏	lbz
沓	dau
沓	tau
睐	ldm
啬	set
栓	ura
拄	vuf
夙	suj
蛆	qui
踵	vsz
剐	gxk
潼	tsd
睑	jmm
鹭	luz
藕	ouc
幔	mjj
篡	crv
蟠	pji
嫔	pbn
裆	dhy
哺	buk
跚	ujz
馥	fuh
孚	fua
僖	xir
窕	tnx
钊	vcj
囤	tyw
喟	kvk
跛	boz
刨	pcb
螳	thi
荤	hyc
捎	ucf
镭	lwj
徨	hlr
蜕	tvi
瑙	ncw
贲	bfu
擞	szf
濑	ldd
鳅	qqy
堑	qmi
绾	wjs
苋	xmc
恸	tsx
粤	ytp
碳	tje
龌	wov
啾	jqk
蹒	pjz
蝼	lzi
龊	iov
揩	kdf
舶	bov
啻	iil
阜	fup
弋	yiq
恪	kex
蜃	ufi
搪	thf
辘	lui
娑	sod
碾	nme
摒	bkf
撬	qnf
倌	grr
髦	mci
蚌	bgi
蚌	bhi
竣	jyl
嗲	dxk
瞌	kem
胚	pwo
愠	yyx
谙	any
啵	bok
匍	pub
脓	nso
蛹	ysi
泯	mbd
讹	eey
潦	lnd
汛	xyd
玷	dmw
瞰	kjm
椰	yea
垠	ybt
邕	ysv
挎	kxf
糯	nom
霾	mdy
俸	fgr
坷	ket
噙	qbk
湍	trd
赣	gjl
芋	yuc
汕	ujd
鬃	zsi
魍	whg
摁	enf
褛	lvy
惰	dox
蚯	qqi
斓	ljw
觐	jbn
镣	lnj
篓	lzv
篑	kvv
睥	pim
沽	gud
怏	yhx
魉	llg
鼾	hjz
帚	vzx
亟	jil
镀	duj
骠	bnm
苯	bfc
宸	ifg
僮	vlr
阗	tmm
豺	idp
纰	bis
阂	hem
蚓	ybi
劾	hew
嵘	rsu
铝	lvj
溉	gdd
轲	kei
螃	phi
涓	jrd
怆	ilx
踊	ysz
氲	yyq
厩	jqi
瑁	mcw
箩	lov
斡	wou
炖	dyh
氤	ybq
芍	ucc
玳	ddw
桧	hva
壬	rfq
瘁	cvb
侗	dsr
侗	tsr
镂	lzj
碴	iae
谤	bhy
嘹	lnk
蔫	nmc
悖	bwx
脐	qio
盹	dym
谆	vyy
殡	bbh
诌	vzy
琊	yaw
蟑	vhi
绥	svs
讧	hsy
夔	kvb
涮	urd
蜗	woi
垛	dot
臃	yso
豚	tyo
皿	mbk
佻	tnr
碉	dne
镐	gcj
镐	hcj
诽	fwy
掖	yef
戛	gae
戛	jxe
叵	pok
泗	sid
鏖	aog
邋	lav
獗	jtq
嗟	jpk
忻	xbx
遢	tao
庖	pcg
怵	iux
忪	vsx
鹄	hun
犒	kcn
焊	hjh
碱	jme
馊	szu
斫	voe
跆	tdz
忸	nqx
闩	urm
鸵	ton
麝	ueg
耙	bal
耙	pal
岷	mbu
粽	zsm
蝈	goi
闳	hsm
佝	gzr
笆	bav
怩	nix
掇	dof
艮	gfx
膘	bno
匮	gvk
皖	wjb
燮	xph
喙	hvk
莓	mwc
颛	vru
椿	iya
陲	ive
椁	goa
漕	ccd
贰	erq
橇	qna
跻	jiz
戊	wui
猷	yzb
锹	qnj
涝	lcd
逅	hzp
肪	fho
囱	csp
阪	bje
浃	jxd
佞	nkr
蘸	vjc
挝	vxf
挝	wof
氢	qkq
蔺	lbc
荏	rfc
磬	qku
闰	rym
缮	ujs
谚	yjy
鸩	vfg
谗	ijy
砥	die
俎	zur
邈	mnp
籽	zim
钠	naj
辍	ioi
鞅	yhg
蹶	jtz
诮	qny
赳	jqz
聒	goe
腌	aao
淙	csd
垩	eeh
磺	hle
钏	irj
酪	lcy
糠	khm
呔	tdk
檬	mga
柩	jqa
纂	zrv
琨	kyw
铄	uoj
镌	jrj
佃	dmr
佃	tmr
沱	tod
貉	hcp
貉	mop
讫	qiy
孀	uln
柠	nka
呶	nck
谟	moy
扪	mff
辔	pws
逖	tiq
猡	loq
掴	gof
茁	voc
诳	kly
颧	qrc
砝	fae
螟	mki
裨	biy
睇	dim
樽	zya
绦	tcs
啮	npk
锲	qpj
懔	lbx
蹴	cuz
篙	gcv
葩	pac
铨	qrj
盥	grp
黜	iuh
覃	qbx
覃	tjx
淞	ssd
璜	hlw
铀	yzj
驷	sim
诰	gcy
滂	phd
槁	gca
獐	vhq
饪	rfu
酵	jny
噱	xtk
锉	coj
蔗	vec
牦	mcn
榷	qta
泵	bge
灞	bad
荪	syc
咩	mpk
箴	vfv
罹	lis
釉	yzp
赊	ueb
熨	yyu
锟	kyj
夯	hhd
酡	toy
痿	wwb
绌	ius
莘	ufc
奘	vlp
锷	eej
崴	wdu
骞	qmg
秆	gjh
膑	bbo
衢	qur
仄	zei
痘	dzb
晷	gvo
懋	mca
稔	rfh
乜	mpv
乜	npv
纫	rfs
媾	gzn
耦	oul
萋	qic
侩	kkr
枰	pka
褫	iiy
遴	lbm
蓑	soc
娩	mmn
虱	uiv
觞	uhd
阡	qme
舢	ujv
铣	xmj
秸	jph
氮	djq
睢	svm
嘞	lek
嘞	lwk
牍	dup
羸	lww
鹑	iyw
蒿	hcc
仃	dkr
鬣	lpi
铡	vaj
碘	dme
镁	mwj
珐	faw
榔	lha
钙	gdj
媪	aon
珲	hyw
肛	gho
镞	zuj
岫	xqu
氯	lvq
蛔	hvi
砒	pie
谌	ufy
狷	jrq
莠	yzc
钨	wuj
镝	dij
旮	gaj
酩	mky
诟	gzy
摈	bbf
黩	duh
闱	wwm
卅	sah
鲧	gyy
蹉	coz
氨	anq
倥	ksr
泖	mcd
榈	lva
跎	toz
囿	yzw
痂	jxb
镗	thj
伉	khr
胪	luo
揆	kvf
鼹	yjj
耄	mct
暝	mko
蚪	dzi
蟀	uki
埙	xyt
獭	taq
墒	uht
滦	lrd
螫	uit
笮	zev
笮	zov
肱	gso
徕	ldr
柚	yza
哙	kkk
挈	qpf
粕	pom
钿	dmj
钿	tmj
纥	ges
纥	hes
戕	qlp
埂	ggt
杷	paa
脍	kko
湟	hld
氦	hdq
缦	mjs
碣	yae
缟	gcs
偬	zsr
胱	glo
铉	xrj
椽	ira
蕨	jtc
鳃	sdy
苌	ihc
腱	jmo
痨	lcb
竽	yuv
辚	lbi
宥	yzg
镊	npj
铬	gej
馏	lqu
炔	qth
踟	iiz
仟	qmr
鹌	and
苫	ujc
龈	kfv
龈	ybv
焖	mfh
蹼	puz
锰	mgj
痢	lib
嵯	cou
蛉	lki
吖	aak
郧	yyk
稞	keh
佚	dpr
淖	iod
淖	ncd
铰	jnj
褡	day
薨	hsc
罨	yjs
枋	fha
垓	gdt
蝓	yui
躅	vuz
矾	fje
缁	zis
陉	xke
堠	hzt
瓤	rhw
坩	gjt
焙	bwh
渑	ugd
氟	fuq
疟	ntb
悭	qmx
阄	jqm
陂	poe
氖	ndq
铙	ncj
桁	hga
妊	rfn
埚	got
苒	rjc
锗	vej
谰	ljy
勰	xpl
侪	idr
疴	keb
蚝	hci
馕	nhu
睾	gcp
烃	tkh
耋	dpt
酮	tsy
柢	iia
稗	bdh
畦	qit
帑	thn
扦	qmf
嗉	suk
爰	yra
锱	zij
杲	gco
禳	rhu
辊	gyi
娠	ufn
豳	bbu
锑	tij
榫	sya
砭	bme
耪	phl
崤	xnu
糁	ufm
啁	tnk
龃	juv
鞯	jmg
铋	bij
髋	krg
穑	seh
刖	yto
囝	jmw
舂	iss
镬	hoj
飧	syx
枞	csa
柙	xxa
痈	ysb
髡	kyi
伧	cfr
伧	ifr
棹	vca
棹	voa
薮	szc
龋	quv
圹	klt
蚬	xmi
鞣	rzg
圯	yit
啭	vrk
钡	bwj
捩	lpf
鲳	ihy
枇	pia
谵	vjy
痱	fwb
皴	cys
漯	tad
诂	guy
郴	ifa
桡	nca
桡	rca
蓊	wgc
鲷	dny
曩	nho
莴	woc
蕞	zvc
厝	coi
钣	bjj
鬲	geh
鳔	bny
箧	qpv
缶	fzw
沤	oud
蛞	koi
猓	goq
揸	vaf
铱	yij
缂	kes
蜩	tni
铍	pij
傧	bbr
隹	vvr
妯	vzn
孓	jtl
坼	iet
梃	tka
砷	ufe
箪	djv
苣	quc
淦	gjd
辏	czi
娌	lin
缫	scs
翮	heh
锂	lij
瘘	lzb
轫	rfi
啉	lbk
啉	ljk
璩	quw
缍	dos
槭	sea
胼	pmo
畚	bfs
绁	xps
磴	dge
篌	hzv
芘	pic
谇	svy
谖	xry
戥	dgo
劬	qub
嬲	nnt
艋	mgv
嫘	lwn
楝	lma
辋	whi
劓	yiz
曷	heo
酚	ffy
氽	tyr
铵	anj
慝	tek
罟	gus
谮	zfy
鲎	hzx
撙	zyf
蚶	hji
锾	hrj
蛲	nci
芈	mic
遘	gzg
戆	ghl
戆	vll
杪	mna
砟	vae
簋	gvv
酴	tuy
鲭	qky
耜	sil
肫	iyo
肫	vyo
钋	poj
钸	buj
氩	yaq
溴	xqd
陬	zze
黉	hsx
坜	lit
疳	gjb
霪	yby
畀	bit
裒	pzw
淠	pid
酞	tdy
畎	qrt
籀	vzv
洫	xud
爨	crp
嶝	dgu
肶	bio
葧	boh
踎	bwz
啋	cdk
罉	chp
吋	cyk
邨	cyt
跶	daz
梼	dca
嘚	dek
扽	dff
氹	dhv
屌	dnu
绖	dps
揼	dyf
惇	dyx
哣	dzk
奀	enb
咁	gjk
噏	hao
㷫	hku
竑	hsl
纮	hss
翃	hsu
閪	hwm
睺	hzm
耖	icl
瞋	ifm
梼	iza
搊	izf
趌	jpz
崁	kju
啹	kok
佢	kor
焜	kyh
痳	lbb
燐	lbh
冧	lfg
唥	lhk
脷	lio
貍	lip
瞭	lnm
暸	lno
㑩	lor
镠	lqj
蹓	lqz
眬	lsm
僇	lur
箓	luv
攰	lwu
孖	maz
冇	mcu
掹	mgf
搣	mif
屘	miu
搣	mpf
乸	nay
嫐	ncn
迺	ndx
奀	nfb
煖	nrh
秾	nsh
砲	pce
珮	pww
哣	pzk
锜	qij
毬	qqm
佺	qrr
踡	qrz
镕	rsj
嗮	sdk
牠	tan
啫	vek
䟴	vfz
搲	waf
抆	wff
薢	xpc
衒	xrr
垚	yct
钖	yhj
旸	yho
赟	yyw
臜	zao
咗	zok
鲗	zwy
十	uihu
直	viuj
使	uirh
剑	jmrd
今	jbrd
微	wwru
似	uirs
武	wuhv
士	uiuh
远	yrez
离	liwk
奇	jidk
活	hodq
极	jiaj
华	hxru
令	lkrd
计	jiyu
玉	yuwd
未	wwha
始	uins
击	jifk
坐	zorr
急	jidx
视	uiuj
尽	jbud
兴	xkxb
客	kegw
统	tssw
异	yikc
政	vghw
居	juug
巴	baku
支	viuy
攻	gsgw
愿	yrix
围	wwww
示	uiex
丽	lihk
既	jigj
睛	jkmf
宫	gsgk
右	yzuk
角	jtdo
止	viuh
恶	wuhx
继	jism
激	jidb
游	yzdf
树	uuay
施	uifr
仅	jbry
治	vids
试	uiyq
室	uigh
阴	ybeo
称	ighd
射	ueuc
厉	liiw
志	viux
致	vihw
伸	ufro
忘	whwx
型	xkkt
营	ykck
付	furc
纪	jisk
假	jxrk
医	yiku
烟	yjhw
食	uirl
食	yirl
呵	hekk
验	yjmr
智	viuo
适	uiqz
邪	xpye
亡	whwv
富	fugh
限	xmeg
吓	hekx
省	xkxm
伊	yirx
释	uipy
敬	jkcw
借	jprg
叔	uuuy
织	visk
彩	cdap
臂	biuo
臂	bwuo
亦	yiwy
预	yuyy
尤	yzyd
偏	pmrh
箭	jmvb
拜	bdfh
唯	wwkv
迹	jiyz
袋	ddry
番	fjpt
鲁	luyo
豪	hcwu
午	wuru
执	vifj
互	huhv
锋	fgjw
尸	uikp
嘛	makg
介	jprp
益	yibm
皱	vzdp
街	jprt
兽	uzbh
伟	wwrw
监	jmum
碎	svew
剧	juud
弃	qiwc
逐	vuuz
附	fuer
歌	gekd
逼	bihz
材	cdac
择	zefy
袭	xiyy
抵	difu
幻	hryv
烧	uchq
妻	qihn
私	sihs
园	yrwe
壁	biut
伏	furq
跃	ytzp
悲	bwfx
竹	vurr
艾	yici
企	qirv
逸	yidz
幕	mucj
汗	hjdg
裂	lphy
陷	xmed
泰	tdsu
浮	fuda
涌	ysds
洲	vzdd
针	vfju
纸	visu
晶	jkoo
讯	xyyv
御	yurw
壮	vldu
雾	wuyw
佳	jxrt
亿	yirv
梁	llda
仔	zdrz
郭	gowe
凉	lldw
减	jmdw
侍	uirt
伍	wurw
朗	lhlo
讶	yayy
诗	uiyt
货	horb
傅	furf
赏	uhxk
摩	mogf
氏	uipq
途	turz
旦	djoh
忆	yixv
季	jihz
侯	hzrv
堡	bcrt
劫	jptl
惧	juxj
慧	hvfx
抚	fufe
漫	mjdo
乘	ugqb
启	qihk
仪	yird
络	losw
洁	jpdu
奉	fgsf
愈	yurx
映	ykok
奴	nuny
健	jmry
尺	iiud
焰	yjhd
述	uuaz
恭	gsgx
辉	hvxg
绪	xust
磨	moge
忌	jikx
贫	pbfb
欺	qiqd
悠	yzrx
艳	yjfd
奖	jldd
截	jptv
递	dibz
嘻	xiku
刹	uaid
慰	wwux
悔	hvxr
姿	zidn
泉	qrbu
勾	gzbs
殊	uuhp
鸡	jiyn
炮	bchb
袖	xqyy
沿	yjdj
鹏	pgon
屈	quui
刃	rfdd
炎	yjhh
墨	moht
驾	jxlm
尝	ihxe
牧	munw
膀	phol
寂	jigu
媚	mwnm
牵	qmdg
祝	vuuk
抹	mofh
溜	lqdp
询	xyyb
腹	fuor
撤	iefw
竞	jklk
喂	wwkt
搭	dafc
茫	mhcd
返	fjpz
挤	jifw
冠	grge
瘦	uzbj
仲	vsrv
违	wwwz
豫	yuyd
柱	vuad
饰	uiur
勉	mmdl
刑	xkkd
黎	lihr
煞	uadd
贤	xmub
衫	ujyp
锦	jbjb
纤	xmsq
购	gzbb
础	iuei
舰	jmvj
魏	wwhg
详	xlyy
撑	igfx
弗	fugp
诱	yzyh
屁	piub
弥	migd
寺	sitc
贸	mcpb
浅	qmdj
猪	vuqt
泄	xpdn
肤	fuoe
渊	yrdp
韦	wwhh
叛	pjbp
鸿	hsdn
缝	fgsw
屠	tuut
莹	ykcw
誉	yuxy
夕	xixd
魄	pobg
巡	xyvz
誓	uify
枚	mwaw
欠	qmdr
稀	xihi
勃	boul
勃	bwul
毅	yilj
汽	qidq
摄	uefe
哎	aikc
植	viau
艰	jmyg
虹	hsig
咽	yekw
蓉	rscx
绩	jisf
坛	tjte
凄	qidh
搬	bjfv
滋	zidb
逆	ninz
卑	bwbu
喉	hzkr
幼	yzyl
赐	cibo
腕	wjog
筹	izvf
拓	tofe
璃	liww
尉	wwuc
尉	yuuc
雁	yjir
吾	wuwk
役	yirj
狮	uiqu
寿	uzfc
患	hrkx
励	liil
愚	yuox
腐	fugk
哑	yakh
恍	hlxx
狄	diqh
妄	whwn
契	qifd
售	uzvk
郡	jyxe
颈	jksy
咕	gukg
歇	xpod
蜜	migi
裹	gowo
殷	ybpj
殷	yjpj
呜	wukw
娶	quen
矩	juuk
嘲	icku
宅	vdgp
鼎	dkmv
削	xnxd
页	yeeb
俞	yurh
盒	herm
漆	qida
蠢	iysi
甫	fuuo
墓	muct
屑	xpux
畅	ihov
涵	hjdl
叉	iayd
搏	boff
逝	uifz
鞋	xpgt
泣	qidl
摊	tjfy
籍	jivl
浴	yudb
鉴	jmuj
逗	dzdz
湘	xlda
晰	xioa
吊	dnkj
串	irkk
哲	vefk
寄	jigd
宰	zdgl
媒	mwng
眯	mimm
贡	gsgb
斧	fubj
惶	hlxb
荆	jkcd
伪	wwrd
冤	yrgd
翅	iiux
拂	fuff
昭	vcod
辨	bmld
愉	yuxr
摘	vdfl
淋	lbda
俯	furg
昔	xigo
揭	jpfo
揭	qifo
竖	uuul
遣	qmvz
弘	hsgs
戚	qiwu
憾	hjxw
仑	lyrb
咯	gekw
卜	boud
卜	buud
夷	yihg
辜	gugl
罕	hjgg
冻	dsdq
赋	fubw
趋	quzd
灿	cjhu
胞	bcob
颠	dmuy
顽	wjey
阎	yjmd
溪	xida
帘	lmxj
侄	virh
贱	jmbj
逻	losz
兔	tudk
轿	jnip
祈	qiuj
兹	ciby
综	zssg
斑	bjww
棠	thxa
腥	xkoo
桂	gvat
翰	hjur
怯	qpxt
寞	mogc
叙	xury
佐	zoru
呐	nakk
栽	zdta
塌	tato
携	xpfv
蹄	tizl
颖	ykby
棵	keao
痒	yhby
裳	ihxy
裳	uhxy
泼	podv
溢	yidb
噬	uikv
缕	lvsm
译	yiyy
泊	bodb
咖	kakl
溅	jmdb
巷	xlgk
膊	boof
姚	ycnv
渔	yudy
遁	dypz
辕	yrit
啡	fwkf
乙	yivv
彦	yjlp
耽	djeg
浸	jbdx
佑	yzru
榜	bhal
症	vgbh
潭	tjdx
滞	vidc
毙	bibh
谊	yiyg
笛	divy
剪	jmbd
囚	qqwr
辟	biul
辟	piul
碌	luex
掷	vifb
桐	tsak
帆	fjjj
矢	uird
藉	jpcl
嚣	xnky
巍	wwuh
窥	kvxe
邵	ucde
胃	wwto
暮	muco
挟	xpfj
琉	lqww
熙	xikd
喀	kakg
妆	vldn
贷	ddrb
宪	xmgn
鞘	qngx
裕	yuyb
株	vuap
蜀	uusb
敞	ihxw
茂	mccw
坎	kjtd
渗	ufds
拘	jufb
脊	jiuo
滔	tcda
挫	cofr
伺	sirv
扁	bmhk
侮	wurr
郊	jnle
莽	mhcq
俘	fura
诛	vuyp
澄	dgdd
淳	vydw
揽	ljfu
厦	uaie
鸦	yayn
哮	xnkt
虞	yuhk
惭	cjxi
熬	aofd
梳	uuaw
浆	jldu
邮	yzye
襄	xlwk
禽	qbrw
勿	wubp
嫉	jinb
嚎	hckw
衔	xmrj
栗	lixa
喻	yukr
虏	luhl
苹	pgcp
苹	pkcp
淘	tcdb
帖	tpjb
襟	jbya
汁	vidu
嘘	uikh
嘘	xukh
峨	eeup
饥	jiuj
秩	vihp
沫	modh
肺	fwoh
砖	vree
弧	hugp
妓	jinu
湛	vjdq
媳	xinz
婿	xunp
扳	bjfp
屡	lvum
犀	xiuu
奢	uedt
诊	vfyr
泳	ysdd
拭	uifq
蚀	uiui
窍	qnxg
脂	viob
戮	luxg
淹	yjdd
喇	lakh
侣	lvrk
逞	igkz
疫	yibj
豁	hogb
殖	vihu
券	qrbd
熄	xihz
疤	babb
蒲	pucd
稚	vihv
冀	jibt
葡	pucb
寓	yugo
舔	tmqt
辖	xxig
梨	liha
砚	yjej
哉	zdtk
缴	jnsb
稽	jihy
涡	wodk
滥	ljdu
搓	cofy
氓	mhwm
腊	xiog
惫	bwwx
淌	thdx
茨	cicd
膜	mooc
讥	jiyj
胶	jnol
凸	tuuh
奎	kvdt
岔	iafu
颅	luby
酥	suyh
冶	yeds
燥	zchk
拙	vofi
蛊	guim
漾	yhdb
凳	dgdj
逾	yurz
唬	hukh
咸	xmwh
嗜	uikt
詹	vjdy
霖	lbya
伶	lkrr
悸	jixh
沼	vcdd
颁	bjfy
泻	xpdg
膨	pgou
栖	qiax
栖	xiax
剔	tiod
靴	xtgr
萌	mgco
棘	jicc
脯	fuof
瞻	vjmd
瀑	pudo
敷	fufw
匣	xxko
歼	jmhq
彰	vhlp
寥	lngx
弊	bibc
敝	bibw
舆	yupb
枢	uuak
叭	bakb
挚	viff
揖	yifk
荫	ybce
祁	qiue
谐	xpyb
啤	pikb
峙	uiut
峙	viut
浇	jndq
婪	ljan
炙	vixh
拣	jmfq
骸	hdgw
邢	xkke
峭	qnux
巩	gsgj
柬	jmhs
竿	gjvg
鸽	gern
崎	qiud
鞍	angg
剿	icvd
剿	jnvd
腑	fuog
厕	siib
虾	xxix
栅	ujak
扒	bafb
庐	lugh
暑	uuot
靡	migf
喳	vaka
芯	xbcx
厘	liio
秽	hvhu
拯	vgfl
汰	tddd
粥	vzgm
奄	yjdo
萎	wwch
奠	dmbd
惺	xkxo
俐	lirh
棱	lgat
牡	munt
藩	fjcd
札	vaav
曙	uuos
殆	ddhs
巳	sikv
纬	wwsw
诣	yiyb
曳	yeov
倡	ihro
仕	uiru
募	mucl
佯	yhry
隋	doeu
隋	sveu
萤	ykci
谴	qmyv
屎	uium
谍	dpyn
缅	mmse
瞩	vumu
蟹	xpdi
漱	uudh
熔	rshx
酱	jldy
辫	bmls
殴	oukj
裔	yiyk
蔼	aicy
痊	qrbr
茧	jmci
侨	qnrp
隧	sveb
湃	pddf
邑	yikb
踌	izzf
苇	wwcw
崭	vjui
屿	yuuh
咨	zidk
陨	yyek
鸳	yrxn
榴	lqap
雌	civv
蠕	ruiy
掺	ijfs
掺	ujfs
掺	xmfs
铅	qmjj
吝	lbwk
雏	iudv
窖	jnxn
簿	buvd
譬	piuy
烬	jbhu
镰	lmjg
紊	wfwy
渍	zidf
邯	hjge
窑	ycxw
粪	ffmg
鸯	yhkn
橡	xlad
孰	uuwj
涧	jmdm
闸	vamo
椒	jnau
癸	gvdt
荧	ykch
噎	yeku
锭	dkjg
瘪	bpbz
沪	hudh
痹	bibt
辐	fuih
煽	ujhh
炳	bkhh
捻	nmfr
锯	juju
蜒	yjip
绎	yisy
茸	rsce
踞	juzu
粟	suxm
寅	ybgh
撮	cofo
灶	zcht
迂	yuez
诬	wuyg
桨	jlda
俭	jmrr
钳	qmjg
橱	iuai
篱	livw
淤	yudf
痞	pibb
迄	qirz
稼	jxhg
槛	jmau
辗	vjiu
辗	zjiu
渝	yudr
蛾	eeip
幌	hljo
瓢	pnxp
翟	vdxv
馈	kvuv
楷	jpab
咀	jukq
掂	dmfg
颐	yiky
芥	jpcr
卉	hvuc
稠	izhk
曝	bcoo
汲	jidj
赂	lubw
吠	fwkq
藻	zccd
蹋	tazo
垦	kfgt
隘	aieb
诲	hvyr
翌	yixl
垣	yrth
抉	jtfv
茬	iacu
沥	lidi
毡	vjmb
垄	lsyt
陇	lsey
袒	tjyo
拌	bjfb
浚	jyds
筏	favr
甥	ugpt
驮	tomd
涤	didw
捍	hjfo
壕	hctw
桔	jpau
桔	juau
讼	ssyb
叼	dnkv
茎	jkcs
剁	dojd
骡	lomt
隅	yueo
卯	mcpe
撅	jtfi
榨	vaax
苞	bccb
坍	tjtk
鸥	oukn
轧	yaiv
糜	mwgm
壹	yiud
蘑	mocg
瘴	vhbl
挛	lryf
腋	yeow
撂	lnft
馅	xmud
渭	wwdt
盅	vsvm
冗	rsgj
硫	lqew
甭	bgbo
皑	aibu
秤	ighp
攫	jtfm
蛰	vefi
盂	yuem
囤	dywt
刨	bcbd
渤	bodu
肾	ufuo
薯	uucs
鳖	bpby
戍	uuwd
摹	mocf
嚏	tiku
沂	yidj
泞	nkdg
饺	jnul
孵	fupa
羚	lkyr
藐	mncp
汐	xidx
郸	djbe
撵	nmfe
痰	tjbh
犁	lihn
臆	yiol
粱	lldm
涸	hedw
箕	jivq
怂	ssrx
噶	gakc
锚	mcjc
疵	cibv
汾	ffdf
梆	bhaf
漳	vhdl
恿	yssx
椭	toae
堰	yjtk
滇	dmdu
淄	zidv
掸	djfb
掸	ujfb
皋	gcbd
帧	vfjb
抠	kzfk
晾	llow
臼	jqpu
腺	xmob
赁	lbrb
匝	zakj
灸	jqxh
畸	jitd
彝	yivm
雹	bcyb
忱	ifxg
荔	licl
硅	gvet
刽	gvrd
孪	lryz
犊	dunu
淆	xndi
耘	yyle
蓟	jicy
酉	yzxh
秧	yhhk
挞	tafd
舀	ycaj
恫	dsxk
檄	xiab
洱	erde
峪	yuub
莆	pucf
戌	xuwh
埠	butp
坯	pitb
抨	pgfp
楔	xpaf
貉	hepw
唁	yjky
佰	bdre
蛀	vuid
谩	mjyo
玖	jqwx
涪	fudl
樟	vhal
菠	bocd
砧	vfeb
赡	ujbd
酗	xuyi
蚤	zcyi
滓	zidg
柑	gjag
豢	hrbu
泅	qqdw
幂	migo
铣	xijn
烩	hvhr
箔	bovd
誊	tgby
荚	jxcj
痔	vibt
岿	kvuu
滁	iude
搽	iafc
傈	lirx
汞	gsgu
铆	mcjp
铂	bojb
癣	xrby
潍	wwds
钎	qmjq
胰	yioh
锌	xbjl
韭	jqfh
酶	mwyr
傣	ddrs
钾	jxjo
淖	vodb
矽	xiex
锨	xmjj
烷	wjhg
氰	qkqf
疥	jpbr
疟	ycbk
黍	uuhr
豌	wjdg
疹	vfbr
疽	jubq
胺	anog
疡	yhbv
蚜	yaiy
毖	bibx
镍	npjz
菏	hecd
捌	bafk
讣	fuyb
蓖	bicp
硼	pgeo
醚	miym
肄	yiby
僳	surx
粳	jkmh
醛	qryc
硷	jmer
拾	uifr
琪	qiwq
薇	wwcr
魅	mwgh
倩	qmrf
岚	ljuf
蓦	mocm
嫣	yjnh
黛	ddrh
芸	yyce
禅	ijub
倏	uuru
肠	ihov
翎	lkrx
逍	xnxz
咦	yikh
倚	yird
怡	yixs
厮	siiq
彷	fhrf
呃	eeki
芷	vicv
乞	qirv
匕	bipv
潇	xndc
嗤	iikc
焉	yjhh
翩	pmhx
弩	nung
兀	wuhe
瑜	yuwr
妍	yjnk
骷	kugg
琦	qiwd
梵	fjaj
唔	wukw
嗦	soku
啧	zekf
炀	yhhv
菁	jkcf
蛟	jnil
朦	mgoc
迦	jxlz
拚	pbfs
奕	yiyd
吏	lihk
祺	qiuq
戟	jiug
丞	iglh
叨	dckd
蝠	fuih
莺	ykcn
阱	jkee
玑	jiwj
讪	ujyu
蹙	cuwz
雳	liyi
缪	mzsx
晖	hvog
璧	biuw
踱	dozg
偎	wwrt
缉	jisk
裘	qqhy
瑛	ykwc
娴	xmnm
蜥	xiia
寰	hrgs
瀚	hjdu
祀	siuk
嬉	xinu
虔	qmhw
娲	wank
恙	yhbx
漪	yidq
翡	fwfx
聆	lker
鸾	lryn
咄	doki
巅	dmuu
煎	jmbd
叽	jikj
曦	xiob
褚	iuyt
褚	vuyt
悴	cvxw
怅	ihxi
伽	jxrl
憔	qnxv
妩	wune
竺	vuve
恺	kdxu
谕	yuyr
庵	angd
胤	ybpy
蜴	yiio
昱	yuol
悻	xkxt
茉	moch
霏	fwyf
嗣	sikv
闵	mbmw
樵	qnav
癫	dmbu
懿	yiud
吆	ycky
鸠	jqjn
幡	fjjp
亵	xpwf
绛	jlsw
煜	yuho
聿	yuxe
琥	huwh
羿	yixc
鲨	uady
戾	lihq
甬	ysso
莞	wjcg
岱	ddru
棣	tiax
羁	jisg
拗	aofy
拗	nqfy
伫	vurg
笠	livl
攸	yzru
唧	jikg
迳	jksz
浏	lqdw
俨	yjrh
泓	hsdg
靓	jkfj
荀	xycb
饕	tckr
稷	jiht
矜	gryr
矜	jbyr
楣	mwam
渎	dudu
呱	gxkp
瞠	igmx
奚	xiay
湮	yjdx
萦	ykcy
飕	szfj
蜈	wuik
咻	xqkr
扈	huhk
噤	jbka
玺	xidw
阖	hemt
璞	puwy
蹊	qiza
蹊	xiza
楮	iuat
嬴	ykwo
遐	xxkz
胭	yjow
顼	xuwy
咫	viuk
骼	gegw
鳄	eeyk
袂	mwyv
缈	mnsm
铎	dojy
惬	qpxk
髻	jiiu
笺	jmvj
杵	iuaw
兖	yjls
曜	ycox
飓	jufj
谏	jmyh
喋	vakn
渥	wodu
邺	yeye
岐	qiuu
耷	dade
橘	juay
濮	pudr
蟾	ijid
淇	qidq
矶	jiej
憬	jkxo
蕃	bocp
蕃	fjcp
弼	bige
毓	yurw
谛	diyl
唏	xiki
膺	ykgo
匐	fubh
嗫	npke
稣	suyh
瓯	oukw
簸	bovq
瞿	jumv
瞿	qumv
羲	xibh
鹦	ykbn
饷	xlup
辄	veie
颌	gery
颌	hery
旖	yifr
荃	qrcr
捋	lvfa
胥	xupo
偕	xprb
胄	vzyo
掬	jufb
诃	heyk
魇	yjig
鹉	wuwn
轼	uiiq
玟	wfww
旌	jkfr
魑	iigw
丕	pibh
隽	jyvn
偃	yjrk
醺	xyyp
嗥	hckb
阉	yjmd
蟆	maic
榭	xpau
婀	eene
郢	ykke
癖	pibu
侏	vurp
渲	xrdg
岌	jiuj
遽	juhz
赧	njte
汴	bmdd
窈	ycxy
靼	dago
霁	jiyw
沅	yrde
卤	lubw
颚	eeky
腼	mmoe
恣	zidx
槌	ivap
苜	mucm
噫	yikl
妤	yuny
谪	veyl
贲	biub
裟	uady
旎	nifr
谄	ijyd
谒	yeyo
谧	miyx
姣	jnnl
姣	xnnl
哂	ufkx
娼	ihno
嗝	gekh
岖	quuk
杳	ycao
妪	yunk
袈	jxly
赈	vfbi
颉	jpuy
颉	jxuy
颉	xpuy
晔	yeor
罔	whkb
颦	pbvb
杞	qiak
龇	zivv
觎	yurj
畿	jiyt
苓	lkcr
犷	glqg
俟	qirs
俟	sirs
弈	yiyc
呓	yikc
觊	jiuj
槟	bbag
槟	bkag
禧	xiuu
祗	viuu
熹	xiud
俑	ysrs
潋	lmdr
巽	xykg
仞	rfrd
釜	fubw
洵	xydb
贻	yibs
谲	jtyy
咿	yikr
咤	vakg
憩	qiqx
睥	bimb
犄	jind
骠	pnmx
僮	tsrl
榄	ljau
辇	nmei
纰	pisb
荦	locn
蜻	qkif
呷	xxko
暹	xmoz
蠡	livi
剽	pnxd
嗳	aika
濡	rudy
昀	yyob
鹞	ycan
徙	xirv
褶	veyx
痣	vibu
廿	nmch
淅	xida
桧	gvar
孱	ijuz
褴	ljyu
羯	jpyo
暨	jigo
鲛	jnyl
敕	iihw
禺	yuok
罂	ykbw
郦	lihe
郦	vihe
橄	gjav
桢	vfab
啕	tckb
澹	djdd
澹	tjdd
銮	lryj
汶	mfdw
汶	wfdw
遑	hlbz
倨	juru
燧	svhb
诘	jiyu
诘	jpyu
摞	loft
舐	uiqu
泱	yhdk
帼	gojw
诋	diyu
骊	limh
荻	dicq
遨	aofz
俪	lirh
瘠	jibu
诠	qryr
忪	ssxb
腴	yuoj
傥	thrx
迩	erdz
绉	vzsd
泠	lkdr
彗	hvfx
鸶	sisn
骛	wuym
蜓	tkiq
奂	hrdk
匮	kvkv
濠	hcdw
钹	boju
鳍	qiyt
鹧	vegn
弭	mige
牒	dppn
鸢	yrqn
砺	liei
雉	viuv
鸪	gugn
轶	yiip
祚	zouv
闾	lvmk
鄱	pope
镳	bnjg
麋	migm
唳	likh
娣	dinb
忾	kdxq
忾	xixq
霰	xmyg
蚱	vaiv
谀	yuyj
俦	izrf
瘀	yubf
邂	xpdz
沏	qidq
咭	jiku
咭	kaku
缙	jbsh
俾	birb
泾	jkds
腓	fwof
驽	nunm
迤	yirz
哔	bikb
刎	wfbd
腌	yjod
饯	jmuj
鳗	mjyo
氅	ihxm
胛	jxoo
遛	lqpz
涿	vodu
翕	xirx
茴	hvcw
呔	ddkd
翳	yikx
莅	licr
嗑	kekt
膻	djow
膻	ujow
徇	xyrb
懑	mfdx
潸	ujda
秣	mohh
汨	mido
璎	ykwb
泸	ludb
剜	wjgd
绶	uzsa
罄	qkuw
嵇	jihy
殓	lmhr
蛭	viih
裨	piyb
赝	yjib
氐	diud
葆	bccr
濯	vodx
溥	pudf
藓	xmcy
鱿	yzyy
葭	jxck
栉	viac
噱	jtkh
崧	ssua
棂	lkax
熨	yuuh
塾	uuwt
囫	huwb
诙	hvyu
痍	yibh
莘	xbcl
殁	mohj
兕	siue
刍	iudx
箸	vuvt
崴	wwuw
纭	yyse
圉	yuwt
莒	juck
渚	vudt
蛎	liii
隍	hleb
骈	pmmb
蓿	xucg
耒	lwfb
烯	xihi
褓	bcyr
偈	jiro
偈	jpro
溧	lidx
榛	vfas
靛	dmfg
徉	yhry
皈	gvbp
菟	tucd
箝	qmvf
狎	xxqo
轾	viih
忝	tmtx
铢	vujp
髭	ziiv
沆	hhdw
孑	jplh
愎	bixr
逦	lihz
薜	bicu
悌	tixb
爻	ycii
雒	lowv
橹	luay
徜	ihrx
擢	vofx
肓	hlwo
伥	ihri
祉	viuv
珲	hvwg
濂	lmdg
诿	wwyh
鼬	yzjy
臬	npza
貊	mope
澧	lidq
饨	tyut
蜇	vefi
馄	hyuo
蜢	mgiz
寮	lngd
酊	dkyd
煲	bcrh
谌	ifyq
蛐	quiq
赭	vett
耆	qito
飨	xlsr
訾	zivy
祆	xmut
僭	jmrj
谯	qnyv
旯	laoj
妁	uonb
孛	bwuz
悒	yixk
谶	ifyr
虺	hvhi
牯	gung
煨	wwht
饴	yius
眇	mnmx
啖	djkh
钴	gujg
錾	zjij
笞	iivs
豕	uiev
撷	xpfu
蟋	xiip
拮	jpfu
拮	jxfu
阕	qtmd
弁	bmsc
逶	wwhz
嘁	qikw
糸	miyx
蝌	keih
俚	liro
姘	pbnb
湎	mmde
螫	veti
饬	iiur
菅	jmcg
鳝	ujyy
瑷	aiwa
颢	hcoy
赅	gdbw
楹	ykan
衽	rfyq
雩	yuyh
鲫	jiyg
斛	hudd
焘	dcfd
焘	tcfd
洌	lpdh
讦	jpyg
烊	yhhy
篁	hlvb
搴	qmgf
醴	liyq
牝	pbnb
篾	mpvs
碣	jpeo
虻	mgiw
膂	lvfo
帏	wwjw
洮	tcdv
屐	jiur
圻	qitj
圻	ybtj
缢	yisb
趺	fuze
茔	ykct
洹	hrdh
镙	lojt
圩	wwte
圩	xute
戡	kjqg
诤	vgyd
妣	binb
楫	jiak
厣	yjio
圄	yuww
纡	yuse
蠹	duhi
柞	vaav
杼	vuay
吖	yakb
舛	irxn
佚	yirp
荠	jicw
荠	qicw
浔	xydx
沔	mmdh
杓	bnab
杓	ucab
蜊	liih
幛	vhjl
愀	qnxh
蕈	xycx
踯	vizb
怫	fuxf
渑	mmdk
鲑	gvyt
鲑	xpyt
疱	pcbb
孳	zibz
庠	xlgy
亳	bowp
麂	jigj
樯	qlat
鲈	luyb
陂	bwep
陂	piep
怛	daxo
桁	hhar
喱	liki
擘	bouf
歙	uerd
歙	xird
焯	ichb
焯	vohb
趸	dywz
叻	lekl
毂	guuj
跸	bizb
篦	bivp
鹳	grcn
瞽	guum
埘	uito
枸	gzab
枸	juab
柢	diau
醮	jnyv
窠	kexo
尢	yzuv
鼙	piub
帑	nunj
溘	kedt
庾	yugj
菔	fuco
鳏	grys
渌	ludx
蛄	guig
侑	yzru
芾	fuch
芾	fwch
钤	qmjr
疣	yzby
筮	uivg
酽	yjyh
愆	qmrx
栀	viap
椟	duau
啁	vckk
啁	vzkk
墀	iitu
乩	jibv
毽	jmmy
愍	mbmx
瘢	bjbv
奁	lmdk
戽	huhd
澶	ijdw
枞	zsar
硎	xkek
缯	zgsb
匏	pcdb
剀	kdud
瓠	hudp
髁	kego
龉	yuvw
疠	libw
芰	jicu
敉	mimw
餍	yjir
疋	pivv
摭	vifg
檠	qkca
盍	hetm
绂	fusu
夤	ybxg
寤	wugp
牖	yzph
赀	zivb
柒	qida
壅	yswt
膈	geoh
卮	vipe
檗	boua
漯	lodt
漯	lwdt
揿	qbfj
苎	vucg
馑	jbun
硒	xiex
怃	wuxe
欤	yuhd
镒	yijb
碓	dvev
妗	jbnr
岘	xmuj
枧	jmaj
鹩	lndn
屙	eeue
碛	qief
赓	gggb
髀	bigb
戢	jike
邶	bwbe
缧	lwst
菽	uucu
豉	iidu
仳	pirb
鲢	lmyi
苣	juck
钒	fjjj
胝	viou
麸	fufe
郾	yjke
圬	wuth
迨	ddsz
俳	pdrf
嗾	szkf
槭	qiaw
踬	vizp
刈	yiid
萸	yucj
嗌	aikb
嗌	yikb
疸	djbo
凇	ssda
屦	juur
芘	bicb
鄞	ybne
燠	yuhp
缣	jmsb
轭	eeii
劂	jtid
笕	jmvj
谠	dhyx
陴	pieb
柝	toaj
洧	wwdu
疝	ujbu
鲔	wwyu
佾	yirb
榇	ifal
菰	gucz
蚵	eeik
鲱	fwyf
绋	fusf
埕	igtk
甍	mgcw
笪	davo
舨	bjvp
芟	ujcj
挢	jnfp
湔	jmdb
羼	ijuy
啶	dkkg
鳜	gvyi
鳜	jtyi
褊	bmyh
籼	xmmu
髑	dugs
鼯	wujw
畋	tmtw
镉	gejh
镘	mjjo
埤	pitb
廾	gshp
噍	jnkv
茆	mccp
襞	biuy
觇	ijbj
淠	pwdt
谂	ufyr
鄹	zzee
赙	fubf
粢	cidm
粢	zidm
荸	bicu
聱	aofe
蕹	wgcw
揞	anfl
揞	yefl
揞	yjfl
洎	jidz
撖	hjfv
滗	bidv
沘	bidb
咇	biox
诐	biyp
抦	bkfh
噃	bokh
揹	bwfb
尐	dicf
啲	dikb
哋	dikt
牴	dinu
揼	djfe
噉	djkv
厾	duvt
唞	dzkf
棻	ffca
瞓	ffmy
芣	fucb
曱	gaou
鎅	gdjt
嘅	gekg
洸	gldx
攰	gvul
珪	gvwt
啩	gxkt
郃	here
鹮	hrsn
吽	hskn
轷	huip
黐	iihw
呎	iiku
伋	jirj
㓤	jiud
趌	jizu
璟	jkwo
彊	jlgh
弶	jlgw
滘	jndg
𠝹	jptd
劼	jpul
焗	juhu
跼	juzu
濬	jydb
愒	kdxo
冚	kjgu
劻	klkl
瑯	lhwl
浬	lido
嚟	likh
琍	liwh
鸰	lkrn
髎	lngx
啰	loks
嚟	lwkh
抆	mffw
瞇	mimm
屘	mjuz
嗱	nakr
臑	ncoy
妳	nind
啱	njku
奅	pcdp
徬	phrl
槃	pjva
碁	qiqe
佢	qurk
嘥	sdkr
𩠌	ssub
梼	tcaf
唞	tckf
㓥	thxd
迆	toyz
奭	uide
啫	uikt
拃	vafr
曌	vcox
嗻	vekg
瑱	vfwu
嗻	vukg
跦	vuzp
揾	wffo
炆	wfhw
喺	xikr
晞	xioi
噏	xior
囍	xiuu
窸	xixp
鸮	xnkn
璿	xrwb
歔	xuhd
煆	xxhk
瞓	xymy
嘢	yeko
吔	yeky
飏	yhfv
浥	yidk
迆	yiyz
黡	yjih
啱	yjku
湲	yrda
玥	ytwo
滪	yudy
彧	yugk
髃	yugo
喐	yuku
堉	yutw
敔	yuww
祐	yzuu
甴	zaou
孖	zizz
捽	zofw
娅	yan
璇	xrwf
茜	qmcx
茜	xicx
歆	xbld
嗔	ifku
觑	quh
佘	uere
钰	yujw
罡	ghsh
哧	iikt
绯	fws
踉	llz
跄	qlz
镔	bbj
婕	jpnh
猝	cuq
嗖	szkj
芊	qmcq
鹫	jqwn
獠	lnq
嵋	mwu
衲	nayk
珂	kewk
祢	miud
铠	kdju
佟	tsrw
芮	rvck
忡	isxv
鬟	hri
熠	yihx
妲	dan
唰	uxk
怦	pgx
虬	qqiv
嚓	iakg
筱	xnvr
忑	tex
忐	tjux
滢	ykdc
眈	djm
璐	luwz
篝	gzvg
忒	teq
忒	tvq
烨	yeh
谑	xtyh
戬	jmhg
呗	bdk
呗	bwkb
昵	niou
婧	jkn
啐	cvk
崽	zdu
劭	ucdl
笈	jivj
鲲	kyy
浣	hrdg
鑫	xbjj
噔	dgk
珏	jtww
呦	yzk
喏	nok
喏	rek
咣	glk
溟	mkd
囔	nhk
漉	ludg
喵	mnk
淼	mnu
馀	yuur
伢	yary
翊	yilx
咂	zakk
佼	jnrl
诩	xuyx
邬	wuwe
炜	wwhw
锺	vsjp
啷	lhkl
玎	dkw
眦	zimv
晟	igow
晟	ugow
呲	cik
呲	zik
铳	isj
嘭	pgk
宓	fugx
宓	migx
隼	syvu
魃	bagu
噘	jtki
呤	lkk
汩	gudo
汩	yudo
礴	boec
纨	wjsj
沣	fgdf
哒	dakd
噼	piku
琬	wjwg
睚	yam
霈	pwy
鸨	bcbn
掰	bdff
攥	zrf
噌	cgk
臊	sco
糗	qqmz
隗	kve
隗	wweg
绔	kus
殒	yyh
挲	uadf
桉	ana
菡	hjc
哐	klkk
倜	tir
猊	niq
臌	guou
獒	aofq
粼	lbmv
揄	yuf
恁	nfr
殛	jihl
邝	klg
螓	qbi
钛	tdj
咝	siks
嗵	tsks
颀	qijy
螭	iii
犸	maq
珈	jxw
忤	wuxw
汜	sidk
琰	yjw
粲	cjbm
飚	bnfh
齑	jiwf
翦	jmbx
旃	vjf
趄	juzq
趄	qpz
猬	wwqt
趔	lpz
囵	lyw
坳	aot
骜	aofm
蘅	hgc
坂	bjt
魈	xngx
袤	mcwy
锏	jmjm
揶	yefe
愫	suxf
嗬	hekc
嘣	bgk
堇	jbnk
骧	xlm
滟	yjdf
藜	lich
潢	gldg
潢	hldg
酆	fgf
孬	ncb
峋	xyu
蒯	kkc
鄢	yjhe
煊	xrhg
蔻	kzc
蓁	vfc
琮	csw
琏	lmw
卟	bukb
嶙	lbum
珩	hgwr
珉	mbwm
踮	dmz
狒	fwq
宕	dhg
邙	mhwe
绡	xns
偻	lvrm
偻	lzr
纾	uusy
荑	tic
荑	yich
槿	jban
绺	lqs
衾	qbry
钺	ytjh
荥	xkcu
荥	ykcu
箬	rov
嫒	ain
繇	ycap
繇	yzap
搡	shf
岈	yauy
幄	woj
骅	hxm
昶	ihdo
撸	lufy
狻	srq
昴	mcop
杈	iaay
龛	kjry
蹇	jmgz
蜚	fwfi
箐	jkv
箐	qkv
阚	hjm
阚	kjmv
嗄	aake
嗄	uak
佥	qmrh
炷	vuhd
姝	uunp
佶	jiru
衩	iayy
恹	yjx
姹	ian
浒	hudy
浒	xudy
跖	vize
钜	jujk
豸	vipd
儆	jkrc
仨	sar
圜	hrws
圜	yrws
蜍	iuir
舄	xijb
戗	qlr
莜	yzcr
椋	lla
聃	djek
町	dkt
町	tkt
龅	bcv
胫	jkos
祛	quut
湫	qqdh
蒺	jicb
囡	njw
矍	jtm
煅	drh
谡	suyt
坨	tot
铤	dkjq
铤	tkj
犟	jlgn
猕	miq
瘌	lab
栾	lrya
殄	tmh
醐	huy
嫱	qln
槊	uona
醍	tiy
逡	qys
鎏	lqdj
鸷	vifn
骓	vvm
哓	xnkq
馍	mou
鹗	eekn
瑗	yrwa
獬	xpq
锃	zgj
蝮	fuir
馗	kvj
嶂	vhu
荟	hvcr
灏	hcdo
脶	loo
鹘	hugn
嚯	hok
碇	dkeg
碜	ife
砣	toeg
仝	tsrg
泫	xrdw
哞	mzks
诓	klyk
桠	yaa
糅	rzm
镫	dgj
貅	xqp
猱	ncq
犴	anqg
犴	hjq
蕲	qicb
訇	hsb
郏	jxje
葺	qick
铩	uaj
蚨	fuie
掾	yrfv
螯	aofi
恽	yyxg
鹜	wuyn
琚	juw
蜮	yuig
抻	iff
襁	qlyg
阈	yumg
邳	pibe
窳	yuxp
貔	pip
炅	gvoh
炅	jso
糨	jlm
抟	trf
腩	njo
锴	kdj
殚	djh
砀	dhe
狴	biq
猢	huqg
囗	wwuv
撺	crfx
缃	xlsa
饽	bouu
嶷	yiub
蝾	rsi
稹	vfhu
俅	qqrh
狍	pcq
梏	gua
橐	toh
韪	wwo
鳕	xtyy
轸	vfi
黢	quhs
桎	viah
泷	lsd
泷	uldy
镏	lqjp
呙	gok
呙	gxkk
呙	wakk
呙	wdk
呙	wokk
璺	wfp
辂	luiw
崂	lcu
炝	qlh
狲	syq
芩	qbcr
阆	lhm
镛	ysj
诨	hyy
璁	cswp
骢	csm
纛	dcfj
楸	qqa
蟊	mcyi
爿	pjvu
聩	kvev
媸	iin
掼	grf
怼	dvy
韫	wfwo
韫	yywo
硭	mhe
蚋	rvi
絷	vify
歃	uaq
嘬	zoko
茯	fucr
邴	bkhe
缛	rus
驺	zzm
遒	qqbz
孢	bcz
嵬	wwug
岬	jxuo
裾	juyu
檑	lwa
谥	uiyb
蚺	rjik
獾	hrq
闫	yjms
祧	tnu
阒	qumm
椤	loa
菀	yycg
嫫	monc
荇	xkc
喑	ybkl
茕	qsc
觥	gsd
晗	hjor
磔	vee
畹	wjt
蓐	ruci
徭	ycra
巯	qqs
剡	ujhd
猁	liqh
逑	qqhz
捭	bdfb
脔	lryk
鬈	qrib
绻	qrs
跹	xmzq
铖	igjw
炻	uihe
裱	bnyf
蕤	rvcu
悱	fwx
猞	ueqr
恚	hvt
貘	mopc
凼	dhu
蜉	fuia
涞	lddl
傩	nor
莳	uic
珙	gsw
筅	xmvn
怄	oux
栎	liap
栎	yta
讴	ouy
觜	zivd
觜	zvv
瘙	scb
唿	hukb
缳	hrss
锝	dej
拊	fufr
螈	yrii
郗	xiie
獍	jkq
邰	tdse
郜	gcne
纩	kls
堞	dptn
鹬	yuyn
酃	lkye
冼	xmdn
锒	lhj
杌	wuah
硌	geew
硌	loe
骝	lqm
鏊	aofj
咴	hvku
荞	qnc
暾	tyow
窨	xyxl
窨	ybxl
鼐	ndnm
鲟	xyyx
竦	ssl
虢	goah
佤	war
狯	kkq
癯	qubm
侔	mzr
腚	dko
眙	iims
眙	yims
尜	gax
蝰	kvi
囹	lkwr
洇	ybdw
鼋	yrek
芫	yjc
芫	yrce
赍	jiub
樘	tha
墉	yst
嘌	pnk
恂	xyx
罅	xxwh
椴	dra
彀	gzuj
盱	xum
噻	sdkg
旄	mcf
犍	jmny
犍	qmn
庹	tog
欹	qidd
珥	erw
撄	ykf
狃	nqq
馐	xquy
峄	yiuy
搠	uof
鼍	tokk
襦	ruyy
擀	gjf
昃	zeo
荛	rcc
峤	jnup
峤	qnup
犰	qqqj
蟥	hlig
殳	uujy
燹	xmuh
缱	qmsv
狁	yyqs
帔	pwjp
樨	xiau
畲	uert
瘐	yubj
腭	eeok
瓴	lkrw
裣	lmyr
郓	yyg
砦	vdv
闼	tam
鞒	qngp
芨	jicj
骐	qimq
瘿	ykbb
笳	jxv
憷	iuxa
颏	kewy
苡	yics
勐	mgzl
澍	uudu
澍	vudu
勖	xuol
诜	ufyn
濉	svd
檫	iaag
郇	hrbe
郇	xybe
骘	viem
凫	funj
垭	yat
钯	baj
搦	nof
喁	ysko
煸	bmhh
苕	tnc
苕	uccd
謇	jmgy
粑	bam
瀣	xpdb
迓	yayz
喈	jpkb
鄯	ujye
鲵	niyj
刭	jksd
罴	pisd
肜	rso
厶	sivd
鲰	zzy
笫	zivp
褰	qmgy
痼	gubw
沭	uuda
缗	mbs
艏	uzvb
裎	igyk
旒	lqf
栳	lca
茏	lsc
艨	mgvc
邛	qsg
尻	kcu
踽	juzp
艄	ucv
鲶	nmyr
眭	gvmt
眭	svmt
榉	juax
笏	huv
廪	lbgw
蚍	pii
殍	pnh
泶	xtxu
淝	fwdo
菘	ssc
蒹	jmcb
忉	dcxd
蝣	yzi
萑	hrc
逋	bufz
唢	sokx
矬	cour
艟	isv
蹰	iuzi
荩	jbc
縻	migy
亍	iuhd
佧	kar
趿	tazj
嘏	gugk
桫	soad
翥	vutx
鲠	ggy
雎	juqv
茑	nnc
觚	gudp
阋	xim
洄	hvdw
焓	hjhr
跗	fuzr
猗	yiqd
笤	tnv
钬	hojh
镪	qljg
鹈	tibn
踅	xtf
棼	ffaf
漭	mhd
逄	phw
锍	lqjw
哚	dokj
砬	lae
砬	liel
钲	vgjh
陟	viev
塄	lgt
痫	xmbm
蚧	jpi
笄	jivk
彖	trv
萘	ndc
郯	tjh
掮	qmfh
鲇	nmy
舸	gev
睃	som
蠃	lowo
岢	keuk
矸	gje
鸱	iiun
狳	yuqr
祜	huug
囟	xbpw
枥	liai
蟛	pgi
擤	xkf
莪	eecp
觋	xigj
醪	lcyx
倬	vor
蚰	yziy
轳	luib
鬻	yugh
栲	kca
嬗	ujnw
谘	ziy
鋈	wudj
阍	hym
柘	vea
馔	vruk
鳐	ycya
鳟	zyy
耔	zilz
锕	aaj
孥	nunz
綦	qiqy
洙	vudp
薅	hccn
蜞	qii
茇	bacu
氪	keq
萁	qicq
芪	qicu
莰	kjc
嵊	uguq
蛩	qsgi
楂	iaaa
楂	vaaa
缒	vvsp
铧	hxj
鹚	cibn
儋	djr
樾	ytaz
茌	iicr
骶	digu
嫜	vhn
溏	thdg
螽	vswi
橛	jtai
遄	iru
坭	nit
熵	uhhl
蔌	suc
鲂	fhyf
岙	aop
殂	cuh
艉	wwv
蠼	quim
鹾	coby
尕	gan
攮	nhf
樗	iuay
皲	jygp
坻	ditu
彘	viv
隈	wwet
朐	iyob
朐	quob
橼	yras
暌	kvo
饧	xku
泔	gjdg
黧	lihh
筚	bivb
鸬	lubn
醯	xiyw
钪	khj
鸹	gxqn
哏	gfk
哏	hfk
甑	zgbw
膣	viox
螅	xiiz
锞	kejo
髫	tnid
宄	gvg
骟	ujmh
棰	ivai
缡	lisw
苷	gjc
蹁	pmz
铗	jxjj
涑	sudh
箜	ksv
芎	xsc
蔟	cuc
觯	vidb
鍪	mzyj
妫	gvn
熘	lqh
秫	uuha
阏	eem
飑	bnf
枳	viak
礅	dyew
茭	jncl
柁	doa
柁	toag
苴	iacq
苴	jucq
铊	taj
铊	toj
柽	igay
栌	luab
酎	vzyc
浠	xidi
蛳	siiu
楱	zza
焐	wuhw
秭	zih
笥	sivv
茈	cicv
茈	zic
蒌	lzc
跏	jxz
镆	moj
怙	huxg
枵	xnak
圊	qkw
圮	pitk
堀	kut
氚	irq
绐	ddss
蟮	uji
邡	fhf
庑	wuge
廨	xpgd
钭	dzj
觳	huuj
闶	khmw
瓿	bul
眚	ugpm
芴	hucb
芴	wucb
鳓	ley
俣	yurk
徼	jnrb
楗	jmay
莨	lhcl
莨	llc
酰	xmyn
雠	izvy
喾	kuxn
笊	vcv
黥	qkh
芏	duc
菖	ihco
袢	pjyb
卺	jbl
垆	lut
旆	pwfr
曛	xyo
汊	iad
穰	rhh
酾	udy
酾	uiyh
鹣	jmbn
塬	yrti
蘖	npca
玢	bbwf
玢	ffw
蕖	qucd
坶	mut
屣	xiur
揎	xrfg
榧	fwa
蓥	ykcj
鼗	tcvu
仂	ler
嫠	lihi
愦	kvxv
癍	bjbw
癔	yibl
蘧	quch
幞	fujy
痦	wubw
蛑	mzi
詈	lisy
钚	bujb
铴	thjd
锆	gcjn
丌	jihp
柰	nda
浜	bhd
蓼	lnc
蓼	lucx
鄣	vhle
偾	ffru
藿	hocy
酢	cuyv
酢	zoy
铟	ybjw
锛	bfj
阊	ihm
骖	cjm
鲆	pkyp
檩	lba
燔	fjhp
蘼	micg
趵	bczb
乇	top
乇	vep
笸	pov
鄄	jrx
黻	fuyu
伲	niru
蜣	qli
谝	pmy
揠	yafk
昝	zjwo
溽	rudi
胙	zoov
萏	djc
麈	vug
溱	qbds
溱	vfds
碚	bwel
蕺	jick
锊	ltj
镧	ljj
坫	dmt
崃	ldu
糌	zjm
缬	xpsu
瞢	mgcm
堙	ybtx
忭	bmx
筌	qrv
艿	ndcn
鳎	tay
厍	ueii
哕	ytk
廑	jbgn
廑	qbgn
敫	jnbw
栊	lsa
碹	xre
磙	gye
笾	bmv
篪	iivp
缌	sist
诹	zzye
诼	voyu
嗍	sokn
欷	xiid
甏	bguw
蓍	uict
蛱	jxi
裉	kfy
颞	npey
椹	ufa
椹	vfaq
诒	ddy
诒	yiys
铯	sej
鞫	jugb
卣	yzbw
尥	lny
槲	huad
氘	dcq
耩	jll
馓	sju
圪	getr
泺	lodp
熳	mjh
胗	vfor
苁	cscr
锘	noj
阌	wfma
唑	zokr
溻	tado
瘰	lob
砗	iee
砩	fuef
砩	fwe
茺	isc
蓠	licw
刳	kud
唣	zckb
悝	kvxo
悝	lixo
慊	qmxb
慊	qpxb
瘳	izb
茼	tsc
麇	jygh
麇	qyg
黾	mbko
黾	mgk
黾	mmk
杩	maa
狨	rsq
狺	ybqy
痧	uab
砜	fge
芡	qmc
蓣	yucy
顸	hjgy
溲	szd
痤	cob
眄	mmmh
糍	cim
葚	ufcq
郐	gvre
郐	kkre
酹	lwya
镢	jtj
隳	doer
隳	hver
鹋	mncn
唛	makf
唛	mdk
嬖	biun
怍	vax
朊	rro
涫	grdg
绲	gys
腧	uuor
葑	fgc
蠓	mgic
鞲	gzgg
饫	yuup
垲	kdt
嵴	jiuu
帻	zej
旰	gjog
旰	hjog
荭	hscs
蘩	fjcr
颃	hhw
颟	mjcy
鸲	qubn
龠	ytr
硖	xxej
耧	lzl
蛸	xni
裰	doyy
謦	qiuy
跣	xmz
踺	jmzy
逯	luxz
陔	gde
堋	bgt
堋	pgt
峁	mcup
廛	ijg
栝	gxa
栝	koa
栝	tma
葸	xict
薏	yicl
踔	ioz
醢	hdy
铒	erj
镲	iaj
鲮	lkyt
仉	vhrj
侉	kxr
桄	gla
泮	pjdb
皤	pobp
粝	limi
蹀	dpz
颡	shy
鲞	xlb
唪	fgk
嗪	qbks
掭	tmf
畈	fjt
簦	dgv
绨	tisb
胍	gxo
胲	hdo
舻	luvb
铘	yej
锩	jrjb
鲋	fuyr
崮	guuw
庋	gvgu
毳	cvmm
箅	bivt
菹	zuc
虿	idw
贶	klb
陧	npeo
隰	xieo
僬	jnrv
匦	gvki
垧	uhtp
疔	dkb
肭	nao
蝤	qqib
趑	zizd
酐	gjyg
醅	pwyl
醑	xuyp
锬	tjj
垅	lst
悛	qrx
拶	zaf
拶	zjfv
簟	dmv
莼	iyc
蒴	uoc
藁	gcc
诖	gxyt
谳	yjyu
邾	vupe
鬏	jqih
龀	ifv
剞	jidd
埸	yito
嵝	lzu
搿	gefr
桴	fuaa
浯	wudw
笱	gzv
肽	tdod
舯	vsvv
芤	kzcz
葙	xlc
鸸	ere
墁	mjto
煳	huhg
硪	woe
礞	mge
趱	zjz
躜	zrz
钼	muj
匚	klh
呋	fuke
媵	ykob
崦	yjud
潲	ucdh
獯	xyq
瘵	vdb
绀	gjs
莩	fuca
镡	ijjx
镡	tjjx
镡	xbjx
髂	qxg
鬯	ihi
鹨	lqx
亓	qiep
洚	jldw
碲	diel
磲	qued
粜	tnim
绱	uhs
芄	wjcj
铪	haj
铪	kejr
髌	bbgg
鲥	uiyo
俜	pkr
刿	gvud
吣	qbkx
垤	dpth
枘	rva
溷	hydw
胬	nunk
蒽	enc
銎	qsgj
锶	sij
骱	jpgr
鹆	yubn
岣	gzu
怿	yixy
掎	jifd
毹	uurm
汆	crpu
沲	dodr
甙	ddq
菝	bacf
讵	juyk
诎	quy
赉	ldl
郄	qpi
鐾	bwuj
塍	igo
屺	qiuk
庥	xqgr
掊	pzfl
柃	lkar
檎	qba
毵	sjsm
渖	ufdg
砘	dye
窭	juxm
肟	woo
蔸	dzc
蛏	igi
躞	xpz
酯	viyb
饩	xiuq
劢	mdwl
嘧	mikg
嵫	ziu
擐	hrf
湓	pfd
蝻	nji
蠖	hoi
觖	jtdv
跬	kvz
仡	gerr
仡	yirr
垌	dst
垌	tst
氆	pum
氇	lum
汔	qidr
篼	dzv
缑	gzs
舾	xivx
莸	yzcq
蠛	mpi
蠲	jrbs
骀	tdm
倮	loro
僦	jqr
崾	ycu
箦	zevf
肼	jkoe
腽	wao
臁	lmog
舳	vuvy
荽	svc
蒉	kkcv
蒉	kvcv
蛴	qiiw
袼	gey
跫	qsgz
儇	xrrs
埽	sct
庀	pig
扃	jshk
搛	jmfb
浼	mwdd
滏	fudb
瓞	dppp
疃	trt
硗	qneq
禊	xiuf
篥	livx
綮	qihy
綮	qkhy
苤	ppc
踣	bozl
躐	lpzv
钽	tjjo
锸	iajq
锼	szjj
阃	kym
鞔	mfg
鞔	mjg
鹪	jnvn
黪	cjhs
黼	fuyf
榀	pba
浍	hvdr
浍	kkd
炱	tdsh
煺	tvhg
犋	jun
砻	lsye
秕	bihb
肷	qmo
胂	ufoo
莛	tkc
裥	jmym
逭	hrgz
钌	lnjl
佴	err
佴	ndr
吲	ybkg
帱	czj
帱	dcj
帱	izj
搌	vjfu
擗	pifu
桷	jtad
氡	dsqw
硐	dse
糇	hzmr
腠	czo
葶	tkcw
袷	qxy
龆	tnvd
哜	jikw
埴	vitu
岜	bau
徂	curq
惝	ihxx
惝	thxx
烀	huhp
眢	yrxm
瞵	lbmm
筇	qsv
簏	luvg
芗	xlcs
蝽	iyis
蟪	hvih
钕	nvj
钫	fhj
楦	xra
氙	xmqu
澌	sidq
畛	vftr
瘅	djbb
砉	hxf
砉	xuf
砹	aiec
碡	vze
穸	xixx
缵	zrs
羟	qlys
膦	lbo
菪	dhcg
虼	geir
蛘	yhi
螨	mji
裼	tiyo
裼	xiyo
迕	wuwz
铈	uij
锇	eejp
锪	hojb
镓	jxjg
镦	dvj
镱	yijl
骒	kemo
鹁	boun
冁	ijbu
哿	gel
埝	nmt
弪	jkgs
攉	hof
浞	vodz
潴	vudq
籴	dip
罱	ljsu
羰	thy
胨	dsoq
胩	kao
舴	zevv
苊	eeci
茛	gfc
蒇	ijc
虮	jiij
蠊	lmi
轺	ycid
锿	aij
髹	xqi
鸫	dsqn
哌	pdk
垸	hrt
垸	yrtg
埏	ujt
埏	yjtp
墼	jiit
帙	vijp
悃	kyx
揲	uefn
晡	buo
榱	cva
殪	yihu
漤	ljda
疬	libi
砑	yaey
缲	qns
缲	scsk
罘	fusb
苈	lici
钔	mfj
铥	dqj
镅	mwjm
髟	bni
鲡	liyh
鲦	tny
鳇	hlyb
鹇	xmmn
鹱	hunc
埒	lpt
岽	dsuq
悫	qtu
攵	wfr
桊	jrba
桕	jqaj
槔	gcab
溆	xudr
牾	wunw
疖	jpbe
矧	ufug
稂	lhh
窀	vyx
腈	jkof
苄	bmc
薷	rucy
褙	bwy
跽	jizk
钐	ujj
锖	qljf
镎	najr
饔	yswr
骣	ijmu
鳙	ysy
坌	bff
沩	wwdd
澉	gjdv
瀹	ytd
珧	ycwv
瘊	hzb
瞍	szm
硇	nce
筘	kzv
聍	nke
舁	yujc
艚	ccv
蜱	piib
钍	tuj
铞	dnjk
铫	dnjv
铫	tnj
铫	ycjv
骺	hzg
鲼	ffyu
劐	hocd
哳	vakf
唼	uakl
忮	vixu
恝	jxfx
戋	jmev
椠	qmia
瘕	jxbk
瘕	xxb
瘛	iibf
瘼	mob
祓	fuuu
窆	bmxp
篚	fwvk
粞	ximx
羧	soy
脬	pco
艽	jncj
艽	qqcj
葜	qxc
蓰	xicr
觌	diuj
豇	jldg
轵	viik
醵	juy
铌	nij
镄	fwj
阼	zoe
鞴	bwgg
鲅	bayu
埯	ant
恧	nve
憝	dvw
搋	ikf
氕	ppq
洳	rudn
浈	vfd
濞	bidz
濞	pidz
礤	cae
艹	ccc
蟓	xlid
襻	pjy
趼	jmzk
迮	zevz
钆	gajv
铷	ruj
镨	pujb
驵	zhm
鲣	jmyu
鳘	mbry
鸺	xqrn
嚆	hckc
堍	tut
巛	vev
廒	aogf
桤	qiau
橥	vuqa
爝	jth
甾	zdv
痄	vab
癀	hlbg
筲	ucvx
箨	tov
耵	dke
舣	yivd
荬	mdc
诔	lwyl
赆	jbb
蹯	fjz
钇	yijv
钶	kej
铕	yzju
镤	pujy
鲻	ziyv
鹛	mwmn
塥	get
庳	bwg
怊	icx
捃	jyf
涠	wwdw
滠	uede
猸	mwq
甓	piuw
瘃	vubu
瞀	mcym
砼	tse
礓	jleh
绠	ggsh
耱	mol
脎	sao
脒	mio
脞	coo
萜	tpc
蕻	hsci
薤	xpch
跞	liz
跞	loz
轹	liip
锎	kdjm
锓	qbjx
馇	iau
鲐	tdys
鲩	hryg
仫	mur
垡	fart
垴	nct
岍	qmuk
崞	gouw
枨	igai
毪	mums
牮	jmrn
癃	lsb
眍	kzm
眵	iimx
稃	fuha
筢	pav
腙	zso
菥	xic
蜾	goio
螬	cci
螵	pni
衄	nvp
谫	jmyb
躔	ijz
郛	fuae
酤	guyg
钷	pojk
锫	pwj
镩	crj
阢	wue
阢	wweh
鼷	xija
劁	qnv
埭	ddtx
墚	llt
摅	uufh
泐	led
牿	gunn
犏	pmn
猹	iaq
猹	vaq
疰	vubd
痃	xrbw
痖	yabh
瘥	cdby
瘥	idb
磉	she
箢	yrv
簖	drv
缋	hvsv
缏	bmsr
耥	thl
脲	nno
膪	iko
膪	vao
膪	vdo
苠	mbc
茳	jlcd
莶	lmcr
莶	xmcr
蒎	pdc
蒡	bhc
虍	hubv
螗	thig
贳	uinb
醌	kyyo
醭	buyy
铹	lcj
铼	ldj
镥	luj
阽	dmeb
馘	gob
鲺	uiyv
鹎	bwbn
鼽	qqz
傺	iirx
勹	bcpv
喹	kvkd
戤	gdn
瀵	ffdm
欸	ais
毐	aium
粃	bamb
嫑	bcbx
栟	bfa
犇	bfn
赑	bibb
屄	biux
碥	bmeh
瘭	bnb
摽	bnfx
俵	bnr
僰	boch
砵	boe
肏	ccp
泚	cidv
悰	csx
荙	dac
	dadd
咑	dakf
捯	dcfh
珰	dhw
赕	djbh
亶	djw
捵	dmfq
饳	douc
剟	doy
欸	eis
鲕	ery
鼢	ffj
昉	fhof
璠	fjw
茀	fucf
洑	fudr
艴	fufd
缹	fzwd
㗎	gaol
饹	geu
舡	ghv
筻	ghvh
玕	gjwg
夬	gkv
馃	gou
咲	gro
祼	gruo
瓘	grwc
馉	guug
鲴	guyw
邽	gvte
觏	gzgj
盉	hehm
饸	heu
龁	hev
姮	hgn
鸻	hgrn
绗	hhs
耲	hkl
锽	hljb
耠	hol
嬛	hrn
翙	hvux
齁	hzz
嵖	iaua
宬	igg
琤	igwd
瀍	ijdg
浐	ijdl
杻	izav
蹐	jizr
鼱	jkjx
烱	jlh
膙	jlo
玠	jpw
冏	jskk
䢛	jskz
囧	jsw
玦	jtw
斝	jxk
槚	jxm
㗎	jxol
莙	jycx
焌	jyh
珺	jyw
蒈	kdc
鲙	kky
夼	kld
矻	kue
堃	kyft
铑	lcjt
耢	lcl
嫪	lcnx
饹	leu
蒗	lhc
○	lkvv
鹠	lqpn
稆	lvhk
礌	lwey
嫲	mang
祃	mau
旻	mbo
擝	mgfo
幪	mgjc
獴	mgqc
嫚	mjn
靺	mogh
嫑	mqb
燘	mwhm
郿	mwme
呣	mzk
齉	nhz
捵	nmfq
杻	nqa
㶶	nshg
呣	omk
粃	pam
洴	pkdb
呯	pkk
抔	pzf
鲯	qiaq
苘	qkck
庼	qkgb
勍	qkwl
硚	qne
赇	qqbh
萩	qqc
訄	qqjw
辁	qrir
嬛	qsn
袪	quyt
纴	rfsq
瑢	rsw
汭	rvd
鳋	scy
偲	sirt
吅	ssk
窣	suxw
裇	svyp
螋	szi
绹	tcsb
铽	tej
镋	thjx
嘡	thk
畑	tmht
兲	tmwb
曈	tso
葖	tucg
瘆	ufb
燊	ufh
湜	uido
浉	uidu
揗	uyf
鲊	vayr
齄	vaz
欸	vds
晢	vefo
喆	veu
烝	vgl
沚	vidv
扺	vifu
铚	vijh
呣	vmk
禚	vou
纻	vus
荮	vzc
鸼	vzvn
婠	wang
婠	wjng
卐	wjv
卍	wjvu
钘	xkj
婞	xknu
狝	xmqd
猃	xmqr
洨	xndw
澥	xpdd
揳	xpff
琇	xqw
吅	xrkk
嬛	xrn
瑄	xrwg
茓	xtcx
糈	xump
烚	xxhr
珣	xyw
茚	ybcp
崟	ybuj
靿	ycg
乂	yip
祎	yiuw
剦	yjdg
弇	yjrc
鲬	ysys
玙	yuwh
涢	yyd
璪	zcw
牂	zhp
嗞	zio
玮	wwww
皙	xiab
焱	yjhh
啐	qikw
咔	kaku
颍	ykby
鳌	aofy
贽	vifb
蹩	bpbz
葳	wwcw
挹	yifk
鹘	gugn
谔	eeyk
呖	liki
呙	hekk
轱	guig
苻	fucr
菀	wjcg
鲽	dpyn
剡	yjhd
荜	bicb
仵	wurw
鹂	lihn
吡	bikb
吡	pikb
裢	lmyi
娈	lryn
黟	yihx
邗	hjge
衿	jbyr
鹕	hugn
蝥	mcyi
潆	ykdc
槎	iaay
滹	hudh
冱	hudh
坻	iitu
椐	juau
赜	zekf
脘	wjog
芑	qick
婺	wuyn
酲	igyk
伛	yurk
郅	vihe
哕	hvku
癜	dmbu
荨	qmcx
荨	xycx
槠	vuay
鳊	bmyh
羝	diyu
嵛	yuur
蚴	yziy
觫	sudh
岵	huug
郄	xiie
渫	xpdn
瘗	yibj
鳆	fuyr
郫	pibe
颥	ruyy
黹	viyb
锔	juju
榍	xpau
萆	bicb
漶	hrdk
氍	qumm
窬	yuxr
鲒	jpyu
罾	zgsb
鲚	jiyw
鳢	liyq
舭	bivb
浡	bodu
翚	hvxg
烱	jshk
〇	lkvv
蔹	lmcr
伾	pirb
焌	quhs
梽	viau
愔	ybxl
酏	yiyy
