的	reod
一	ssss
了	blll
是	sfso
不	alob
我	tlow
人	hhhh
这	ywiz
他	hbvt
有	aayy
来	swol
道	prid
你	homo
个	hlgg
大	cccc
到	drjd
上	hsss
说	ipje
们	huvm
着	pgks
出	bllc
中	kslz
地	rbvd
那	nbnn
就	yjma
也	bvyy
下	foxx
要	fxsy
么	wcmm
子	bszz
时	sfos
为	pvow
然	ecoo
可	fjkk
她	xbvt
过	figg
之	iiii
以	chyy
看	tkss
会	hgck
会	hgch
得	qssf
天	gwot
去	rcqq
自	rvsz
好	xbsh
心	ioox
和	tjhh
没	lecm
能	caee
对	cfod
后	qsjh
还	aihh
里	kssl
小	moxx
手	mmmm
而	akll
起	rhnv
只	jwzz
身	rvws
想	ukio
都	fsbd
头	octt
如	xjrr
无	gwvw
面	akls
多	eeod
已	nvyy
发	xcff
事	fvls
生	tsss
知	tjzz
家	vavo
前	pajq
声	fbsw
开	gwlk
方	yvwf
经	vcfs
现	gkex
笑	ttwo
什	hxss
力	xlll
点	hjoo
两	fvol
法	lrcf
国	kglo
样	upgs
所	qqsl
成	avoc
意	ysio
见	kejj
但	hssd
老	fell
用	esly
又	cyyy
情	ogaq
于	glyy
当	lnsd
动	gcxd
己	nvjj
些	hegx
行	qglx
行	qglh
此	hecc
眼	knso
气	tsvq
把	mbsv
回	kjhh
话	itjh
将	gefo
真	xkwz
长	tvoc
三	gsss
间	usjj
进	gijj
年	tsln
神	iksl
明	samm
十	xxxx
女	xsnn
向	rjxx
定	vfso
正	fssz
实	vocs
本	fwsb
很	qnso
同	ksjt
从	hhcc
高	yjkj
问	ujww
才	fwcc
全	hgls
被	ixcb
主	yssz
再	fvsz
走	rhwo
却	rcbq
儿	eeee
分	wxff
口	jjjj
其	fwqq
作	htls
种	tksl
几	ejjj
外	elww
打	mfdd
最	sfcz
门	uvmm
与	dsyy
给	vhsj
光	legg
白	rvsb
等	trfo
听	jqsl
因	kcyy
重	tlsc
少	mows
风	ewff
相	ukss
住	hyss
次	gohc
何	hfjh
让	ihsr
色	obsv
二	geee
公	wcgg
日	ssss
怎	tioo
名	ejmm
死	aess
便	hfvo
位	hyos
部	yjbb
果	ksog
应	yows
体	hfws
感	asji
太	cott
内	kwon
觉	oike
水	llll
先	texx
难	chys
王	glsw
比	debb
别	jxjb
入	wrrr
边	xibb
第	tnvw
直	xkss
机	uejj
理	gkss
快	onwo
更	fvog
做	hxjt
处	elcc
者	fszz
并	pgwl
接	myxs
西	fvsx
马	vsmm
轻	dcfs
四	kess
关	pgwo
山	klss
月	aaaa
放	ytwo
连	dill
加	xjjj
目	kssm
脸	ahso
飞	vwff
使	hfvo
龙	aell
强	njnq
强	njnj
张	ntvo
由	kssy
金	qqqq
立	yosl
叫	jbjj
安	vxsa
师	mfvl
吧	jbsv
剑	hsoj
信	hygj
学	oibs
军	idsl
望	yagl
算	tkal
原	armo
美	pgcm
像	hoke
平	swlp
东	dlod
场	rvqc
吗	jvsm
战	hjdw
特	trfo
万	dwww
数	pxtw
云	gcyy
清	lgaq
今	hijj
变	yjcb
任	htls
空	vwfs
表	gewo
完	vgew
合	hsjh
合	hsjg
带	fikl
常	lijk
量	ssks
海	ltvo
受	wics
解	oext
文	ywww
命	hsjb
转	dgvo
斯	fwqs
通	ckit
冷	ghio
思	kioo
黑	kooo
世	flvs
该	iyxh
双	ccss
利	tjll
至	drzz
非	hhss
林	uull
呢	jnen
新	yuqs
步	hmwb
候	hlnt
五	fvsw
李	ubsl
度	yfcd
虽	jnss
路	pejl
惊	oyjm
微	qkst
跟	pnso
似	hchs
物	teqw
许	itsl
化	hehh
制	tjzz
火	pwoh
性	otss
反	qcff
武	sdhl
总	pjio
指	mesz
系	emox
系	emoj
结	vfjj
花	dheh
亲	yuqq
教	fbtw
功	fxgg
刚	kwjg
提	msfs
杀	wuss
竟	ysej
士	fsss
远	geiy
百	asbb
红	vfsh
红	vfsg
它	vett
离	ywbk
满	ldfv
找	mdwo
落	dlej
容	vwhj
必	ioob
深	liwu
城	ravo
拉	myos
奇	cfjq
奇	cfjj
若	dajr
各	ejgg
失	tsos
尔	omoe
言	ygjy
传	hgvo
且	kssq
形	gqwx
青	gaqq
石	wwww
干	glgg
半	pslb
近	qijj
认	ihrr
怕	orvs
队	bhdd
电	ksvd
夫	gwof
往	qyss
突	vwco
吃	jtvc
啊	jbfj
倒	hdrj
活	ltjh
件	htsl
随	baai
绝	vobs
刻	yxhj
息	rioo
即	nbjj
工	fsgg
早	sxzz
极	ueoj
乎	wwlh
界	khrj
记	invj
紧	jcvm
怪	ocrg
流	lycr
报	mbcb
车	dslj
车	dslc
管	tvks
音	ysyy
衣	yewo
保	hjub
暗	sysa
弟	pnvw
及	eojj
交	ywwj
影	syjq
华	hexh
爱	wiac
精	pgaj
伤	htxs
势	mexs
民	nvvm
令	hiol
计	ixjj
决	gnwo
玉	gloy
服	abcf
条	eutt
众	hhhz
领	hiab
哥	fjfj
南	xkpg
般	qecb
元	geyy
罗	keol
收	btwo
未	glow
始	xcjs
办	xoob
题	sfab
星	stss
克	xjek
根	unso
谁	ihys
阵	bdsl
则	bjzz
象	okew
男	kxnn
达	cidd
告	tjgg
展	nflo
击	gllj
坐	hhrz
灵	npwo
血	rvsx
整	ftfs
员	jbyy
兵	rwbb
急	onio
千	tlqq
切	dxqq
越	rhdv
喜	fjpj
语	ifjy
站	yhjz
请	igaq
德	qxki
帮	gbkl
敢	vftw
消	llax
业	josy
姐	xkss
周	erjz
视	ikes
字	vbsz
八	wbbb
每	tvoo
苦	dxjk
房	iyvw
忙	oyvm
雷	skss
团	kfwt
片	rsvp
哪	jnbn
尽	nojj
书	vlos
备	ekss
求	fooq
司	njss
北	hebb
静	gaon
错	qfsc
断	pvqs
准	ghys
江	lfsj
刀	xddd
建	ncjj
兄	jexx
终	veoz
足	pppp
兴	owxx
冲	gksl
阳	bsyy
代	hdod
或	djsh
楚	uubs
底	yeso
夜	yheo
术	uoss
格	uejg
识	ijws
持	mrfo
答	thsj
哈	jhsj
留	exks
确	woes
易	seqy
七	dqqq
论	ihel
父	wwff
拿	hsjm
程	tjgl
阿	bfje
阿	bfja
害	vgjh
族	ytts
破	wxcp
孩	byxh
魔	yuuc
官	vkss
沉	liec
显	sjos
够	ejee
宝	vglo
取	fcqq
单	pksl
掌	lijm
务	exww
低	heso
雪	snsx
响	jrjx
布	aklb
市	ykls
摇	mwts
依	hyew
久	eojj
级	veoj
首	prvs
运	gciy
朝	xsxa
待	qrfo
娘	xiso
客	vejk
统	vyce
忽	eqio
速	fiss
复	tseo
修	hleq
欢	cohh
异	naly
式	dfss
护	misw
爷	wwby
况	gjek
脚	arcb
招	mxjz
九	ejjj
集	hyuj
区	dwqq
区	dwoo
晚	soks
铁	qtso
黄	fkwh
友	acyy
亚	flsy
除	bhgl
钱	qgvo
送	pgis
兰	pgsl
联	fpgw
政	ftwo
义	owyy
丝	vvss
古	xjgg
六	ywll
器	jjcj
甚	fwvs
照	sxjo
基	fwrj
闪	uhss
院	bvge
装	gfye
居	nxjj
产	yowc
呼	jwwl
杨	uvqy
露	spej
句	ejjj
句	ejgg
乱	tjvl
举	owgl
敌	tjtw
斗	oxdd
香	tsxx
停	hyjf
台	cjtt
群	njpg
嘴	jhee
希	wakl
酒	lfvs
巴	bsvb
怀	oalo
议	iowy
类	pcll
支	xczz
慢	oskc
陈	bdlo
仙	hklx
段	recd
调	ierj
顿	dabd
派	lqew
英	dkso
喝	jsev
期	fwaq
威	asxs
另	jxll
府	yhfo
改	ntwo
旁	ypiy
资	gohb
续	vxvc
造	tjiz
乐	eloy
乐	elol
攻	ftwo
左	afsz
愿	armi
围	kgvl
疑	etcb
念	hiio
引	nlyy
热	meoo
怒	xcio
退	nitt
缓	vwgc
线	vgvo
注	lyss
细	vkss
图	keot
背	heab
需	sakl
痛	ycks
观	ckeg
组	vkss
雨	fvoy
曾	pksc
约	veoy
包	envb
木	uuuu
技	mxcj
示	gmos
皇	rgls
据	mnxj
差	pgfs
设	iecs
密	vikl
谢	irfo
鬼	rcgg
穿	vwdl
脑	aywb
赶	rhgl
莫	dscm
丽	skko
品	jjjp
叶	jxyy
叶	jxxx
既	ndwv
存	absc
睛	kgaj
宫	vjjg
烈	ajoo
诉	iqso
追	rizz
推	mhys
您	homi
右	ajyy
商	ypkj
争	onsl
角	oesl
淡	lppw
止	hlsz
谈	ippw
严	flwy
恶	fioo
狂	egls
挥	mids
亮	yjie
卫	bsww
闻	ufls
忍	xioo
态	cioo
汉	lchh
继	vpvj
模	udsc
银	qnso
仍	hxrr
跑	penv
否	ajpp
否	ajff
君	njjj
妹	xglo
隐	boni
母	voom
科	toxk
凌	grwe
选	teix
梦	uueo
刘	ywjl
寒	vgwo
局	nvjj
冰	glbb
禁	uugm
境	ryse
掉	mhsx
究	vwej
余	hglo
查	ussc
激	lryt
号	jdhh
防	byvw
费	nbff
恐	feio
楼	upxs
导	nfod
肯	hakk
故	xjtw
游	lytb
球	gfoo
树	ucfo
叹	jctt
救	ftwo
施	ytbv
帝	ypik
佛	hnvl
简	tusj
料	poxl
际	bgmo
顾	avab
齐	ywrq
抓	mqlo
玩	ggew
猛	ebkl
份	hwxf
米	psom
仅	hcjj
具	kwjj
胜	atss
治	lcjz
章	ysxz
巨	dvsj
险	bhso
守	vfos
散	fatw
须	qabx
眉	bkss
抱	menv
权	ucqq
试	idfs
独	endd
震	sagv
索	xivm
证	ifss
礼	ivll
助	kxzz
圣	crss
股	aecg
跳	pwxo
波	lxcb
负	obff
虎	hdeh
练	vdvo
姑	xxjg
唐	ynjt
室	vdrs
伙	hpwo
沙	lmow
妈	xvsm
阴	bayy
称	tomo
投	mect
柔	cbur
扬	mvqy
规	gkeg
毫	yjit
温	lskl
较	dyww
毒	gvoo
耳	flse
座	yhhr
射	rfos
厉	adwl
层	ngcc
副	sjkj
担	mssd
参	ccqw
置	kxks
历	axll
初	ixcc
卡	hlqq
卡	hlkk
承	bvwc
质	qxbz
属	nrvo
渐	ldqs
蓝	djtk
船	qejc
逃	wxit
皮	xcpp
药	dveo
呀	jdlw
靠	tjhh
充	ycec
标	ugmo
坚	jcrj
贵	kbgg
共	fwgg
赵	rhwz
维	vhys
陆	bgll
块	rnwo
吸	jeox
刺	fjcc
堂	lijr
醒	fsts
考	fdkk
松	uwcs
排	mhhs
划	djhh
换	moks
河	lfjh
环	galo
土	rrrr
志	fioo
责	gbzz
致	drtw
压	aroy
素	gvmo
湖	lxja
睡	ktls
苏	dxoo
京	yjmo
效	ywwt
朋	aapp
宇	vgly
顺	rabs
紫	hevm
伸	hksl
赛	vgwb
超	rhxj
忘	yioo
幸	rpgl
遇	kiyy
孙	bmos
顶	fabd
拍	mrvs
警	dejj
按	mvxs
察	vegm
广	ywgg
藏	dadl
胡	xjah
秘	tioo
凡	eoff
型	gjrx
尚	lkjs
恩	kcio
脱	apje
营	dijj
增	rpks
价	hhrj
史	ksos
节	dbjj
秋	tpwo
翻	wkcc
迷	pimm
州	puuz
付	hfof
项	fabx
萧	dnwl
状	gcoz
尼	nenn
雅	dhys
凤	ecff
秦	gtlo
草	dsxc
败	btwo
著	dfsz
咱	jrvs
朱	tsoz
呆	judd
呆	juaa
封	rrfo
普	pfsp
景	syjm
专	gvoz
味	jglo
舞	tfed
弄	galn
弄	gall
虚	hdjo
毕	dexb
讲	igwl
福	isjk
纪	vnvj
握	mndr
习	csxx
社	irss
永	ivoy
寻	nfox
默	koco
洞	lksj
控	mvwf
骑	vscj
钟	qksl
徐	qhgl
辈	hhds
假	hnnc
病	yfvo
胸	aewb
欲	whjh
伯	hrvs
峰	kegs
肉	khrr
岁	keos
医	dtso
野	kcby
值	hxks
职	fjwz
尊	pffo
恨	onso
狠	enso
田	ksst
魂	gcrc
毛	tsvm
免	oksv
短	tsjp
秀	txxx
麻	yuum
坏	ralo
印	ebyy
良	isol
迎	ebiy
枪	uhvq
弹	npks
骨	kagg
探	miwu
啦	jmyo
研	wgwl
妖	xtwo
劲	cfxj
临	jtkl
宁	vfnn
屋	ndrw
案	vxua
杰	uooo
欧	dwoh
饭	oqcf
村	ufoc
升	twls
抬	mcjt
蒙	disa
略	kejl
丹	eosd
源	larm
纷	vwxf
雄	achy
烟	pkcy
危	oavw
优	havo
写	idsx
床	yucc
罪	khhs
网	kwww
食	hiso
板	uqcb
校	uyww
某	fumm
妙	xmow
休	huxx
珠	gtso
列	ajll
盘	qkls
透	txit
春	gscc
委	txsw
移	teeo
呵	jfjk
呵	jfjh
呵	jfja
偷	hhsj
奥	rpca
吴	jgwo
验	vsho
牙	dlwy
泪	lkss
宗	vgmo
摆	mkrc
善	pgjs
浪	liso
羽	ccsy
肩	iajj
智	tjsz
拥	mesl
弱	ngng
柳	uebl
硬	wfvo
纳	vkwo
洛	lejl
范	dlvf
混	lsde
玄	yvox
买	vocm
济	lywr
徒	qrhw
烦	pabf
配	fnvp
适	tjis
适	tjik
端	ykak
娜	xnbn
哭	jjco
凝	getb
镇	qxkw
率	yvxs
率	yvxl
避	njyi
拳	pmqq
创	hvjc
采	wucc
晓	sdav
托	mtvt
森	uuus
哼	jyjb
惜	ofsx
束	fvos
熟	yjbo
归	mnsg
抗	myek
邪	dbxx
庄	yrzz
喊	jasj
梅	utvo
韩	xsxg
罢	krcb
仇	heqq
仇	hecc
奔	cxal
亡	yvww
富	vsjk
限	bnso
吓	jfox
吓	jfoh
养	pgry
厅	aftt
贝	bbbb
娇	xtrj
省	mkss
占	hjzz
横	ufkw
飘	fgmw
戏	cdwo
画	skbh
暴	sfwl
灭	spwo
域	rdjs
瞧	khyo
软	dohr
摸	mdsc
席	yfkl
稳	toni
绿	vnll
伊	hnsw
讨	ifot
释	wcgl
获	deco
店	yhjd
敬	dejt
谷	whjy
谷	whjg
仿	hyvw
借	hfsj
丈	aozz
姓	xtss
挑	mwxo
祖	ikss
套	cfct
困	kukk
墙	rfkj
冒	skss
夏	akeo
叔	hmcs
架	xjuj
鱼	oooo
织	vjwz
尖	mcjj
丁	fddd
牛	tsln
旧	lsjj
扑	mlpp
彩	wuqw
降	bedl
燕	fjho
卷	pvjj
臂	njya
桌	hsuz
卖	xvoc
嘿	jkoo
骂	jjvs
鲜	opgs
幽	kvvo
训	irlx
演	lvfw
闭	ufwb
巧	fdqq
奋	ckss
杂	euzz
亦	yrwo
预	cbab
尤	avoy
偏	hiks
替	ggst
箭	tpaj
残	agvo
拜	tgsl
腿	anit
婆	lxcx
唯	jhys
迹	yrij
班	gpgl
诸	ifsz
吉	fjjj
诺	idaj
狼	eiso
洋	lpgs
虑	hdio
杯	ualo
袋	hdye
策	tfvo
腰	afxs
殿	nfwc
番	wkss
测	lbjc
输	dhsj
杜	urdd
惨	occq
盟	sakl
鲁	osll
豪	yjia
积	tjwj
趣	rhfc
圆	kjby
午	tslw
户	iswh
执	meoz
妇	xnsf
沈	liwv
登	csjp
懂	odtl
含	hijh
犹	eavo
互	dvsh
律	qnsl
锋	qegs
抢	mhvq
厚	asbs
聚	fcrw
尸	nwss
闹	uykl
纵	vhhz
凭	htep
迅	vxix
财	bfwc
搞	myjj
嘛	jyuu
侧	hbjc
农	iwon
稍	tlas
介	hrjj
宣	vsss
抽	mkss
颜	yqab
躲	reud
舒	hgjb
供	hfwg
傲	hgtw
勇	ckxy
阶	bhrj
犯	evff
益	pwkl
尘	mrcc
甲	kslj
皱	onxc
街	qrrg
孤	bqvo
协	xxoo
兽	pksj
碰	wpfl
伟	hgvl
塔	rdhj
批	mdep
盖	pgkl
监	jtkl
劳	dixl
碎	wyhx
撞	myks
阻	bkss
操	mjju
概	undw
曲	kssq
胆	assd
轮	dhel
婚	xesh
迟	nicc
凶	wbxx
党	lije
爸	wwbs
剧	nxjj
弃	ycal
奈	cgmo
逐	aizz
疯	yewf
距	pdvs
附	bhfo
谓	ikaw
歌	fjfh
哦	jtlo
构	uecg
咬	jyww
误	ijgw
塞	vgwr
慕	dscm
笔	ttsv
孔	bvkk
牌	rrxp
陪	byjp
折	mqsl
窗	vwre
逼	sjki
材	ufwc
挡	mlns
岛	ekld
择	mcgl
袭	aeye
挂	mrrg
伦	hhel
遍	ikib
芒	dyvw
芒	dyvm
征	qfss
触	oenc
瞪	kcsp
荡	dlvq
抵	meso
郎	ibll
滚	lywe
怜	ohio
乃	xnnn
幻	vvhh
臣	dllc
判	pjpp
烧	pdav
翼	cckw
腾	apvs
欣	qohx
灯	pfdd
库	ydsl
妻	dxsq
私	tcss
荣	diur
夺	cfod
园	kgey
壁	njyr
贼	bdaz
颗	kabk
累	kvmo
宋	vuss
狗	eejg
悄	olaq
颤	ykjb
吟	jhiy
伏	hcof
瞬	kwid
舍	hgjs
补	ilbb
扫	mnss
跃	ptwo
艺	dvyy
挺	mtct
岳	rkly
悲	hhio
圈	kpvq
圈	kpvj
旋	ytbs
瑞	gkak
惑	djsi
竹	ttlz
蛋	bndd
艾	dwyy
艾	dwaa
扎	mvzz
莉	dtjl
损	mjbs
迫	ripp
盛	akls
企	hhls
缘	vvav
纯	vdlv
俊	hcwe
努	xcxn
逸	okiy
菲	dhhs
抖	moxd
乌	esww
油	lkss
炼	pdvo
唇	agjc
幕	dsck
康	ynso
吐	jrtt
汗	lglh
馆	ovks
昨	stls
赞	tetb
茶	dhuc
苍	dhvc
恢	oapw
裂	ajye
育	ycay
央	ksoy
闲	uuxx
吼	jbvh
爆	psfl
鼓	fjpc
乡	vwxx
陷	borv
曼	skcm
泰	gltt
踪	pvgm
灰	apwo
赤	rrwo
萨	dbyo
缺	tnwo
宽	vdke
岂	knvq
伴	hpsl
猜	egac
额	vejb
遗	kbiy
遗	kbiw
谋	ifum
浮	lwbs
昏	eshh
融	sjkn
妮	xnen
菜	dwuc
例	hajl
盯	kfdd
涌	lcks
遭	fsiz
洲	lpuu
潜	lggs
拼	mpgw
勒	fkxl
博	xffo
蛇	nvey
蛇	nves
港	lfwn
貌	were
绍	vxjs
拔	macb
洗	ltex
彻	qdxc
针	qxzz
纸	vesv
莱	dswo
县	kcxx
剩	thej
扶	mgwo
愤	oxdb
镜	qyse
爵	wknf
晶	sssj
佩	hefv
讯	ivxx
忧	oavo
鼻	rkal
御	qtby
均	regj
枫	uewf
泽	lcgl
凯	knek
浩	ltjh
奶	xxnn
怨	evio
毁	rfec
壮	gfsz
诚	iavo
忠	kioo
洪	lfwh
雾	sexw
糊	pxja
固	kxjg
轰	dcch
坦	rsst
睁	kons
佳	hrrj
爹	wwee
蒂	dypk
丢	tcdd
庆	ycqq
亿	hvyy
词	injc
辛	yxxx
丰	gslf
缩	vvhs
吹	johc
仰	heby
迪	kidd
晃	sleh
庭	ytct
莲	ddil
梁	lxul
仔	hbsz
侠	hswo
阁	uejg
检	uhso
暂	dqsz
读	ixvc
郭	yjbb
绕	vdav
插	mtls
凉	gyjm
净	gons
召	xjss
减	gasj
侍	hrfo
慌	odyr
敏	tvtw
伍	hfvs
鹰	yhhs
朗	iall
讶	idlw
诗	irfo
货	hebh
掩	mcks
码	wvsm
浑	lids
隔	bsjp
傅	hffo
疾	ytso
鸟	esnn
鸟	esdd
赏	lijb
摩	yuum
池	lbvc
氏	esvs
振	magv
途	hgit
闷	uioo
童	ykss
朵	eudd
傻	hrwe
粗	pkss
旦	ssdd
悉	wioo
鸣	jesm
径	qcfs
旅	ytew
赫	rrrr
穴	vwxx
延	rcyy
惯	ovbg
唤	joks
皆	derv
盗	gohk
琴	gghi
帐	ktvo
戴	xdkw
忆	ovyy
仁	hgrr
宜	vkss
甘	flsg
炸	ptls
戒	dalj
琳	guul
浓	liwo
吻	jeqw
季	tbsj
疼	yeot
桑	cccu
侯	hnts
堡	hjur
珍	ghqw
贴	bhjt
符	thfo
芳	dyvw
嗯	jkci
羞	pgbs
典	kwdd
劫	rcxj
骗	vsik
旗	ytfw
啸	jnwl
堆	rhys
霸	sfka
廷	tctt
促	hpcc
惧	okwj
耐	akfo
庞	yaep
荒	dyrv
序	ycbx
躺	rlkj
粉	pwxf
慧	ggni
餐	hchi
喃	jxkg
踏	plst
吕	jjll
孟	bkls
抚	mgwv
匆	eqoc
漫	lskc
乘	thes
乘	thec
启	ijqq
脉	aivo
仪	howy
络	vejl
拒	mdvs
洁	lfjj
郑	pgbz
奉	gglf
漂	lfgm
愈	hsai
倍	hyjb
拖	mtbv
怔	ofss
映	skso
访	iyvw
奴	xcnn
乔	trqq
颇	xcab
愣	okyv
献	xkpc
编	viks
健	hncj
扭	mbss
缠	vyks
核	uyxh
评	iswl
享	yjbs
尾	ntsv
碧	grwb
瓦	dvow
尺	nwoc
票	fgmo
玛	gvsm
川	rlcc
彼	qxcb
焰	porv
醉	fyhx
述	uiss
痕	ynso
晨	sagv
薄	dlff
胖	apsl
恭	fwmo
辉	leid
绪	vfsx
倾	hdab
亏	gvkk
躯	rdwq
磨	yuuw
隆	best
岸	kagl
括	mtjk
括	mtjg
废	yxcf
狐	eqvo
吞	gjtt
丫	plyy
锁	qlbs
忌	nioo
悟	ofjw
滑	lkah
椅	ucfj
赌	bfsd
垂	tlsc
粮	piso
厂	accc
辰	agvo
曹	fscc
霍	shys
遥	wtiy
痴	ytjc
款	fgmh
贫	wxbp
扩	mywk
督	hmck
乖	theg
欺	fwoh
聊	febl
悠	hlti
艳	gobs
奖	gecj
帅	mkls
估	hxjg
爬	qbsv
匹	depp
录	nlll
截	xdhy
牢	vtsl
锐	qpje
递	pnid
唱	jssc
唉	jcts
嘻	jfjj
董	dtls
刹	wujs
刹	wujc
钢	qkwg
惹	daji
焦	hyoo
穷	vwxq
援	mwgc
慰	ngmi
措	mfsc
悔	otvo
革	fksl
陵	brwe
姿	gohx
扯	mhls
泉	rlqq
予	cbyy
筑	tfeo
勾	ecgg
授	mwic
罩	khsx
埋	rkss
熊	caeo
潮	lxsa
漠	ldsc
轩	dglx
殊	atso
哀	yjew
鸡	cesj
掠	myjm
肚	ardd
聪	fpji
斩	dqsl
狱	eico
俩	hfvo
炮	penv
俱	hkwj
挣	mons
邦	gbbb
袖	ikss
泛	lwif
沿	lejy
辞	tjyx
卓	hsxz
恼	oywb
航	qyeh
零	shio
盈	xckl
载	xdds
扰	mavo
末	glom
恋	yjio
肃	nwls
鹏	aaes
姆	xvoo
屈	nbll
眸	kcts
冥	isyw
辆	dfvo
劝	cxqq
刃	xorr
炎	ppwo
姬	xdll
拦	mpgs
堪	rfwv
劈	njyx
墨	korm
培	ryjp
霜	suks
斜	hgox
审	vksl
甜	tjfl
撒	mfat
驾	xjvs
耀	lecy
脆	aoav
袍	ienv
驻	vsys
霞	snnc
厌	acoy
尝	ligc
弯	yjnv
宏	vach
滴	lypj
牧	ttwo
键	qncj
耶	fbyy
销	qlax
膀	aypy
寂	vhmc
媚	xbks
枝	uxcz
牵	cits
丧	foos
祝	ijez
趁	rhhq
舌	tjss
课	ikso
麦	geom
抹	mglo
玲	ghio
喷	jxdb
染	leur
跪	poav
擦	mvem
翔	pgcc
币	rvlb
埃	rcts
钻	qhjz
贯	vbgg
盾	qxks
灾	vpwo
溜	lexk
询	iesx
腹	atse
渡	lyfc
燃	peco
眨	kwiz
撤	myct
敲	yjkc
侵	hnic
喘	jkak
柄	ufvo
悦	opje
嫁	xvav
岩	kwyy
赖	fobl
烂	ppgs
嘉	fjpj
拾	mhsj
泥	lnen
夹	swoj
版	rqcb
搜	mrcs
汇	ldhh
冬	eodd
俗	hwhj
僧	hpks
竞	yjej
喂	jkdw
骇	vsyh
搭	mdhj
暖	swgc
茫	dlyv
返	qcif
莎	dlmo
挤	mywr
宾	vrwb
冠	igef
析	uqsl
郁	aaby
允	ceyy
疗	ybll
繁	tvtm
桥	utrq
葛	dsev
祥	ipgs
瘦	yrcs
仲	hksl
耸	hhfl
仗	haoz
弓	nvgg
违	giww
豫	cboe
幅	ksjk
胁	axoo
瓶	pgdv
愧	orck
晕	sids
柱	uyss
饰	otkl
翠	ccyx
勉	okxm
矮	ttxs
宿	vhas
偶	hkso
汤	lvqt
刑	gjxx
涛	lgfo
黎	tehl
煞	onto
贤	jcbx
姊	xelw
衫	iqws
锦	qrkl
抛	mexp
虫	nnnn
昂	seba
恰	ohsj
咐	jhfo
铺	qfvo
琪	gfwq
衡	qokg
饮	oohy
捉	mpzz
纤	vtlx
纤	vtlq
袁	rjew
猎	efsl
赢	yjae
购	becg
卢	hnwl
础	wbll
亭	yjif
娃	xrrw
慈	pvvi
晴	sgaq
咒	jjez
羊	pgsl
签	thso
猫	edks
薇	dqkt
覆	fqte
祸	ijkw
罚	kijf
舰	qkej
魏	txrc
耗	gtsv
寸	focc
跌	ptso
俄	htlo
蝶	nfud
详	ipgs
撑	mlim
闯	uvsc
箱	tuks
弗	nvlf
扮	mwxb
诱	itxy
障	bysx
怖	oakl
屁	ndep
弥	nomo
歉	pnoh
砍	wohk
齿	hhbc
踢	pseq
寺	rfos
爪	qloz
贸	exbm
脏	ayrz
棋	ufwq
贺	xjbh
迈	dimm
捕	mfvo
笼	tael
浅	lgvo
扣	mjkk
拨	mxcb
扇	iccs
臭	rcox
臭	rcoc
篇	tiks
猪	efsz
邓	cbdd
泄	lflv
辱	agfo
肤	agwo
懒	ofob
裁	xdye
仆	hlpp
穆	trmq
昆	sdek
丑	bssc
愁	tpio
渊	lwpl
勤	fkxq
悬	kcio
铃	qhio
韦	gvlw
崇	kvgm
井	gwlj
帕	krvs
昌	sscc
鞭	fkhf
叛	pqcp
僵	hsks
纹	vyww
鸿	lfes
瑶	gwts
雕	erjy
洒	lfvs
冯	gvsp
冯	gvsf
蛮	yjnm
爽	cwww
跨	pcgv
饶	odav
矛	cbwm
缝	vegi
湾	lyjn
税	tpje
涉	lhmw
铜	qksj
屠	nfst
麽	yuuc
乾	xsxt
莹	digl
涂	lhgl
奸	xglj
梯	upnv
邀	ryti
誉	owyj
诡	ioav
慎	oxkw
夕	eoxx
婉	xvev
吩	jwxf
镖	qfgm
摔	myvx
魄	rrct
魄	rrcp
魄	rrcb
卧	dlww
酷	ftjk
丛	hhsc
巡	vixx
祭	egmo
崖	karr
誓	mqyj
描	mdks
奏	ggwo
肖	laxx
碍	wssf
曰	ksyy
霄	slax
糟	pfsz
麟	yndd
枚	utwo
肌	aejj
欠	ohqq
稀	twak
阔	ultj
液	lyhe
笨	tfws
勃	xibx
毅	yeec
矿	wywk
湿	lsjo
桃	uwxo
疲	yxcp
荷	dhfj
汽	ltsv
姜	pgxs
摄	mfcc
哎	jdwa
植	uxks
艰	cnso
脖	axib
催	hkhy
虹	nfsj
虹	nfsh
巫	fhhw
屏	npgw
咽	jkcy
驰	vsbv
蓉	dvwj
凑	gggw
愕	ojjg
肥	absv
绩	vgbj
坛	rgct
凄	gdxs
搬	mqec
扔	mxrr
瑟	ggio
杖	uaoz
芙	dgwo
畏	kdwo
频	hmab
润	lugl
酸	fcwe
割	vgjj
绵	vrkl
披	mxcp
滋	lpvv
秒	tmow
戈	dwog
贪	hibt
捷	mdso
瞒	kdfv
播	mwks
逆	pinn
咳	jyxh
申	ksls
卑	rxbb
搂	mpxs
寇	vgec
魅	rcgl
惠	fioo
宛	vevw
喉	jhnt
幼	vxyy
卿	enbq
龄	hhbi
赐	bseq
驶	vsks
瓜	qvog
氛	twxf
腕	avev
污	lgvw
谅	iyjm
筹	tgfo
宠	vaec
碗	wvev
妃	xnvp
妃	xnvf
筋	taxj
甩	esvs
驱	vsdw
寨	vgwu
蕾	dsks
兼	pnso
婷	xyjf
捏	msrn
妥	wxst
拓	mwtt
斥	qsoc
吵	jmow
订	ifdd
纠	vbjj
璃	gywk
届	nkss
饿	otlo
夸	cgvk
倩	hgaq
薛	dryx
窜	vwks
崔	khys
尉	ngmf
恒	osss
後	qveo
宴	vsxs
晌	srjs
艘	qrcs
辣	yafv
哇	jrrw
柜	udvs
斤	qslj
储	hifs
挨	mcts
豹	weeo
雁	ahhy
吾	fjww
挖	mvwv
饱	oenv
彭	fjpq
役	qecy
琼	gyjm
遮	yfoi
舟	qvoz
佣	hesl
狮	emfv
寿	gfos
陶	bets
患	kioo
砸	wdkl
颊	sabj
励	adxl
愚	kioo
腐	yhfh
牲	ttss
哑	jfls
恍	oleh
裤	iyds
俏	hlaq
鼠	rccv
岚	kewl
狄	epwo
妄	yxsw
丘	rssq
抑	meby
呈	jgls
蓦	dscs
尹	nswy
坡	rxcp
契	gxcx
契	gxcq
嫌	xpns
津	lnsl
售	hyjs
棒	uggl
郡	njbj
撕	mfwq
骤	vsfr
疆	nrss
颈	cfab
贾	fbjj
贾	fbgg
咕	jxjg
歇	sehh
漏	lnfv
脾	arxp
窝	vwjk
嫣	xfdo
盼	kwxp
耻	fhls
蜜	vinm
姨	xdso
厨	asjf
珊	gews
链	qdil
裹	ykew
汪	lgls
靖	ygaj
殷	qecy
拟	mchn
淫	lwtl
呜	jesw
韵	yseg
柯	ufjk
巾	kljj
庙	ykss
纱	vmow
娶	fcxs
矩	tdvs
棍	usde
晋	fsjj
伐	hdwo
绳	vjks
涨	lntv
添	lgmo
陛	bder
嘲	jxsa
捧	mggl
宅	vtvz
鼎	knhl
谨	ifks
乏	wiff
黛	hdko
仓	hvcc
岗	kkwg
掏	mets
削	lajx
诧	ivtv
灌	ldjy
旨	eszz
刷	nkjs
页	abyy
泡	lenv
辩	yaix
俞	hsaj
婴	bbxs
盒	hsjk
嚷	jyje
沾	lhjz
漆	luhl
蠢	gsnn
甫	fvof
膝	auhl
墓	dscr
逢	egif
嫩	xftw
坠	bhrz
雀	mhys
枯	uxjk
偿	hlic
陌	basm
屑	nlax
畅	kvqc
陡	brhw
挽	moks
鹤	iyes
涵	lbbh
署	kfss
沃	ltwo
叉	cocc
搏	mffo
逝	mqis
趟	rhlj
鞋	fkrr
赴	rhlf
谦	ipns
砰	wswl
骄	vstr
遂	pais
泣	lyos
档	ulns
摊	mchy
慨	ondw
籍	tgfs
擒	mhyk
苗	dkss
浴	lwhj
鉴	jtqj
尴	ajtk
迁	tiqq
疏	bycr
尬	ahrg
赚	bpns
逗	sjpi
豆	sjps
孝	fbsx
芬	dwxf
湘	luks
诀	inwo
晰	suqs
廉	ypns
馨	fbes
辽	bill
械	udal
吊	jkld
炉	pisw
串	kslc
裸	ikso
哲	mqjz
凛	gykm
渴	lsev
柏	urvs
芸	dgcy
拱	mfwg
妨	xyvw
揉	mcbu
樱	ubbx
寄	vcfj
宙	vkss
宰	vyxz
媒	xfum
眯	kpso
贡	fbgg
崩	kaab
绑	vgbb
斧	wwqs
惶	orgl
嘶	jfwq
沟	lecg
禅	ipks
骚	vscn
荆	dgjj
歪	afss
涯	larr
耍	akxs
遵	pffi
伪	hpvo
冤	ioks
悍	osgl
耿	fpwo
翅	xccc
循	qqxk
聂	fccn
猴	ehnt
拂	mnvl
裙	injq
蓬	degi
芝	dizz
昭	sxjz
倏	hlec
舱	qhvc
肆	fcns
帽	ksks
岭	khio
叮	jfdd
拐	mjxg
儒	hsak
嫂	xrcs
瞥	ptks
廊	yibl
赔	byjp
辨	yapx
鄙	jxkb
哩	jkss
逊	bmix
愉	ohsj
摘	mypj
淋	luul
牺	tfvs
俯	hyhf
谭	ifsx
蒋	dgef
劣	mxll
玫	gtwo
吁	jgly
吁	jglx
肠	avqc
押	mksl
昔	fsxx
攀	uwwm
乳	wbvr
鹿	ynde
潘	lwks
娅	xfls
藤	dapl
躬	rnvg
蔡	degm
粒	pyos
涩	lxhl
揭	msev
嗓	jccu
啪	jmrv
翎	hicc
撼	masi
竖	jcyo
遣	kkiq
囊	fije
眠	knvv
掀	mroh
旺	sgls
弘	nchh
戚	ahmo
烁	pelo
逍	laix
坤	rksl
憾	oasi
仑	hell
租	tkss
咯	jejl
咯	jejk
咯	jejg
卜	lbbb
凰	ergl
哄	jfwh
匪	dhhs
膛	alir
淑	lhmc
忖	ofoc
堵	rfsd
夷	dsoy
柴	heuc
撇	mptw
歹	avod
辜	xjyx
沐	lumm
绽	vvfs
辅	dfvo
萍	dlsw
敖	gtwo
拆	mqso
磊	wwwl
罕	iwgl
冻	gdlo
赋	bsdh
趋	rhon
瞳	kyks
杆	uglg
灿	pklc
葬	daea
篮	tjtk
胞	aenv
颠	xkwb
黯	koys
峡	kswo
顽	geab
朕	apgw
兆	wxoz
擅	myks
陀	bvet
龟	oksv
蜂	negs
贞	hbzz
阎	uorv
咦	jdso
惟	ohys
竭	ysev
厢	auks
惩	qfio
谎	idyr
腔	avwf
裴	hhye
玻	gxcb
璇	gytb
溪	lwvc
铭	qejm
邻	hibl
朴	ulpp
衷	ykew
帘	vwkl
拢	mael
魁	rcox
哗	jhex
侄	hdrz
茵	dkcy
盆	wxkl
阅	upje
弦	nyvo
兮	wdxx
翁	wccc
贱	bgvo
债	hgbz
斌	ywsh
坑	ryek
逻	keil
踩	pwuc
瞎	kvgj
躁	pjju
讽	iewf
钉	qfdd
蓄	dyvk
丸	eoww
丐	fsvg
矣	ctso
册	ewsc
兔	okso
溃	lkbk
溃	lkbh
隙	bmsm
叠	ccck
瞄	kdks
倚	hcfj
轿	dtrj
舅	rkxj
钦	qohq
祈	iqsl
烛	pnzz
怡	ocjy
兹	pvvo
肢	axcz
综	vvgm
禀	ykjm
於	yhoy
於	yhow
壶	fijo
雯	syww
栏	upgs
览	jtke
斑	gywg
蹲	ppff
纽	vbss
践	pgvo
棠	liju
汹	lwbx
胎	acjt
妾	yxsq
篷	tegi
腥	asts
厮	afwq
锅	qjkw
楞	ukyv
澳	lrpc
窃	vwdx
霆	stct
桂	urrg
艇	qtct
轨	degg
哨	jlas
寡	vakx
挪	mnbn
翰	xsxc
尧	davy
咧	jajl
怯	orcq
瑰	grcg
沧	lhvc
寞	vdsc
叙	hgcx
彷	qyvw
佐	hafs
呐	jkwo
卒	yhhx
栽	xduz
焕	poks
塌	rscc
绣	vtxx
骆	vsej
敛	hsot
携	mhyx
蹄	pypk
颖	etab
棵	ukso
廖	yccq
呻	jksl
痒	ypgs
驳	vsww
裳	lije
睹	kfsd
泼	lxcp
溢	lpwk
狡	eyww
倘	hlkj
胳	aejg
羡	pggh
婢	xrxb
枕	uiwv
妒	xisw
绮	vcfj
噬	jtfh
呃	jave
喔	jndr
狸	ekss
缕	vpxs
译	icgl
泊	lrvs
芷	dhls
咪	jpso
刮	tjjg
咖	jxjk
咖	jxjg
恕	xjio
煌	prgl
嘱	jnrv
蚩	bncc
栋	udlo
锤	qtls
逛	egig
暇	snnc
栈	ugvo
溅	lbgv
巷	fwnv
填	rxkw
膊	affo
诈	itls
昧	sglo
乞	tvqq
叱	jecc
姚	xwxo
渔	loyy
摧	mkhy
遁	qxki
焚	uupw
糕	ppgo
衬	ifoc
倦	hpvj
辕	drje
啡	jhhs
啥	jhgj
乙	vvvv
彦	yqwy
郝	rrbh
履	nqte
匕	ebbb
潇	ldnl
茜	dfvs
嘟	jfsb
汝	lxsr
耽	fiwv
旭	esxx
浸	lnic
畜	yvks
硕	wabs
蕴	dvsk
侦	hhbz
佑	hajy
灼	peoz
嗤	jbnc
峻	kcwe
菊	deps
彤	eqwt
焉	fdoo
敦	yjbt
哟	jveo
筒	tksj
棉	urkl
霉	stvo
衰	ykew
烤	pfdk
麒	yndw
钩	qecg
犬	coqq
庸	ynsl
滩	lchy
姥	xfem
姥	xfel
桶	ucks
榜	uypy
茅	dcbw
狭	eswo
剥	nljb
症	yfss
诞	ircd
乍	tlsz
翩	ikcc
辑	djfl
棺	uvks
潭	lfsx
歆	ysoh
滞	lfik
抄	mmow
谱	ipfs
枉	ugls
趴	pwpp
狞	evfn
隶	nsol
嗔	jxkw
毙	deae
谊	ivks
淮	lhys
笛	tkss
缚	vffo
剪	pajx
囚	khqq
蔽	dptw
辟	njyx
碌	wnll
塑	pars
刊	gjkk
澜	lufv
捂	mfjw
秃	tett
掷	mpgb
桐	uksj
霎	syxs
搁	muej
帆	keof
矢	tsos
腻	adgb
函	bbhh
址	rhls
弩	xcnv
邱	rbqq
孽	dryb
藉	dgfs
胀	atvo
兀	avww
嚣	jjaj
雍	yvhy
巍	ktxc
匠	dqsl
冉	kssr
窥	vwge
蛛	ntso
狈	ebbb
瑜	ghsj
妍	xgwl
衍	qlgl
邵	xjbs
朽	udxx
噗	jjpg
苟	dejg
鲍	oenv
胃	kaww
壳	fieq
壳	fiek
暮	dscs
萝	dkeo
恳	nioo
渠	lduq
挟	mswo
琉	gycr
熙	dnoo
噢	jrpc
雇	ihys
碑	wrxb
驼	vsve
俺	hcks
绘	vhgc
喀	jvej
捡	mhso
斐	hhyw
阮	bger
嘎	jakd
吱	jxcz
炽	pjwc
钥	qayy
妆	gxsz
杏	ujxx
桓	usss
昊	sgwo
擎	dejm
贷	hdbd
磁	wpvv
宪	vtex
沸	lnvl
衙	qfjg
匙	sfes
匙	sfec
鞘	fkla
剂	ywrj
搅	moie
猿	erje
赠	bpks
徽	qkdt
裕	iwhj
祷	igfo
株	utso
蜀	kens
桩	uyrz
账	btvo
巢	vkso
堕	baar
梭	ucwe
兜	erne
敞	lkjt
肿	aksl
骷	kaxj
髅	kapx
娟	xjaj
茂	davo
窄	vwtl
菱	drwe
吨	jdlv
絮	xjvm
坎	rohk
琦	gcfj
芦	disw
渗	lccq
拘	mejj
梵	uueo
脊	gwha
澡	ljju
窟	vwnb
姻	xkcy
捐	mjaj
盏	gkls
孕	xbsy
滔	lwrv
挫	mhhr
伺	hnjs
伺	hnjc
贩	bqcf
扁	iksl
墅	kcbr
寝	vgnc
侮	htvo
垃	ryos
郊	ywwb
眶	kdgl
莽	dcal
俘	hwbs
蝉	npks
卦	rrlg
喧	jvss
圾	reoj
诛	itso
澄	lcsp
妞	xbss
彪	hdeq
淳	lyjb
唔	jfjw
唔	jfje
揽	mjte
厦	aake
嗡	jwcc
勋	jbxx
歧	hxcq
鸦	desy
聘	fkdp
珑	gael
哮	jfbs
嗦	jxim
虞	hdjg
惭	odqs
熬	gtoo
迭	tidd
盐	rlkl
啧	jgbz
捣	mekl
梳	uycr
浆	gelj
烫	lvqp
虐	hdds
钧	qegj
掘	mnbl
忿	wxio
畔	kpsl
樊	uwwc
倪	hren
亩	ykss
咙	jaeo
邮	kbyy
襄	yjje
禽	hywk
鳞	oped
勿	eqww
炀	pvqy
嫉	xyts
杭	uyeh
嚎	jyja
衔	qqgl
菁	dgaj
眩	kyvo
栗	full
蹦	pkaa
喻	jhsj
盲	ykss
虏	hdxl
茹	dxjr
觑	hdje
佘	hgmo
蔓	dskc
陋	bfvl
苹	dswl
娱	xjgw
堤	rsfs
彬	uuqw
绷	vaab
铸	qgfo
酬	fpuu
绞	vyww
渺	lkmo
淘	lets
卸	tbxx
蛟	nyww
朦	adia
帖	khjt
菩	dyjp
坊	ryvw
旷	sywk
襟	iuum
汁	lxzz
僻	hnjx
翘	dacc
盔	apkl
嘘	jhdj
峨	ktlo
疚	yeoj
慑	ofcc
粹	pyhx
醋	ffsc
饥	oejj
秩	ttso
沫	lglo
肺	afvl
咆	jenv
砖	wgvo
嘀	jypj
弧	nqvo
锡	qseq
顷	dabq
迦	xjij
拚	mcal
胧	aael
妓	xxcj
捞	mdix
蹈	pwrv
坟	rywf
幢	kyks
湛	lfwv
亨	yjbh
媳	xrio
荐	dabs
奕	yrcy
吏	fvol
磕	wrck
皓	rtjh
婿	xbax
跋	pacb
钰	qglo
罡	kfss
扳	mqcb
屡	npxs
犀	nlts
稿	tyjj
蚁	nowy
咚	jeod
耕	ggwl
锻	qrec
奢	cfss
诊	ihqw
祺	ifwq
泳	livo
拭	mdfs
蚀	onss
垒	cccr
冈	kwgg
窍	vwfd
龚	aefw
戟	xsxd
萱	dvss
绰	vhsx
脂	aesz
宵	vlax
钓	qeod
蔑	dkao
嵌	kfoh
戮	cchd
叩	jbkk
迸	pgib
淹	lcks
丞	bscc
喇	jfjl
哧	jrrw
叨	jxtt
叨	jxdd
瓷	gohd
炯	pkjj
蝎	nsev
揪	mtpw
沛	lfvl
斋	ywak
侣	hjjl
挠	mdav
蝠	nsjk
逞	jgic
疫	yecy
眷	pkss
姗	xews
懈	ooet
瘫	ychy
饼	opgw
嗅	jrco
豁	vgjj
棚	uaap
煤	pfum
框	udgl
绸	verj
殖	axks
券	pxxx
券	pxqq
蒸	dbso
熄	prio
疤	ybsv
蒲	dlfv
稚	thys
莺	dies
冀	hekw
稻	twrv
葡	defv
侃	hjrv
捆	mkuk
澈	lyct
毯	tppw
傍	hypy
旬	esxx
呕	jdwo
梧	ufjw
寓	vkso
粘	phjn
滨	lvrw
薪	dyuq
阱	bgwl
撩	masm
舔	tjgm
辖	dvgj
舜	wied
梨	tjul
猾	ekah
抿	mnvv
禹	rvoy
啼	jypk
炭	kapw
砚	wkey
玑	gejj
掐	morv
夭	twoy
榻	uscc
哉	xdjz
逮	nidd
旱	sglh
驴	vsis
甄	frdv
煮	fsoo
憋	ptio
缴	vryt
蕊	diii
稽	taes
绯	vhhs
喽	jpxs
涡	ljkw
滥	ljtk
搓	mpgf
颓	teab
瞅	ktpw
铮	qons
纲	vkwg
揍	mggw
鹅	tese
氓	ynvv
瑾	gfks
肝	aglg
踉	piso
讪	ikls
箫	tnwl
腊	afsx
腊	afsl
霓	sren
惫	ekio
淌	llkj
霹	snjx
垫	merd
跄	phvq
茨	dgoh
刁	nddd
禄	inll
膜	adsc
诅	ikss
擂	msks
轴	dkss
厥	apoh
讥	iejj
厄	avee
胶	ayww
扛	mfsk
扛	mfsg
惕	oseq
瞟	kfgm
凸	hlst
肘	afoz
媛	xwgc
拧	mvfn
浙	lmqs
奎	crrk
熏	tooo
沁	lioo
骏	vsce
笙	ttss
岔	wxkl
沮	lkss
颅	hnab
酥	ftlo
冶	gcjy
嗽	jfoh
舵	qved
燥	pjju
拙	mbll
蛊	nkls
瓣	yaqx
吭	jyek
吭	jyeh
绫	vrwe
蝴	nxja
罐	tdjy
糖	pynj
蹙	ahmp
琢	gavo
漾	lpgi
绅	vksl
怠	cjio
嗷	jgtw
沦	lhel
鸭	kesy
涅	lsrn
驭	vscy
咏	jivo
窒	vwdr
槐	urch
凳	csje
臀	nfwa
伞	hpsl
懊	orpc
雳	saxl
逾	hsai
唬	jhde
葫	dxja
闺	urrg
咸	asjx
镶	qyje
萄	dets
梢	ulas
嗜	jfes
戳	cchd
铲	qyow
缪	vccq
猩	ests
跺	peud
蟒	ndca
詹	oawj
晒	sfvs
浦	lfvo
邹	onbz
黝	kovx
筷	tonw
狰	eons
霖	suul
炫	pyvo
凹	klsw
凹	klsa
伶	hhio
揣	mkak
窘	vwnj
悸	otbs
垮	rcgv
噜	josl
颔	hijb
嚼	jwkf
尿	nlss
尿	nlnn
沼	lxjz
塘	rynj
肋	axll
簇	tytt
哆	jeeo
兢	xjee
琐	glbs
颁	wxab
泻	lids
鞠	fkep
匿	ddaj
膨	afjq
酿	fiso
颂	wcab
瘾	yboi
栖	ufvs
蔚	dngf
楠	uxkg
帜	kjwz
剔	seqj
靴	fkhe
萌	dsam
棘	ffvo
娥	xtlo
沌	ldlv
谜	ipim
觅	wkem
砂	wmow
脯	afvo
讳	igvl
螺	nkvm
晖	sids
韧	gxor
瞻	koaj
蜡	nfsl
瀑	lsfl
璧	njyg
蚕	gncc
聋	aefl
漓	lywk
踱	pyfc
谣	iwts
敷	fytw
偎	hkdw
绢	vjaj
噩	fjjj
搔	mcns
晏	svxs
匣	dksl
倔	hnbl
蹬	pcsp
苑	devy
婶	xvks
歼	atlj
缉	vjfl
彰	ysxq
拇	mvoo
寥	vccq
昼	nssz
弊	ptal
坪	rswl
敝	ptwo
裘	fyew
呸	jasp
憎	opks
镔	qvrw
悯	ouyw
舆	rdnw
诵	icks
拎	mhio
唾	jtls
瑛	gdks
枢	udws
叭	jwbb
挚	memz
揖	mjfl
兑	pjed
蜘	ntjz
秉	tvob
荫	dbay
衅	rpsl
壤	ryje
匀	egyy
驯	vsrl
浊	lnzz
惚	oeqi
牟	ctsl
呛	jhvq
祁	ibqq
娴	xuux
蜥	nuqs
炒	pmow
婕	xdso
甸	ekss
惮	opks
碟	wfud
谐	ider
叟	rcss
猝	eyhx
侥	hdav
斟	fwvx
啤	jrxp
髓	kaai
寰	vkse
峙	krfo
赦	rrtw
噪	jjju
枭	euxx
浇	ldav
腮	akio
遏	sehi
哽	jfvo
芽	ddlw
婪	uuxs
倭	htxs
卵	ebol
暧	swic
阙	upoh
诏	ixjz
炙	epwo
祟	bgmo
拣	mdvo
邸	ebdd
骸	kayh
谬	iccq
磋	wpgf
涕	lpnv
瀚	lxsc
邢	gbxx
捶	mtls
袱	ihco
洽	lhsj
峭	klaq
巩	feog
檀	uyks
赎	bxvc
祀	invs
滕	aplt
柬	fvoj
嵩	kyjj
嬉	xfjj
僚	hasm
睬	kwuc
葱	deqi
嬷	xyuc
缸	tfsg
杉	uqws
虔	hdyw
娲	xjkw
拽	mksw
廓	yyjb
玮	ggvl
蔷	dfkj
恃	orfo
竿	tglg
恙	pgio
绒	vdar
瑚	gxja
漪	lecj
鹃	jaes
睫	kdso
鸽	hsjs
陕	bswo
钞	qmow
蝙	niks
搀	moko
袅	eyew
蝇	njks
佬	hfel
蚂	nvsm
蚊	nyww
翡	hhcc
朔	pass
踹	pkak
嗖	jrcs
芊	dtlq
崎	kcfj
啃	jhak
璋	gysx
慷	oyns
咋	jtls
檐	uoaj
鞍	fkvx
剿	vkjj
剿	vkjc
腑	ayhf
悚	ofvo
缎	vrec
匈	ewbx
厕	abjs
厕	abjc
鹫	yjms
涟	ldil
虾	nfox
虾	nfoh
漩	lytb
聆	fhio
栅	uews
搐	myvk
鸾	yjes
蓓	dhyj
扒	mwpp
扒	mwbb
穹	vwnv
瑕	gnnc
珀	grvs
锥	qhys
矫	ttrj
庐	yisw
暑	sfss
溶	lvwj
靡	yuuh
晦	stvo
喳	juss
咄	jbll
巅	kxkb
墟	rhdj
煎	pajo
芯	dioo
亢	yekk
掳	mhdx
屯	dlvt
叽	jejj
曦	spgd
獠	easm
厘	akss
懦	osak
渣	luss
桀	eduj
恬	otjt
缀	vccc
褪	init
嵋	kbks
筝	tons
秽	tkeo
庇	ydeb
绊	vpsl
褚	ifsc
拯	mbsz
衲	ikwo
眺	kwxo
悴	oyhx
驹	vsej
钝	qdlv
酋	pfvs
珂	gfjk
祢	iomo
狙	ekss
汰	lcot
镯	qken
贿	baah
铠	qknv
粥	npnv
佟	heot
芮	dkwo
奄	cksv
怅	otvo
剖	yjjp
伽	hxjq
伽	hxjj
伽	hxjg
忡	oksl
萎	dtxs
凿	jpgb
鬟	fcqe
奠	pfcd
熠	pccr
憔	ohyo
钮	qbss
妩	xgwv
抡	mhel
崆	kvwf
弛	nbvc
褐	isev
勘	fwvx
妲	xssd
唰	jnkj
惺	osts
膏	yjia
筠	treg
贬	bwib
绚	vesx
嗨	jltv
怦	oswl
晤	sfjw
俐	htjl
窦	vwxc
驿	vscg
棱	urwe
竺	tgzz
烙	pejl
睿	hisk
锣	qkeo
溺	lngg
恺	oknv
缔	vypk
牡	trmm
鬓	fcqw
藩	dlwk
谕	ihsj
庵	ycks
憨	vfti
瘟	yskl
钗	qcoc
昕	sqsl
徊	qkjh
偌	hdaj
髯	fcqk
缰	vsks
庶	yfoo
札	uvzz
缭	vasm
徘	qhhs
曙	skfs
阀	uhdw
殆	acjd
巳	nvss
纬	vgvl
缄	vasj
澎	lfjq
掣	tjmc
惘	okpy
槽	ufsc
诣	iesy
曳	kswy
娄	pxsl
胤	wvav
惋	ovev
虬	nvqq
倡	hssc
芭	dbsv
琛	giwu
肴	waay
蹭	ppks
庚	ynso
飙	cccw
仕	hfss
貂	wexj
嚓	jvem
蜴	nseq
募	dscx
昱	syos
圳	rrlz
氧	tpgs
悻	orpg
佯	hpgs
锵	qgef
隋	bafa
笃	tvsd
筱	thlt
忑	fioo
捅	mcks
捺	mcgm
茉	dglo
萤	diny
佗	hvet
睨	kren
邃	vwpi
谴	ikki
霏	shhs
屎	npso
乒	rwpp
谍	ifud
缅	vakl
忐	hioo
暄	svss
簌	tfoh
鲸	oyjm
涎	lrcx
瞩	knrv
攒	mteb
蟹	oexn
茄	dxjq
茄	dxjj
漱	lfoh
饲	onjs
嗣	jknj
诫	idal
阐	upks
瑭	gynj
熔	pvwj
冽	gajl
棕	uvgm
酱	gefv
辫	yavx
辙	dyct
闵	uywm
殴	dwec
蛙	nrrw
滢	ldig
晁	swxo
删	ejss
裔	yekj
膳	apgj
殃	akso
蔼	disv
茱	dtso
苛	dfjk
跷	pdav
痊	yhgl
樵	uhyo
烘	pfwh
癫	yxkb
懿	fisi
扼	mave
吆	jvoy
鸠	eesj
茧	dnjj
孜	btwo
侨	htrq
幡	kwks
咎	eljj
蔬	dbyr
酣	ffls
亵	ymee
哝	jiwo
隧	bpai
禾	tloh
纺	vyvw
黏	thlj
湃	ltgs
绛	vedl
崛	knbl
嘈	jfsc
眈	kiwv
皙	uqrv
礁	whyo
琅	giso
睦	krwr
薰	dtoo
璐	gpej
蹿	pvwk
邑	jbsv
躇	pdfs
菌	dktl
枣	fozz
踌	pgfo
迢	xjit
赃	byrz
臻	drgt
苇	dgvl
篝	tgfv
袜	iglo
崭	kdqs
屿	kdsy
娆	xdav
靳	fkqs
咨	gohj
煜	psyo
聿	nsly
陨	bjby
鸳	eves
榴	uexk
帷	khys
钵	qfws
毋	vwsw
橙	ucsp
雌	hdhy
丙	fvob
琥	ghde
匡	dgls
狩	evfo
芜	dgwv
羿	ccal
璀	gkhy
鲨	lmos
冕	soks
讷	ikwo
蠕	nsak
砌	wdxq
戾	icol
掺	mccq
拈	mhjn
酌	feoz
殇	atvq
忒	dioo
铅	qejy
铅	qejq
戎	darr
蹑	pfcc
唠	jdix
苔	dcjt
栩	uccs
烨	phex
吝	ywjl
啜	jccc
涣	loks
甬	cksl
莞	dvge
恻	objc
雏	onhy
窖	vwtj
傀	hrck
傀	hrcg
蜷	npvq
岱	hdkl
疙	ytvg
飒	yews
衮	ywce
谑	ihdd
乓	ropp
棣	unso
磅	wypy
焱	pppw
猖	essc
簿	tlff
譬	njyj
羁	kfks
戬	fsdw
拗	mvxn
拗	mvxk
拗	mvxa
煦	sejo
烬	pnoj
伫	hvsz
葵	dcgw
镰	qypn
瘩	ydhj
笠	tyos
趾	phls
攸	hltw
剌	fjll
唧	jnbj
睽	kcgw
坝	rbbb
紊	ywvm
渍	lgbz
迳	cfij
靶	fkbs
糙	ptji
宦	vdll
吮	jces
勺	eoss
祯	ihbz
邯	fbhh
鄂	jjgb
窑	vwts
圭	rrgg
侈	heeo
粪	pfwf
杠	ufsg
鸯	kesy
炬	pdvs
浏	lywj
橡	uoke
孰	yjbe
琶	ggbs
俨	hflw
泓	lnch
涧	lusj
呗	jbbb
麾	yuut
昵	snen
屹	ktvy
恤	orvs
寐	vbgl
婧	xgaj
闸	uksl
韶	ysxj
菇	dxxj
靓	gake
椒	uhmc
荀	desx
癸	cgwo
饕	jdhi
啐	jyhx
疮	yhvc
岑	khic
辎	dvks
攘	myje
琵	ggde
稷	tkwe
肮	ayea
矜	cbhi
楣	ubks
渎	lxvc
荧	dipw
噎	jfip
呱	jqvo
崽	kkio
饵	ofls
拷	mfdk
锭	qvfs
缥	vfgm
瘪	yrhe
瞠	klir
沪	lisw
奚	wvcx
籁	tfob
湮	lfry
萦	divm
劭	xjxs
铛	qlns
茗	dejm
弑	wudf
痹	ykal
飕	ewrc
铿	qjcr
璨	ghcp
赘	gtbz
缨	vbbx
畴	kgfo
儡	hkkk
冢	iavo
辐	dsjk
蜈	njgw
珞	gejl
鞑	fkci
咻	jhux
笈	teoj
扈	ijbs
壑	hisr
骰	kaec
撰	mnnw
鲲	osde
噤	juum
煽	picc
玺	omgl
炳	pfvo
捻	mhii
诶	icts
嗒	jdhj
锯	qnxj
浣	lvge
窿	vwbt
坞	resw
鑫	qqqx
磷	wped
蜒	nrcy
噔	jcsp
绎	vcgl
咔	jhlk
扉	ihhs
阖	urck
穗	tfio
叁	ccgs
茸	dfls
踞	pnxj
皂	rdzz
璞	gjpg
垢	rqsj
枷	uxjj
珏	gglo
骋	vskd
矗	xkxk
缇	vsfs
蹊	pwvc
粟	fpso
呦	jvxy
驸	vshf
唆	jcwe
馒	oskc
寅	vfwy
撮	msfc
羹	pgoc
楮	ufsc
峦	yjkl
灶	przz
餮	ahqi
靥	acak
嬴	yjae
遐	nnci
胭	akcy
顼	gabx
榕	uvwj
胯	acgv
迂	giyy
惦	oyhj
伎	hxcj
诬	ifhh
癌	yjjk
桨	geuj
黠	kofj
逵	rwri
韬	gwrv
嫡	xypj
悼	ohsx
喏	jdaj
帛	rklb
俭	hhso
啄	javo
咣	jleg
铐	qfdk
咫	njwz
钳	qfls
骼	kaej
舷	qyvo
祠	injc
箍	tmdk
橱	uasf
鳄	ojjg
袂	inwo
溟	lisw
锈	qtxx
篱	tywk
缈	vkmo
淤	lyho
铎	qcgl
囔	jfie
蚣	nwcg
痞	yajp
吒	jtvz
迄	tiqq
稼	tvav
汀	lftt
槛	ujtk
漉	lyne
椎	uhys
辗	dnfl
滤	lhdi
洼	lrrw
醇	fyjb
瘤	yexk
桅	uoav
喵	jdks
亥	yxhh
渝	lhsj
惬	odsw
淼	lllm
咛	jvfn
蛾	ntlo
筛	tmfv
髻	fcqj
幌	ksle
笺	tgvo
憧	oyks
梗	ufvo
颍	elab
瓢	fgmq
馀	ohgl
殉	aesx
翟	cchy
盎	kkls
濒	lhmb
簧	tfkw
馈	okbk
孺	bsak
伢	hdlw
闽	unmm
楷	uder
亘	sssg
惴	okak
瓒	gteb
笋	tnsw
咀	jkss
幺	voyy
蒜	dgmm
掂	myhj
杵	utsl
瞑	kisw
兖	ywce
峒	kksj
颐	daby
曜	sccy
螂	nibl
毗	kdep
飓	ewkw
缆	vjte
芥	dhrj
芥	dhrg
缤	vvrw
蜿	nvev
翊	yccs
卉	xalh
屉	nflv
翱	rcxc
拴	mhgl
湄	lbks
稠	terj
桦	uhex
鹊	fses
咂	jdkl
燎	pasm
谏	ifvo
贮	bvsz
猥	ekdw
峥	kons
溯	lpas
佼	hyww
喋	jfud
诩	iccs
渥	lndr
曝	ssfl
剃	pnjt
邺	jbyy
羔	pgoo
匾	diks
汲	leoj
邬	esbw
赂	bejl
炜	pgvl
锢	qkxj
吠	jcof
锄	qkxc
蛤	nhsj
藻	dlju
烹	yjbo
蹋	pscc
垦	nrkk
迥	kjij
岐	kxcq
耷	cfls
隘	bpwk
淬	lyhx
嚅	jsak
慵	oyns
烽	pegs
诲	itvo
橘	ucbj
翌	ccyo
濮	lhjg
蟾	noaj
垣	rsss
锺	qtls
抉	mnwo
茬	darc
啷	jibl
淇	lfwq
硝	wlax
沥	laxl
褥	iagf
踝	pkso
矶	wejj
骁	vsda
酝	fgcy
梓	uyxz
唷	jyca
玎	gfdd
憬	osym
霭	sisv
蕉	dhyo
眦	khez
墩	ryjt
毡	thjz
蕃	dwks
弼	nasn
肇	itns
阑	ufvo
垄	aerl
晟	savo
呲	jhec
毓	tvyr
痪	yoks
陇	bael
鳌	gtoa
袒	isst
谛	iypk
忏	otlc
拌	mpsl
臾	rvoy
瀛	lyje
簪	tdds
懵	odkk
纶	vhel
纶	vheg
跤	pyww
胴	aksj
浚	lcwe
唏	jwak
筏	thdw
甥	tkxs
蝗	nrgl
癞	yfob
瓮	wcdv
驮	vsct
驮	vscd
涤	leud
捍	msgl
膺	yhha
铳	qyce
芹	dqsl
嘭	jfjq
骥	vshw
炕	pyek
匐	esjk
羌	pgsv
娓	xnts
壕	ryja
宓	vioo
隼	hyxs
泌	lioo
嗫	jfcc
桔	ufjj
圃	kfvo
抒	mcbs
稣	otlo
瓯	dwdv
鲤	okss
磐	qecw
萃	dyhx
魃	rcac
侬	hiwo
讼	iwcs
萼	djjg
皎	ryww
簸	tfwc
姒	xchs
叼	jndd
茎	dcfs
瞿	kkhy
剁	eujd
篆	tvav
羲	pgtd
骡	vskm
鹦	bbxs
蕙	dfio
隅	bkso
瘸	yxjh
炊	pohc
饷	orjx
辄	dfvz
嘤	jbbx
颌	hsjb
腆	akwt
嫖	xfgm
惆	oerj
媲	xrwe
馁	owxs
娉	xkdp
褒	yhje
旖	ytcj
馋	ooko
噘	japh
呤	jhio
缜	vxkw
荃	dhgl
捋	mwfo
胥	baxx
潺	lnbb
卯	ebmm
婵	xpks
撅	maph
涔	lkhi
舫	qyvw
柿	uykl
偕	hder
汩	lkss
榨	uvwt
苞	denv
胄	kazz
坍	reos
麓	uuye
鸥	dwes
掬	meps
礴	wdlf
轧	dvyy
轧	dvgg
纣	vfoz
淀	lvfs
糜	yuup
昙	sgct
壹	fisp
埔	rfvo
诃	ifjk
诃	ifjh
魇	acrc
凋	gerj
蹂	pcbu
荼	dhgl
镑	qypy
鹉	sdhs
臧	adll
褂	irrl
筐	tdgl
纨	veow
筵	trcy
轼	ddfs
蘑	dyuw
潞	lpej
榆	uhsj
沣	lgsl
黔	kohi
玟	gyww
玟	gywm
婊	xgew
旌	ytts
痉	ycfs
魑	rcyk
嫦	xlik
卞	ylbb
瘴	yysx
丕	aspp
贽	mebz
袄	itwo
砾	welo
挛	yjml
麴	feep
腋	ayhe
隽	hyxj
躏	pduy
撂	mkej
偃	hdsx
馅	oorv
醺	ftoo
嗥	jrcx
渭	lkaw
阉	ucks
蟆	ndsc
盅	kkls
沓	lstt
沓	lsdd
榭	urfo
睐	kswo
婀	xbfj
哒	jcid
啬	fkjs
郢	jgby
噼	jnjx
琬	gvev
栓	uhgl
冗	ierr
睚	karr
硫	wycr
癖	ynjx
霈	slfv
甭	aesl
侏	htso
皑	rknv
拄	myss
夙	eavo
渲	lvss
秤	tswl
攫	mkkc
岌	keoj
遽	hdai
蛆	nkss
赧	rrbc
踵	ptls
汴	lylb
鸨	exes
剐	jkjg
窈	vwvx
潼	lyks
靼	fkss
睑	khso
霁	sywr
沅	lgey
卤	hkwl
掰	twxm
攥	mtkm
鹭	pejs
藕	dgks
颚	jjgb
蛰	menz
幔	kskc
腼	aakl
篡	tkcc
恣	gohi
蟠	nwks
噌	jpks
嫔	xvrw
裆	ilns
哺	jfvo
跚	pews
馥	tste
孚	wbsf
僖	hfjj
窕	vwwx
盂	gkls
钊	qjzz
囤	kdlv
喟	jkak
跛	pxcb
刨	enjp
刨	enjb
槌	uric
臊	ajju
苜	dkss
渤	lxix
螳	nlir
肾	jcas
荤	dids
捎	mlas
镭	qsks
糗	prco
薯	dkfs
徨	qrgl
蜕	npje
瑙	gvrw
噫	jysi
鳖	ptob
妤	xcby
谪	iypj
贲	xdbb
隗	brcw
隗	brck
裟	lmye
擞	mpxt
濑	lfob
绔	vcgv
鳅	otpw
戍	aoos
摹	dscm
堑	dqrq
绾	vvks
捱	marr
旎	ytne
谄	iorv
谒	isev
谧	iikl
嚏	jxib
苋	dkex
苋	dkej
恸	ogcx
粤	rpdy
姣	xyww
碳	wkap
殒	ajby
哂	jfvs
龌	hhbr
啾	jtpw
蹒	pdfv
蝼	npxs
龊	hhbp
娼	xssc
揩	mder
沂	lqsl
舶	qrvs
泞	lvfn
啻	ypij
阜	rxff
弋	doyy
恪	oejk
蜃	agns
搪	mynj
辘	dyne
挲	lmms
娑	lmxs
嗝	jsjp
饺	oyww
桉	uvxs
岖	kdwq
杳	usyy
碾	wnfl
妪	xdwy
袈	xjye
赈	bagv
摒	mnpg
孵	ebwb
菡	dbbh
哐	jdgl
羚	pghi
撬	mttt
颉	fjab
晔	shex
罔	kpyv
倜	herj
倌	hvks
藐	dwee
髦	fcqt
猊	eren
汐	leox
颦	hmax
臌	afjc
獒	gtco
粼	pedv
杞	unvq
蚌	ngsl
郸	pkbd
揄	mhsj
竣	ycwe
嗲	jwwe
瞌	krck
胚	aasp
愠	oskl
谙	iysa
恁	htio
龇	hhbe
啵	jlxc
匍	efvo
脓	aiwo
撵	mggd
痰	yppw
蛹	ncks
觎	hsae
畿	vvdk
殛	abjs
泯	lnvv
讹	ihee
潦	lasm
犁	tjts
苓	dhio
犷	eywg
俟	hcts
邝	ybkk
弈	yral
呓	jdvy
汛	lvxx
螓	ngtl
觊	knke
玷	ghjd
瞰	kvft
槟	uvrw
椰	ufby
垠	rnso
邕	vjbs
臆	aysi
钛	qcot
挎	mcgv
粱	lxps
涸	lkxj
糯	psak
霾	swek
禧	ifjj
俸	hggl
箕	tfwj
坷	rfjk
祗	ieso
熹	fjpo
俑	hcks
怂	hhio
噙	jhyk
湍	lkak
赣	ysxb
芋	dgly
咝	jvvs
潋	lhst
噶	jdsv
巽	nnfw
汕	lkls
仞	hxor
釜	wwgl
鬃	fcqm
嗵	jcki
颀	qabq
锚	qdks
螭	nywk
洵	lesx
犸	evsm
珈	gxjj
魍	rcky
摁	mkci
疵	yhec
忤	otsl
汾	lwxf
汜	lnvs
琰	gppw
褛	ipxs
惰	oafa
蚯	nrss
斓	ywuf
觐	fkke
梆	ugbb
漳	lysx
镣	qasm
贻	bcjy
粲	hcps
恿	ckio
谲	icbj
咿	jhns
咤	jvtv
篓	tpxs
飚	ewpp
篑	tkbk
憩	tjri
椭	ubaa
睥	krxp
睥	krxb
沽	lxjg
犄	tcfj
怏	okso
魉	rcfv
鼾	rkag
堰	rdsx
齑	ywhl
帚	nikl
亟	bjcs
镀	qyfc
骠	vsfm
苯	dfws
宸	vagv
僮	hyks
阗	uxkw
榄	ujte
辇	ggds
豺	wefw
翦	pajc
纰	vdep
阂	uyxh
旃	yteo
荦	dits
蚓	nnly
趄	rhks
猬	ekaw
劾	yxhx
趔	rhaj
蜻	ngaq
嵘	kdiu
铝	qjjl
滇	lxkw
呷	jksl
暹	shyi
蠡	vann
淄	lvks
囵	khel
掸	mpks
溉	lndw
坳	rvxk
坳	rvxa
轲	dfjk
皋	rcxg
骜	gtvs
螃	nypy
帧	khbz
蘅	dqog
剽	fgmj
坂	rqcb
涓	ljaj
魈	rcla
怆	ohvc
袤	ycbe
嗳	jwic
踊	pcks
锏	qusj
濡	lsak
昀	segy
鹞	wtes
氲	tskl
厩	andw
徙	qhhw
瑁	gsks
箩	tkeo
斡	xsxx
抠	mdwk
褶	iccr
痣	yfio
晾	syjm
廿	flsn
揶	mfby
炖	pdlv
氤	tkcy
蹩	ptpb
芍	deos
愫	ogvm
玳	ghdo
嗬	jdhj
臼	rvsj
淅	luqs
嘣	jkaa
桧	uhgc
腺	arlx
壬	tlsr
瘁	yyhx
堇	fkss
侗	hksj
赁	htbl
匝	dklz
孱	nbbb
灸	epwo
褴	ijtk
镂	qpxs
畸	kcfj
碴	wuss
羯	pgsv
暨	ndss
谤	iypy
彝	vpva
嘹	jasm
雹	senv
忱	oiwv
蔫	dfdo
荔	dxxx
鲛	oyww
硅	wrrg
刽	hgcj
悖	oxib
脐	aywr
骧	vsye
夥	keeo
盹	kdlv
孪	yjbs
谆	iyjb
殡	avrw
诌	ions
琊	gdby
敕	ftwo
禺	ksoy
罂	bbts
犊	txvc
滟	lgob
藜	dtel
蟑	nysx
郦	skkb
绥	vwxs
讧	ifsh
潢	lfkw
夔	phre
橄	uvft
桢	uhbz
酆	kggb
淆	lwaa
涮	lnkj
蜗	njkw
垛	reud
啕	jets
孬	axbs
臃	ayvy
澹	loaj
耘	ggcy
徵	qkst
銮	yjql
豚	aavo
蓟	dojj
汶	lyww
皿	klsm
遑	rgih
倨	hnxj
燧	ppai
佻	hwxo
诘	ifjj
碉	werj
摞	mkvm
镐	qyjj
诽	ihhs
掖	myhe
峋	kesx
戛	akdw
蒯	daaj
叵	djpp
泗	lkes
鄢	fdob
鏖	yndq
邋	vkwi
舐	tjes
獗	eaph
酉	fvsy
煊	pvss
嗟	jpgf
忻	oqsl
泱	lkso
蔻	dvgh
蓁	dgtl
琮	gvgm
遢	scci
庖	yenv
帼	kkgl
琏	gdil
诋	ieso
骊	vssk
荻	depw
遨	gtia
俪	hskk
秧	tkso
怵	ouoc
瘠	ygwa
诠	ihgl
忪	owcs
鹄	tjes
卟	jlbb
腴	arvo
嶙	kped
犒	tyjj
挞	mcit
焊	psgl
碱	wasj
傥	hlie
迩	omie
馊	orcs
摺	mccr
珩	gqgl
葳	dasx
绉	vons
斫	wqsl
跆	pcjt
珉	gnvv
泠	lhio
忸	obss
闩	usss
鸵	esve
彗	ggns
麝	yndf
耙	gbsv
岷	knvv
鸶	vvss
粽	pvgm
蝈	nkgl
闳	uach
骛	cbts
佝	hejg
蜓	ntct
笆	tbsv
怩	onen
奂	okso
掇	mccc
艮	nsog
舀	wrvs
膘	afgm
踮	pyhj
匮	dkbk
匮	dkbg
濠	lyja
狒	envl
宕	vwdd
皖	rvge
燮	pygc
邙	ybmm
喙	jvav
莓	dtvo
颛	kakb
椿	ugsc
陲	btls
恫	oksj
钹	qacb
檄	uryt
绡	vlax
鳍	ofes
椁	uyjb
偻	hpxs
纾	vcbs
鹧	yfos
弭	nfls
漕	lfsc
荑	ddso
贰	dgbe
槿	ufks
牒	rfud
鸢	desy
砺	wadw
雉	thys
鸪	xjes
绺	velj
橇	uttt
跻	pywr
轶	dtso
戊	avow
猷	pfco
锹	qtpw
衾	hiye
钺	qdvo
祚	itls
闾	ujjl
涝	ldix
荥	dilx
逅	qsji
肪	ayvw
囱	reoc
洱	lfls
峪	kwhj
鄱	wkbp
箬	tdaj
嫒	xwic
繇	wtem
莆	dfvo
阪	bqcb
镳	qyno
浃	lswo
佞	hgxs
麋	yndp
搡	mccu
蘸	dfho
挝	mfiw
岈	kdlw
唳	jico
娣	xpnv
忾	otsv
戌	asox
幄	kndr
氢	tcfs
霰	sfat
蔺	duhy
骅	vshx
蚱	ntls
谀	irvo
俦	hgfo
昶	iscc
撸	mosl
狻	ecwe
荏	dhtl
磬	fbew
昴	sebm
杈	ucoc
闰	ugls
缮	vpgj
谚	iyqw
龛	hsje
鸩	iesz
谗	ioko
砥	weso
俎	hhks
瘀	yyho
邂	oexi
沏	ldxq
邈	weri
埠	rrxb
坯	rasp
咭	jfjy
咭	jfjq
咭	jfjj
缙	vfsj
蹇	vgwp
俾	hrxb
蜚	hhnf
箐	tgaq
籽	pbsz
阚	uvft
嗄	jake
钠	qkwo
泾	lcfs
腓	ahhs
驽	xcvs
辍	dccc
鞅	fkks
蹶	paph
迤	tbiy
诮	ilaq
哔	jdex
赳	rhbj
刎	eqjw
聒	ftjg
抨	mswl
腌	acks
佥	hsow
炷	pyss
淙	lvgm
饯	ogvo
垩	free
磺	wfkw
鳗	oskc
钏	qrlc
氅	lkjt
胛	aksl
遛	exki
涿	lavo
酪	fejl
糠	pyns
翕	hsjc
姝	xtso
佶	hfjj
茴	dkjh
呔	jcot
呔	jcod
檬	udia
衩	icoc
柩	udeo
恹	oaco
翳	dtec
纂	tkcm
姹	xvtv
浒	lits
跖	pwzz
琨	gsde
铄	qelo
镌	qhyx
佃	hkss
钜	qdvs
莅	dhyo
嗑	jrck
沱	lvet
膻	ayks
楔	ugxc
徇	qesx
懑	ldfi
豸	weww
儆	hdet
貉	weej
潸	luua
仨	hgss
讫	itvq
圜	kkse
孀	xsuk
秣	tglo
蜍	nhgl
汨	lsmm
柠	uvfn
唁	jygj
舄	reoo
呶	jxcn
戗	hvdw
璎	gbbx
莜	dhlt
泸	lhnw
谟	idsc
椋	uyjm
扪	muvm
聃	fkss
辔	vdvj
逖	epit
猡	ekeo
剜	vevj
佰	hasb
掴	mkgl
绶	vwic
茁	dbll
罄	fbet
町	kftt
町	kfdd
龅	hhbn
蛀	nyss
诳	iegl
颧	djjb
嵇	takl
谩	iskc
砝	wrcf
殓	ahso
胫	acfs
螟	nisw
玖	geoj
蛭	ndrz
祛	ircq
裨	irxp
裨	irxb
赝	ahhb
氐	esod
湫	ltpw
葆	dhju
蒺	dyts
睇	kpnv
樽	upff
绦	veut
涪	lyjf
啮	jhhb
锲	qgxc
懔	oykm
囡	kxsn
蹴	pyja
篙	tyjj
葩	drbs
濯	lccy
矍	kkhc
溥	lffo
藓	dopg
铨	qhgl
盥	rlnk
黜	kobl
覃	fsxt
覃	fsxq
煅	prec
谡	ikwe
坨	rvet
淞	luwc
铤	qtct
铤	qtcd
犟	njnt
璜	gfkw
铀	qkss
驷	vske
樟	uysx
猕	enom
菠	dlxc
鱿	oavo
瘌	yfjl
诰	itjg
滂	lypy
葭	dnnc
槁	uyjj
獐	eysx
栾	yjul
饪	otls
殄	ahqw
栉	udbj
酵	ffbs
噱	jhda
醐	fxja
锉	qhhr
崧	kuwc
砧	whjz
蔗	dyfo
牦	ttsv
榷	uiys
泵	wlbb
嫱	xfkj
槊	paus
醍	fsfs
逡	cwei
赡	boaj
鎏	lycq
鸷	mees
灞	lsfa
荪	dbmo
骓	vshy
酗	fwbx
咩	jpgs
箴	tasj
哓	jdav
蚤	cnzz
罹	kohy
馍	odsc
滓	lvyx
鹗	jjgs
釉	wkss
棂	unpw
赊	bhgm
熨	ngmp
塾	yjbr
瑗	gwgc
锟	qsde
挹	mjbs
夯	cxhh
夯	cxbb
囫	keqh
诙	iapw
酡	fvet
痍	ydso
痿	ytxs
绌	vbll
莘	dyxx
莘	dyxs
殁	aecm
兕	kess
刍	onsc
奘	bfcz
獬	eoet
箸	tfsz
锷	qjjg
崴	kasx
纭	vgcy
骞	vgws
锃	qjgl
蝮	ntse
柑	ufls
秆	tglg
圉	krpg
馗	aprv
嶂	kysx
莒	djjj
膑	avrw
荟	dhgc
豢	pavo
灏	lsyb
脶	ajkw
衢	qkkg
仄	ahzz
鹘	kaes
痘	ysjp
嚯	jshy
碇	wvfs
晷	selj
渚	lfsz
碜	wccq
蛎	nadw
隍	brgl
砣	wvet
谔	ijjg
泅	lkhq
骈	vspg
懋	ucbi
仝	hfst
稔	thii
泫	lyvo
哞	jcts
乜	vmmm
诓	idgl
蓿	dvhs
桠	ufls
耒	gsol
糅	pcbu
烯	pwak
镫	qcsp
貅	wehu
猱	ecbu
犴	eglh
犴	egla
纫	vxor
褓	ihju
蕲	dpkq
偈	hsev
溧	lful
訇	eygj
媾	xgfv
榛	ugtl
郏	sbjj
葺	djfl
铩	qwus
蚨	ngwo
掾	mvav
靛	gavf
螯	gtnk
螯	gtna
耦	gkso
萋	ddxs
侩	hhgc
恽	oids
徉	qpgs
枰	uswl
鹜	cbts
褫	iqhe
琚	gnxj
蜮	ndjs
抻	mksl
襁	injn
遴	pedi
蓑	dyke
皈	rqcg
娩	xoks
虱	vwns
菟	doks
阈	udjs
觞	oetq
呖	jaxl
箝	tmfl
狎	eksl
邳	asbp
轾	ddrz
幂	isck
阡	btlq
忝	gmoo
窳	vwqq
貔	were
炅	spwo
舢	qkls
铢	qtso
糨	pnjn
髭	fcqe
抟	mgvo
沆	lyeh
铣	qtex
腩	axkg
烩	phgc
锴	qder
殚	apks
秸	tfjj
砀	wvqd
氮	tppw
孑	bsjj
愎	otse
睢	khys
逦	skki
薜	dnjx
嘞	jfkx
狴	eder
悌	opnv
猢	exja
爻	wwyy
牍	rxvc
羸	yjae
撺	mvwk
鹑	yjbs
缃	vuks
饽	ofib
嶷	ketb
蒿	dyjj
蝾	ndiu
稹	txkw
雒	ejhy
仃	hfdd
俅	hfoo
狍	eenv
梏	utjg
橐	fiwu
韪	sfgv
橹	uosl
鳕	osns
轸	dhqw
黢	koce
徜	qlkj
桎	udrz
鬣	fcqv
擢	mccy
肓	yahh
泷	lael
镏	qexk
呙	jkwo
璺	rksg
铡	qbjz
碘	wkwd
镁	qpgc
伥	htvo
珐	grcf
辂	dejl
崂	kdix
炝	phvq
祉	ihls
狲	ebmo
榔	uibl
钙	qfsv
媪	xskl
珲	gids
肛	afsg
濂	lypn
芩	dhiq
诿	itxs
镞	qytt
鼬	rcck
臬	runn
岫	kkss
氯	tnll
阆	uiso
箔	tlrv
貊	weas
澧	lksp
饨	odlv
蜇	mqnz
馄	osde
蜢	nbkl
镛	qyns
寮	vasm
蛔	nkjh
诨	iids
酊	ffdd
璁	grei
骢	vsri
砒	wdep
纛	gvkm
楸	utpw
蟊	cbnn
煲	hjup
爿	bswp
谌	ifwv
狷	ejaj
聩	fkbk
媸	xbnc
掼	mvbg
蛐	nkss
莠	dtxy
钨	qesw
镝	qypj
怼	cfio
旮	esgg
酩	fejm
韫	gskl
诟	iqsj
硭	wdyv
摈	mvrw
蚋	nkwo
赭	rrfs
絷	mevm
歃	tohs
黩	koxc
耆	fesq
闱	ugvl
嘬	jsfc
飨	vhis
茯	dhco
邴	fbbb
缛	vagf
驺	vson
訾	heyj
轱	dxjg
卅	alls
祆	igwo
鲧	oemo
甯	viks
蹉	ppgf
氨	tvxs
遒	pfiq
僭	hdds
谯	ihyo
倥	hvwf
孢	benv
嵬	krcw
誊	pygj
旯	sell
妁	xeos
岬	kksl
孛	xibs
泖	lebm
裾	inxj
榈	uujj
荚	dswo
跎	pvet
囿	kaay
悒	ojbs
檑	usks
谥	ipwk
谶	ihhh
蚺	nkss
痂	yxjj
虺	anhh
牯	txjg
镗	qlir
煨	pkdw
饴	ocjy
獾	edjy
眇	kmow
闫	ugsy
伉	hyek
祧	iwxo
胪	ahnw
啖	jppw
钴	qxjg
揆	mcgw
苻	dhfo
錾	dqqz
鼹	rccx
阒	ukco
笞	tcjc
豕	avos
耄	fets
撷	mfjb
椤	ukeo
痔	yrfo
菀	dvev
嫫	xdsc
蟋	nwio
拮	mfjj
暝	sisw
岿	kmns
阕	ucgw
滁	lbhg
弁	calb
荇	dqgl
逶	txiw
蚪	noxd
喑	jysy
蟀	nyvx
嘁	jahm
糸	vmom
茕	divx
埙	rjbx
獭	efob
觥	oele
晗	shij
蝌	ntox
俚	hkss
磔	wedu
墒	rypj
搽	mdhu
滦	lyju
姘	xpgw
湎	lakl
螫	rrtn
畹	kvev
笮	ttls
饬	otxc
菅	dvks
肱	aacg
徕	qswo
傈	hful
汞	flgg
蓐	dagf
徭	qwts
鳝	opgj
巯	cfyr
鲽	ofud
铆	qebm
剡	ppjy
剡	ppjs
猁	etjl
柚	ukss
逑	fiqq
捭	mrxb
脔	yjkh
鬈	fcqv
哙	jhgc
铂	qrvs
挈	gxmq
绻	vpvq
跹	ptix
瑷	gwic
铖	qavo
炻	pwss
癣	yopg
颢	syjb
裱	igew
蕤	dats
悱	ohhs
猞	ehgj
赅	byxh
楹	uxck
恚	rrio
潍	lvhy
衽	itls
貘	wedc
钎	qtlq
凼	lbdd
蜉	nwbs
粕	prvs
钿	qkss
涞	lswo
雩	sgvy
鲫	onbj
傩	hchy
莳	dsfo
斛	oeox
珙	gfwg
纥	vtvh
纥	vtvg
筅	ttex
胰	adso
荜	ddex
焘	gfoo
怄	odwo
栎	uelo
讴	idwo
洌	lajl
觜	heoe
瘙	ycns
唿	jeqi
缳	vkse
戕	bdwo
锝	qssf
埂	rfvo
拊	mhfo
讦	iglj
螈	narm
锌	qyxx
郗	wakb
仵	htsl
烊	ppgs
篁	trgl
搴	vgwm
獍	eyse
杷	ubsv
脍	ahgc
醴	fksp
鹂	skks
邰	cjbt
郜	tjbg
纩	vywk
堞	rfud
鹬	cbks
牝	tepp
湟	lrgl
酃	sjjb
冼	gtex
氦	tyxh
锒	qiso
篾	tkao
缦	vskc
杌	uavw
硌	wejl
硌	wejg
骝	vsek
碣	wsev
鏊	gtqa
虻	nyvm
膂	ytea
咴	japw
缟	vyjj
荞	dtrq
偬	heqi
暾	syjt
窨	vwys
鼐	xknh
帏	kgvl
洮	lwxo
胱	aleg
铉	qyvo
鲟	onfo
竦	yfvo
虢	wfhe
椽	uvav
韭	hhsj
佤	hdvo
蕨	daph
狯	ehgc
屐	nqxc
癯	ykky
鳃	okio
苌	dtvo
侔	hcts
腚	avfs
腱	ancj
圻	rqsl
痨	ydix
眙	kcjy
竽	tgly
缢	vpwk
辚	dped
尜	mcmo
趺	pgwo
茔	diry
蝰	ncrr
囹	khio
洇	lkcy
鼋	gejk
芫	dgey
赍	xhhb
宥	vaay
樘	ulir
酶	ftvo
墉	ryns
嘌	jfgm
恂	oesx
罅	thdw
镊	qfcc
椴	urec
彀	fisc
洹	lsss
盱	kglx
噻	jvgr
旄	ytts
犍	tncq
犍	tncj
庹	yfnw
欹	cfjh
珥	gfls
吡	jdep
吡	jdeb
撄	mbbx
狃	ebss
裢	idil
镙	qkvm
圩	rglx
圩	rglw
铬	qejg
馐	opgb
峄	kcgl
馏	oexk
搠	mpas
炔	pnwo
踟	ptjc
鼍	jjkk
仟	htlq
鹌	ckes
戡	fwvd
苫	dhjs
襦	isak
擀	mxsg
娈	yjxs
昃	sahz
荛	ddav
龈	hhbn
焖	puio
诤	ions
峤	ktrq
峤	ktrj
犰	eeqq
蟥	nfkw
蹼	pjpg
殳	ecss
妣	xdeb
楫	ujfl
燹	aapw
缱	vkki
厣	acks
傣	hgld
狁	ecey
帔	kxcp
锰	qbkl
圄	kfjy
痢	ytjl
嵯	kpgf
樨	unlt
纡	vgly
畲	hgmk
瘐	yrvo
腭	ajjg
瓴	hidv
蠹	fiwn
裣	ihso
郓	idby
柞	utls
砦	hewz
杼	ucbz
闼	ucit
鞒	fktr
芨	deoj
蛉	nhio
骐	vsfw
吖	jply
吖	jpla
瘿	ybbx
笳	txjj
郧	jbby
黟	koee
舛	edlc
钾	qksl
憷	ouub
稞	tkso
颏	yxhb
佚	htso
苡	dchy
勐	bkxm
淖	lhsx
澍	lfjf
勖	skxx
铰	qyww
褡	idhj
诜	ites
诜	iter
薨	dkie
濉	lkhy
檫	uvem
郇	esbx
郇	esbh
骘	bhms
凫	eeff
垭	rfls
罨	kcks
邗	gbhh
钯	qbsv
搦	mngg
荠	dywr
喁	jkso
枋	uyvw
浔	lnfo
煸	piks
矽	weox
苕	dxjt
苕	dxjs
謇	vgwj
垓	ryxh
沔	lfvv
粑	pbsv
蝓	nhsj
躅	pken
锨	qqoh
瀣	lhch
迓	diyy
杓	ueos
杓	ueob
喈	jder
烷	pvge
矾	weof
缁	vvks
蜊	ntjl
陉	bcfs
堠	rhnt
鄯	pgjb
幛	kysx
愀	otpw
瓤	yjjq
蕈	dfsx
踯	ppgb
鲵	oren
刭	cfjj
怫	onvl
罴	krco
坩	rfls
焙	pyjb
氰	tgaq
渑	ljks
疥	yhrj
肜	aqwr
厶	csss
氟	tnvl
鲰	ofcz
疟	ydsy
疟	ydsn
笫	telw
褰	vgwe
痼	ykxj
鲑	orrg
黍	thls
沭	luos
缗	vnsm
菸	dyho
悭	ojcr
疱	yenv
衿	ihij
艏	qprv
裎	ijgl
孳	pvvb
庠	ypgs
旒	ytyr
栳	ufel
茏	dael
阄	uoks
亳	yjit
艨	qdia
邛	fbqq
麂	ynde
尻	nekk
樯	ufkj
豌	sjpv
踽	prvo
鲈	ohnw
艄	qlas
鲶	ohii
眭	krrs
陂	bxcp
陂	bxcb
榉	uowg
氖	txnn
笏	teqh
廪	yykm
怛	ossd
蚍	ndep
铙	qdav
殍	awbs
泶	oilx
淝	labs
菘	duwc
蒹	dpns
忉	oxdd
桁	uqgl
疹	yhqw
蝣	nytb
喱	jaks
妊	xtls
萑	dhys
擘	njym
逋	fibb
埚	rjkw
苒	dkss
锗	qfsz
唢	jlbs
谰	iufv
歙	hsjh
焯	phsx
矬	thhr
疽	ykss
艟	qyks
趸	dpdd
蹰	pasf
荩	dnoj
縻	yuum
亍	glcc
佧	hhlk
叻	jxll
趿	peot
勰	xxxi
嘏	xjnc
桫	ulmo
侪	hywr
疴	yfjk
翥	fscc
蚝	ntsv
鲠	ofvo
雎	khys
毂	fidc
茑	desn
觚	oeqv
阋	urex
洄	lkjh
洄	lkjg
焓	phij
跗	phfo
猗	ecfj
胺	avxs
鹕	xjas
笤	txjt
跸	pdex
钬	qpwo
镪	qnjn
馕	ofie
疡	yvqy
篦	trwe
鹈	pnes
踅	mqpx
棼	uuwx
睾	rrpg
鹳	djjs
漭	ldca
烃	pcfs
瞽	fjpk
逄	edip
锍	qycr
哚	jeud
砬	wyos
蝥	cbtn
钲	qfss
陟	bhmw
耋	fedr
酮	fksj
塄	rkyv
痫	yuux
蚧	nhrj
埘	rsfo
枸	uejj
枸	uejg
柢	ueso
潆	ldim
笄	tgwl
醮	fhyo
彖	vavo
稗	trxb
窠	vwks
萘	dcgm
郯	ppbt
掮	miaq
尢	avyy
鲇	ohjn
鼙	fjpx
畦	krrq
舸	qfjg
帑	xckl
睃	kcwe
蚜	ndlw
溘	lrck
蠃	yjae
岢	kfjk
矸	wglg
鸱	eesc
狳	ehgl
祜	ixjh
囟	rwxx
扦	mtlq
枥	uaxl
庾	yrvo
菔	dabc
蟛	nfjq
嗉	jgvm
擤	mrka
莪	dtlo
觋	fhhe
醪	fccq
倬	hhsx
爰	wgcy
蚰	nkss
轳	dhnw
锱	qvks
鬻	npnp
鳏	okmw
栲	ufdk
渌	lnll
蛄	nxjg
嬗	xyks
谘	igoj
鋈	ltqw
阍	uesh
杲	sugg
柘	uwzz
毖	deio
禳	iyje
馔	onnw
鳐	owts
鳟	opff
耔	gbsz
辊	dsde
镍	qrun
侑	haay
娠	xagv
槎	upgf
芾	dfvl
豳	kaav
钤	qhiq
锕	qbfj
孥	xcbs
綦	fwvm
锑	qpnv
洙	ltso
榫	uhyx
疣	yavo
砭	wwib
筮	tfhh
酽	fflw
愆	qlgi
栀	uqsv
耪	gypy
薅	dxaf
蜞	nfwq
崤	kwaa
椟	uxvc
糁	pccq
茇	dacb
啁	jerj
氪	txje
萁	dfwq
龃	hhbk
墀	rnlt
芪	desv
莰	droh
菏	dlfj
嵊	kthe
蛩	fenq
鞯	fkdb
楂	uuss
缒	vriz
乩	hjvj
捌	mjxj
毽	tncj
愍	ntio
瘢	yqec
铋	qioo
铧	qhex
髋	kave
鹚	pvvs
儋	hoaj
奁	cdwl
樾	urhd
滹	lhdw
穑	tfkj
茌	dhfs
骶	kaes
刖	ajyy
嫜	xysx
溏	lynj
螽	eonn
囝	kbsj
戽	ioxh
橛	uaph
舂	grvs
遄	kaki
坭	rnen
澶	lyks
熵	pypj
镬	qdhc
飧	ehis
枞	uhhc
柙	uksl
硎	wgjx
缯	vpks
蔌	dfoh
鲂	oyvw
冱	gdvs
岙	tklk
岙	tkla
殂	akss
艉	qnts
蠼	nkkc
匏	cgen
痈	yesl
鹾	hkwf
尕	xmog
攮	mfie
樗	usgv
皲	idxc
髡	fcqa
坻	reso
伧	hhvc
剀	knjk
椐	unxj
瓠	cgqv
讣	ilff
髁	kaks
龉	hhbj
彘	vdte
棹	uhsx
疠	ydwl
薮	dpxt
隈	bkdw
龋	hhbr
朐	aejq
橼	uvva
芰	dxcj
圹	rywk
敉	ptwo
暌	scgw
饧	ovqx
饧	ovqt
泔	lfls
赜	dgbz
黧	teko
筚	tdex
蓖	drwe
鸬	hnes
蚬	nkex
醯	fyck
钪	qyek
餍	achi
鸹	tjes
哏	jnso
甑	pksd
疋	bsoy
疋	bsop
膣	avwr
螅	nrio
锞	qkso
髫	fcqj
宄	vegg
摭	myfo
檠	deju
盍	rckl
绂	vacf
骟	vsic
棰	utls
缡	vywk
苷	dfls
蹁	piks
铗	qswo
鞣	fkcu
圯	rnvy
涑	lfvo
箜	tvwf
芎	dnvx
芎	dnvs
蔟	dytt
觯	oepk
鍪	cbtq
镟	qytb
夤	evfw
妫	xpvo
熘	pexk
硼	waap
秫	tuos
阏	uyho
飑	ewen
啭	jdgv
枳	ujwz
礅	wyjt
耨	gagf
茭	dyww
钡	qbbb
捩	mico
柁	uvet
柁	uved
苴	dkss
铊	qvet
寤	vbfj
牖	rifv
赀	hebz
醚	fpim
柽	ucrc
栌	uhnw
肄	etns
脘	avge
酎	ffoz
鲳	ossc
柒	lduq
浠	lwak
蛳	nmfv
壅	yvhr
枇	udep
楱	uggw
焐	pfjw
秭	telw
笥	tnjs
茈	dhec
蒌	dpxs
谵	ioaj
跏	pxjj
镆	qdsc
怙	oxjh
枵	ujdx
痱	yhhs
膈	asjp
卮	qsvz
圊	kgaq
圮	rnvp
堀	rnbl
氚	trlc
皴	cwec
绐	vcjd
蟮	npgj
邡	ybff
庑	ygwv
廨	yoet
钭	qoxt
钭	qoxd
觳	fisc
闶	uyek
檗	njyu
漯	lkvm
瓿	yjdv
眚	tkss
芴	deqw
诂	ixjg
郴	uubc
鳓	ofkx
俣	hjgw
徼	qryt
桡	udav
楗	uncj
莨	diso
酰	ftex
雠	hyiy
喾	oitj
揿	mqoh
笊	tqlo
苎	dvsz
黥	koym
僳	hfps
芏	drdd
菖	dssc
蓊	dwcc
袢	ipsl
馑	ofks
卺	bsvj
垆	rhnw
旆	ytfv
曛	stoo
汊	lcoc
硒	wfvs
穰	tyje
粳	pfvo
酾	fskk
鲷	oerj
鹣	pnes
塬	rarm
曩	syje
莴	djkw
蕞	dsfc
蘖	dryu
怃	ogwv
欤	dsoh
玢	gwxf
玢	gwxb
蕖	dldu
镒	qpwk
厝	afsc
坶	rvoo
屣	nqhh
揎	mvss
榧	udhh
芑	dnvq
蓥	diqy
钣	qqcb
鬲	sjkp
鳔	ofgm
鼗	wxfc
仂	hxll
婺	cbtx
嫠	gtax
愦	okbk
癍	ygyg
癔	yysi
碓	whys
箧	tdsw
缶	tslf
蘧	dhdi
妗	xhij
幞	kjpg
沤	ldwo
痦	yfjw
蛑	ncts
詈	kygj
钚	qalo
铴	qlvq
锆	qtjg
丌	aljj
岘	kkex
枧	ukej
柰	ugmo
浜	lrwb
蓼	dccq
蛞	ntjk
鄣	ysxb
偾	hxdb
藿	dshy
酢	ftls
铟	qkcy
锛	qcxa
阊	ussc
骖	vscq
鲆	oswl
檩	uykm
燔	pwks
猓	ekso
蘼	dyuh
趵	peob
酲	fjgl
鹩	asms
乇	tvtt
屙	nbfj
揸	muss
碛	wgbq
笸	tdjp
赓	ynbg
鄄	frbj
铱	qyew
黻	jpac
伲	hnen
缂	vfks
蜣	npgs
蜩	nerj
谝	iiks
铍	qxcp
伛	hdwy
傧	hvrw
揠	mdsx
昝	elsz
溽	lagf
胙	atls
萏	dorv
隹	hyss
麈	yndy
妯	xkss
孓	bojj
溱	lgtl
碚	wyjb
蕺	djfl
锊	qwfo
镧	qufv
髀	karx
坫	rhjd
崃	kswo
戢	jflo
糌	pels
缬	vfjb
邶	hdbb
坼	rqso
梃	utct
瞢	dkik
缧	vkvm
菽	dhmc
豉	sjpc
仳	hdep
堙	rfry
忭	oylb
砷	wksl
筌	thgl
箪	tpks
艿	dxnn
郅	drbz
鲢	odil
鳎	oscc
厍	adsl
哕	jkeo
廑	yfks
敫	rytw
栊	uael
癜	ynfc
碹	wvss
磙	wywe
笾	txib
篪	tqhe
缌	vkio
苣	ddvs
荨	dnfo
诹	ifcz
诼	iavo
钒	qeof
嗍	jpas
槠	uifs
欷	wakh
淦	lqgg
甏	fjpd
胝	aeso
蓍	dfes
蛱	nswo
裉	inso
辏	dggw
颞	fccb
麸	gegw
娌	xkss
椹	ufwv
缫	vvks
翮	sjkc
诒	icjy
诒	icjp
诒	icjd
郾	dsxb
铯	qobs
锂	qkss
鞫	fkej
卣	hkvs
圬	rgvw
尥	aeol
槲	uoex
氘	trdd
瘘	ypxs
耩	ggfv
轫	dxor
迨	cjid
馓	ofat
啉	juul
圪	rtvg
泺	lelo
熳	pskc
璩	ghda
胗	ahqw
苁	dhhc
薹	dfjr
锘	qdaj
阌	uwic
鳊	oiks
唑	jhhr
溻	lscc
瘰	ykvm
砗	wdsl
砩	wnvl
羝	pges
茺	dyce
蓠	dywk
俳	hhhs
刳	cgjk
唣	jrdz
悝	okss
慊	opns
瘳	yccq
茼	dksj
麇	yndt
黾	jksv
嗾	jytt
嵛	khsj
杩	uvsm
狨	edar
狺	eygj
痧	ylmo
砜	wewf
缍	vtls
芡	dohq
蓣	dcbb
顸	gabh
槭	uahm
溲	lrcs
痤	yhhr
眄	kfvv
糍	ppvv
葚	dfwv
郐	hgcb
酹	fwfo
镢	qaph
隳	bafm
鹋	dkes
唛	jgeo
嬖	njyx
怍	otls
朊	ager
涫	lvks
绲	vsde
胼	apgw
腧	ahsj
葑	drrf
蠓	ndia
踬	pqxb
鞲	fkgf
饫	otwo
刈	wjyy
垲	rknv
嵴	kgwa
帻	kgbz
旰	sglg
畚	ccks
荭	dvfs
萸	drvo
蘩	dtvm
颃	yeab
颟	dfab
鸲	ejes
龠	hsjk
呒	jgwv
嗌	jpwk
疸	yssd
硖	wswo
绁	vflv
耧	gpxs
蚴	nvxy
蛸	nlax
蛸	nlas
裰	iccc
謦	fbej
跣	ptex
踺	pncj
逯	nlil
陔	byxh
凇	guwc
堋	raap
屦	nqpx
峁	kebm
廛	ykwr
栝	utjk
栝	utjg
磴	wcsp
篌	thnt
芘	ddep
芘	ddeb
葸	dkio
薏	dysi
踔	phsx
鄞	fkby
醢	fajk
铒	qfls
镲	qvem
鲮	orwe
仉	hezz
侉	hcgv
桄	uleg
泮	lpsl
燠	prpc
皤	rwks
粝	padw
蹀	pfud
颡	cccb
鲞	poxx
唪	jggl
嗪	jgtl
掭	mgmo
畈	kqcf
簦	tcsp
绨	vpnv
胍	aqvo
胲	ayxh
舻	qhnw
铘	qdby
锩	qpvj
鲋	ohfo
崮	kkxj
庋	yxcg
毳	ttts
箅	tkal
缣	vpns
菹	dlks
虿	dncc
谇	iyhx
贶	bjek
陧	bsrn
隰	bsvo
僬	hhyo
匦	ddeg
垧	rrjs
疔	yfdd
肭	akwo
蝤	npfv
谖	iwgc
趑	rhgh
轭	dave
酐	fglg
醅	fyjp
醑	fbax
醛	fdhg
锬	qppw
劂	apoj
垅	rael
悛	ocwe
戥	stdw
拶	mveo
硷	whso
笕	tkej
簟	tfsx
莼	dvdl
蒴	dpas
藁	dyju
诖	irrg
谠	ilie
谳	ixkc
邾	tbzz
陴	brxp
鬏	fcqp
龀	hhbe
剞	cfjj
劬	ejxq
埸	rseq
嬲	kxxx
嵝	kpxs
搿	thsm
柝	uqso
桴	uwbs
洧	laaw
浯	lfjw
疝	ykls
笱	tejg
肽	acot
舯	qksl
艋	qbkl
芤	dbvk
葙	duks
鲔	oaaw
鸸	akes
佾	hway
墁	rskc
嫘	xkvm
榇	uyuc
煳	pxja
硪	wtlo
礞	wdia
菰	dbqv
蚵	nfjk
蚵	nfjh
趱	rhtb
躜	pteb
钼	qkss
鲱	ohhs
呋	jgwo
媵	apxs
崦	kcks
楝	ufvo
潲	ltla
獯	etoo
瘵	yegm
绀	vfls
绋	vnvl
莩	dwbs
觫	oefv
辋	dkpy
镡	qfsx
髂	kavj
鬯	wbec
鹨	cchs
亓	salq
劓	rkaj
埕	rjgl
曷	sehv
洚	ledl
碲	wypk
磲	wldu
粜	bpso
绱	vlkj
芄	deow
酚	fwxf
铪	qhsj
髌	kavw
鲥	osfo
俜	hkdp
刿	kejg
吣	jioo
垤	rdrd
枘	ukwo
氽	hltt
溷	lkav
甍	dkid
笪	tssd
胬	xckh
舨	qqcb
芟	decs
蒽	dkci
銎	feqq
铵	qvxs
锶	qkio
骱	kahr
鹆	whjs
岣	kejg
岵	kxjh
怿	ocgl
慝	ddai
挢	mtrj
掎	mcfj
毹	hsat
汆	wlcc
沲	ltbv
湔	lpaj
甙	dfls
罟	kxjg
羼	npgg
菝	dmac
讵	idvs
诎	ibll
谮	idds
赉	sbll
郄	wacb
鐾	njyq
鲎	oioh
啶	jvfs
塍	aprc
屺	knvq
庥	yhux
掊	myjp
撙	mpff
柃	uhio
檎	uhyk
毵	ccqt
渖	lvks
砘	wdlv
窭	vwpx
肟	agvw
蔸	dere
蚶	nfls
蛏	ncrc
躞	ppyc
酯	fesz
锾	qwgc
饩	otsv
劢	dxmm
嘧	jvik
嵫	kpvv
擐	mkse
湓	lwxk
蝻	nxkg
蠖	ndhc
觖	oenw
跬	prrk
鳜	oaph
仡	htvy
仡	htvg
垌	rksj
氆	tpfs
氇	tosl
汔	ltvq
篼	tere
缑	vhnt
舾	qfvs
莸	deav
蛲	ndav
蠛	ndka
蠲	pwkn
褊	iiks
醣	fynj
骀	vscj
倮	hkso
僦	hyja
崾	kfxs
渫	lfux
瘗	ysry
箦	tgbz
肼	agwl
腽	askl
臁	aypn
舳	qkss
芈	hhgl
荽	dwxs
蒉	dkbk
蛴	nywr
袼	iejg
跫	fepq
遘	gfig
儇	hkse
埽	rnik
庀	yepp
戆	ysxi
扃	ikjj
搛	mpns
杪	umow
浼	loks
滏	lwwg
瓞	qtso
疃	kyks
砟	wtls
硗	wdav
禊	igxc
篥	tful
簋	tnkl
綮	itvm
苤	dasp
踣	pyjb
躐	pvkv
酴	fhgl
钽	qsst
锸	qtls
锼	qrcs
阃	ukuk
鞔	fkok
鲭	ogaq
鹪	hyos
黪	kocq
黼	jpfv
榀	ujjj
榘	tduj
浍	lhgc
炱	cjpw
煺	pnit
犋	tkwj
砻	aewl
秕	tdeb
籼	pklx
耜	gkss
肫	adlv
肷	aohq
胂	aksl
莛	dtct
裥	iusj
逭	vkih
钋	qlpp
钌	qbll
钸	qakl
髑	kakn
鳆	otse
鼯	rccj
佴	hfls
吲	jnly
帱	kgfo
搌	mnfl
擗	mnjx
桷	uoes
氡	teod
氩	tfls
溴	lrco
畋	ktwo
硐	wksj
糇	phnt
腠	aggw
葶	dyjf
袷	ihsj
陬	bfcz
黉	oifw
龆	hhbj
哜	jywr
埴	rxks
岜	kbsv
徂	qkss
惝	olkj
烀	pwwl
眢	evks
瞵	kped
筇	tfbq
簏	tyne
芗	dvwx
蝽	ngsc
蟪	nfio
郫	rxbp
钕	qxsn
钫	qyvw
镉	qsjp
镘	qskc
颥	sakb
黹	jplo
坜	raxl
埤	rrxp
埤	rrxb
楦	uvss
氙	tklx
澌	lfwq
畛	khqw
疳	yfls
瘅	ypks
砉	gwxx
砉	gwhh
砹	wdwa
碡	wgvo
穸	vweo
缵	vteb
羟	pgcf
膦	aped
菪	dvwd
虼	ntvg
蛘	npgs
螨	ndfv
裼	iseq
迕	tiww
铈	qykl
锇	qtlo
锔	qnvj
锪	qeqi
镓	qvav
镦	qyjt
镱	qysi
霪	slwt
骒	vsks
鹁	xibs
冁	pknf
哿	xjfj
噍	jhyo
埝	rhii
弪	ncfs
攉	mshy
浞	lpzz
潴	lefs
畀	kalb
籴	wpso
罱	kxkg
羰	pgkp
胨	adlo
胩	ahlk
舴	qtls
苊	dave
茆	debm
茛	dnso
蒇	dabc
虮	nejj
蠊	nypn
裒	yrew
襞	njye
觇	hjke
轺	dxjy
锿	qyje
髹	fcqu
鸫	desd
哌	jqew
垸	rvge
埏	rrcs
墼	fecr
帙	ktso
悃	okuk
揲	mfus
揲	mfud
晡	sfvo
榍	unla
榱	uyke
殪	afip
淠	lkal
漤	luux
疬	yaxl
砑	wdlw
缲	vjju
罘	kalo
苈	daxl
萆	drxb
谂	ihii
鄹	fcrb
酞	fcot
钔	quvm
铥	qtcd
镅	qbks
髟	fcqw
鲡	oskk
鲦	oeut
鳇	orgl
鹇	uues
鹱	esdc
埒	rwfo
岽	kdlo
悫	fiei
桊	pujj
桕	urvs
槔	urcx
溆	lhgc
漶	lkio
牾	tfjw
畎	kcoq
疖	ybjj
矧	tnls
稂	tiso
窀	vwdl
籀	tmek
腈	agaj
苄	dylb
薷	dsak
褙	ihea
赙	bffo
跽	pnio
钐	qqws
锖	qgaq
镎	qhsm
饔	yvhi
骣	vsnb
鳙	oyns
坌	wxrb
氍	kkht
沩	lpvo
洫	lrvs
澉	lvft
瀹	lhsk
爨	rksp
珧	gwxo
瘊	yhnt
瞍	krcs
硇	wrwn
筘	tmjk
粢	gohp
聍	fvfn
舁	raly
艚	qfsc
荸	dxib
蜱	nrxp
钍	qrtt
铞	qjkl
铫	qwxo
骺	kaqj
鲼	oxdb
劐	dhyj
哳	jmqs
唼	jyxs
忮	oxcz
恝	gxio
戋	gvoj
椠	dquq
瘕	ynnc
瘛	ygxi
瘼	ydsc
祓	iacf
窆	vwwi
窬	vwhj
篚	tdhh
粞	pfvs
羧	pgce
脬	awbs
艽	dejj
葜	dgxc
蓰	dqhh
觌	xvoe
豇	sjpf
轵	djwz
醵	fhda
铌	qnen
镄	qnbf
阼	btls
鞴	fkfk
鲅	oacb
鲒	ofjj
埯	rcks
恧	akio
憝	yjbi
搋	mqhe
氕	twpp
洳	lxjr
浈	lhbr
濞	lrka
礤	wdem
聱	gtfl
蟓	noke
襻	iuwm
趼	pgwl
迮	tizz
钆	qvgg
铷	qxjr
镨	qpfs
驵	vsks
鲣	ojcr
鳘	tvto
鸺	hues
嚆	jdyj
堍	roks
嶝	kcsp
廒	ygtw
桤	uknv
橥	efsu
爝	pwkf
甾	vkss
痄	ytls
癀	yfkw
筲	tlas
箨	tmcg
罾	kpks
耵	ffdd
舣	qowy
荬	dvoc
蕹	dyvy
诔	igso
赆	bnoj
蹯	pwks
钇	qvyy
钶	qfjk
铕	qaay
镤	qjpg
鲚	oywr
鲻	ovks
鳢	oksp
鹛	bkes
塥	rsjp
庳	yrxb
怊	oxjc
捃	mnjj
揞	mysa
洎	lrvs
涠	lkgv
滠	lfcc
猸	ebks
甓	njyd
瘃	yavo
瞀	cbtk
砼	whfs
礓	wsks
绠	vfvo
耱	gyuw
脎	awus
脒	apso
脞	ahhr
萜	dkhj
蕻	dfcw
薤	dahs
跞	pelo
轹	delo
锎	qugw
锓	qnic
馇	ouss
鲐	ocjt
鲩	ovge
仫	hwcm
垡	hdrf
垴	rywb
岍	kgwl
崞	kyjb
枨	utvo
毪	tcts
牮	hdts
癃	ybet
眍	kdwk
眵	keeo
稃	twbs
筢	tmbs
腙	avgm
舭	qdeb
菥	duqs
蜾	nkso
螬	nfsc
螵	nfgm
衄	rbss
谫	ipax
躔	pykr
郛	wbbf
酤	fxjg
钷	qdjp
锫	qyjp
镩	qvwk
阢	bavw
鼷	rccc
劁	hyoj
埭	rnso
墚	rlxu
摅	mhdi
撖	mvft
泐	lbxl
滗	ltts
牿	ttjg
犏	tiks
猹	euss
疰	yyss
痃	yyvo
痖	yfls
瘥	ypgf
磉	wccu
箢	tvev
簖	tpvq
缋	vkbh
缏	vhfv
耥	glkj
脲	anln
膪	aypj
苠	dnvv
茳	dlfs
莶	dhso
蒎	dlqe
蒡	dypy
螗	mynj
贳	fbss
軎	fjww
醌	fsde
醭	fjpg
铹	qdix
铼	qswo
镥	qosl
阽	bhjy
阽	bhjd
馘	prds
鲺	ovwn
鹎	rxes
鼽	rkae
傺	hegm
喹	jcrr
戤	xckd
攴	hcpp
瀵	lpkw
〇	vvvv
〇	vlll
乸	bvoo
佢	hdvs
佺	hhgl
係	hemo
俤	hpnv
俬	htcs
俵	hgew
個	hkxj
傢	hvav
冇	akmm
冚	iklk
冧	iuul
劼	fjxj
吋	jfoc
吔	jbvy
吤	jhrj
吤	jhrg
呣	jvoo
呯	jswl
呾	jssd
咁	jfls
咈	jnvl
咗	jafs
咥	jdrx
咥	jdrd
哋	jrbv
唓	jfvl
唞	jmox
唥	jghi
唸	jhii
啟	ijtw
啩	jrrl
啫	jfss
啰	jkeo
啱	jkwy
啲	jreo
喆	fjfj
喐	jaab
喥	jyfc
喰	jhis
喺	jhem
喼	joni
嗮	jsfv
嗰	jhkj
嗱	jhsm
嗻	jyfo
嘅	jndw
嘚	jqsf
嘢	jkcb
嘥	jqhh
噃	jwks
噉	jvft
噏	jhsc
噖	jggi
嚄	jdhc
嚟	jtel
嚤	jyum
嚿	jdhr
囉	jkvy
囍	fjpj
囖	jtky
囧	kwks
垚	rrry
垯	rcid
埗	rhmw
埲	rggl
堃	yyrk
塅	rrec
塆	ryjn
夼	crlk
奀	acff
奀	acee
妡	xqsl
妺	xglo
姤	xqsj
娒	xtvo
婥	xhsx
媇	xyuq
嫄	xarm
嫐	xkxx
嫚	xskc
嫲	xyuu
嬛	xkse
孖	bbsm
孭	bkwm
孻	bnok
尛	mmmo
尪	agls
屄	nvwb
屌	njkl
峃	oikl
彧	djso
慄	oful
慳	odcr
憇	tjfi
懞	odia
抃	mylb
抦	mfvo
抰	mkso
捽	myhx
掟	mvfs
掹	mbkl
揦	mfjl
揹	mhea
揾	mskl
搊	mebb
搕	mrck
搣	masp
搧	micc
搵	mkhk
搾	mvwt
摑	mkds
摱	mskc
撚	meco
攞	mkvy
旻	sywm
昇	stwl
昳	ktso
昽	saeo
晄	sleh
晝	nssz
晞	swak
曌	savf
曚	sdia
曱	ksly
朤	aaaa
杧	uyvm
枒	udlw
椇	ukwj
椪	upfl
楋	ufjl
槃	qecu
槑	juju
樑	ulxu
檮	ufvf
歔	hdjh
氹	vldd
沢	lnwo
湉	lotj
滘	liwj
潎	lptw
潝	lhsc
潽	lpfs
澣	lxsg
濛	ldia
炆	pyww
烜	psss
焗	pnvj
煕	dkno
燚	pppp
燿	pccy
牗	ryns
犽	edlw
猃	ehso
猄	eyjm
猺	ewtl
玘	gnvq
玡	gdlw
玥	gayy
玨	ggls
珅	gksl
珪	grrg
珮	gefv
珺	gnjj
琤	gons
琯	gvks
瑄	gvss
瑨	gfsj
瑯	gibl
瑱	gxkw
璘	gped
璟	gsym
甴	klsy
痡	yfvo
痾	ybfj
瘈	ygxc
瘖	yysy
瘭	yfgm
癐	yhss
癥	yqkt
皊	rhio
皝	rgle
皡	rrgw
盵	ktvq
眊	ktsv
眬	kael
瞓	kygr
瞭	kasm
瞶	kkkw
硚	wtrq
碁	fwwq
碥	wiks
磡	wfwx
祇	iesv
祎	igvl
祐	iajy
祐	iajs
禇	ifsc
禚	ipgo
禛	ixkw
禤	ikcc
稆	tjjl
窣	vwyx
窸	vwwi
竑	yach
筻	tfvo
箓	tnll
籂	thik
糈	pbax
紶	vrcg
纮	vach
绗	vqgl
罉	tlim
翀	ccks
翃	accc
耖	gmow
耠	ghsj
耢	gdix
聽	fgxi
肏	wkhc
脷	atjl
腍	ahii
腯	aqxk
腳	awhb
膶	angs
臑	asak
臓	adad
臜	ateb
臢	atew
舡	qfsc
艴	nobs
芃	deop
苘	dkjq
苳	deod
茚	deby
荄	dyxh
荮	dvfo
菴	dcks
萣	dvfs
萹	diks
葧	dxix
葾	devi
蒈	dder
蒗	dlis
蔹	dhst
薙	dthy
薢	doet
藸	dafs
蘗	dnju
蝲	nfjl
螆	npvv
螋	nrcs
螲	nvwr
蟅	nyfo
袆	igvl
觏	gfke
詏	ygjx
豨	awak
赇	bfoo
赕	bppw
赟	ywsb
赯	rryj
跶	pcid
踎	pajm
踭	pons
蹓	pexk
蹻	ptjj
軤	fwwl
轷	dwwl
辁	dhgl
迉	niqq
迴	kjih
遊	ytbi
遯	aaid
邨	dbcc
郃	hsjb
酏	fbvy
鎔	qvwj
鎚	qric
铑	qfel
铽	qdio
镕	qvwj
镚	qkaa
镠	qccq
隨	bafi
霑	slhj
霠	syhi
颋	tcab
餸	hipi
驙	doys
骹	kayw
髃	kaks
髎	kacq
魆	rcdv
鯡	ohhs
鲕	oakl
鲴	okxj
鳋	ocns
鴞	jdeo
鵻	eohy
鸮	jdes
鹮	ksjs
黐	thlk
黡	acko
鼢	rccx
齄	rkas
	jjkw
	vkss
	iqsl
吽	jtsl
哣	jsjp
嚫	jyue
尐	modd
屘	ntbh
揼	majk
攰	xcxg
甂	ikdo
睺	khnc
閪	kkfh
