的	dreo
了	lbbb
一	ysss
是	ssfs
不	balo
在	zarr
这	zywi
地	drbv
人	rhhh
他	thbv
我	wtlo
个	ghll
有	yaaa
你	nhom
到	ddrj
好	hxbs
得	dqsf
上	shss
道	dpri
可	kfjj
她	txbv
就	jyja
看	ktks
说	yipe
已	ynvv
来	lswo
们	mhuv
着	zpgk
么	mwcc
那	nnbb
回	hkjj
行	hqgl
和	htjj
前	qpaj
去	qrcc
而	eakl
说	sipe
见	jkee
时	ssfo
十	sxxx
天	tgwo
会	khgc
无	wgwv
为	wpvo
下	xfoo
小	xmoo
想	xuki
过	gfii
也	ybvv
眼	ykns
国	gkgl
力	lxxx
大	dccc
之	ziii
中	zksl
自	zrvs
出	cbll
都	dfsb
能	ncae
会	hhgc
年	ntsl
比	bdee
便	phfv
怕	porv
很	hqns
打	dmff
后	hqsj
奇	jcfj
情	qoga
起	qrhn
此	chee
将	jgef
如	rxjj
声	sfbs
然	reco
四	skee
定	dvfs
己	jnvv
手	smmm
金	jqqq
实	svoc
经	jvcf
同	tksj
给	jvhj
头	tocc
发	fxcc
家	jvav
方	fyvw
望	wyag
口	kjjj
心	xioo
便	bhfv
放	fytw
法	flrc
笑	xttw
成	cavo
以	ychh
两	lfvo
要	yfxs
变	byjc
因	ykcc
光	glee
果	gkso
样	yupg
利	ltjj
子	zbss
转	zdgv
再	zfvs
正	zfss
只	zjww
名	mejj
对	dcfo
没	mlec
长	ztvo
还	haii
花	hdhe
门	muvv
车	cdsl
动	dgcx
但	dhss
点	dhjo
次	cgoh
女	nxss
黑	hkoo
河	hlfj
处	cell
护	hmis
怀	hoal
电	dksv
并	bpgw
从	chhh
轻	qdcf
提	dmsf
其	qfww
将	qgef
斗	doxx
且	qkss
半	bpsl
强	qnjn
当	dlns
气	qtsv
本	bfws
亲	qyuu
进	jgii
表	bgew
日	rsss
双	sccc
件	jhts
第	dtnv
使	shfv
事	sfvl
虽	sjnn
山	skll
度	dyfc
少	smow
色	sobs
儿	eeee
身	srvw
生	stss
近	jqii
受	swic
尔	eomo
太	tcoo
间	juss
听	tjqs
被	bixc
风	feww
百	bass
铁	tqts
特	ttrf
白	brvs
交	jyww
外	well
位	whyo
开	kgwl
反	fqcc
问	wujj
完	wvge
险	xbho
宝	bvgl
西	xfvs
些	xheg
现	xgke
响	xjrj
空	kvwf
龙	laee
脸	laho
向	xrjj
行	xqgl
老	lfee
落	ldlj
种	ctks
理	lgks
里	lkss
吧	bjbs
与	ydss
用	yesl
长	ctvo
于	ygll
员	yjbb
该	giyh
由	ykss
流	llyr
边	bxii
路	lpej
兰	lpgs
越	yrhd
量	lssk
关	gpgw
爷	ywwb
李	lubs
应	yyow
意	yysi
林	luuu
至	zdrr
部	byjb
战	zhjd
作	zhtl
产	cyow
面	makl
管	gtvk
指	zmes
张	zntv
公	gwcc
目	mkss
走	zrhw
知	ztjj
高	gyjj
美	mpgc
真	zxkw
多	deeo
或	hdjs
每	mtvo
马	mvss
妹	mxgl
魔	myuc
黄	hfkw
难	nchy
弄	ngal
何	hhfj
内	nkwo
男	nkxx
话	hitj
号	hjdd
哈	hjhj
怒	nxci
南	nxkg
区	odww
冲	cgks
避	bnji
配	pfnv
海	hltv
活	hltj
品	pjjj
派	plqe
排	pmhh
拍	pmrv
跑	ppen
盘	pqkl
传	chgv
安	avxs
包	benv
破	pwxc
画	hskb
奇	qcfj
掉	dmhx
切	qdxx
取	qfcc
求	qfoo
红	hvfs
全	qhgl
毫	hyjt
胡	hxja
案	avxu
请	qiga
脚	jarb
断	dpvq
弟	dpnv
清	qlga
钱	qqgv
却	qrcb
德	dqxi
千	qtll
几	jeee
系	jemo
教	jfbt
若	rdaj
等	dtrf
让	rihs
答	dthj
静	jgan
决	jgnw
死	saee
胜	sats
吃	cjtv
帮	bgbk
集	jhyu
军	jids
剑	jhsj
叫	jjbb
记	jinv
三	sgss
什	shxx
沉	clie
界	jkhr
常	clik
具	jkww
深	sliu
势	smex
水	slll
司	snjj
接	jmyx
即	jnbb
单	spks
二	eggg
所	sqqs
急	joni
惊	joym
算	stka
持	cmrf
书	svlo
啊	ajbj
杀	swuu
兵	brww
商	sypj
通	tcki
层	cngc
替	tggs
体	thfw
调	tiej
停	thyf
团	tkfw
堂	tlir
极	jueo
机	juee
夫	fgwo
继	jvpv
佛	fhnv
究	jvwe
姐	jxks
题	tsfb
它	tvee
加	jxjj
威	wasx
布	bakl
竟	jyse
王	wgls
保	bhju
苦	kdxj
曾	cpks
非	fhhs
危	woav
往	wqys
物	wteq
微	wqkt
维	wvhy
文	wyww
胸	xaeb
习	xcss
封	frrf
萧	xdnl
副	fsjj
系	xemo
快	konw
信	xhyj
许	xits
兄	xjee
叶	xjxx
富	fvsk
消	xlla
城	crav
刻	kyxj
学	xoib
飞	fvww
府	fyhf
感	gasi
分	fwxx
星	xsts
先	xtee
相	xuks
线	xvgv
乐	lelo
留	lexk
联	lfpg
月	yaaa
友	yacc
原	yarm
各	gejj
又	yccc
称	ctom
哥	gfjj
办	bxoo
更	gfvo
共	gfww
云	ygcc
玉	yglo
另	ljxx
合	ghsj
重	ctls
呀	yjdl
业	yjos
查	cuss
叶	yjxx
拉	lmyo
源	ylam
病	byfv
灵	lnpw
异	ynal
摇	ymwt
鱼	yooo
刚	gkwj
益	ypwk
银	yqns
域	yrds
滚	glye
影	ysyq
窗	cvwe
雷	lsks
朝	cxsa
欲	ywhh
乱	ltjv
存	cabs
言	yygj
跟	gpns
左	zafs
练	lvdv
把	bmbs
著	zdfs
藏	zdad
鬼	grcc
周	zerj
者	zfss
准	zghy
专	zgvo
传	zhgv
做	zhxt
住	zhys
床	cyuu
嘴	zjhe
莫	mdsc
队	dbhh
治	zlcj
格	guej
注	zlys
找	zmdw
根	guns
命	mhsb
争	zons
吗	mjvs
足	zppp
红	gvfs
阿	abfj
最	zsfc
古	gxjj
种	ztks
民	mnvv
术	zuoo
字	zvbs
忙	moyv
董	ddtl
才	cfww
东	ddlo
明	msaa
毛	mtsv
模	mudc
木	muuu
密	mvik
买	mvoc
忽	heqi
码	mwvs
妈	mxvs
蛮	myjn
昏	hess
麻	myuu
脑	nayb
带	dfik
魂	hgcc
聂	nfcc
凝	ngeb
化	hhee
倒	dhdj
伙	hhpw
合	hhsj
毒	dgvo
扭	nmbs
代	dhdo
低	dhes
聪	cfpi
喊	hjaj
呵	hjfj
调	diej
纳	nvkw
宁	nvff
呼	hjww
娘	nxis
欧	odwh
朋	paaa
否	pajj
汉	hlcc
洪	hlfw
汗	hlgl
浑	hlid
飘	pfgw
佩	phef
混	hlse
湖	hlxa
评	pisw
挥	hmid
换	hmok
哎	ajdw
漂	plfm
盯	dkff
扑	pmll
恢	hoap
劈	pnjx
普	ppfs
判	ppjj
仇	chee
典	dkww
片	prsv
暴	psfl
平	pswl
火	hpwo
淡	dlpp
坏	hral
皇	hrgl
皮	pxcc
丛	chhs
赫	hrrr
抵	dmes
七	qddd
催	chky
挡	dmln
按	amvx
区	qdww
促	chpp
巧	qfdd
宏	hvac
害	hvgj
青	qgaa
秦	qgtl
乎	hwwl
缓	hvwc
诚	ciav
韩	hxsg
谦	qipn
豪	hyja
痕	hyns
瞧	qkho
曲	qkss
器	qjjj
潜	qlgs
际	jbgm
阶	jbhr
单	dpks
劲	jcfx
悄	qola
警	jdej
节	jdbb
敬	jdet
荆	jdgj
待	dqrf
车	jdsl
叱	cjee
缺	qtnw
备	beks
巨	jdvs
桥	qutr
九	jeee
段	drec
确	qwoe
弃	qyca
及	jeoo
聚	jfcw
柔	rcbu
软	rdoh
基	jfwr
仍	rhxx
任	rhtl
肉	rkhh
热	rmeo
弱	rngg
吹	cjoh
般	bqec
绕	rvda
今	jhii
入	rwww
盛	sakl
借	jhfs
孙	sbmo
随	sbai
圣	scrr
式	sdfs
输	sdhj
苏	sdxo
狮	semf
散	sfat
速	sfii
斯	sfwq
计	jixx
似	shch
紧	jjcm
坚	jjcr
伤	shtx
设	siec
神	siks
诉	siqs
尝	clic
睛	jkga
爱	awic
巾	jkll
刀	dxxx
思	skio
睡	sktl
渐	jldq
酒	jlfv
江	jlfs
湿	slsj
激	jlrt
济	jlyr
师	smfv
折	smqs
帝	dypk
属	snrv
耳	efls
技	jmxc
建	jncc
恶	efio
首	sprv
数	spxt
强	jnjn
射	srfo
觉	joie
哦	ejtl
居	jnxj
举	jowg
稍	stla
失	stso
闪	suhh
松	suwc
守	svfo
术	suoo
宋	svuu
卷	jpvv
丝	svvs
石	swww
索	sxim
否	fajj
市	sykl
施	sytb
脱	tape
套	tcfc
台	tcjj
奋	fcks
景	jsym
季	jtbs
积	jtjw
条	teuu
步	bhmw
箭	jtpj
背	bhea
叹	tjcc
谈	tipp
凤	fecc
北	bhee
逼	bsji
辈	bhhd
凡	feoo
禁	juum
提	tmsf
结	jvfj
绝	jvob
纪	jvnv
悲	bhhi
骑	jvsj
跳	tpwx
徒	tqrh
秘	btio
土	trrr
拜	btgs
堡	bhjr
房	fiyv
娇	jxtr
福	fisk
突	tvwc
统	tvye
痛	tyck
迹	jyri
唐	tynj
卫	wbss
薇	wdqt
峰	fkeg
务	wexx
恶	wfio
万	wdww
伟	whgv
单	cpks
考	kfdd
围	wkgv
网	wkww
杯	bual
温	wlsk
况	kgje
尾	wnts
倍	bhyj
卡	khll
错	cqfs
呵	kjfj
武	wsdh
饭	foqc
闻	wufl
困	kkuu
愤	foxb
忘	wyio
费	fnbb
雄	xacy
胁	xaxo
烦	fpab
控	kmvf
扩	kmyw
抗	kmye
薛	xdrx
彻	cqdx
标	bugm
项	xfab
复	ftse
喜	xfjj
型	xgjr
形	xgqw
修	xhlq
像	xhoe
袖	xiks
谢	xirf
讯	xivx
靠	ktjh
吁	xjgl
纷	fvwx
县	xkcc
宾	bvrw
宽	kvde
客	kvej
砍	kwoh
克	kxje
寻	xnfo
遍	biki
场	crvq
象	xoke
性	xots
兴	xoww
烈	lajo
须	xqab
八	bwww
陆	lbgl
臭	xrco
息	xrio
需	xsak
显	xsjo
必	bioo
连	ldii
孤	gbqv
巴	bbsv
闲	xuuu
校	xuyw
细	xvks
观	gcke
希	xwak
悉	xwio
献	xxkc
席	xyfk
够	geje
冷	lghi
句	gejj
凌	lgre
愿	yari
阴	ybaa
隐	yboi
阳	ybss
别	bjxj
领	lhib
鸦	ydes
营	ydij
歌	gfjh
英	ydks
论	lihe
良	liso
礼	livv
乐	yelo
怨	yevi
燕	yfjo
工	gfss
功	gfxx
罗	lkeo
临	ljtk
优	yhav
余	yhgl
伊	yhns
依	yhye
语	yifj
干	ggll
估	ghxj
浪	llis
吟	yjhi
洛	llej
泪	llks
咬	yjyw
野	ykcb
遇	ykii
楚	cuub
暗	asys
幽	ykvv
沿	ylej
油	ylks
演	ylvw
游	ylyb
骨	gkaa
扬	ymvq
尉	yngf
怜	lohi
引	ynll
忧	yoav
鲁	loss
义	yoww
类	lpcc
焰	ypor
跃	yptw
烂	lppg
料	lpox
铃	lqhi
律	lqns
岳	yrkl
邀	yryi
映	ysks
易	yseq
缠	cvyk
挂	gmrr
阎	yuor
杨	yuvq
约	yveo
露	lspj
缘	yvva
研	ywgw
遥	ywti
改	gntw
妖	yxtw
柳	lueb
衣	yyew
夜	yyhe
颜	yyqb
怪	gocr
采	cwuu
穿	cvwd
丈	zaoo
脏	zayr
绿	lvnl
阵	zbds
牢	lvts
盛	cakl
瓜	gqvo
斩	zdqs
赶	grhg
充	cyce
波	blxc
杂	zeuu
财	cbfw
离	lywk
责	zgbb
装	zgfe
珠	zgts
侧	zhbj
六	lyww
众	zhhh
陈	cbdl
立	lyos
证	zifs
识	zijw
诈	zitl
矛	mcbw
蒙	mdia
咱	zjrv
茫	mdly
苗	mdks
奔	bcxa
罪	zkhh
置	zkxk
助	zkxx
掌	zlim
猛	mebk
某	mfuu
参	cccq
执	zmeo
抓	zmql
承	cbvw
招	zmxj
属	znrv
展	znfl
藏	cdad
抱	bmen
报	bmbc
总	zpji
曾	zpks
州	zpuu
默	mkoc
官	gvks
爪	zqlo
质	zqxb
满	mldf
给	gvhj
照	zsxo
故	gxjt
怎	ztio
重	ztls
乾	gxst
栈	zugv
查	zuss
荡	ddlq
慢	mosc
终	zveo
组	zvks
米	mpso
砸	zwdk
铭	mqej
支	zxcc
直	zxks
站	zyhj
庄	zyrr
主	zyss
秘	mtio
轰	hdcc
岛	dekl
获	hdec
草	cdsx
梅	mutv
梦	muue
雕	dery
划	hdjj
缈	mvkm
互	hdvs
母	mvoo
貌	mwee
荒	hdyr
媒	mxfu
狠	hens
顶	dfab
扳	bmqc
搬	bmqc
盲	myks
麽	myuc
摩	myum
耐	nakf
惠	hfio
猜	cega
环	hgal
匿	nddj
冻	dgdl
鸟	ness
狞	nevf
囊	nfie
耗	hgts
虐	nhdd
虎	hhde
拿	nhsm
华	hhex
含	hhij
盗	dgok
袋	dhde
候	hhlt
呢	njne
浓	nliw
泥	nlne
拟	nmch
扈	hijb
播	bmwk
户	hisw
尼	nnee
耻	cfhl
恼	noyb
逆	npii
钮	nqbs
吼	hjbv
褡	didj
昵	nsne
暖	nswc
呵	ajfj
喉	hjht
嘿	hjko
奴	nxcc
读	dixc
喝	hjsv
娜	nxnb
哼	hjyb
咳	hjyh
臂	bnja
偶	ohks
患	hkio
哦	ojtl
胖	paps
脾	parx
膀	payy
陪	pbyj
匹	pdee
矮	attx
叮	djff
嘟	djfb
璧	bnjg
票	pfgm
滑	hlka
琶	pggb
珀	pgrv
冯	pgvs
偏	phik
堡	phjr
凭	phte
呆	djuu
谱	pips
咆	pjen
瞪	dkcp
啪	pjmr
喷	pjxb
帕	pkrv
泡	plen
盼	pkwx
浦	plfv
虹	hnfs
弧	hnqv
潘	plwk
批	pmde
婆	plxx
迪	dkii
屁	pnde
怖	boak
屏	pnpg
鼎	dknh
恨	hons
悔	hotv
叛	ppqc
爬	pqbs
侧	chbj
焓	hphj
彷	pqyv
煌	hprg
牌	prrx
沌	dldl
糊	hpxa
洞	dlkj
篷	ptei
党	dlie
衡	hqog
朴	pull
屏	bnpg
骗	pvsk
航	hqye
碰	pwpf
番	pwks
毁	hrfc
庞	pyae
痞	pyaj
熬	agto
疲	pyxc
戚	qahm
鲍	boen
滴	dlyj
劝	qcxx
旁	pypy
擎	qdem
茜	qdfv
抖	dmox
秽	htke
篁	htrg
偿	chlc
横	hufw
担	dmss
卿	qenb
桓	huss
殿	dnfc
蝶	dnfu
壳	qfie
勤	qfkx
寒	hvgo
期	qfwa
凄	qgdx
球	qgfo
骇	hvsh
倾	qhdb
幻	hvvv
仇	qhee
企	qhhl
卡	qhll
歧	qhxc
贺	hxjb
婚	hxes
启	qijj
谴	qiki
裙	qinj
蹬	dpcp
亨	hyjb
衬	cifo
嵌	qkfh
肌	jaee
峭	qkla
黔	qkoi
灯	dpff
岐	qkxc
递	dpni
词	cinj
汽	qlts
炮	bpen
降	jbed
屈	qnbl
祠	cinj
群	qnjg
踱	dpyc
钝	dqdl
禅	cipk
恰	qohj
鸡	jces
戒	jdal
钉	dqff
拳	qpmm
蹊	qpwc
券	qpxx
爆	bpsl
菁	jdga
蒋	jdgf
初	cixx
墙	qrfj
泉	qrll
晴	qsga
舵	dqve
稽	qtas
匠	jdqs
签	qtho
秋	qtpw
权	qucc
棋	qufw
枪	quhv
逞	cjgi
绮	qvcj
缉	qvjf
较	jdyw
纤	qvtl
穷	qvwx
久	jeoo
句	jejj
庆	qycc
敲	qyjc
齐	qywr
辱	ragf
阮	rbge
堆	drhy
呈	cjgl
荣	rdiu
逗	dsji
嘉	jfjj
鞠	jfkp
瑞	rgkk
儒	rhsk
救	jftw
认	rihh
晋	jfss
减	jgaj
旦	dsss
润	rlug
丢	dtcc
瑾	jgfk
饶	roda
燃	rpeo
锐	rqpe
击	jgll
嘲	cjxa
嗔	cjxw
净	jgon
敌	dtjt
容	rvwj
厦	saae
俊	jhce
腮	saki
耍	sakx
殊	sats
殖	saxk
短	dtsp
价	jhhr
假	jhnc
收	sbtw
佳	jhrr
参	sccq
萨	sdby
杜	durr
伽	jhxj
莎	sdlm
黜	ckob
岸	akag
隽	jhyx
缎	dvrc
崇	ckvm
肩	jiaa
酸	sfce
讲	jigw
士	sfss
世	sflv
寿	sgfo
示	sgmo
素	sgvm
石	dwww
耸	shhf
伸	shks
叔	shmc
侍	shrf
俞	shsj
测	clbj
扇	sicc
试	sidf
识	sijw
谁	sihy
池	clbv
社	sirr
唆	sjce
嗓	sjcu
嘶	sjfq
颠	dxkb
哨	sjla
戴	dxdw
噬	sjth
沧	clhv
墅	skcr
岁	skeo
且	jkss
申	sksl
史	skso
瞬	skwd
敦	dyjt
赏	slib
端	dykk
尚	slkj
彼	bqxc
沙	slmo
津	jlns
镔	bqvw
涩	slxh
旧	jlss
撒	smft
尖	jmcc
损	smjb
阿	ebfj
捡	jmho
授	smwc
摔	smyx
尿	snll
蛇	snve
尸	snww
揭	jmsv
慑	sofc
挤	jmyr
据	jmnj
鼻	brka
既	jndw
措	cmfs
烧	spda
君	jnjj
送	spgi
扯	cmhl
锁	sqlb
尽	jnoo
局	jnvj
剧	jnxj
蛟	jnyw
恩	ekci
解	joet
晒	ssfv
碧	bgrw
私	stcc
剩	sthj
舌	stjj
适	stji
版	brqc
税	stpe
精	jpga
树	sucf
搓	cmpf
距	jpdv
姜	jpgx
森	suuu
室	svdr
赛	svgb
绅	svks
审	svks
兼	jpns
缩	svvs
插	cmtl
绍	svxj
硕	swab
释	swcg
服	fabc
始	sxcj
额	eveb
召	sxjj
擦	cmvm
脯	fafv
街	jqrg
熟	syjo
腹	fate
呆	ajuu
镜	jqye
厅	taff
陶	tbet
腾	taps
防	fbyv
态	tcio
颊	jsab
卑	brxx
夹	jswo
晶	jsss
芙	fdgw
筋	jtax
蜍	cnhg
矩	jtdv
霸	bsfa
迟	cnii
菲	fdhh
偷	thhj
贪	thib
黯	akos
暴	bsfl
范	fdlv
褪	tini
简	jtus
饕	tjdi
吐	tjrr
尺	cnwo
惨	cocq
检	juho
图	tkeo
瞳	tkyk
涛	tlgf
杰	juoo
犯	fevv
覆	ffqe
触	coen
甫	ffvo
投	tmec
推	tmhy
级	jveo
托	tmtv
绩	jvgb
丰	fgsl
退	tnii
兔	toks
伏	fhco
恬	totj
踏	tpls
傅	fhff
踢	tpsq
笨	btfw
铜	tqkj
窖	jvwj
绞	jvyw
爵	jwkf
塔	trdj
躺	trlj
付	fhfo
截	jxdy
坦	trss
霆	tstc
廷	ttcc
筒	ttkj
透	ttxi
架	jxju
仿	fhyv
桃	tuwx
嫁	jxva
疚	jyeo
驼	tvse
靖	jyga
份	fhwx
京	jyjm
疼	tyeo
庭	tytc
歪	wafs
疾	jyts
咐	fjhf
剂	jywj
郊	jywb
卧	wdll
吩	fjwx
瓦	wdvo
笔	btts
孔	kbvv
差	cpgf
巫	wfhh
玩	wgge
未	wglo
五	wfvs
伍	whfv
伪	whpv
狂	kegl
谓	wika
味	wjgl
浮	flwb
遗	wkbi
恐	kfei
泛	flwi
粗	cpks
伴	bhps
扶	fmgw
伯	bhrv
抚	fmgw
握	wmnr
肯	khaa
蜂	fneg
慰	wngi
悟	wofj
惘	woky
蝠	fnsk
课	kiks
弗	fnvl
裤	kiyd
雾	wsex
旺	wsgl
负	fobb
晚	wsok
委	wtxs
板	buqc
棒	bugg
宛	wvev
颗	kkab
纹	wvyw
碗	wwvv
娃	wxrr
膀	bayy
闭	bufw
凯	kkne
亡	wyvv
粉	fpwx
夏	xake
柏	burv
膝	xaul
降	xbed
限	xbns
戏	xcdw
邪	xdbb
轩	xdgl
彷	fqyv
恳	knio
熙	xdno
赴	frhl
绑	bvgb
蓄	xdyk
惩	cqfi
夕	xeoo
愧	korc
跨	kpcg
孝	xfbs
烤	kpfd
船	cqej
醒	xfst
巷	xfwn
刑	xgjj
枫	fuew
璇	xgyb
虚	xhdj
繁	ftvm
仙	xhkl
堪	krfv
休	xhuu
昆	ksde
询	xies
祥	xipg
科	ktox
陛	bbdr
贤	xjcb
块	krnw
适	ktji
俺	ahck
嚣	xjjj
柯	kufj
啸	xjnl
悬	xkci
斥	cqso
肖	xlaa
削	xlaj
泄	xlfl
寇	kvgc
翻	fwkc
洗	xlte
铳	cqye
溪	xlwc
番	fwks
省	xmks
库	kyds
屑	xnla
斧	fwwq
康	kyns
弦	xnyv
解	xoet
父	fwww
鲜	xopg
悻	xorg
豹	bwee
列	lajj
疯	fyew
补	bill
腐	fyhh
券	xpxx
历	laxx
股	gaec
欣	xqoh
隆	lbet
川	crll
碑	bwrx
胳	gaej
陵	lbre
血	xrvs
轮	ldhe
晓	xsda
赤	crrw
雪	xsns
爸	bwwb
选	xtei
劳	ldix
香	xtss
隔	gbsp
朽	xudd
秀	xtxx
莱	ldsw
矜	gcbi
析	xuqs
颈	gcfb
绪	xvfs
策	ctfv
宣	xvss
纤	xvtl
狼	leis
迅	xvxi
续	xvxc
聆	lfhi
剌	lfjj
赖	lfob
葛	gdsv
协	xxxo
姓	xxts
襄	xyje
旋	xytb
弄	lgal
新	xyuq
勾	gecc
琅	lgis
腰	yafx
雁	yahy
凉	lgym
右	yajj
例	lhaj
尤	yavo
陶	ybet
虑	lhdi
程	ctjg
预	ycbb
羽	yccs
令	lhio
勇	yckx
尧	ydav
芽	yddl
颅	lhnb
卢	lhnw
雅	ydhy
敛	lhst
茵	ydkc
牙	ydlw
辕	ydre
革	gfks
药	ydve
艺	ydvv
艾	ydww
印	yebb
谅	liym
甘	gfls
攻	gftw
辨	byax
耶	yfbb
焉	yfdo
恭	gfwm
雨	yfvo
亚	yfls
运	ygci
远	ygei
览	ljte
规	ggke
艳	ygob
材	cufw
倚	yhcj
虞	yhdg
略	lkej
供	ghfw
仪	yhow
愈	yhsi
岭	lkhi
亿	yhvv
讶	yidl
累	lkvm
议	yiow
永	yivo
谣	yiwt
裕	yiwj
溜	llek
哑	yjfl
吁	yjgl
喻	yjhj
咽	yjkc
冠	gigf
漏	llnf
庇	byde
澜	lluf
遗	ykbi
梁	llxu
淋	lluu
鸭	ykes
园	ykge
愚	ykio
圆	ykjb
曰	ykss
央	ykso
岩	ykww
涌	ylck
耀	yley
湮	ylfr
泳	yliv
搂	lmpx
掠	lmym
洋	ylpg
液	ylye
掩	ymck
拥	ymes
录	lnll
援	ymwc
察	cvem
痹	byka
蝇	ynjk
纯	cvdl
懒	lofb
尹	ynsw
蛇	ynve
宠	cvae
愉	yohj
愣	loky
逸	yoki
炼	lpdv
贵	gkbb
固	gkxj
烟	ypkc
丫	ypll
炎	yppw
港	glfn
灌	gldy
驰	cvsb
衍	yqlg
粒	lpyo
御	yqtb
汩	glks
瘪	byre
链	lqdi
延	yrcc
斌	bywh
锣	lqke
臾	yrvo
禹	yrvo
拱	gmfw
厂	caaa
拐	gmjx
移	ytee
氧	ytpg
筠	ytrg
椅	yucj
括	gmtj
雳	lsax
阅	yupe
杳	yuss
零	lshi
归	gmns
宇	yvgl
宜	yvks
丽	lskk
笼	ltae
窑	yvwt
黎	ltel
硬	ywfv
砚	ywke
弓	gnvv
胤	ywvv
盈	yxck
娅	yxfl
嫣	yxfo
姚	yxwx
残	cagv
毅	yyec
唇	cagj
辰	cagv
鹰	yyhs
惯	govb
奕	yyrc
亦	yyrw
音	yyss
雍	yyvy
栏	lupg
麓	luue
楼	lupx
肿	zaks
逐	zaii
胀	zatv
裁	cxde
贼	zbda
坠	zbhr
阻	zbks
则	zbjj
骆	lvsj
障	zbyx
蒸	zdbo
钢	gqkw
帘	lvwk
芝	zdii
轴	zdks
泊	blrv
暂	zdqs
致	zdrt
辎	zdvk
猪	zefs
厨	casf
氏	zesv
脆	caov
酌	zfeo
廊	lyib
遭	zfsi
志	zfio
整	zftf
恋	lyji
状	zgco
资	zgob
姿	zgox
颤	cykb
鹿	lyne
仔	zhbs
廉	lypn
肠	cavq
紫	zhem
亮	lyje
告	gtjj
桌	zhsu
止	zhls
除	cbhg
衰	cyke
篝	gtgf
诸	zifs
毕	bdex
眉	mbks
蟊	mcbn
诛	zits
赐	cbsq
刮	gtjj
茅	mdcb
咒	zjje
嘱	zjnr
痴	cytj
咋	zjtl
嘲	zjxa
胄	zkaa
萌	mdsa
构	guec
慕	mdsm
阁	guej
睁	zkon
帐	zktv
胆	dass
芒	mdyv
滞	zlfk
湛	zlfv
肚	darr
丑	cbss
洲	zlpu
汁	zlxx
振	zmag
择	zmcg
概	gund
棍	guse
玛	mgvs
末	mglo
挣	zmon
折	zmqs
翠	cccx
扎	zmvv
撞	zmyk
贯	gvbb
蛋	dbnn
冥	misw
喵	mjdk
鸣	mjes
骂	mjjs
嘿	mjko
咪	mjps
尊	zpff
敢	gvft
宫	gvjj
眸	mkct
瞒	mkdf
夺	dcfo
炸	zptl
踪	zpvm
眠	mknv
征	zqfs
锥	zqhy
钟	zqks
铮	zqon
舟	zqvo
奥	arpc
谷	gwhj
追	zrii
达	dcii
渺	mlkm
震	zsag
顿	ddab
赞	zteb
筑	ztfe
稚	zthy
早	zsxx
制	ztjj
乍	ztls
朱	ztso
秩	ztts
杖	zuao
栅	zuew
椎	zuhy
枕	zuiw
姑	gxxj
郭	gyjb
枝	zuxc
勉	mokx
柱	zuys
广	gyww
免	moks
迷	mpii
茶	cdhu
骤	zvsr
驻	zvsy
窒	zvwr
宰	zvyx
砖	zwgv
锚	mqdk
灰	hapw
厚	hasb
朝	zxsa
遮	zyfi
孩	hbyh
座	zyhr
衷	zyke
冒	msks
章	zysx
族	zytt
瘴	zyyx
邸	debb
秒	mtmo
薄	bdlf
甸	deks
牧	mttw
臣	cdll
昂	aseb
冬	deoo
闷	muio
闽	munn
枚	mutw
丹	deos
独	denn
闵	muyw
缅	mvak
兜	dere
蜜	mvin
宓	mvio
糸	mvmo
鸟	dess
绵	mvrk
葫	hdxa
朵	deuu
硭	mwdy
剁	deuj
摒	bmng
媚	mxbk
姥	mxfe
猴	heht
妙	mxmo
猾	heka
卖	mxvc
摆	bmkc
嬷	mxyc
袤	myce
凰	herg
庙	myks
麋	mynp
氓	mynv
耽	dfiw
靡	myuh
酣	hffl
磨	myuw
鬟	hfce
腻	nadb
蔟	cdyt
鞑	dfki
巷	hfwn
陧	nbsr
靛	dgaf
奈	ncgm
摈	bmvw
醐	hfxa
孽	ndrb
冱	hgdv
璜	hgfw
慧	hggi
玎	dgff
袅	neye
酿	nfis
廿	nfls
玷	dghj
瑚	hgxa
瑙	ngvw
琥	hghe
匆	ceqo
扮	bmwx
您	nhoi
念	nhii
诺	nidj
唉	ajct
颔	hhib
农	niwo
壑	hhir
猖	cess
扒	bmww
侯	hhnt
哪	njnb
咛	njvf
黛	dhdo
喃	njxg
谎	hidr
拨	bmxc
册	cews
涅	nlsr
讳	higv
挠	nmda
傣	dhgl
捻	nmhi
挪	nmnb
捏	nmsr
拧	nmvf
祸	hijk
督	dhmk
诲	hitv
罕	hiwg
怩	none
鲵	nore
懦	nosk
粘	nphj
鹤	hiys
弼	bnan
镊	nqfc
钠	nqkw
镍	nqru
诒	dicj
坭	nrne
嗬	hjdj
赧	nrrc
寸	cfoo
哄	hjfw
吓	hjfo
唬	hjhe
楠	nuxg
哗	hjhx
订	diff
闹	nuyk
妞	nxbs
祷	digf
唤	hjok
弩	nxcn
嫩	nxft
努	nxcx
蚌	bngs
妮	nxne
奶	nxxx
乃	nxxx
谛	diyk
骸	hkah
鸥	odws
醇	cfyb
哒	djci
喔	ojnr
噢	ojrc
怄	oodw
咄	djbl
鹏	paas
吨	djdl
凑	cggg
嗒	djdj
丕	pass
涵	hlbb
哆	djee
璨	cghp
辉	hled
匏	pcgn
鸿	hlfs
蓬	pdei
潢	hlfw
琛	cgiu
萍	pdls
苹	pdsw
淮	hlhy
喋	djfu
沪	hlis
璀	cgky
吊	djkl
溃	hlkb
彭	pfjq
耙	pgbs
涸	hlkj
璞	pgjg
泓	hlnc
耪	pgyy
啖	djpp
裴	phhe
浩	hltj
涣	hlok
仆	phll
僻	phnx
壁	bnjr
袍	pien
翩	pikc
瀚	hlxc
蚕	cgnn
濠	hlya
呸	pjas
嘭	pjfq
噗	pjjg
撼	hmai
啤	pjrx
叨	djxx
瞟	pkfm
圃	pkfv
畔	pkps
睥	pkrx
弘	hncc
溥	plff
沛	plfv
虾	hnfo
蚶	hnfl
舂	cgrv
蠢	cgsn
湃	pltg
瀑	plsl
泼	plxc
拚	pmca
抛	pmex
餐	chci
憾	hoai
拼	pmpg
慌	hodr
披	pmxc
町	dkff
惚	hoei
鲎	hoio
譬	pnjj
恍	hole
匕	beee
雌	chdy
怦	posw
惶	horg
春	cgss
悍	hosg
瓶	ppgd
恒	hoss
瞥	pptk
睇	dkpn
磐	pqew
辟	bnjx
铺	pqfv
钋	pqll
铍	pqxc
焕	hpok
剥	bnlj
焊	hpsg
乓	proo
澄	dlcp
迫	prii
坪	prsw
乒	prww
坡	prxc
培	pryj
侈	chee
稽	ptas
牝	ptee
徊	hqkj
篇	ptik
繁	ptvm
柴	cheu
杷	pubs
徨	hqrg
逅	hqsi
攀	puwm
後	hqve
骈	pvsg
饱	boen
砒	pwde
镐	hqyj
渡	dlyc
贫	pwxb
盆	pwxk
颇	pxcb
齿	chhb
妃	pxnv
媲	pxre
郝	hrrb
龊	chhp
庖	pyen
剖	pyjj
皓	hrtj
蔼	adiv
储	chis
昊	hsgw
腔	qavf
脐	qayr
亟	qbjs
晖	hsid
垫	dmer
搭	dmdj
牵	qcit
翘	qdac
晃	hsle
颢	hsyb
萋	qddx
簧	htfw
蔷	qdfj
鳔	bofm
荃	qdhg
掸	dmpk
禾	htlo
蕖	qdlu
氦	htyh
闳	huac
芹	qdqs
芊	qdtl
惫	beki
茄	qdxj
妻	qdxs
犰	qeee
槐	hurc
阖	hurk
伺	chnj
杭	huye
核	huyh
阂	huyh
逮	dnii
耆	qfes
刁	dnnn
憨	hvfi
鞘	qfka
创	chvj
导	dnfo
欺	qfwh
弹	dnpk
裘	qfye
绘	hvhc
傲	ahgt
琴	qggi
璩	qgha
契	qgxc
嗷	ajgt
琼	qgym
悼	dohx
觑	qhde
仓	chvv
倩	qhga
惮	dopk
俏	qhla
懂	dodt
卉	hxal
侨	qhtr
跋	bpac
禽	qhyk
祁	qibb
惦	doyj
祺	qifw
谯	qiho
翰	hxsc
诮	qila
飚	bewp
祈	qiqs
祛	qirc
讫	qitv
咭	qjfj
噙	qjhk
跺	dpeu
褚	cifs
崎	qkcj
麾	hyut
奠	dpfc
殛	jabs
遣	qkki
瞿	qkky
鳌	agto
黢	qkoe
郸	dpkb
戛	jakd
圈	qkpv
峤	qktr
腱	janc
厥	japh
渠	qldu
蹲	dppf
浅	qlgv
歼	jatl
沁	qlio
漆	qlul
泣	qlyo
抢	qmhv
贱	jbgv
扦	qmtl
跌	dpts
亟	jbjs
螓	qngt
蹈	dpwr
蛆	qnks
蛐	qnks
蜷	qnpv
虬	qnvv
谄	cior
惬	qods
迳	jcfi
铎	dqcg
欠	qohh
艰	jcns
颈	jcfb
炳	bpfv
钓	dqeo
迸	bpgi
荐	jdab
褫	ciqe
歉	qpnh
糗	qprc
茎	jdcf
铛	dqln
铅	qqej
锲	qqgc
皆	jder
昶	ciss
锻	dqrc
鬓	bfcw
钦	qqoh
蕉	jdho
诧	civt
躯	qrdw
趣	qrhc
嗤	cjbn
趋	qrhn
苋	jdke
丘	qrss
菌	jdkt
箧	qtds
箐	qtga
茧	jdnn
锭	dqvf
憩	qtji
啜	cjcc
迁	qtii
盾	dqxk
乔	qtrr
轿	jdtr
阕	qucg
碍	awsf
樵	quho
茄	jdxj
阒	qukc
杞	qunv
阙	quph
獗	jeah
寝	qvgc
骞	qvgs
桀	jedu
绻	qvpv
骑	qvsj
驱	qvsw
窍	qvwd
祭	jegm
鸲	jejs
狙	jeks
弊	bpta
喘	cjkk
塔	drdj
鳖	bpto
吵	cjmo
痊	qyhg
麒	qynw
旗	qytw
躲	dreu
妾	qyxs
贾	jfbb
牒	drfu
孺	rbsk
戎	rdaa
惹	rdai
棘	jffv
茸	rdfl
荏	rdht
蕊	rdii
颉	jfjb
芮	rdkw
茹	rdxj
蓉	rdvj
觐	jfke
髯	rfck
偌	rhdj
仁	rhgg
墩	dryt
睿	rhik
戬	jfsd
褥	riaf
吉	jfjj
堤	drsf
柬	jfvo
敝	bptw
嚷	rjye
鞭	bfkf
染	rleu
奖	jgec
玑	jgee
汝	rlxs
扰	rmav
唱	cjss
玖	jgeo
攘	rmye
桨	jgeu
蠕	rnsk
糅	rpcu
熔	rpvj
喳	cjus
嚓	cjvm
壤	rrye
融	rsjn
箬	rtdj
靶	bfkb
钹	bqac
闰	rugl
榕	ruvj
笛	dtks
纫	rvxo
仅	jhcc
井	jgwl
忍	rxio
瓤	ryjq
侥	jhda
遽	jhdi
厮	safq
氘	dtrr
笃	dtvs
佶	jhfj
戍	saoo
殇	satq
冀	jhew
豕	savo
俭	jhho
畴	ckgf
祟	sbgm
栋	dudl
隧	sbpi
稻	dtwr
疏	sbyr
厶	sccc
健	jhnc
棣	duns
桑	sccu
爽	scww
倦	jhpv
僵	jhss
档	duln
椴	durc
介	jhrr
椟	duxc
蒜	sdgm
伎	jhxc
芎	sdnv
莳	sdsf
菘	sduc
焦	jhyo
佼	jhyw
夙	seav
狻	sece
猞	sehj
诫	jida
庵	ayck
甩	sesv
讥	jiee
氏	sesv
肆	sfcn
串	cksl
谏	jifv
丧	sfoo
瞅	cktp
谨	jifk
束	sfvo
甚	sfwv
畅	ckvq
裾	jinj
诀	jinw
瑟	sggi
镖	bqfm
俟	shct
襟	jium
舒	shgb
貂	dwej
佘	shgm
怂	shhi
食	shis
倏	shlc
僧	shps
伞	shps
傻	shre
噱	jjha
戢	jjfl
俗	shwj
哀	ayje
隼	shyx
诵	sick
邦	bgbb
碇	dwvf
爹	dwwe
监	jjtk
鉴	jjtq
视	sike
嚼	jjwf
衫	siqw
诗	sirf
讼	siwc
嗄	sjae
肾	sjca
峻	jkce
竖	sjcy
羁	jkfs
嗜	sjfs
嗉	sjgm
妒	dxis
妲	dxss
呻	sjks
唰	sjnj
娣	dxpn
矍	jkkc
嗖	sjrc
嗦	sjxm
癌	ayjk
瘩	dydj
髓	skai
崛	jknb
圈	jkpv
署	skfs
底	dyes
峙	skrf
裳	clie
沈	cliw
店	dyhj
嵩	skyj
渗	slcq
漱	slfh
浇	jlda
淑	slhc
洒	slfv
洁	jlfj
沈	sliw
班	bgpg
浅	jlgv
裟	slme
鲨	slmo
浸	jlnc
沮	jlks
潺	clnb
溯	slpa
潸	slua
沭	sluo
癫	dyxb
搔	smcn
涧	jlus
拭	smdf
撕	smfq
摄	smfc
潮	clxa
拾	smhj
淳	clyb
拒	jmdv
捷	jmds
省	smks
掸	smpk
掬	jmep
逝	smqi
搜	smrc
掘	jmnb
刷	snkj
镑	bqyy
蛳	snmf
淬	clyx
嚣	ajjj
搅	jmoe
肃	snwl
挟	jmsw
坝	brbb
揪	jmtp
悚	sofv
饲	sonj
煞	sono
掺	cmcq
抽	cmks
饰	sotk
忪	sowc
慎	soxw
遂	spai
槊	spau
烁	spel
跚	spew
虹	jnfs
俄	ehtl
善	spgj
燧	sppi
忌	jnio
届	jnks
诶	eict
舢	sqkl
讹	eihe
呃	ejav
蛱	jnsw
艘	sqrc
顺	srab
玻	bgxc
寺	srfo
颚	ejjb
饥	joee
鄂	ejjb
赦	srrt
匙	ssfe
角	joes
帛	brkl
暑	ssfs
撑	cmlm
霜	ssuk
惧	jokw
摧	cmky
乘	sthe
嗯	ejki
舐	stje
斑	bgyg
抄	cmmo
鲸	joym
搀	cmoo
笥	stnj
饺	joyw
矢	stso
剪	jpax
牲	stts
煎	jpao
升	stwl
枢	sudw
栅	suew
愕	eojg
述	suii
鳄	eojg
梢	sula
践	jpgv
尘	cmrr
炯	jpkj
饿	eotl
塞	svgr
宿	svhs
缌	svki
烬	jpno
踞	jpnj
币	brvl
缮	svpj
遏	esei
骚	svsn
驶	svsk
鹅	etes
邃	svwi
虱	svwn
捶	cmtl
娥	extl
颂	swcb
舜	swid
砂	swmo
魄	brrc
径	jqcf
钧	jqeg
碎	swyx
姗	sxew
肥	fabs
舰	jqke
嫂	sxrc
膘	bafm
肺	fafv
瘙	sycn
庶	syfo
搐	cmyk
键	jqnc
衰	syke
锦	jqrk
斤	jqsl
瘦	syrc
率	syvx
胎	tacj
腑	fayf
餮	tahi
膛	talr
腿	tani
滕	tapl
舅	jrkx
圾	jreo
贴	tbhj
赋	fbsh
附	fbhf
境	jrye
藤	tdal
荑	tdds
萄	tdet
忒	tdio
炅	jspw
屯	tdlv
凹	akls
苕	tdxj
霁	jsyr
稽	jtas
彤	teqw
雹	bsen
辅	fdfv
橐	tfiu
覃	tfsx
酡	tfve
笈	jteo
鞍	afkx
吞	tgjj
籍	jtgs
泰	tgll
佟	theo
虫	cnnn
藩	fdlk
途	thgi
忐	thio
侗	thkj
倘	thlj
凸	thls
佗	thve
筠	jtrg
矫	jttr
讨	tifo
谶	tihh
橘	jucj
袒	tiss
蕃	fdwk
嗵	tjci
嗒	tjdj
蝉	cnpk
芳	fdyv
唾	tjtl
叨	tjxx
骰	tkac
炭	tkap
逢	fegi
帖	tkhj
田	tkss
眺	tkwx
狒	fenv
滩	tlcy
汀	tlff
潭	tlfx
添	tlgm
涂	tlhg
湍	tlkk
淌	tllj
涕	tlpn
沓	tlss
惭	codq
汤	tlvq
惆	coej
缄	jvaj
校	juyw
抬	tmcj
寄	jvcj
掏	tmet
探	tmiu
挺	tmtc
拓	tmww
挑	tmwx
搪	tmyj
臀	tnfa
屠	tnfs
螳	tnlr
寂	jvhc
弹	tnpk
忱	coiw
缉	jvjf
悌	topn
冯	fgvs
惴	cokk
跆	tpcj
趿	tpeo
缴	jvrt
剃	tpnj
焕	tpok
骄	jvsr
伐	fhdw
畿	jvvk
蹄	tpyk
钛	tqco
窘	jvwj
刍	cons
锑	tqpn
翡	fhhc
碱	jwaj
雏	cony
艇	tqtc
澳	alrc
坛	trgc
馋	cooo
趟	trhj
魄	trrc
姬	jxdl
塌	trsc
填	trxw
塘	tryj
奸	jxgl
娟	jxja
煲	bhjp
俯	fhyf
甜	ttjf
舔	ttjm
毯	ttpp
讽	fiew
驾	jxjs
椭	tuba
桶	tuck
桐	tukj
梯	tupn
榻	tusc
妓	jxxc
檀	tuys
嫉	jxyt
绦	tveu
驮	tvsc
缇	tvsf
簿	btlf
瘠	jyga
碳	twkp
吠	fjco
逃	twxi
迢	txji
竞	jyje
访	fiyv
亭	tyjf
悴	coyx
童	tyks
憧	coyk
麇	jynt
啡	fjhh
兀	wavv
腕	wavv
竭	jysv
旌	jytt
鹜	wcbs
葳	wdax
苇	wdgv
芜	wdgw
躇	cpds
蔚	wdnf
蔓	wdsc
盔	kapk
踌	cpgf
芒	wdyv
猬	weka
罚	fkij
丸	weoo
勿	weqq
乌	wess
奎	kcrr
吾	wfjj
顽	wgeb
幅	fksk
秉	btvo
违	wgii
苛	kdfj
幡	fkwk
匡	kdgl
偎	whkd
匮	kdkb
侮	whtv
诬	wifh
误	wijg
沸	flnv
吻	wjeq
炽	cpjw
吴	wjgw
喂	wjkd
款	kfgh
胃	wkaa
灿	cpkl
畏	wkdw
帷	wkhy
酷	kftj
罔	wkpy
珂	kgfj
巍	wktc
汪	wlgl
污	wlgv
渭	wlka
渥	wlnr
洼	wlrr
沃	wltw
湾	wlyn
亏	kgvv
捂	wmfj
挽	wmok
挖	wmvv
屋	wndr
蜈	wnjg
蛙	wnrr
侃	khjr
蚊	wnyw
柄	bufv
惟	wohy
忤	wots
惋	wovv
隘	abpk
炜	wpgv
蝮	fnte
诃	kifj
蹲	cppf
蹭	cpps
圩	wrgl
皖	wrve
糙	cpti
咯	kjej
晤	wsfj
叩	kjbb
雯	wsyw
舞	wtfd
傧	bhvw
稳	wtoi
午	wtsl
哭	kjjc
喟	kjka
枉	wugl
喀	kjvj
桅	wuov
剜	wvej
咖	kjxj
咳	kjyh
艾	adww
骷	kkaj
窝	wvwk
瓮	wwcd
妩	wxgw
娲	wxjk
眶	kkdg
烽	fpeg
婉	wxvv
於	wyho
兹	cpvv
瘟	wysk
弯	wyjn
踩	cpwu
妄	wyxs
燹	xaap
溃	klkb
殉	xaes
袭	xaee
咸	xasj
腥	xast
厢	xauk
渴	klsv
胥	xbaa
返	fqci
逊	xbmi
陷	xbor
铖	cqav
锋	fqeg
括	kmtj
茜	xdfv
榜	buyy
拗	kmvx
芯	xdio
苋	xdke
尻	knee
匣	xdks
钗	cqco
垦	knrr
荇	xdqg
薰	xdto
恪	koej
萱	xdvs
蓿	xdvs
薪	xdyq
恺	kokn
坊	fryv
坟	fryw
旭	xess
旬	xess
慨	kond
匈	xewb
枭	xeuu
馨	xfbs
慷	koyn
颉	xfjb
绷	bvaa
靴	xfke
鞋	xfkr
糠	kpyn
符	fthf
铐	kqfd
顼	xgab
铠	kqkn
舱	cqhv
瑕	xgnc
冼	xgte
褓	bihu
魁	krcx
垮	krcg
契	xgxc
锄	cqkx
叙	xhgc
斜	xhgx
编	bvik
俞	xhsj
氛	ftwx
侠	xhsw
谐	xidr
焚	fuup
逵	krwi
铛	cqln
谑	xihd
缝	fvei
详	xipg
训	xirl
写	xids
钞	cqmo
篑	ktkb
勋	xjbx
哓	xjda
鎚	cqri
吸	xjeo
嘻	xjfj
吓	xjfo
钏	cqrl
唬	xjhe
框	kudg
嘘	xjhj
楷	kudr
缚	fvff
驸	fvsf
喧	xjvs
阔	kulj
峋	xkes
锤	cqtl
峡	xksw
瞎	xkvj
枯	kuxj
逍	xlai
潇	xldl
汐	xleo
扁	biks
溆	xlhc
泻	xlis
浒	xlit
涎	xlrc
砜	fwew
湘	xluk
渲	xlvs
汛	xlvx
汹	xlwb
漩	xlyb
泫	xlyv
乏	fwii
矿	kwyw
掀	xmrh
亢	kyee
挟	xmsw
砝	fwrc
犀	xnlt
拗	amvx
颏	kyxb
蝎	xnsv
蜥	xnuq
魑	crck
蟹	xoen
惜	xofs
厉	ladw
超	crhj
励	ladx
懈	xoot
妇	fxns
垄	laer
恤	xorv
腊	lafs
妨	fxyv
妃	fxnv
殓	laho
羞	xpgb
裂	laje
鲞	xpoo
熄	xpri
厘	laks
煊	xpvs
烯	xpwk
蹊	xpwc
败	bbtw
趁	crhq
陇	lbae
徐	xqhg
废	fyxc
衔	xqqg
循	xqqk
陋	lbfv
锈	xqtx
辽	lbii
泵	bwll
戮	lccd
垒	lccr
舄	xreo
臌	gafc
墟	xrhj
衅	xrps
幸	xrpg
莲	lddi
歇	xseh
暹	xshi
辆	ldfv
霄	xsla
霞	xsnc
昕	xsqs
曦	xspd
晰	xsuq
卸	xtbb
顾	gavb
牺	xtfv
罅	xthw
箫	xtnl
贝	bbbb
蓝	ldjk
昌	csss
械	xuda
颁	bwxb
楔	xugc
蕾	ldsk
莉	ldtj
樨	xunt
购	gbec
藜	ldtl
榭	xurf
辘	ldye
猎	lefs
绚	xves
獠	leam
匙	csfe
宿	xvhs
呗	bjbb
宵	xvla
驯	xvsr
狸	leks
轨	gdee
缃	xvuk
笞	ctcj
乡	xvww
聊	lfeb
郗	xwab
凶	xwbb
兮	xwdd
酪	lfej
芥	gdhr
硝	xwla
奚	xwvc
婿	xxba
筹	ctgf
嫌	xxpn
栗	lfuu
吏	lfvo
勒	lfkx
序	xycb
享	xyjb
亵	xyme
轧	gdvv
冽	lgaj
戈	gdwo
珞	lgej
玄	xyvo
玲	lghi
效	xywt
页	yabb
郁	yaab
腌	yack
靥	yack
璐	lgpj
厌	yaco
掣	ctjm
殒	yajb
辞	ctjx
殃	yaks
狗	geej
压	yaro
凛	lgym
琉	lgyr
博	bxff
僚	lham
虏	lhdx
婴	ybbx
陨	ybjb
仑	lhee
伦	lhhe
院	ybve
俩	lhfv
伶	lhhi
垂	ctls
翼	yccw
允	ycee
翎	lhic
埃	arct
矣	ycts
侣	lhjj
儡	lhkk
荑	ydds
莸	ydea
卤	lhkw
苑	ydev
芸	ydgc
婊	bxge
愁	ctpi
鼓	gfjc
萤	ydin
荧	ydip
俐	lhtj
莺	ydis
朗	liaa
郎	libb
戾	lico
裢	lidi
谙	aiys
夷	ydso
褴	lijk
医	ydts
蕴	ydvk
裸	liks
勃	bxix
耿	gfpw
犹	yeav
迎	yebi
簇	ctyt
丐	gfsv
咧	ljaj
狱	yeic
颖	yetb
疑	yetb
唠	ljdx
鸳	yevs
橱	cuaf
咯	ljej
鄢	yfdb
酝	yfgc
啷	ljib
懿	yfii
婢	bxrx
严	yflw
哩	ljks
璎	ygbx
啦	ljmy
冶	ygcj
瑛	ygdk
元	ygee
耘	yggc
瑜	yghj
迂	ygii
村	cufo
槽	cufs
瑗	ygwc
瑶	ygwt
佑	yhaj
髅	lkax
侥	yhda
伢	yhdl
偃	yhdx
佣	yhes
仰	yheb
楮	cufs
岚	lkew
攸	yhlt
悠	yhli
觎	yhse
逾	yhsi
嶙	lkpd
佚	yhts
傀	ghrc
俞	yhsj
睐	lksw
译	yicg
诣	yies
谕	yihj
鸽	ghss
冤	yiok
谒	yisv
诱	yitx
伽	ghxj
谚	yiyq
阐	cupk
邑	yjbs
嘤	yjbx
咦	yjds
呓	yjdv
噎	yjfp
郢	yjgb
雇	gihy
滤	llhi
咏	yjiv
潋	llht
泸	llhn
诡	giov
滥	lljk
吆	yjvo
哟	yjve
唷	yjya
褂	girl
腌	aack
诰	gitj
潞	llpj
崖	ykar
鄙	bjxb
眙	ykcj
罨	ykck
屿	ykds
浏	llyj
鸯	ykes
漓	llyk
嘎	gjad
咯	gjej
圜	ykke
拢	lmae
黝	ykox
禺	ykso
捞	lmdx
抡	lmhe
屹	yktv
掳	lmhx
揽	lmje
淹	ylck
涯	ylar
撂	lmkj
漪	ylej
滟	ylgb
沅	ylge
渝	ylhj
呱	gjqv
擂	lmsk
渔	yloo
劣	lmxx
溢	ylpk
拦	lmpg
渊	ylwl
咖	gjxj
淤	ylyo
螂	lnib
抑	ymeb
螺	lnkm
揄	ymhj
咕	gjxj
闯	cuvs
骼	gkaj
禀	bykm
隶	lnso
屡	lnpx
蜊	lntj
蛹	ynck
馏	loek
熨	yngp
宸	cvag
蚁	ynow
粥	ynpn
蜒	ynrc
聿	ynsl
罡	gkfs
尾	ynts
蝣	ynyb
恹	yoac
鳞	lopd
饴	yocj
怡	yocj
飙	bccw
岗	gkkw
饮	yooh
悦	yope
忆	yovv
誉	yowj
冈	gkww
慵	yoyn
熠	ypcr
恙	ypgi
羊	ypgs
养	ypgr
鹭	lpes
剡	yppj
羚	lpgi
焱	yppp
炉	lpis
粮	lpis
钥	yqaa
踉	lpis
役	yqec
衙	yqfg
娄	lpxs
钰	yqgl
涡	gljk
镣	lqam
洄	glkj
徭	yqwt
铱	yqye
镛	yqyn
溉	glnd
鼬	yrck
舆	yrdw
堰	yrdx
铝	lqjj
袁	yrje
骢	cvsi
盐	yrlk
粤	yrpd
圻	yrqs
镂	lqpx
镭	lqsk
垣	yrss
徕	lqsw
昀	yseg
曜	yscy
扛	gmfs
晕	ysid
晏	ysvx
昱	ysyo
魉	lrcf
罢	bkrc
氤	ytkc
趔	lrhj
筵	ytrc
毓	ytvr
夭	ytwo
窜	cvwk
垃	lryo
阈	yuds
椰	yufb
榆	yuhj
檐	yuoj
毙	bdee
擀	gmxg
郦	lskb
逦	lski
酃	lsjb
绎	yvcg
缨	yvbx
纭	yvgc
搞	gmyj
寓	yvks
霖	lsuu
驭	yvsc
验	yvso
宴	yvsx
乙	yvvv
窳	yvwq
籁	ltfb
肴	ywaa
幼	yvxx
豺	cwef
谷	ywhj
刈	ywjj
蚣	gnwc
篮	ltjk
梨	ltju
箩	ltke
爻	ywww
妤	yxcb
姨	yxds
妪	yxdw
妍	yxgw
娱	yxjg
姻	yxkc
媛	yxwc
瘾	yybi
育	yyca
磋	cwpf
榴	luek
疫	yyec
栳	lufe
刹	cwuj
膺	yyha
於	yyho
龟	goks
赢	yyje
懊	aorc
痒	yypg
弈	yyra
闾	lujj
楞	luky
韵	yysg
羹	gpgc
旖	yytj
疡	yyvq
岔	cwxk
兖	yywe
棱	lure
娠	cxag
臧	zadl
脂	zaes
盖	gpgk
仄	zahh
蹙	cahp
朕	zapg
跪	gpov
缭	lvam
蠡	lvan
糕	gppo
肢	zaxc
赈	zbag
翅	cxcc
奘	zbfc
缆	lvje
钙	gqfs
络	lvej
缕	lvpx
账	zbtv
孜	zbtw
绫	lvre
翟	zccy
葬	zdaa
茁	zdbl
骡	lvsm
锅	gqjk
辄	zdfv
窿	lvwt
芷	zdhl
砺	lwad
匝	zdkl
婵	cxpk
屯	zdlv
辗	zdnf
碌	lwnl
獒	agtc
磊	lwww
姥	lxfe
茱	zdts
姹	cxvt
轧	zdvv
辙	zdyt
辣	lyaf
螽	zeon
狰	zeon
廖	lycq
疗	lybb
痨	lydx
獐	zeyx
鬃	zfcm
瘤	lyek
盥	grlk
庐	lyis
枣	zfoo
甄	zfrd
煮	zfso
职	zfjw
皈	grqc
政	zftw
琢	zgav
卦	grrl
醉	zfyx
壮	zgfs
鸾	lyjs
珍	zghq
恣	zgoi
咨	zgoj
赘	zgtb
麟	lynd
妆	zgxs
佐	zhaf
贞	zhbb
旅	lyte
侄	zhdr
觜	zhee
偬	zhei
訾	zhej
斓	lywf
债	zhgb
瀑	blsl
吝	lywj
刘	lywj
坐	zhhr
朦	mada
卓	zhsx
膜	madc
值	zhxk
缸	gtfs
脉	maiv
冢	ziav
褶	zicr
祗	zies
苞	bden
孟	mbkl
褚	zifs
祯	zihb
乖	gthe
祝	zije
祖	ziks
蝥	mcbn
诤	zion
祚	zitl
肇	zitn
诏	zixj
牟	mcts
茂	mdav
莽	mdca
鹄	gtjs
啧	zjgb
茗	mdej
蚩	cbnn
噪	zjju
畜	cyvk
凿	zjpb
迈	mdii
嘬	zjsc
喳	zjus
皑	arkn
吱	zjxc
遯	daai
颛	zkab
崭	zkdq
眦	zkhe
蔓	mdsc
忠	zkio
滨	blvw
幕	mdsk
墓	mdsr
峥	zkon
暮	mdss
柜	gudv
胴	dakj
眨	zkwi
幢	zkyk
嶂	zkyx
涿	zlav
泽	zlcg
杠	gufs
沌	zldl
渍	zlgb
溱	zlgt
猫	medk
杆	gugl
涨	zlnt
猕	menm
贸	mexb
渣	zlus
淄	zlvk
沼	zlxj
汴	blyl
赌	dbfs
拯	zmbs
摺	zmcr
麦	mgeo
桂	gurr
蛰	zmen
歹	davo
玫	mgtw
揍	zmgg
撰	zmnw
掷	zmpb
梏	gutj
捉	zmpp
棺	guvk
攒	zmtb
攥	zmtm
拶	zmve
椁	guyb
谋	mifu
谬	micq
拄	zmys
戳	cccd
祢	miom
寡	gvax
昼	znss
蚱	zntl
蛛	znts
绀	gvfl
蟑	znyx
詹	zoaj
怔	zofs
惴	zokk
皱	zonc
割	gvgj
憎	zops
咩	mjpg
蓓	bdhj
籽	zpbs
灼	zpeo
糟	zpfs
郑	zpgb
粘	zphj
嘛	mjyu
躁	zpju
叠	dcck
瞄	mkdk
烛	zpnn
翟	dccy
灶	zprr
皿	mkls
瞑	mkiw
粽	zpvm
兹	zpvv
炷	zpys
坳	arvx
墨	mkor
钻	zqhj
睦	mkrr
镯	zqkn
叉	ccoo
帽	mksk
湄	mlbk
虢	gwfe
葆	bdhu
锺	zqtl
镇	zqxw
针	zqxx
皂	zrdd
址	zrhl
沫	mlgl
赵	zrhw
怠	dcji
增	zrps
迨	dcji
泌	mlio
溟	mliw
昨	zstl
拔	bmac
泯	mlnv
漫	mlsc
笫	ztel
沐	mluu
竺	ztgg
毡	zthj
凳	dcse
登	dcsp
造	ztji
抹	mmgl
智	ztjs
抿	mmnv
筝	zton
拇	mmvo
竹	zttl
篆	ztva
蟒	mnda
葱	cdei
荻	ddep
椹	zufv
蟆	mndc
弭	mnfl
桢	zuhb
膏	gyja
闸	zuks
蚂	mnvs
弥	mnom
株	zuts
棕	zuvm
札	zuvv
裹	gyke
桩	zuyr
植	zuxk
蔡	cdem
缀	zvcc
纸	zves
宗	zvgm
纵	zvhh
织	zvjw
趸	ddpp
宙	zvks
灾	zvpw
煤	mpfu
驺	zvsn
疙	gytv
衮	gywe
宅	zvtv
缁	zvvk
锰	mqbk
缜	zvxw
综	zvvm
豸	zwew
遨	agti
斫	zwqs
繇	zwtm
兆	zwxo
载	zxdd
捕	bmfv
召	zxjj
魅	mrcg
埋	mrks
墁	mrsc
痣	zyfi
症	zyfs
盟	msak
昴	mseb
颤	zykb
昧	msgl
痔	zyrf
曼	mskc
搏	bmff
灭	mspw
冕	msok
欢	hcoh
斋	zywk
夯	hcxx
毪	mtct
秣	mtgl
菡	hdbb
嚄	ajdc
篾	mtka
穆	mtrq
牡	mtrr
蕙	hdfi
牦	mtts
蕻	hdfw
鳘	mtvo
荟	hdhc
敏	mtvt
楣	mubk
懋	muci
檬	muda
荷	hdhj
劐	hdhj
杪	mumo
虿	cdnn
荤	hdid
萑	hdhy
棉	murk
狄	depw
惑	hdji
杩	muvs
苍	cdhv
杧	muyv
捌	bmjj
薨	hdke
寐	mvbg
茴	hdkj
缪	mvcq
菏	hdlj
寞	mvdc
菖	cdss
蘅	hdqg
藿	hdsy
缗	mvns
荭	hdvf
拌	bmps
氐	deso
缦	mvsc
轷	hdww
乜	mvvv
菠	bdlc
礞	mwda
薅	hdxf
貘	mwec
蒿	hdyj
邈	mwei
苌	cdtv
貊	mwes
獾	hedy
觅	mwke
耋	dfer
嫫	mxdc
犴	hegl
妺	mxgl
莼	cdvd
丁	dfff
娩	mxok
嫚	mxsc
娒	mxtv
酊	dfff
姆	mxvo
狐	heqv
耵	dfff
嫲	mxyu
郇	hesb
邙	mybb
瘼	mydc
鹱	hesc
菝	bdmc
亩	myks
荽	cdwx
訇	heyj
猢	hexa
旄	mytt
醢	hfak
邯	hfbb
蠹	dfin
縻	myum
茺	cdye
糜	myup
霭	asiv
壶	hfij
觳	hfic
脓	naiw
靼	dfks
恧	naki
肭	nakw
脲	nanl
臑	nask
孬	naxb
腩	naxg
聃	dfks
孻	nbnk
軤	hfww
乸	nbvo
蘗	bdnu
顸	hgab
菜	cdwu
萘	ndcm
慝	nddi
邗	hgbb
茑	ndes
舛	cedl
蔫	ndfo
蘖	ndru
艿	ndxx
狃	nebs
猱	necu
猊	nere
凋	dgej
鸱	cees
萃	cdyx
颞	nfcb
彗	hggn
耠	hghj
珲	hgid
焘	dgfo
聍	nfvf
耨	ngaf
捭	bmrx
珩	hgqg
辇	nggd
砉	hgww
傩	nhcy
玳	dghd
佴	nhfl
薜	bdnx
佞	nhgx
侬	nhiw
伲	nhne
纛	dgvm
刺	cfjj
倪	nhre
货	hheb
恁	nhti
蔽	bdpt
谂	nihi
衲	nikw
讷	nikw
祢	niom
贷	dhdb
喏	njdj
嗫	njfc
囔	njfe
啮	njhb
唸	njhi
嗱	njhm
哝	njiw
嗯	njki
呐	njkw
猹	ceus
颌	hhsb
郃	hhsb
呶	njxc
岱	dhdk
睨	nkre
盒	hhsk
囡	nkxs
嬲	nkxx
螯	agtn
淖	nlhx
诙	hiap
诃	hifj
溺	nlng
讧	hifs
泞	nlvf
袆	higv
猝	ceyx
仃	dhff
捺	nmcm
撚	nmeo
攮	nmfe
诨	hiid
撵	nmgd
拈	nmhj
醋	cffs
戽	hiox
搦	nmng
侗	dhkj
拗	nmvx
褐	hisv
蛲	nnda
佃	dhks
尿	nnll
蝻	nnxg
忸	nobs
馕	nofe
鲶	nohi
祜	hixj
鲇	nohj
抃	bmyl
儋	dhoj
喐	hjab
馁	nowx
俤	dhpn
蹑	npfc
咴	hjap
糯	npsk
酲	cfjg
铙	nqda
嚄	hjdc
锘	nqdj
镎	nqhm
裰	dicc
嚆	hjdj
铌	nqne
钕	nqxs
衄	nrbs
嚿	hjdr
埝	nrhi
蓖	bdre
臬	nruu
垴	nryb
唿	hjei
暧	aswc
霓	nsre
曩	nsye
黏	nthj
诋	dies
牛	ntsl
氖	ntxx
柰	nugm
萆	bdrx
柠	nuvf
酬	cfpu
纽	nvbs
哕	hjke
甯	nvik
谍	difu
碾	nwnf
硇	nwrw
嗨	hjlv
孥	nxcb
蝙	bnik
胬	nxch
谠	dile
嗥	hjrx
驽	nxcs
酢	cftl
喙	hjva
嚯	hjsy
曹	cfss
鼐	nxkh
嫐	nxkx
裆	diln
嚎	hjya
敕	cftw
诞	dirc
吭	hjye
疟	nyds
旎	nyte
藕	odgk
殴	odwc
瓯	odwd
骺	hkaj
鹘	hkas
岙	atkl
耦	ogks
夥	hkee
讴	oidw
囫	hkeq
呕	ojdw
呔	djco
噔	djcp
迴	hkji
沤	oldw
蕃	bdwk
胚	paas
圜	hkke
膨	pafq
襞	bnje
脯	pafv
胼	papg
幌	hkse
鹮	hkss
邳	pasb
岵	hkxj
脬	pawb
咥	djdr
殍	pawb
陴	pbrx
疋	pbso
爿	pbsw
陂	pbxc
赔	pbyj
汇	hldd
荸	bdxb
苤	pdas
芘	pdde
咚	djeo
哚	djeu
葡	pdef
芃	pdeo
莆	pdfv
叵	pdjj
蒎	pdle
浍	hlhc
蒲	pdlf
滹	hlhw
葩	pdrb
莩	pdwb
菩	pdyj
逄	pedi
狍	peen
匍	pefv
刨	penj
浒	hlit
剽	pfgj
溷	hlka
瓢	pfgq
唞	djmx
鼙	pfjx
叼	djnn
聘	pfkd
漶	hlki
醅	pfyj
珮	pgef
亍	cgll
耖	cgmo
擘	bnjm
洄	hlkj
琵	pgge
嘚	djqf
攴	phcc
仳	phde
湟	hlrg
哋	djrb
灏	hlsb
葧	bdxx
俳	phhh
啲	djre
俜	phkd
洹	hlss
频	phmb
呾	djss
颦	phmx
瓷	cgod
诒	picj
鐾	bnjq
谝	piik
浣	hlve
扁	piks
啶	djvf
袢	pips
澣	hlxg
裨	pirx
噉	djvt
襻	pium
吡	pjde
沆	hlye
琤	cgon
嘌	pjfm
嗲	djwe
嘀	djyj
璁	cgri
噼	pjnx
哌	pjqe
擐	hmke
呯	pjsw
喥	djyc
捍	hmsg
毗	pkde
苄	bdyl
攉	hmsy
撖	hmvt
罴	pkro
檗	bnju
骶	dkae
蠖	hndc
帔	pkxc
蟪	hnfi
蚵	hnfj
髑	dkan
澎	plfq
嶝	dkcp
濮	plhg
淠	plka
潽	plps
泮	plps
潎	plpt
蟥	hnfw
泊	plrv
蒡	bdyy
桉	auvx
湓	plwk
蛔	hnkj
盹	dkdl
蛤	hnhj
滂	plyy
蝗	hnrg
岽	dkdl
囤	dkdl
蚝	hnts
捧	pmgg
琮	cgvm
擗	pmnx
蝴	hnxa
撇	pmpt
嬖	bnjx
抨	pmsw
扒	pmww
睹	dkfs
掊	pmyj
蚍	pnde
斛	hoex
螵	pnfm
帱	dkgf
甓	pnjd
黉	hoiw
蟛	pnfq
奂	hoks
辟	pnjx
蜱	pnrx
蟠	pnwk
胺	aavx
螃	pnyy
鳇	horg
鲆	posw
蹒	ppdf
峒	dkkj
馄	hose
炮	ppen
粲	chcp
蹁	ppik
蹼	ppjg
眈	dkiw
黩	dkoc
粕	pprv
鲩	hove
趴	ppww
怙	hoxj
钷	pqdj
槃	pqeu
豢	hpav
烘	hpfw
徘	pqhh
镤	pqjg
烩	hphc
昳	dkts
镨	pqps
糇	hpht
锫	pqyj
踝	hpks
堋	praa
坯	pras
埔	prfv
屄	bnvw
牖	prif
圮	prnv
氨	atvx
凼	dlbb
埤	prrx
烀	hpww
魄	prrc
傺	chem
皤	prwk
煳	hpxa
郫	prxb
镬	hqdc
巅	dkxb
锪	hqei
霈	pslf
鲅	boac
曝	pssl
铪	hqhj
霹	psnx
笸	ptdj
铧	hqhx
涤	dleu
犏	ptik
俦	chgf
筢	ptmb
氆	ptps
徽	hqkt
氕	ptww
棚	puaa
钬	hqpw
枇	pude
榀	pujj
狴	bedr
椪	pupf
枰	pusw
澹	dloj
纰	pvde
辔	pvdj
缥	pvfm
缏	pvhf
锾	hqwc
沓	dlss
骠	pvsm
沲	dltb
硼	pwaa
貔	pwee
鄱	pwkb
龀	chhe
渎	dlxc
盍	hrck
砰	pwsw
皝	hrge
淀	dlvf
遑	hrgi
磅	pwyy
滇	dlxw
嫖	pxfm
堠	hrht
娉	pxkd
姘	pxpg
鼾	hrkg
嫔	pxvw
狈	bebb
皡	hrrg
庀	pyee
恚	hrri
疱	pyen
痡	pyfv
掇	dmcc
烹	pyjo
癖	pynx
壕	hrya
裒	pyre
曷	hsev
旆	pytf
朐	qaej
旱	hsgl
肷	qaoh
捣	dmek
伧	chhv
戕	qbdw
赇	qbfo
晗	hshj
阡	qbtl
欹	qcfh
翮	hsjc
巯	qcfr
饽	bofb
犬	qcoo
晄	hsle
逡	qcwi
揲	dmfu
顷	qdab
晦	hstv
霍	hshy
觇	chje
苣	qddv
笏	hteq
芪	qdes
檠	qdeu
鹾	chkf
篌	htht
萁	qdfw
葜	qdgc
辁	qdhg
鹄	htjs
芩	qdhi
蘧	qdhi
茕	qdix
颧	qdjb
葺	qdjf
苘	qdkj
鳊	boik
荨	qdnf
芑	qdnv
芡	qdoh
蕲	qdpq
阍	hues
堑	qdqr
掟	dmvf
椠	qdqu
荞	qdtr
桧	huhc
桦	huhx
掂	dmyj
槲	huox
荠	qdyr
桁	huqg
鸲	qejs
劬	qejx
刨	benj
邛	qfbb
謦	qfbj
罄	qfbt
磬	qfbw
阚	huvt
鬈	qfcv
饼	bopg
娶	qfcx
醛	qfdg
蛩	qfen
跫	qfep
麴	qfep
纮	hvac
銎	qfeq
屌	dnjk
逑	qfii
悫	qfii
愎	bote
鞒	qfkr
宦	hvdl
蚪	dnox
鹊	qfss
覃	qfsx
倘	chlj
倡	chss
綦	qfwm
碁	qfww
豁	hvgj
螲	dnvr
惰	doaa
缋	hvkb
琦	qgcj
缳	hvke
寰	hvke
伥	chtv
琪	qgfw
逭	hvki
玘	qgnv
绗	hvqg
悖	boxb
鲷	doej
挈	qgxm
骅	hvsx
俟	qhct
忭	boyl
佢	qhdv
纥	hvtv
虔	qhdw
鲽	dofu
俅	qhfo
貉	hwej
佺	qhhg
侪	chyr
龋	qhhr
磺	hwfw
衾	qhie
恫	dokj
侵	qhnc
佥	qhso
仟	qhtl
砹	awdw
戗	qhvd
怛	doss
伽	qhxj
劁	qhyj
雠	chyy
鹕	hxjs
诎	qibl
祇	qies
嬛	hxke
隹	chys
诠	qihg
袷	qihj
忉	doxx
肓	hyaa
啟	qijt
竑	hyac
跶	dpci
痾	hybj
襁	qinn
颃	hyeb
粑	bpbs
癀	hyfw
綮	qitm
瘊	hyht
嘁	qjam
衩	cico
嗪	qjgt
喰	qjhi
炖	dpdl
呛	qjhv
吣	qjio
飑	bewn
髂	qkaj
骹	qkaw
痪	hyok
畎	qkco
岖	qkdw
亥	hyxh
圊	qkga
岍	qkgw
蹀	dpfu
劾	hyxx
囚	qkhh
氍	qkkt
羝	dpge
胫	jacf
屺	qknv
禇	cifs
肼	jagw
腈	jaga
黥	qkom
谌	cifv
畦	qkrr
胛	jaks
岂	qknv
丌	jall
盵	qktv
跸	bpdx
柒	qldu
厩	jand
沏	qldx
淇	qlfw
兑	dpje
劂	japj
溱	qlgt
嗌	ajpk
洽	qlhj
谶	cihh
泅	qlkh
腳	jawb
湫	qltp
汔	qltv
裎	cijg
胶	jayw
擒	qmhk
煅	dprc
雀	qmhy
掮	qmia
掐	qmor
趵	bpeo
揿	qmqh
撬	qmtt
阱	jbgw
蜞	qnfw
蜻	qnga
赆	jbno
迉	qnii
孓	jboo
鸨	bexs
蠼	qnkc
孑	jbss
卺	jbsv
蝤	qnpf
蜣	qnpg
矜	jcbi
邴	bfbb
蚯	qnrs
蛴	qnyr
悛	qoce
慳	qodr
踮	dpyj
剞	jcfj
鳍	qofs
鲭	qoga
镫	dqcp
刭	jcfj
憔	qoho
悭	qojr
谗	cioo
慊	qopn
怯	qorc
愀	qotp
鳅	qotp
蕨	jdah
跷	qpda
遒	qpfi
酋	qpfv
羟	qpgf
羌	qpgs
铞	dqjk
炝	qphv
苣	jddv
跄	qphv
艽	jdee
炔	qpnw
蹻	qptj
钿	dqks
髟	bfcq
颀	qqab
芨	jdeo
钳	qqfl
锖	qqga
钭	dqox
锵	qqgf
菊	jdep
铨	qqhg
钤	qqhi
衢	qqkg
愆	qqli
锓	qqnc
镪	qqnn
藉	jdgs
钎	qqtl
莶	jdho
锹	qqtp
煸	bpik
邱	qrbb
锝	dqsf
芥	jdhr
蕺	jdjf
趄	qrhk
铥	dqtc
辑	jdjf
鼽	qrke
莒	jdjj
圻	qrqs
铤	dqtc
亓	qsal
苴	jdks
瓞	dqts
氢	qtcf
茳	jdlf
筇	qtfb
吖	ajpl
氰	qtga
筌	qthg
葭	jdnc
荩	jdno
迄	qtii
憇	qtji
蓟	jdoj
铫	dqwx
箝	qtmf
蒹	jdpn
犍	qtnc
唓	cjfl
遁	dqxi
荚	jdsw
乞	qtvv
槭	quam
蹦	bpka
菅	jdvk
樯	qufj
吋	cjfo
栖	qufv
檎	quhk
芰	jdxc
镀	dqyc
榷	quiy
荠	jdyr
桤	qukn
逋	bfii
镝	dqyj
茭	jdyw
楸	qutp
镦	dqyt
橇	qutt
蒺	jdyt
褰	qvge
唓	cjfv
搴	qvgm
嘈	cjfs
缲	qvju
垯	drci
缱	qvki
鸠	jees
骐	qvsw
媪	axsk
憋	bpti
狷	jeja
穹	qvwn
垤	drdr
窃	qvwx
郄	qwab
硗	qwda
砌	qwdx
碛	qwgb
磲	qwlu
咎	jelj
硚	qwtr
嫱	qxfj
嬛	qxke
乾	qxst
媇	qxyu
甏	bfjd
灸	jepw
廑	qyfk
坻	dres
飓	jeww
癯	qyky
獍	jeye
猄	jeym
狡	jeyw
喰	cjhi
瘸	qyxh
垛	dreu
朊	rage
堵	drfs
腍	rahi
膶	rang
肜	raqw
鬏	jfcp
蹩	bptp
堞	drfu
髻	jfcj
墼	jfer
蓐	rdaf
坫	drhj
蕤	rdat
荛	rdda
酵	jffb
醵	jfha
葚	rdfv
醮	jfho
呲	cjhe
醭	bfjg
苒	rdks
垌	drkj
薷	rdsk
埭	drns
哧	cjrr
劼	jfjx
轫	rdxo
塅	drrc
狨	reda
鞣	rfku
鞯	jfkb
鞫	jfkj
肮	aaye
噌	cjps
韧	rgxo
倬	rhhx
牍	drxc
堇	jfks
靳	jfkq
鄄	jfrb
仞	rhxo
跛	bpxc
冗	riee
嘬	cjsc
豆	dsjp
襦	risk
诜	rite
衽	ritl
禳	riye
喏	rjdj
嚅	rjsk
踣	bpyj
嵘	rkdu
靓	jgae
冉	rkss
戥	dstd
溽	rlaf
浈	rlhb
濡	rlsk
鏊	agtq
溶	rlvj
洳	rlxj
酱	jgef
簦	dtcp
揉	rmcu
浆	jgel
扔	rmxx
篼	dtee
蝾	rndu
焙	bpyj
蚺	rnks
氡	dteo
蚋	rnkw
瑨	jgfs
饪	rotl
簟	dtfx
耩	jggf
玨	jggl
蹂	rpcu
珏	jggl
鎔	rqvj
镕	rqvj
铷	rqxj
嫒	axwc
颥	rsab
琚	jgnj
迭	dtii
珺	jgnj
稔	rthi
壬	rtls
稹	rtxw
穰	rtye
桡	ruda
璟	jgsm
枘	rukw
戋	jgvo
缛	rvaf
绒	rvda
脊	jgwa
钸	bqak
氮	dtpp
恝	jgxi
乳	rwbv
箪	dtpk
娆	rxda
珈	jgxj
刃	rxoo
簖	dtpq
妊	rxtl
啐	cjyx
厕	sabj
厍	sads
遄	ckai
僭	jhds
蜃	sagn
眵	ckee
腧	sahj
牮	jhdt
臊	saju
帱	ckgf
胂	saks
卅	sall
儆	jhdt
鞴	bfkk
岑	ckhi
龃	jhhk
膳	sapj
笪	dtss
脎	sawu
僬	jhho
膻	says
钚	bqal
隨	sbai
韭	jhhs
隋	sbaa
赊	sbhm
犊	dtxc
乩	jhjv
赡	sboj
钡	bqbb
陕	sbsw
赎	sbxc
倔	jhnb
颡	sccb
柢	dues
俱	jhkw
叁	sccg
廒	aygt
毵	scct
倨	jhnj
奢	scfs
瞠	cklr
崔	ckhy
荪	sdbm
蔬	sdbr
钯	bqbs
轼	sddf
芟	sdec
芍	sdeo
蔌	sdfh
蓍	sdfs
偈	jhsv
葚	sdfv
傢	jhva
菽	sdhc
锛	bqca
苫	sdhj
柁	duve
薯	sdks
僦	jhya
蒴	sdpa
黪	ckoq
薮	sdpt
鹪	jhys
荽	sdwx
绐	dvcj
苕	sdxj
蓑	sdye
莘	sdyx
氹	dvll
狲	sebm
绨	dvpn
殳	secc
舭	bqde
飧	sehi
谲	jicj
删	sejj
皲	jidc
勺	seoo
嵯	ckpf
狩	sevf
讵	jidv
飕	sewc
贳	sfbb
驮	dvsc
骀	dvsj
丙	bfvo
诘	jifj
鞘	sfka
缍	dvtl
啬	sfkj
讦	jigl
粟	sfps
酾	sfsk
窦	dvwc
衿	jihi
酥	sftl
袷	jihj
宕	dvww
谡	jike
珊	sgew
扃	jikj
嗳	ajwc
珅	sgks
耜	sgks
磴	dwcp
琐	sglb
缔	dvyk
凇	sguc
谫	jipx
睬	ckwu
砘	dwdl
僳	shfp
裥	jius
仕	shfs
碉	dwej
舍	shgj
畲	shgk
噘	jjah
仨	shgs
钵	bqfw
砥	dwes
餸	shii
鹃	jjas
幢	ckyk
滁	clbg
碟	dwfu
喈	jjdr
伺	shnj
碓	dwhy
叽	jjee
咭	jjfj
歙	shsh
硐	dwkj
碘	dwkw
毹	shst
俬	shtc
噍	jjho
铋	bqio
吤	jjhr
售	shyj
籴	dwps
祐	siaj
咀	jjks
唧	jjnb
喼	jjoi
嗟	jjpf
谌	sifv
谂	sihi
镚	bqka
澄	clcp
谡	sike
啾	jjtp
砀	dwvq
讪	sikl
噤	jjum
祀	sinv
汊	clco
谥	sipk
哜	jjyr
禅	sipk
骱	jkar
囝	jkbs
碲	dwyk
诜	site
舨	bqqc
谇	siyx
耙	bgbs
畸	jkcj
礅	dwyt
吮	sjce
睫	jkds
嗽	sjfh
漕	clfs
啫	sjfs
岌	jkeo
哂	sjfv
嵴	jkga
喰	sjhi
嘘	sjhj
啥	sjhj
钣	bqqc
嗣	sjkj
睑	jkho
唢	sjlb
雎	jkhy
迥	jkji
嗍	sjpa
嘥	sjqh
觌	dxve
嗮	sjsf
岬	jkks
噻	sjvr
咝	sjvs
瞿	jkky
嗾	sjyt
唼	sjyx
铂	bqrv
骰	skac
睃	skce
觊	jkne
黥	jkom
兕	skee
嫡	dxyj
蜀	sken
舶	bqrv
睢	skhy
甲	jksl
冰	bgll
瞍	skrc
峤	jktr
囧	jkwk
眭	skrr
疔	dyff
嵊	skte
溅	jlbg
崧	skuc
骜	agts
浚	jlce
泾	jlcf
滠	slfc
憝	dyji
澍	slff
澌	slfq
涑	slfv
洚	jled
汲	jleo
涔	clki
涉	slhm
氅	clkt
裳	slie
敞	clkt
渑	sljk
癜	dync
泗	slke
汕	slkl
濉	slky
滘	jlij
涓	jlja
瘅	dypk
挲	slmm
鏖	aynq
娑	slmx
涮	slnj
汜	slnv
痘	dysp
溲	slrc
湔	jlpj
潲	slta
疸	dyss
淞	sluc
洎	jlrv
渖	slvk
淙	clvm
抒	smcb
浃	jlsw
掺	smcq
奀	eacc
搡	smcu
搊	smeb
湫	jltp
腭	eajg
胞	baen
撅	jmah
揲	smfu
镳	bqyo
拴	smhg
摅	smhi
掎	jmcj
搧	smic
鸸	eaks
拣	jmdv
帅	smkl
捎	smla
厄	eavv
拘	jmej
扫	smns
澶	clys
搠	smpa
拮	jmfj
擞	smpt
轭	edav
捐	jmja
澈	clyt
誓	smqj
苊	edav
攫	jmkc
摑	jmks
擅	smys
蛸	snla
贰	edgb
捃	jmnj
蟮	snpj
萼	edjg
螋	snrc
抉	jmnw
屎	snps
蒽	edki
巳	snvv
搛	jmpn
蟀	snyx
莪	edtl
鳋	socn
觫	soef
觞	soeq
盎	akkl
馓	soft
挢	jmtr
愫	sogm
鳃	soki
搽	cmdu
噩	efjj
蚀	sonn
鳝	sopj
馊	sorc
恃	sorf
鲥	sosf
魃	brcc
稣	sotl
鲺	sovn
弪	jncf
垩	efrr
朔	spaa
暨	jnds
塑	spar
埲	brgg
糁	spcq
虮	jnee
挫	cmhr
蚧	jnhr
鄯	spgb
羧	spge
珥	egfl
佴	ehfl
煽	spic
郡	jnjb
兽	spkj
玢	bgwx
剡	sppj
犟	jnjt
炻	spww
埗	brhm
熵	spyj
铄	sqel
锶	sqki
屐	jnqc
艄	sqla
屦	jnqx
铯	sqob
艏	sqpr
谔	eijg
钐	sqqw
锼	sqrc
揣	cmkk
铩	sqwu
铈	sqyk
疆	jnrs
抻	cmks
叟	srcc
唔	ejfj
鼠	srcv
埽	srnk
埏	srrc
垧	srrj
螫	srrn
觖	joen
埘	srsf
甭	baes
墒	sryj
鹗	ejjs
晟	ssav
鲒	jofj
操	cmju
馑	jofk
霰	ssft
饯	jogv
曙	ssks
晌	ssrj
昇	sstw
鲣	jojr
霎	ssyx
悭	jojr
簌	stfh
筮	stfh
穗	stfi
穑	stfj
鲫	jonb
峨	ektl
籂	sthk
黍	sthl
洱	elfl
憬	josm
悸	jotb
扼	emav
眚	stks
甥	stkx
筲	stla
摁	emki
筛	stmf
鲚	joyr
矧	stnl
屙	enbj
歃	stoh
鲛	joyw
笋	stns
坂	brqc
翦	jpac
蹶	jpah
笙	stts
鲕	eoak
秫	stuo
蛾	entl
梭	suce
搋	cmqe
杓	sueo
炬	jpdv
椹	sufv
粳	jpfv
栓	suhg
榫	suhx
饵	eofl
犴	aegl
桫	sulm
羯	jpgv
杉	suqw
趼	jpgw
闩	suss
迩	eomi
柿	suyk
埠	brrx
纾	svcb
眷	jpks
梳	suyr
踺	jpnc
拆	cmqs
跽	jpni
绳	svjk
缲	svju
铒	eqfl
焗	jpnj
佰	bhas
绱	svlj
糨	jpnn
锷	eqjg
纱	svmo
锇	eqtl
骟	svsc
鹣	jpns
驷	svse
踽	jprv
撮	cmsc
蹻	jptj
缫	svvk
桊	jpuu
鸶	svvs
埤	brrx
绶	svwc
爝	jpwf
窣	svwx
蠲	jpwn
绥	svwx
跏	jpxj
婀	exbj
蹴	jpya
磉	swcu
跻	jpyr
攒	cmtb
砷	swks
跤	jpyw
痾	eybj
弑	swuf
镢	jqah
刹	swuj
邶	bhdb
娠	sxag
钜	jqdv
姒	sxch
妁	sxeo
撺	cmvk
镌	jqhx
邵	sxjb
奀	facc
恕	sxji
钾	jqks
劭	sxjx
孀	sxsk
姝	sxts
锯	jqnj
婶	sxvk
锔	jqnj
嬗	sxys
锩	jqpv
飒	syew
竦	syfv
孰	syje
肤	fagw
塾	syjr
腓	fahh
疝	sykl
徼	jqrt
痧	sylm
麝	synf
彪	bhdq
铗	jqsw
韶	sysj
锏	jqus
撤	cmyt
镓	jqva
豚	taav
肽	taco
孱	cnbb
铰	jqyw
殄	tahq
肪	fayv
腆	takw
劫	jrcx
均	jreg
鹎	brxs
弛	cnbv
腯	taqk
赳	jrhb
赙	fbff
粜	tbps
趄	jrhk
陀	tbve
蛏	cncr
邰	tcjb
臼	jrvs
炱	tcjp
敫	jryt
贩	fbqc
皎	jryw
苔	tdcj
螬	cnfs
慝	tddi
郏	jsbb
薹	tdfr
豇	jsjf
荼	tdhg
茼	tdkj
萜	tdkj
菔	fdac
菟	tdok
莛	tdtc
薙	tdty
芾	fdfv
葶	tdyf
獭	tefb
逖	tepi
蝽	cngs
鸵	tese
嵇	jtak
髫	tfcj
酞	tfco
聽	tfgi
酴	tfhg
忑	tfio
茯	fdhc
酮	tfkj
榘	jtdu
醍	tfsf
苻	fdhf
醣	tfyj
焘	tgfo
犄	jtcj
秸	jtfj
耥	tglj
箕	jtfw
忝	tgmo
匪	fdhh
韬	tgwr
笺	jtgv
瑭	tgyj
蒽	fdki
倜	thej
笄	jtgw
仝	thfs
笕	jtke
俦	thgf
龆	thhj
稷	jtke
犋	jtkw
蟾	cnoj
犍	jtnc
佃	thks
葑	fdrf
傥	thle
氽	thll
毽	jtnc
羼	cnpg
佻	thwx
辐	fdsk
僮	thyk
蘩	fdtm
侪	thyr
稼	jtva
谭	tifx
晡	bsfv
笳	jtxj
橛	juah
谄	tior
裼	tisq
莩	fdwb
祧	tiwx
栉	judb
螆	cnpv
呔	tjco
柩	jude
楷	judr
啕	tjet
鼍	tjjk
芬	fdwx
柜	judv
俵	bhge
嚏	tjxb
枸	juej
啼	tjyk
孵	febb
桔	jufj
槿	jufk
囤	tkdl
凫	feee
町	tkff
椒	juhc
峒	tkkj
楫	jujf
槛	jujk
畋	tktw
螭	cnyk
疃	tkyk
枧	juke
椇	jukw
汰	tlco
楗	junc
曝	bssl
椐	junj
淘	tlet
桷	juoe
匐	fesk
榉	juog
棠	tliu
阄	juok
漯	tlkm
恻	cobj
湉	tloj
桕	jurv
澹	tloj
溻	tlsc
笆	btbs
沱	tlve
烫	tlvp
枷	juxj
滔	tlwr
洮	tlwx
溏	tlyj
潼	tlyk
挞	tmci
酚	ffwx
捅	tmck
摊	tmcy
纠	jvbb
秕	btde
掭	tmgm
抟	tmgv
敷	ffyt
麸	fgeg
奉	fggl
绛	jved
拖	tmtb
膊	baff
忖	cofo
缙	jvfs
螗	tmyj
珐	fgrc
蜩	tnej
謇	jvgj
屉	tnfl
筚	btdx
忡	coks
蹇	jvgp
蜕	tnpe
怆	cohv
蜓	tntc
绢	jvja
鲐	tocj
饨	todl
鲦	toeu
恸	togx
剿	jvkj
惝	tolj
玢	fgwx
鳎	tosc
惕	tosq
缣	jvpn
饧	tovq
烃	tpcf
瑷	agwc
垡	fhdr
羰	tpgp
冁	tpkf
骏	jvse
煺	tpni
簸	btfc
鹈	tpns
驹	jvsj
郯	tppb
蹋	tpsc
缰	jvss
跎	tpve
惝	colj
誊	tpyj
俸	fhgg
糖	tpyj
龅	bhhn
铽	tqdi
镡	tqfx
骥	jvsw
铴	tqlq
镗	tqlr
窭	jvwx
钭	tqox
锬	tqpp
蜚	fhhn
钍	tqrr
钽	tqss
铤	tqtc
矶	jwee
硷	jwho
铊	tqve
铫	tqwx
礁	jwho
坍	treo
斐	fhhw
礓	jwss
埕	trjg
垌	trkj
碣	jwsv
堍	trok
俘	fhwb
赯	trrj
婕	jxds
鲳	coss
婧	jxga
坨	trve
忏	cotl
偾	fhxb
遢	tsci
赍	jxhb
剔	tsej
妗	jxhi
昙	tsgc
暾	tsyt
颋	ttcb
嘏	jxjc
颓	tteb
兢	jxje
秃	ttee
祓	fiac
怅	cotv
箨	ttmg
袈	jxje
箅	btka
乇	ttvv
迦	jxji
笤	ttxj
饬	cotx
闼	tuci
袱	fihc
檮	tuff
诽	fihh
樘	tulr
戟	jxsd
柝	tuqs
憷	coub
梃	tutc
柁	tuve
怵	couo
讣	fill
阗	tuxw
彖	tvav
姣	jxyw
疖	jybb
绨	tvpn
膑	bavw
竣	jyce
痉	jycf
骀	tvsj
扉	fihh
窕	tvwx
馇	cous
砼	twhf
廑	jyfk
砣	twve
鼗	twxc
箔	btlr
疥	jyhr
妥	twxs
怊	coxj
帑	txck
唪	fjgg
婷	txyf
呋	fjgw
瘫	tycy
庹	tyfn
鹫	jyjs
篦	btre
疽	jyks
瘕	jync
痰	typp
麂	jyne
尪	wagl
肟	wagv
腽	wask
咈	fjnv
脘	wave
戊	wavo
殡	bavw
黻	fjpc
阢	wbav
隈	wbkd
隗	wbrc
黼	fjpf
骛	wcbs
稗	btrx
婺	wcbx
噃	fjwk
芄	wdeo
芴	wdeq
齑	jywl
蹰	cpaf
莴	wdjk
辋	wdky
痂	jyxj
罘	fkal
胯	kacg
脍	kahc
萎	wdtx
胩	kahl
莞	wdve
菀	wdvv
蓊	wdwc
馗	kapr
帆	fkeo
蕹	wdyy
贶	kbje
酆	fkgb
猥	wekd
隗	kbrc
刎	weqj
刳	kcgj
邬	wesb
夸	kcgv
脖	baxb
夼	kcrl
幞	fkjg
軎	wfjj
踔	cphx
畈	fkqc
蒯	kdaj
芤	kdbv
玮	wggv
焯	cphx
葵	kdcg
蒈	kddr
韦	wgvl
轲	kdfj
琬	wgvv
玟	wgyw
佤	whdv
瞓	fkyr
捱	amar
蒉	kdkb
龌	whhr
淝	flab
仵	whts
莰	kdrh
倭	whtx
冁	cpkf
沣	flgs
蔻	kdvh
袜	wigl
掰	btwm
诿	witx
狯	kehc
呜	wjes
瀵	flpw
唔	wjfj
髡	kfca
唯	wjhy
	wjjk
笾	btxi
喔	wjnr
哇	wjrr
踹	cpkk
嗡	wjwc
崴	wkax
壳	kfie
滏	flwg
聩	kfkb
醌	kfse
帏	wkgv
凹	wkls
幄	wknr
戡	kfwd
嵬	wkrc
汾	flwx
畹	wkvv
勘	kfwx
洧	wlaa
浯	wlfj
涪	flyj
刊	kgjj
涡	wljk
琨	kgse
涠	wlkg
聱	kgtf
沩	wlpv
杓	bueo
骜	kgts
鋈	wltq
螯	kgtn
拊	fmhf
潍	wlvy
汶	wlyw
挝	wmfi
摁	fmki
搵	wmkk
侉	khcg
拂	fmnv
揾	wmsk
郐	khgb
炒	cpmo
尉	wngf
侩	khhc
俾	bhrx
佧	khhl
蜗	wnjk
龈	khhn
蜿	wnvv
炊	cpoh
鲔	woaa
蹉	cppf
傀	khrc
怃	wogw
蚨	fngw
艴	fnob
龛	khse
倥	khvf
焐	wpfj
伉	khye
煨	wpkd
烷	wpve
诓	kidg
炆	wpyw
钨	wqes
诳	kieg
艉	wqnt
冚	kikl
鼯	wrcj
魍	wrcy
坞	wres
裉	kins
圬	wrgv
蜉	fnwb
璺	wrkg
塆	wryn
糍	cppv
喹	kjcr
鹉	wsds
鲋	fohf
韪	wsfg
哐	kjdg
豌	wsjv
鲱	fohh
啃	kjha
悱	fohh
慈	cpvi
牾	wtfj
迕	wtii
哙	kjhc
咔	kjhl
鯡	fohh
魏	wtxc
踟	cptj
逶	wtxi
怫	fonv
杌	wuav
嘅	kjnd
梧	wufj
闱	wugv
嗑	kjrk
梆	bugb
阌	wuwc
鳆	fote
寤	wvbj
纨	wveo
吭	kjye
鲼	foxb
纬	wvgv
挨	amct
绾	wvvk
髋	kkae
毋	wvws
蹿	cpvk
翁	wwcc
髁	kkak
硪	wwtl
鲂	foyv
睽	kkcg
鹚	cpvs
娓	wxnt
眍	kkdw
媪	wxsk
岢	kkfj
斡	wxsx
瞶	kkkw
痦	wyfj
庑	wygw
岿	kkmn
癐	wyhs
粪	fpfw
剀	kknj
瞌	kkrk
趺	fpgw
痿	wytx
跗	fphf
紊	wywm
崆	kkvf
厦	xaae
燔	fpwk
黡	xaco
浍	klhc
蹴	cpya
蹯	fpwk
瞰	kkvt
溘	klrk
腊	xafs
躔	cpyr
腺	xarl
揆	kmcg
戌	xaso
挎	kmcg
傍	bhyy
豨	xawk
揩	kmdr
抠	kmdw
陉	xbcf
拷	kmfd
粹	cpyx
扛	kmfs
隙	xbmm
彬	buuq
扣	kmjj
隰	xbso
钒	fqeo
搕	kmrk
熊	xcao
薤	xdah
镄	fqnb
荀	xdes
捆	kmku
蕈	xdfx
裱	bige
莶	xdho
荤	xdid
荥	xdil
舫	fqyv
蝰	kncr
葸	xdki
煕	xdko
钫	fqyv
蚵	knfj
荨	xdnf
鼢	frcx
芎	xdnv
藓	xdog
薢	xdot
蛞	kntj
蓰	xdqh
蝌	kntx
槟	buvw
葙	xduk
菥	xduq
喾	koij
辖	xdvj
愦	kokb
芗	xdvw
阜	frxx
馈	kokb
莘	xdyx
猃	xeho
悝	koks
狎	xeks
艚	cqfs
獬	xeot
悃	koku
郇	xesb
霏	fshh
猩	xest
狭	xesw
獯	xeto
褙	biha
鲲	kose
忾	kots
醑	xfba
篚	ftdh
敖	agtw
髹	xfcu
觋	xfhe
舡	cqfs
囍	xfjj
夔	kphe
熹	xfjo
跬	kprr
筏	fthd
炕	kpye
昔	xfss
镡	cqfx
酰	xfte
锴	kqdr
醺	xfto
氟	ftnv
酗	xfwb
钶	kqfj
醯	xfyk
孢	bben
铿	kqjr
锉	cqhr
邢	xgbb
缶	ftsl
锟	kqse
锞	kqks
瑄	xgvs
锎	kqug
砉	xgww
钪	kqye
歔	xhdh
稃	ftwb
偕	xhdr
馥	ftse
係	xhem
缏	bvhf
僖	xhfj
坷	krfj
儇	xhke
垲	krkn
坤	krks
榧	fudh
翕	xhsc
徂	cqks
歙	xhsh
堀	krnb
鸺	xhus
阀	fuhd
坎	kroh
坳	krvx
诩	xicc
褊	biik
梵	fuue
禧	xifj
禊	xigc
圹	kryw
祆	xigw
禤	xikc
暌	kscg
棼	fuux
旷	ksyw
徜	cqlj
	xiqs
桴	fuwb
坑	krye
裼	xisq
筐	ktdg
袄	xitw
绊	bvps
谖	xiwc
喐	xjab
岙	ktkl
稞	ktks
枋	fuyv
鴞	xjdo
咥	xjdr
鸮	xjds
筘	ktmj
樊	fuwc
绂	fvac
哮	xjfb
咁	xjfl
筷	kton
箜	ktvf
噱	xjha
噏	xjhc
氪	ktxe
犒	ktyj
喺	xjhm
咻	xjhu
绯	fvhh
绋	fvnv
呷	xjks
栲	kufd
嗅	xjrc
阪	bbqc
唏	xjwk
槛	kujk
骹	xkaw
锸	cqtl
棵	kuks
阃	kuku
盱	xkgl
岘	xkke
岫	xkks
栝	kutj
黠	xkoj
阚	kuvt
崤	xkwa
骠	bvsm
眩	xkyv
闶	kuye
纺	fvyv
绔	kvcg
浚	xlce
镩	cqvk
洵	xles
孚	fwbs
渫	xlfu
郛	fwbb
潝	xlhc
缂	kvfk
瀣	xlhh
骒	kvsk
矾	fweo
镲	cqvm
浔	xlnf
溴	xlrc
洫	xlrv
窟	kvwb
窥	kvwe
窠	kvwk
淅	xluq
纩	kvyw
淆	xlwa
磡	kwfx
驳	bvsw
浠	xlwk
缤	bvvw
艟	cqyk
撷	xmfb
磕	kwrk
携	xmhx
砩	fwnv
踅	xmqp
擤	xmra
邝	kybb
窆	bvwi
揎	xmvs
釜	fwwg
虾	xnfo
蚬	xnke
疴	kyfj
廒	kygt
蛸	xnla
遐	xnni
巽	xnnw
蟓	xnoe
屣	xnqh
螅	xnri
铲	cqyo
廓	kyyb
蟋	xnwi
堃	kyyr
邂	xoei
朤	laaa
恂	xoes
胧	laae
臭	crco
忿	fwxi
峃	xoik
泶	xoil
礴	bwdf
玺	xomg
鲟	xonf
馅	xoor
聋	laef
尥	laeo
馐	xopb
囱	creo
忻	xoqs
砻	laew
饷	xorj
鳕	xosn
惺	xost
胪	lahn
饩	xots
邡	fybb
饧	xovq
糈	xpba
粞	xpfv
坻	cres
翔	xpgc
羲	xpgd
羡	xpgh
碥	bwik
籼	xpkl
躞	xppc
脶	lajk
烜	xpss
跣	xpte
膦	lapd
跹	xpti
鹩	lass
痱	fyhh
脷	latj
燮	xpyc
肋	laxx
炫	xpyv
徇	xqes
舾	xqfv
揞	amys
镡	xqfx
臁	layn
徙	xqhh
埕	crjg
销	xqla
赂	lbej
锨	xqqh
爨	crkp
鑫	xqqq
锡	xqsq
铣	xqte
肱	gaac
镟	xqyb
镶	xqye
舷	xqyv
铉	xqyv
锌	xqyx
魈	xrca
鼷	xrcc
魆	xrcd
龚	gaew
鹨	lccs
圩	xrgl
奁	lcdw
茏	ldae
墀	crnt
埙	xrjb
苈	ldax
肛	gafs
蓼	ldcq
囟	xrww
坼	crqs
尬	gahr
辂	ldej
煦	xseo
轹	ldel
霰	xsft
肝	gagl
勖	xskx
裨	birx
尴	gajk
苓	ldhi
暇	xsnc
轳	ldhn
胱	gale
蔹	ldht
曛	xsto
胍	gaqv
暄	xsvs
晞	xswk
莅	ldhy
砭	bwwi
芦	ldis
莨	ldis
筱	xtht
膈	gasp
氙	xtkl
荦	ldit
熏	xtoo
晨	csag
筅	xtte
萝	ldke
箱	xtuk
蒗	ldli
稀	xtwk
谤	biyy
栩	xucc
辚	ldpd
栖	xufv
蒌	ldpx
枵	xujd
豉	csjc
杏	xujj
柙	xuks
菱	ldre
榍	xuna
陔	gbyh
橡	xuoe
皙	xuqr
鬲	csjp
阋	xure
蔺	lduy
檄	xurt
鹇	xuus
赅	gbyh
楦	xuvs
荔	ldxx
蓠	ldyk
缬	xvfb
绁	xvfl
贬	bbwi
癸	gcgw
飨	xvhi
卵	lebo
巡	xvii
坌	bwxr
绡	xvla
雒	lejy
骁	xvsa
菰	gdbq
骧	xvse
猡	leke
宪	xvte
匦	gdde
绣	xvtx
猁	letj
穸	xvwe
窸	xvwi
窨	xvws
遛	lexi
穴	xvww
碚	bwyj
鬣	lfcv
醪	lfcq
欷	xwah
苷	gdfl
苟	gdej
晁	cswx
矽	xweo
貅	xweu
硒	xwfv
硎	xwgj
稠	ctej
鹳	gdjs
硖	xwsw
醴	lfkp
碹	xwvs
陂	bbxc
嬉	xxfj
匮	gdkb
絮	xxjm
嬛	xxke
茛	gdns
妡	xxqs
媳	xxri
辊	gdse
娴	xxuu
勰	xxxi
磅	bwyy
酹	lfwf
珑	lgae
庥	xyhu
贲	bxdb
黐	cthk
靓	lgae
癣	xyog
廨	xyot
庠	xypg
弁	bcal
琏	lgdi
歆	xysh
耢	lgdx
痫	xyuu
矬	cthr
畜	xyvk
轱	gdxj
痃	xyyv
莞	gdve
辛	xyxx
瑯	lgib
菇	gdxj
妣	bxde
魇	yacc
荄	gdyh
餍	yaci
璘	lgpd
厣	yack
藁	gdyu
胰	yads
殪	yafp
耧	lgpx
赝	yahb
袄	aitw
耒	lgso
刖	yajj
嫠	lgtx
胭	yakc
吡	bjde
媵	yapx
逛	gegi
琳	lguu
璃	lgyk
腴	yarv
篡	ctkc
尢	yavv
腋	yaye
臆	yayi
臃	yayy
乘	cthe
鹦	ybbs
罂	ybbt
鹌	acks
贻	ybcj
哺	bjfv
阽	ybhj
猓	geks
隅	ybks
佬	lhfe
疋	ybso
罉	ctlm
犷	geyw
傈	lhfu
予	ycbb
旮	gess
豫	ycbe
鹬	ycbs
羿	ycca
孛	bxib
贾	gfbb
邻	lhib
翌	yccy
贡	gfbb
龄	lhhi
恿	ycki
甬	ycks
瓴	lhid
奄	ycks
巩	gfeo
颐	ydab
酐	gfgl
荫	ydba
蓣	ydcb
苡	ydch
毂	gfic
俚	lhks
倮	lhks
茚	ydeb
葾	ydei
彀	gfic
哔	bjdx
鸢	ydes
鸬	lhns
芫	ydge
芋	ydgl
莜	ydht
偻	lhpx
莹	ydig
迓	ydii
俪	lhsk
鹁	bxis
萦	ydim
赁	lhtb
蓥	ydiq
氚	ctrl
茔	ydir
彧	ydjs
仂	lhxx
煕	ydko
篪	ctqe
瞽	gfjk
蔚	ydnf
鞲	gfkf
弋	ydoo
萸	ydrv
郾	ydsb
诔	ligs
欤	ydsh
畚	bcck
翳	ydtc
裣	liho
轶	ydts
汞	gfll
莠	ydtx
毳	cttt
轧	ydvv
禄	linl
菀	ydvv
褛	lipx
轺	ydxj
薏	ydyi
菸	ydyo
谰	liuf
啵	bjlc
冧	liuu
狁	yece
猗	yecj
犽	yedl
匀	yegg
狳	yehg
聒	gftj
颍	yelb
咙	ljae
猿	yere
喱	ljak
秤	ctsw
嘹	ljam
肄	yetn
呖	ljax
眢	yevk
嘣	bjka
夤	yevw
猺	yewt
狺	yeyj
喇	ljfj
酏	yfbv
嘞	ljfx
杈	cuco
唥	ljgi
酽	yffl
酤	gfxj
壹	yfip
呤	ljhi
鄞	yfkb
鞅	yfkk
唳	ljic
橙	cucp
吕	ljjj
啰	ljke
酉	yfvs
玥	ygaa
觏	ggfe
囉	ljky
珙	ggfw
遘	ggfi
琊	ygdb
柽	cucr
玡	ygdl
噜	ljos
喽	ljpx
锕	aqbj
鼋	ygek
珏	yggl
耕	gggw
嚟	ljtl
盂	ygkl
囖	ljty
瓣	byax
啉	ljuu
琰	ygpp
叻	ljxx
韫	ygsk
瑰	ggrc
珧	ygwx
眬	lkae
侑	yhaa
瞭	lkam
珪	ggrr
髎	lkaq
俑	yhck
琯	ggvk
卟	bjll
伛	yhdw
崂	lkdx
佝	ghej
辩	byax
俨	yhfl
逻	lkei
龉	yhhj
龈	yhhn
俣	yhjg
卣	yhkv
噃	bjwk
椿	cugs
囹	lkhi
疤	bybs
個	ghkj
囵	lkhe
罹	lkoy
佯	yhpg
瞵	lkpd
龠	yhsk
楱	cugg
仡	yhtv
嵝	lkpx
佾	yhwa
刽	ghgj
祐	yiaj
崃	lksw
诒	yicj
枞	cuhh
郓	yidb
颌	ghsb
辫	byax
祎	yigv
罱	lkxg
詈	lkyj
椎	cuhy
泷	llae
谀	yirv
仡	ghtv
潦	llam
洌	llaj
谊	yivk
铵	aqvx
沥	llax
泐	llbx
谳	yixc
郧	yjbb
倌	ghvk
涝	lldx
邺	yjbb
吔	yjbv
槎	cupf
芭	bdbs
涟	lldi
袼	giej
咭	yjfj
泺	llel
濑	llfb
瘭	byfm
噖	yjgi
溧	llfu
沦	llhe
槌	curi
咿	yjhn
泠	llhi
嘢	yjkb
樗	cusg
哕	yjke
喁	yjks
啱	yjkw
吲	yjnl
诟	giqj
嗌	yjpk
吖	yjpl
阊	cuss
澧	llkp
漯	llkm
呦	yjvx
诖	girr
噫	yjyi
唁	yjyj
哜	yjyr
渌	llnl
喑	yjys
囿	ykaa
髃	ykak
诂	gixj
睚	ykar
涞	llsw
邮	ykbb
癍	bygg
杵	cuts
漤	llux
峄	ykcg
喐	gjab
崦	ykck
岈	ykdl
粱	llxp
棰	cutl
嶷	ykeb
漉	llye
圄	ykfj
崾	ykfx
噶	gjdv
嵛	ykhj
濂	llyn
枨	cutv
鎏	llyq
夯	bcxx
甴	ykls
咁	gjfl
黟	ykoe
滦	llyu
圉	ykrp
曱	yksl
郴	cuub
哽	gjfv
撩	lmam
揦	lmfj
曳	yksw
昳	ykts
嗰	gjhj
吤	gjhr
峪	ykwj
褒	byhe
拎	lmhi
捩	lmic
叭	bjww
剐	gjkj
滢	yldg
楂	cuus
潆	yldm
摞	lmkm
咣	gjle
攞	lmky
撸	lmos
呙	gjkw
潝	ylhc
嘅	gjnd
瀹	ylhk
豳	bkaa
洇	ylkc
哏	gjns
泱	ylks
汩	ylks
捋	lmwf
檫	cuvm
漾	ylpi
椽	cuva
沂	ylqs
啩	gjrl
浴	ylwj
蛎	lnad
淫	ylwt
蝲	lnfj
蜡	lnfs
瓿	byjd
瀛	ylye
蛉	lnhi
撄	ymbx
揠	ymdx
嗝	gjsp
榱	cuye
揶	ymfb
逯	lnli
挹	ymjb
揖	ymjf
拽	ymks
押	ymks
抰	ymks
锿	aqye
掾	ymva
蝼	lnpx
履	lnqe
鹘	gkas
掖	ymye
螈	ynam
弪	yncf
榇	cuyu
蚜	yndl
蠊	lnyn
蜮	ynds
刿	gkej
蝓	ynhj
鲢	lodi
蚰	ynks
岣	gkej
蚓	ynnl
慄	lofu
蝤	ynpf
蛘	ynpg
鳓	lofx
鬻	ynpp
亳	byjt
鲈	lohn
绌	cvbl
鳢	lokp
蜴	ynsq
帼	gkkg
鲤	loks
蚴	ynvx
悝	loks
畀	bkal
鱿	yoav
崮	gkkj
怿	yocg
瞶	gkkw
鲮	lore
鲡	losk
馀	yohg
恽	yoid
悒	yojb
懔	loym
怏	yoks
粝	lpad
绸	cvej
燎	lpam
愠	yosk
饫	yotw
卞	byll
崩	bkaa
鳐	yowt
躏	lpdy
鳙	yoyn
遴	lpei
踊	ypck
罟	gkxj
燿	ypcy
猷	ypfc
烙	lpej
熘	lpek
绰	cvhx
蹓	lpek
烨	yphx
崞	gkyb
茇	bdac
跞	lpel
烊	yppg
髌	bkaw
燚	yppp
粼	lpev
燠	yprc
	cvks
煜	ypsy
炀	ypvq
沟	glec
铕	yqaa
巢	cvks
铘	yqdb
钺	yqdv
泔	glfl
殷	yqec
铅	yqej
剿	cvkj
躐	lpvv
铟	yqkc
瘢	byqc
铀	yqks
骣	cvsb
舣	yqow
徉	yqpg
镒	yqpk
钌	lqbb
钇	yqvv
镠	lqcq
铫	yqwx
庳	byrx
镱	yqyi
铹	lqdx
舁	yral
塬	yram
镏	lqek
铑	lqfe
鼹	yrcx
淦	glqq
骋	cvsd
舻	lqhn
垭	yrfl
涫	glvk
堙	yrfr
牖	yrif
锒	lqis
澉	glvt
劓	yrkj
镙	lqkm
垠	yrns
锂	lqks
圯	yrnv
髀	bkax
垚	yrrr
镥	lqos
埸	yrsq
垸	yrve
骖	cvsq
尜	gmcm
沽	glxj
墉	yryn
牗	yryn
铼	lqsw
镧	lquf
聱	agtf
雩	ysgv
锊	lqwf
晔	yshx
镰	lqyn
霪	yslt
锍	lqyr
厕	cabj
霠	ysyi
垅	lrae
坜	lrax
迤	ytbi
掴	gmkg
氩	ytfl
皊	lrhi
竽	ytgl
摑	gmks
秧	ytks
垆	lrhn
荜	bddx
塄	lrky
氲	ytsk
箢	ytvv
墚	lrlu
埒	lrwf
樱	yubx
阉	yuck
枒	yudl
昽	lsae
栎	yuel
岜	bkbs
桠	yufl
赉	lsbb
闫	yugs
柚	yuks
旯	lsee
掼	gmvb
搁	gmuj
撖	gmvt
樾	yurd
鬲	lsjp
橼	yuva
鬯	cwbe
楹	yuxk
阏	yuyo
宥	yvaa
厝	cafs
蛤	gnhj
鹂	lsks
寅	yvfw
碜	cwcq
纡	yvgl
础	cwbl
邕	yvjb
礤	cwdm
蛊	gnkl
幺	yvoo
彝	yvpa
缢	yvpk
蝈	gnkg
晾	lsym
驿	yvsg
蜾	gnks
濒	blhb
艮	gnso
窬	yvwj
腠	cagg
窨	yvws
黧	lteo
窈	yvwx
虼	gntv
篥	ltfu
稂	ltis
砑	ywdl
稆	ltjj
爰	ywgc
砗	cwds
彩	cwuq
肏	cwkh
鹆	ywhs
犁	ltjt
釉	ywks
芘	bdde
舀	ywrv
繇	ywtm
鹞	ywts
汆	cwll
蛄	gnxj
箓	ltnl
嫄	yxam
鳜	goah
氯	ltnl
氇	ltos
孕	yxbs
睥	bkrx
篓	ltpx
簏	ltye
磁	cwpv
觥	goee
笠	ltyo
媪	yxsk
篱	ltyk
栊	luae
鲧	goem
疣	yyav
枥	luax
觚	goeq
瘿	yybx
翊	yycc
痍	yyds
鲠	gofv
疟	yyds
栎	luel
裔	yyej
鲴	gokj
痈	yyes
楋	lufj
痖	yyfl
詏	yygx
楝	lufv
鳏	gokm
阑	lufv
柃	luhi
嬴	yyje
栌	luhn
庸	yyns
埯	arck
榔	luib
阆	luis
彦	yyqw
鲑	gorr
榄	luje
裒	yyre
庾	yyrv
瘐	yyrv
椤	luke
碴	cwus
卜	blll
樑	lulu
瘗	yysr
遊	yyti
棂	lunp
脞	cahr
饔	yyvi
壅	yyvr
橹	luos
赟	yywb
羔	gpgo
癔	yyyi
瘀	yyyo
瘖	yyys
臓	zadd
肫	zadl
檑	lusk
胝	zaes
榈	luuj
肘	zafo
馆	govk
炔	gpnw
胗	zahq
椋	luym
婪	luux
檩	luym
寮	lvam
媸	cxbn
臜	zatb
胙	zatl
泌	blio
臢	zatw
腙	zavm
馘	gprs
膣	zavr
寥	lvcq
殖	zaxk
殂	caks
孖	zbbs
绺	lvej
钩	gqec
陬	zbfc
铬	gqej
陟	zbhm
纶	lvhe
婥	cxhx
骘	zbhs
缧	lvkm
赚	zbpn
舸	gqfj
赠	zbps
阼	zbtl
邋	lvki
濞	blra
贮	zbvs
矗	cxkk
赃	zbyr
锢	gqkj
蚤	zcnn
骊	lvsk
驴	lvsi
藸	zdas
骝	lvsk
嫦	cxlk
轾	zddr
锟	gqse
蘸	zdfo
〇	lvvv
赜	zdgb
镉	gqsp
蓁	zdgt
锆	gqtj
茈	zdhe
塍	capr
轸	zdhq
轵	zdjw
缡	lvyk
硌	lwej
菹	zdlk
砾	lwel
藻	zdlu
钆	gqvv
驙	zdos
錾	zdqq
磷	lwpd
钴	gqxj
郅	zdrb
砬	lwyo
臻	zdrt
镐	gqyj
蕞	zdsc
硫	lwyr
荮	zdvf
嫘	lxkm
苎	zdvs
娌	lxks
蔗	zdyo
皋	grcx
鸠	zees
娼	cxss
橥	zefu
疬	lyax
昝	zels
坩	grfl
鵻	zeoy
癃	lybt
炙	zepw
埂	grfv
旨	zess
猹	zeus
瘳	cycq
疠	lydw
鄹	zfcb
埚	grjk
髭	zfce
癞	lyfb
酯	zfes
瘈	cygc
酎	zffo
喆	zfjj
瘌	lyfj
浜	blrw
垢	grqj
翥	zfsc
孪	lyjb
瘛	cygi
疵	cyhe
羸	lyje
躬	grnv
酢	zftl
蠃	lyje
脔	lyjh
斟	zfwx
膪	cayj
峦	lyjk
灞	blsa
耔	zgbs
睾	grrg
挛	lyjm
銮	lyjq
奏	zggw
痤	cyhr
圭	grrr
栾	lyju
盏	zgkl
塥	grsp
娈	lyjx
粢	zgop
瘰	lykm
圪	grtv
瓒	zgtb
垓	gryh
亵	lyme
毖	bdei
瑱	zgxw
璋	zgyx
卒	cyhx
晷	gsej
疮	cyhv
瘘	lypx
仗	zhao
旰	gsgl
赀	zheb
仉	zhee
膂	lyta
鬲	gsjp
痢	lytj
旒	lytr
砦	zhew
鹑	cyjs
畲	zhgk
炅	gspw
侦	zhhb
龇	zhhe
亘	gsss
俎	zhhk
僬	zhho
杲	gsuu
倬	zhhx
率	lyvx
占	zhjj
廪	lyym
腼	maak
嗄	ajae
仲	zhks
笱	gtej
侏	zhts
伫	zhvs
罐	gtdy
廛	cykr
僮	zhyk
隹	zhys
殁	maec
冇	makk
诼	ziav
筻	gtfv
谮	zids
脒	maps
鸩	zies
祇	zies
诹	zifc
孖	mbbs
陌	mbas
秆	gtgl
谘	zigj
瘥	cypf
祉	zihl
鹛	mbks
诊	zihq
孭	mbkw
竿	gtgl
勐	mbkx
诅	ziks
滗	bltt
谵	zioj
瞀	mcbk
禚	zipo
搿	gthm
郜	gtjb
鍪	mcbq
诌	zion
啻	cypj
禛	zixw
谆	ziyb
谪	ziyj
咗	zjaf
啄	zjav
啭	zjdg
咂	zjdk
啁	zjej
啫	zjfs
茆	mdeb
喋	zjfu
鸹	gtjs
呲	zjhe
颟	mdfb
唑	zjhr
箍	gtmk
咀	zjks
哳	zjmq
茉	mdgl
簋	gtnk
黹	zjpl
唣	zjrd
蔑	mdka
牿	gttj
瞢	mdkk
甍	mdkd
吒	zjtv
瘁	cyyx
咤	zjvt
苜	mdks
丞	cbss
喥	zjyc
嗻	zjyo
鹋	mdks
篙	gtyj
苠	mdnv
帻	zkgb
牯	gtxj
帧	zkhb
殆	dacj
畛	zkhq
稿	gtyj
罩	zkhx
帜	zkjw
崽	zkki
盅	zkkl
瞩	zknr
胨	dadl
瞻	zkoj
摹	mdsm
罾	zkps
嵫	zkpv
峙	zkrf
蓦	mdss
曳	zksw
帙	zkts
陲	cbtl
莓	mdtv
募	mdsx
荬	mdvc
藐	mdwe
枸	guej
幛	zkyx
劢	mdxx
殚	dapk
蘼	mdyh
濯	zlcy
柑	gufl
潴	zles
蘑	mdyw
渚	zlfs
卯	mebb
翱	arcc
猸	mebk
浈	zlhb
梗	gufv
沾	zlhj
澡	zlju
浙	zlmq
桧	guhc
浊	zlnn
沢	zlnw
浞	zlpp
桄	gule
滋	zlpv
洙	zlts
犸	mevs
腚	davf
滓	zlvx
酩	mfej
髦	mfct
耄	mfet
漳	zlyx
鞔	mfkk
拙	zmbl
醚	mfpi
苯	bdfw
酶	mftv
擢	zmcy
闺	gurr
贽	zmeb
搊	zmeb
挚	zmem
翀	ccck
絷	zmem
珉	mgnv
鸷	zmes
槔	gurx
挝	zmfi
瑁	mgsk
拽	zmks
搌	zmnf
栝	gutj
玟	mgyw
堕	dbar
耱	mgyw
撙	zmpf
侔	mhct
哲	zmqj
芈	mhhg
蜇	zmqn
渤	blxx
撮	zmsc
橄	guvt
揸	zmus
仫	mhwc
掟	zmvf
搾	zmvt
阽	dbhj
谟	midc
摘	zmyj
槁	guyj
摭	zmyo
谧	miik
捽	zmyx
蛭	zndr
袂	minw
帚	znik
咫	znjw
粥	znpn
谜	mipi
晝	znss
谩	misc
赕	dbpp
幂	misk
宄	gvee
蜘	zntj
螲	znvr
蟅	znyo
哞	mjct
蛀	znys
菴	adck
觯	zoek
唛	mjge
鲰	zofc
鲭	zoga
呒	mjgw
邹	zonb
陡	dbrh
绠	gvfv
馔	zonw
黾	mjks
鳟	zopf
怍	zotl
鲻	zovk
忪	zowc
忮	zoxc
槑	mjuu
皴	ccwc
嘧	mjvk
糌	zpes
呣	mjvo
遵	zpfi
纶	gvhe
邓	dcbb
嚤	mjym
趾	zphl
缑	gvht
焯	zphx
嵋	mkbk
燥	zpju
炽	zpjw
甑	zpkd
蒇	cdab
躅	zpkn
纲	gvkw
踭	zpon
峁	mkeb
踯	zppb
踬	zpqb
眄	mkfv
紶	gvrc
躜	zptb
怼	dcfi
踵	zptl
绲	gvse
孳	zpvb
眇	mkmo
岷	mknv
纥	gvtv
跖	zpww
铡	zqbj
锗	zqfs
缟	gvyj
钲	zqfs
铸	zqgf
眯	mkps
耷	dcfl
锃	zqjg
钊	zqjj
幔	mksc
舯	zqks
硌	gwej
舳	zqks
徵	zqkt
眊	mkts
湎	mlak
卮	zqsv
舴	zqtl
矸	gwgl
铢	zqts
锱	zqvk
漭	mlda
濛	mlda
漠	mldc
茬	cdar
镞	zqyt
硅	gwrr
趱	zrhb
趑	zrhh
懑	mldi
藸	cdas
泖	mleb
磙	gwye
齄	zrks
戤	gxcd
圳	zrrl
沔	mlfv
赭	zrrs
埴	zrxk
曌	zsaf
媾	gxgf
昃	zsah
嘏	gxjc
霑	zslj
渑	mljk
昭	zsxj
邨	cdbb
淼	mlll
箴	ztaj
邾	ztbb
哿	gxjj
簪	ztds
浼	mlok
秭	ztel
汨	mlss
箸	ztfs
箦	ztgb
鸪	gxjs
搣	mmap
雉	zthy
掹	mmbk
迮	ztii
辍	cdcc
描	mmdk
辜	gxjx
摸	mmdc
尕	gxmo
纂	ztkm
尛	mmmm
租	ztks
蔸	ddee
妫	gxpv
摱	mmsc
籀	ztmk
姤	gxqj
笊	ztql
扪	mmuv
笮	zttl
苳	ddeo
蜢	mnbk
蛑	mnct
稹	ztxw
蠓	mnda
杼	zucb
栉	zudb
桎	zudr
萹	bdik
蠛	mnda
疳	gyfl
榛	zugt
癐	gyhs
枞	zuhh
螨	mndf
棹	zuhx
鸫	ddes
槠	zuis
枳	zujw
螟	mniw
愍	mnti
樽	zupf
栀	zuqv
匾	bdik
甙	ddfl
柞	zutl
楂	zuus
虻	mnyv
懞	moda
榨	zuvt
柘	zuww
馍	modc
抦	bmfv
懵	modk
痼	gykj
梓	zuyx
赓	gynb
樟	zuyx
鳗	mosc
彘	zvde
庚	gyns
茨	cdgh
纣	zvfo
馒	mosc
赣	gysb
寨	zvgu
缲	zvju
悯	mouw
踎	mpaj
甾	zvks
戆	gysi
绉	zvon
辏	cdgg
缯	zvps
缒	zvri
缴	zvrt
驵	zvsk
熳	mpsc
萏	ddor
骓	zvsy
敉	mptw
缵	zvtb
焖	mpui
绽	zvvf
镅	mqbk
茈	cdhe
窀	zvwd
庋	gyxc
翃	hacc
艨	mqda
艋	mqbk
窄	zvwt
芏	ddrr
磔	zweu
碡	zwgv
镆	mqdc
铆	mqeb
砧	zwhj
砟	zwtl
虺	hann
钼	mqks
镁	mqpc
茌	cdhf
哉	zxdj
镘	mqsc
栽	zxdu
钔	mquv
姊	zxel
萣	ddvf
妯	zxks
贿	hbaa
嫜	zxyx
瘃	zyav
瘵	zyem
胲	hayh
坶	mrvo
揹	bmha
鹧	zyfs
瘈	zygc
函	hbbb
曚	msda
疹	zyhq
隳	hbam
卒	zyhx
菪	ddvw
麈	zyny
癥	zyqt
暝	msiw
隍	hbrg
鄣	zysb
戆	zysi
彰	zysq
苁	cdhh
蒂	ddyk
旃	zyte
痄	zytl
瓠	hcgq
霉	mstv
霾	mswk
疰	zyys
旻	msyw
痃	zyyv
