一下	yi	xia
一下	yi	xia
一世	yi	shi
一个劲儿	yi	ge	jin	er
一个劲儿	yi	ge	jin	er
一举	yi	ju
一举	yi	ju
一二	yi	er
一代	yi	dai
一代	yi	dai
一会儿	yi	hui	er
一会儿	yi	hui	er
一传十	yi	chuan	shi
一体	yi	ti
一体	yi	ti
一元化	yi	yuan	hua
一再	yi	zai
一再	yi	zai
一刹那	yi	cha	na
一刹那	yi	cha	na
一刻	yi	ke
一刻千金	yi	ke	qian	jin
一半	yi	ban
一半	yi	ban
一去不返	yi	qu	bu	fan
一句话	yi	ju	hua
一向	yi	xiang
一向	yi	xiang
一味	yi	wei
一味	yi	wei
一哄而上	yi	hong	er	shang
一哄而上	yi	hong	er	shang
一哄而起	yi	hong	er	qi
一哄而起	yi	hong	er	qi
一唱一和	yi	chang	yi	he
一唱一和	yi	chang	yi	he
一块	yi	kuai
一块儿	yi	kuai	er
一块儿	yi	kuai	er
一声令下	yi	sheng	ling	xia
一孔之见	yi	kong	zhi	jian
一孔之见	yi	kong	zhi	jian
一家子	yi	jia	zi
一家子	yi	jia	zi
一对	yi	dui
一小撮	yi	xiao	cuo
一小撮	yi	xiao	cuo
一带	yi	dai
一带	yi	dai
一年到头	yi	nian	dao	tou
一年到头	yi	nian	dao	tou
一律	yi	lv
一律	yi	lv
一心	yi	xin
一心	yi	xin
一心一德	yi	xin	yi	de
一心一德	yi	xin	yi	de
一息尚存	yi	xi	shang	cun
一息尚存	yi	xi	shang	cun
一手	yi	shou
一手	yi	shou
一扫而光	yi	sao	er	guang
一扫而光	yi	sao	er	guang
一把手	yi	ba	shou
一把手	yi	ba	shou
一整套	yi	zheng	tao
一整套	yi	zheng	tao
一早	yi	zao
一早	yi	zao
一时	yi	shi
一时	yi	shi
一时间	yi	shi	jian
一时间	yi	shi	jian
一暴十寒	yi	pu	shi	han
一条心	yi	tiao	xin
一条心	yi	tiao	xin
一来	yi	lai
一气	yi	qi
一水之隔	yi	shui	zhi	ge
一波又起	yi	bo	you	qi
一波未平	yi	bo	wei	ping
一派	yi	pai
一流	yi	liu
一流	yi	liu
一点儿	yi	dian	er
一点儿	yi	dian	er
一生	yi	sheng
一生	yi	sheng
一番话	yi	fan	hua
一直	yi	zhi
一直	yi	zhi
一相情愿	yi	xiang	qing	yuan
一瞬间	yi	shun	jian
一瞬间	yi	shun	jian
一穷二白	yi	qiong	er	bai
一端	yi	duan
一级	yi	ji
一而再	yi	er	zai
一脉相承	yi	mai	xiang	cheng
一脉相承	yi	mai	xiang	cheng
一般性	yi	ban	xing
一表人才	yi	biao	ren	cai
一表人才	yi	biao	ren	cai
一览表	yi	lan	biao
一览表	yi	lan	biao
一角	yi	jiao
一言一行	yi	yan	yi	xing
一言一行	yi	yan	yi	xing
一言堂	yi	yan	tang
一言堂	yi	yan	tang
一边	yi	bian
一边	yi	bian
一连	yi	lian
一连	yi	lian
一连串	yi	lian	chuan
一连串	yi	lian	chuan
一针一线	yi	zhen	yi	xian
一面	yi	mian
一面	yi	mian
一齐	yi	qi
一齐	yi	qi
丁香	ding	xiang
七一	qi	yi
七巧板	qi	qiao	ban
七绝	qi	jue
万万	wan	wan
万事	wan	shi
万事通	wan	shi	tong
万年	wan	nian
万年青	wan	nian	qing
万死一生	wan	si	yi	sheng
万水千山	wan	shui	qian	shan
万物	wan	wu
万籁	wan	lai
万里无云	wan	li	wu	yun
丈夫	zhang	fu
丈夫	zhang	fu
丈夫	zhang	fu
三伏	san	fu
三废	san	fei
三座大山	san	zuo	da	shan
三弦	san	xian
三昧	san	mei
三民主义	san	min	zhu	yi
三维	san	wei
三角洲	san	jiao	zhou
上下班	shang	xia	ban
上下级	shang	xia	ji
上乘	shang	cheng
上书	shang	shu
上任	shang	ren
上冻	shang	dong
上告	shang	gao
上品	shang	pin
上场	shang	chang
上好	shang	hao
上家	shang	jia
上尉	shang	wei
上届	shang	jie
上山下乡	shang	shan	xia	xiang
上峰	shang	feng
上工	shang	gong
上水	shang	shui
上溯	shang	su
上相	shang	xiang
上窜下跳	shang	cuan	xia	tiao
上缴	shang	jiao
上肢	shang	zhi
上议院	shang	yi	yuan
上访	shang	fang
上蹿下跳	shang	cuan	xia	tiao
上载	shang	zai
上载	shang	zai
上限	shang	xian
上风	shang	feng
下乡	xia	xiang
下人	xia	ren
下任	xia	ren
下功夫	xia	gong	fu
下地	xia	di
下工	xia	gong
下摆	xia	bai
下放	xia	fang
下水道	xia	shui	dao
下滑	xia	hua
下级	xia	ji
下脚料	xia	jiao	liao
下蛋	xia	dan
下议院	xia	yi	yuan
下野	xia	ye
下限	xia	xian
下陷	xia	xian
下马威	xia	ma	wei
不丹	bu	dan
不为所动	bu	wei	suo	dong
不乏	bu	fa
不仅仅	bu	jin	jin
不住	bu	zhu
不依	bu	yi
不便	bu	bian
不便	bu	bian
不再	bu	zai
不再	bu	zai
不利	bu	li
不利	bu	li
不力	bu	li
不力	bu	li
不单	bu	dan
不只	bu	zhi
不可一世	bu	ke	yi	shi
不可一世	bu	ke	yi	shi
不可抗力	bu	ke	kang	li
不可收拾	bu	ke	shou	shi
不可收拾	bu	ke	shou	shi
不可磨灭	bu	ke	mo	mie
不可胜数	bu	ke	sheng	shu
不可逾越	bu	ke	yu	yue
不合	bu	he
不周	bu	zhou
不善	bu	shan
不善	bu	shan
不定	bu	ding
不定	bu	ding
不对	bu	dui
不已	bu	yi
不幸	bu	xing
不幸	bu	xing
不得要领	bu	de	yao	ling
不息	bu	xi
不成方圆	bu	cheng	fang	yuan
不拘	bu	ju
不时	bu	shi
不易	bu	yi
不易	bu	yi
不服	bu	fu
不止	bu	zhi
不死不活	bu	si	bu	huo
不比	bu	bi
不法	bu	fa
不独	bu	du
不甘	bu	gan
不甚了了	bu	shen	le	le
不甚了了	bu	shen	liao	liao
不由得	bu	you	de
不由得	bu	you	de
不畏	bu	wei
不畏强暴	bu	wei	qiang	bao
不知去向	bu	zhi	qu	xiang
不禁	bu	jin
不端	bu	duan
不等式	bu	deng	shi
不结盟	bu	jie	meng
不绝于耳	bu	jue	yu	er
不胜枚举	bu	sheng	mei	ju
不胜枚举	bu	sheng	mei	ju
不能不	bu	neng	bu
不致	bu	zhi
不致	bu	zhi
不苟言笑	bu	gou	yan	xiao
不见	bu	jian
不见泰山	bu	jian	tai	shan
不解之缘	bu	jie	zhi	yuan
不足为怪	bu	zu	wei	guai
不轨	bu	gui
不辞辛劳	bu	ci	xin	lao
不辞辛苦	bu	ci	xin	ku
不辱使命	bu	ru	shi	ming
不远千里	bu	yuan	qian	li
不适	bu	shi
不适	bu	shi
不道德	bu	dao	de
不锈钢	bu	xiu	gang
不锈钢	bu	xiu	gang
不齿	bu	chi
与会	yu	hui
与其	yu	qi
与此同时	yu	ci	tong	shi
丑事	chou	shi
丑剧	chou	ju
丑化	chou	hua
专一	zhuan	yi
专业化	zhuan	ye	hua
专业课	zhuan	ye	ke
专利局	zhuan	li	ju
专利权	zhuan	li	quan
专制	zhuan	zhi
专区	zhuan	qu
专号	zhuan	hao
专场	zhuan	chang
专攻	zhuan	gong
专机	zhuan	ji
专款	zhuan	kuan
专电	zhuan	dian
专稿	zhuan	gao
专署	zhuan	shu
专著	zhuan	zhu
专集	zhuan	ji
世世代代	shi	shi	dai	dai
世事	shi	shi
世人	shi	ren
世代	shi	dai
世代相传	shi	dai	xiang	chuan
世俗	shi	su
世家	shi	jia
世态	shi	tai
世情	shi	qing
世故	shi	gu
世故	shi	gu
世族	shi	zu
世界性	shi	jie	xing
世界杯	shi	jie	bei
世界语	shi	jie	yu
世纪	shi	ji
世袭	shi	xi
世间	shi	jian
世面	shi	mian
丙纶	bing	lun
业大	ye	da
业经	ye	jing
丛书	cong	shu
丛刊	cong	kan
东京	dong	jing
东北风	dong	bei	feng
东头	dong	tou
东宫	dong	gong
东洋	dong	yang
东经	dong	jing
东芝	dong	zhi
东道	dong	dao
东道国	dong	dao	guo
东面	dong	mian
东鳞西爪	dong	lin	xi	zhao
丝线	si	xian
丝织	si	zhi
丝织品	si	zhi	pin
丞相	cheng	xiang
丢卒保车	diu	zu	bao	ju
丢面子	diu	mian	zi
丢面子	diu	mian	zi
两便	liang	bian
两性	liang	xing
两极	liang	ji
两栖	liang	qi
两重性	liang	chong	xing
两面性	liang	mian	xing
两鬓	liang	bin
严严实实	yan	yan	shi	shi
严于律己	yan	yu	lv	ji
严刑	yan	xing
严守	yan	shou
严实	yan	shi
严寒	yan	han
严惩不贷	yan	cheng	bu	dai
严惩不贷	yan	cheng	bu	dai
严整	yan	zheng
严正	yan	zheng
严词	yan	ci
丧事	sang	shi
丧葬费	sang	zang	fei
个个	ge	ge
个人	ge	ren
个人主义	ge	ren	zhu	yi
个体户	ge	ti	hu
个儿	ge	er
个儿	ge	er
个子	ge	zi
个子	ge	zi
中下游	zhong	xia	you
中世纪	zhong	shi	ji
中伤	zhong	shang
中低档	zhong	di	dang
中兴	zhong	xing
中农	zhong	nong
中医师	zhong	yi	shi
中医院	zhong	yi	yuan
中南	zhong	nan
中卫	zhong	wei
中和	zhong	he
中国画	zhong	guo	hua
中国话	zhong	guo	hua
中坚	zhong	jian
中型	zhong	xing
中子	zhong	zi
中宣部	zhong	xuan	bu
中将	zhong	jiang
中小型	zhong	xiao	xing
中小学校	zhong	xiao	xue	xiao
中小学生	zhong	xiao	xue	sheng
中山装	zhong	shan	zhuang
中师	zhong	shi
中年人	zhong	nian	ren
中庸	zhong	yong
中式	zhong	shi
中成药	zhong	cheng	yao
中指	zhong	zhi
中暑	zhong	shu
中标	zhong	biao
中止	zhong	zhi
中用	zhong	yong
中的	zhong	de
中看	zhong	kan
中程	zhong	cheng
中空	zhong	kong
中立	zhong	li
中立国	zhong	li	guo
中策	zhong	ce
中篇	zhong	pian
中纪委	zhong	ji	wei
中继	zhong	ji
中继线	zhong	ji	xian
中草药	zhong	cao	yao
中药	zhong	yao
中药材	zhong	yao	cai
中装	zhong	zhuang
中转	zhong	zhuan
中选	zhong	xuan
中间商	zhong	jian	shang
中间派	zhong	jian	pai
中队长	zhong	dui	zhang
中青年	zhong	qing	nian
中风	zhong	feng
中饭	zhong	fan
中饱私囊	zhong	bao	si	nang
中高级	zhong	gao	ji
丰产	feng	chan
丰台	feng	tai
丰姿	feng	zi
丰年	feng	nian
丰沛	feng	pei
丰裕	feng	yu
丰采	feng	cai
串连	chuan	lian
串通	chuan	tong
临场	lin	chang
临时工	lin	shi	gong
临沂	lin	yi
临深履薄	lin	shen	lv	bao
临界点	lin	jie	dian
临街	lin	jie
丹心	dan	xin
为伍	wei	wu
为数	wei	shu
为数不多	wei	shu	bu	duo
为数众多	wei	shu	zhong	duo
为时	wei	shi
为期	wei	qi
为止	wei	zhi
为民请命	wei	min	qing	ming
为生	wei	sheng
为辅	wei	fu
主义	zhu	yi
主人	zhu	ren
主人公	zhu	ren	gong
主人家	zhu	ren	jia
主人翁	zhu	ren	weng
主力	zhu	li
主力军	zhu	li	jun
主动性	zhu	dong	xing
主动权	zhu	dong	quan
主动脉	zhu	dong	mai
主妇	zhu	fu
主客观	zhu	ke	guan
主宰	zhu	zai
主将	zhu	jiang
主峰	zhu	feng
主席团	zhu	xi	tuan
主心骨	zhu	xin	gu
主意	zhu	yi
主战场	zhu	zhan	chang
主持人	zhu	chi	ren
主攻手	zhu	gong	shou
主教	zhu	jiao
主教练	zhu	jiao	lian
主旨	zhu	zhi
主权国	zhu	quan	guo
主板	zhu	ban
主治	zhu	zhi
主犯	zhu	fan
主航道	zhu	hang	dao
主见	zhu	jian
主观主义	zhu	guan	zhu	yi
主讲	zhu	jiang
主课	zhu	ke
主轴	zhu	zhou
主队	zhu	dui
主题歌	zhu	ti	ge
主题词	zhu	ti	ci
主食	zhu	shi
举不胜举	ju	bu	sheng	ju
举不胜举	ju	bu	sheng	ju
举世	ju	shi
举人	ju	ren
举例	ju	li
举报人	ju	bao	ren
举杯	ju	bei
举步维艰	ju	bu	wei	jian
举重	ju	zhong
乃是	nai	shi
久久	jiu	jiu
久别重逢	jiu	bie	chong	feng
久已	jiu	yi
久拖不决	jiu	tuo	bu	jue
久经	jiu	jing
久经沙场	jiu	jing	sha	chang
久远	jiu	yuan
义举	yi	ju
义务兵	yi	wu	bing
义务教育	yi	wu	jiao	yu
义勇军	yi	yong	jun
义卖	yi	mai
义和团	yi	he	tuan
义士	yi	shi
义愤	yi	fen
义正词严	yi	zheng	ci	yan
义气	yi	qi
义气	yi	qi
义演	yi	yan
义理	yi	li
之上	zhi	shang
之下	zhi	xia
之余	zhi	yu
之最	zhi	zui
之际	zhi	ji
乌发	wu	fa
乌江	wu	jiang
乌纱帽	wu	sha	mao
乏力	fa	li
乐呵呵	le	he	he
乐声	yue	sheng
乐府	yue	fu
乐滋滋	le	zi	zi
乐舞	yue	wu
乐融融	le	rong	rong
乐音	yue	yin
乒乓球	ping	pang	qiu
乒坛	ping	tan
乖舛	guai	chuan
乘兴	cheng	xing
乘务员	cheng	wu	yuan
乘势	cheng	shi
乘员	cheng	yuan
乘数	cheng	shu
乘机	cheng	ji
乘法	cheng	fa
乘积	cheng	ji
乘除	cheng	chu
乘隙	cheng	xi
乘风破浪	cheng	feng	po	lang
乙丑	yi	chou
乙烯	yi	xi
乙醇	yi	chun
九泉	jiu	quan
乞求	qi	qiu
习习	xi	xi
习气	xi	qi
乡下	xiang	xia
乡下人	xiang	xia	ren
乡亲	xiang	qin
乡思	xiang	si
乡邻	xiang	lin
乡里	xiang	li
书名	shu	ming
书后	shu	hou
书展	shu	zhan
书市	shu	shi
书报	shu	bao
书架	shu	jia
书案	shu	an
书橱	shu	chu
书法家	shu	fa	jia
书目	shu	mu
书箱	shu	xiang
书记	shu	ji
书院	shu	yuan
书香	shu	xiang
买方	mai	fang
乱哄哄	luan	hong	hong
乳白色	ru	bai	se
了不得	liao	bu	de
了不得	liao	bu	de
了结	liao	jie
争执	zheng	zhi
争权	zheng	quan
争气	zheng	qi
争相	zheng	xiang
争胜	zheng	sheng
争衡	zheng	heng
争论不休	zheng	lun	bu	xiu
争鸣	zheng	ming
事业心	shi	ye	xin
事主	shi	zhu
事事	shi	shi
事例	shi	li
事儿	shi	er
事先	shi	xian
事务	shi	wu
事后	shi	hou
事宜	shi	yi
事实上	shi	shi	shang
事物	shi	wu
事理	shi	li
事由	shi	you
事端	shi	duan
事过境迁	shi	guo	jing	qian
事迹	shi	ji
二人转	er	ren	zhuan
二副	er	fu
二极管	er	ji	guan
二氧化硫	er	yang	hua	liu
二老	er	lao
二话	er	hua
二重唱	er	chong	chang
二重性	er	chong	xing
于今	yu	jin
于是乎	yu	shi	hu
于是乎	yu	shi	hu
亏得	kui	de
亏得	kui	de
云南省	yun	nan	sheng
云团	yun	tuan
云母	yun	mu
云端	yun	duan
云集	yun	ji
云雨	yun	yu
互利	hu	li
互助组	hu	zhu	zu
互帮互学	hu	bang	hu	xue
互换	hu	huan
互联网	hu	lian	wang
五一	wu	yi
五保户	wu	bao	hu
五台山	wu	tai	shan
五味	wu	wei
五四	wu	si
五官	wu	guan
五岳	wu	yue
五指	wu	zhi
五星	wu	xing
五行	wu	xing
五角大楼	wu	jiao	da	lou
五角星	wu	jiao	xing
五讲四美	wu	jiang	si	mei
五谷	wu	gu
五金	wu	jin
五雷轰顶	wu	lei	hong	ding
五黄六月	wu	huang	liu	yue
井架	jing	jia
亚热带	ya	re	dai
亚运会	ya	yun	hui
亚运村	ya	yun	cun
亡命	wang	ming
亡国	wang	guo
交口	jiao	kou
交口称赞	jiao	kou	cheng	zan
交响乐	jiao	xiang	yue
交响曲	jiao	xiang	qu
交响诗	jiao	xiang	shi
交好	jiao	hao
交工	jiao	gong
交底	jiao	di
交待	jiao	dai
交心	jiao	xin
交情	jiao	qing
交手	jiao	shou
交换机	jiao	huan	ji
交接班	jiao	jie	ban
交易会	jiao	yi	hui
交流会	jiao	liu	hui
交火	jiao	huo
交点	jiao	dian
交班	jiao	ban
交电	jiao	dian
交税	jiao	shui
交纳	jiao	na
交谊舞	jiao	yi	wu
交费	jiao	fei
交还	jiao	huan
交通线	jiao	tong	xian
交通网	jiao	tong	wang
交通费	jiao	tong	fei
交道	jiao	dao
交际	jiao	ji
亦然	yi	ran
产业界	chan	ye	jie
产妇	chan	fu
亨利	heng	li
享年	xiang	nian
享有盛誉	xiang	you	sheng	yu
享誉	xiang	yu
京华	jing	hua
京师	jing	shi
京戏	jing	xi
京胡	jing	hu
京郊	jing	jiao
亮晶晶	liang	jing	jing
亲事	qin	shi
亲事	qin	shi
亲兄弟	qin	xiong	di
亲切感	qin	qie	gan
亲如兄弟	qin	ru	xiong	di
亲密无间	qin	mi	wu	jian
亲手	qin	shou
亲痛仇快	qin	tong	chou	kuai
亲笔信	qin	bi	xin
亲缘	qin	yuan
人不知	ren	bu	zhi
人世	ren	shi
人世间	ren	shi	jian
人为	ren	wei
人事	ren	shi
人事局	ren	shi	ju
人事部	ren	shi	bu
人代会	ren	dai	hui
人伦	ren	lun
人力车	ren	li	che
人名	ren	ming
人命	ren	ming
人士	ren	shi
人声	ren	sheng
人工湖	ren	gong	hu
人心	ren	xin
人心浮动	ren	xin	fu	dong
人心齐	ren	xin	qi
人手	ren	shou
人手一册	ren	shou	yi	ce
人数	ren	shu
人梯	ren	ti
人次	ren	ci
人武部	ren	wu	bu
人氏	ren	shi
人治	ren	zhi
人物	ren	wu
人物画	ren	wu	hua
人生观	ren	sheng	guan
人祸	ren	huo
人缘	ren	yuan
人证	ren	zheng
人质	ren	zhi
人身	ren	shen
人造卫星	ren	zao	wei	xing
亿万	yi	wan
什么样	shen	me	yang
什么样	shen	me	yang
什锦	shi	jin
仁义	ren	yi
仁人志士	ren	ren	zhi	shi
今人	jin	ren
今儿	jin	er
今春	jin	chun
今译	jin	yi
介绍人	jie	shao	ren
介绍信	jie	shao	xin
介词	jie	ci
介质	jie	zhi
从从容容	cong	cong	rong	rong
从命	cong	ming
从头至尾	cong	tou	zhi	wei
从师	cong	shi
从新	cong	xin
从未有过	cong	wei	you	guo
从艺	cong	yi
仓猝	cang	cu
仔仔细细	zi	zi	xi	xi
仔猪	zi	zhu
仕女	shi	nv
他乡	ta	xiang
他们	ta	men
他们	ta	men
付之东流	fu	zhi	dong	liu
付印	fu	yin
付账	fu	zhang
付费	fu	fei
仙人	xian	ren
仙人掌	xian	ren	zhang
仙境	xian	jing
仙逝	xian	shi
仙鹤	xian	he
代名词	dai	ming	ci
代培	dai	pei
代序	dai	xu
代数	dai	shu
代理人	dai	li	ren
代用品	dai	yong	pin
代职	dai	zhi
代表团	dai	biao	tuan
代表性	dai	biao	xing
代购	dai	gou
令人不安	ling	ren	bu	an
令人注目	ling	ren	zhu	mu
以一当十	yi	yi	dang	shi
以东	yi	dong
以儆效尤	yi	jing	xiao	you
以北	yi	bei
以南	yi	nan
以外	yi	wai
以太	yi	tai
以少胜多	yi	shao	sheng	duo
以往	yi	wang
以期	yi	qi
以来	yi	lai
以泪洗面	yi	lei	xi	mian
以至	yi	zhi
以至于	yi	zhi	yu
以致	yi	zhi
以西	yi	xi
仪仗	yi	zhang
仪仗队	yi	zhang	dui
仪器	yi	qi
仪式	yi	shi
仲夏	zhong	xia
仳离	pi	li
价值观	jia	zhi	guan
价码	jia	ma
任期	ren	qi
仿制	fang	zhi
仿制品	fang	zhi	pin
仿古	fang	gu
仿生	fang	sheng
仿真	fang	zhen
企业主	qi	ye	zhu
企业化	qi	ye	hua
企业家	qi	ye	jia
企业界	qi	ye	jie
企事业	qi	shi	ye
企望	qi	wang
企求	qi	qiu
企盼	qi	pan
伊始	yi	shi
伊斯兰	yi	si	lan
伊斯兰教	yi	si	lan	jiao
伊甸园	yi	dian	yuan
伏尔加	fu	er	jia
伏法	fu	fa
伏特	fu	te
伏羲	fu	xi
休会	xiu	hui
休养	xiu	yang
休憩	xiu	qi
休整	xiu	zheng
休斯敦	xiu	si	dun
休止符	xiu	zhi	fu
众擎易举	zhong	qing	yi	ju
众议员	zhong	yi	yuan
众议院	zhong	yi	yuan
优于	you	yu
优先权	you	xian	quan
优哉游哉	you	zai	you	zai
优异	you	yi
优待	you	dai
优抚	you	fu
优游	you	you
优生	you	sheng
优生优育	you	sheng	you	yu
优育	you	yu
优胜	you	sheng
优胜者	you	sheng	zhe
优裕	you	yu
优越性	you	yue	xing
优越感	you	yue	gan
优选	you	xuan
伙食费	huo	shi	fei
会上	hui	shang
会刊	hui	kan
会务	hui	wu
会友	hui	you
会合	hui	he
会员国	hui	yuan	guo
会员证	hui	yuan	zheng
会址	hui	zhi
会客室	hui	ke	shi
会师	hui	shi
会心	hui	xin
会意	hui	yi
会战	hui	zhan
会操	hui	cao
会旗	hui	qi
会期	hui	qi
会标	hui	biao
会演	hui	yan
会聚	hui	ju
会计师	kuai	ji	shi
会议室	hui	yi	shi
会长	hui	chang
会长	hui	zhang
会风	hui	feng
伟人	wei	ren
伟力	wei	li
伟绩	wei	ji
传动	chuan	dong
传家宝	chuan	jia	bao
传导	chuan	dao
传感器	chuan	gan	qi
传染病	chuan	ran	bing
传略	zhuan	lue
传略	zhuan	lve
传票	chuan	piao
传记	zhuan	ji
传诵	chuan	song
传达室	chuan	da	shi
传送带	chuan	song	dai
传阅	chuan	yue
传颂	chuan	song
伤亡	shang	wang
伤兵	shang	bing
伤势	shang	shi
伤害	shang	hai
伤残人	shang	can	ren
伤病员	shang	bing	yuan
伤筋动骨	shang	jin	dong	gu
伦巴	lun	ba
伦理学	lun	li	xue
伪币	wei	bi
伪证	wei	zheng
伫立	zhu	li
伯仲	bo	zhong
伯父	bo	fu
估价	gu	jia
伴儿	ban	er
伶俐	ling	li
伸长	shen	chang
伺候	ci	hou
伺候	ci	hou
伺机	si	ji
似的	shi	de
似的	shi	de
伽利略	jia	li	lve
位居	wei	ju
位移	wei	yi
低下	di	xia
低产	di	chan
低产田	di	chan	tian
低压	di	ya
低回	di	hui
低年级	di	nian	ji
低微	di	wei
低端	di	duan
低谷	di	gu
低贱	di	jian
住地	zhu	di
住宅区	zhu	zhai	qu
住手	zhu	shou
住持	zhu	chi
住院	zhu	yuan
佐证	zuo	zheng
体例	ti	li
体协	ti	xie
体型	ti	xing
体委	ti	wei
体式	ti	shi
体形	ti	xing
体罚	ti	fa
体育课	ti	yu	ke
体表	ti	biao
体裁	ti	cai
何妨	he	fang
何尝	he	chang
何许	he	xu
余力	yu	li
余年	yu	nian
余粮	yu	liang
余音	yu	yin
余韵	yu	yun
佛教徒	fo	jiao	tu
佛罗里达	fo	luo	li	da
作主	zuo	zhu
作价	zuo	jia
作假	zuo	jia
作协	zuo	xie
作成	zuo	cheng
作曲家	zuo	qu	jia
作法	zuo	fa
作用力	zuo	yong	li
佩剑	pei	jian
佩带	pei	dai
佳丽	jia	li
佳人	jia	ren
佳句	jia	ju
佳品	jia	pin
佳境	jia	jing
佳期	jia	qi
佳绩	jia	ji
佳节	jia	jie
佳话	jia	hua
佼佼者	jiao	jiao	zhe
使用权	shi	yong	quan
使节	shi	jie
侃侃	kan	kan
例举	li	ju
例会	li	hui
例行	li	xing
例行公事	li	xing	gong	shi
例证	li	zheng
例题	li	ti
侍候	shi	hou
侍奉	shi	feng
侏儒	zhu	ru
供品	gong	pin
供稿	gong	gao
供稿	gong	gao
供给	gong	ji
供认	gong	ren
供销	gong	xiao
供销社	gong	xiao	she
供销社	gong	xiao	she
供需	gong	xu
依仗	yi	zhang
依依惜别	yi	yi	xi	bie
依存	yi	cun
依山傍水	yi	shan	bang	shui
依次	yi	ci
依附	yi	fu
侠客	xia	ke
侦察兵	zhen	cha	bing
侦察员	zhen	cha	yuan
侦察机	zhen	cha	ji
侧重点	ce	zhong	dian
侨乡	qiao	xiang
侨务	qiao	wu
侨商	qiao	shang
侨属	qiao	shu
侨汇	qiao	hui
侨眷	qiao	juan
侵略者	qin	lve	zhe
侵蚀	qin	shi
便携式	bian	xie	shi
便服	bian	fu
便衣	bian	yi
便道	bian	dao
促织	cu	zhi
促进会	cu	jin	hui
俄国	e	guo
俄语	e	yu
俏货	qiao	huo
俗名	su	ming
俗话说	su	hua	shuo
俘获	fu	huo
俚语	li	yu
保值	bao	zhi
保守党	bao	shou	dang
保守派	bao	shou	pai
保密性	bao	mi	xing
保护伞	bao	hu	san
保有	bao	you
保温瓶	bao	wen	ping
保皇派	bao	huang	pai
保票	bao	piao
保管员	bao	guan	yuan
保育员	bao	yu	yuan
保育院	bao	yu	yuan
保苗	bao	miao
保荐	bao	jian
保证书	bao	zheng	shu
保送	bao	song
保释	bao	shi
保量	bao	liang
保镖	bao	biao
保险柜	bao	xian	gui
保险箱	bao	xian	xiang
保驾	bao	jia
保鲜	bao	xian
信义	xin	yi
信件	xin	jian
信任感	xin	ren	gan
信使	xin	shi
信号弹	xin	hao	dan
信号灯	xin	hao	deng
信天游	xin	tian	you
信奉	xin	feng
信守	xin	shou
信心百倍	xin	xin	bai	bei
信念	xin	nian
信息量	xin	xi	liang
信手	xin	shou
信教	xin	jiao
信教	xin	jiao
信条	xin	tiao
信用卡	xin	yong	ka
信用社	xin	yong	she
信笔	xin	bi
信笺	xin	jian
信访	xin	fang
信贷员	xin	dai	yuan
信赏必罚	xin	shang	bi	fa
信阳	xin	yang
信马由缰	xin	ma	you	jiang
俭朴	jian	pu
修剪	xiu	jian
修整	xiu	zheng
修旧利废	xiu	jiu	li	fei
修正主义	xiu	zheng	zhu	yi
修理厂	xiu	li	chang
修葺	xiu	qi
修道院	xiu	dao	yuan
俯仰	fu	yang
俯仰之间	fu	yang	zhi	jian
俯拾即是	fu	shi	ji	shi
俯瞰	fu	kan
俯视	fu	shi
倍受	bei	shou
倍数	bei	shu
倏地	shu	di
倏忽	shu	hu
倒伏	dao	fu
倒班	dao	ban
倒立	dao	li
倒置	dao	zhi
候机室	hou	ji	shi
候车室	hou	che	shi
候选人	hou	xuan	ren
倚仗	yi	zhang
借以	jie	yi
借据	jie	ju
借支	jie	zhi
借故	jie	gu
借机	jie	ji
借读	jie	du
借调	jie	diao
借贷	jie	dai
倡议书	chang	yi	shu
倥偬	kong	zong
债券	zhai	quan
债务人	zhai	wu	ren
债权人	zhai	quan	ren
值勤	zhi	qin
值日	zhi	ri
值此	zhi	ci
值班室	zhi	ban	shi
值钱	zhi	qian
倾倒	qing	dao
倾倒	qing	dao
倾向性	qing	xiang	xing
倾心	qing	xin
倾心吐胆	qing	xin	tu	dan
倾注	qing	zhu
倾泻	qing	xie
倾覆	qing	fu
倾角	qing	jiao
假使	jia	shi
假借	jia	jie
假大空	jia	da	kong
假大空	jia	da	kong
假如	jia	ru
假想	jia	xiang
假扮	jia	ban
假案	jia	an
假牙	jia	ya
假肢	jia	zhi
假药	jia	yao
假象	jia	xiang
假账	jia	zhang
假货	jia	huo
假释	jia	shi
偏听偏信	pian	ting	pian	xin
偏好	pian	hao
偏废	pian	fei
偏瘫	pian	tan
做出	zuo	chu
做功	zuo	gong
做客	zuo	ke
做活	zuo	huo
停办	ting	ban
停息	ting	xi
停机坪	ting	ji	ping
停歇	ting	xie
停滞	ting	zhi
停职	ting	zhi
停航	ting	hang
停课	ting	ke
健儿	jian	er
健身房	jian	shen	fang
偷运	tou	yun
储户	chu	hu
储蓄所	chu	xu	suo
储藏室	chu	cang	shi
储藏量	chu	cang	liang
傲然	ao	ran
傻事	sha	shi
傻气	sha	qi
像片	xiang	pian
像章	xiang	zhang
僵化	jiang	hua
僵死	jiang	si
儒将	ru	jiang
儒教	ru	jiao
儿媳	er	xi
儿媳妇	er	xi	fu
兀自	wu	zi
元件	yuan	jian
元曲	yuan	qu
充气	chong	qi
充盈	chong	ying
充饥	chong	ji
先人	xian	ren
先公后私	xian	gong	hou	si
先哲	xian	zhe
先声	xian	sheng
先导	xian	dao
先手	xian	shou
先是	xian	shi
先期	xian	qi
先河	xian	he
先知	xian	zhi
先行	xian	xing
先行者	xian	xing	zhe
先贤	xian	xian
先进性	xian	jin	xing
先遣	xian	qian
先遣队	xian	qian	dui
先锋队	xian	feng	dui
先驱者	xian	qu	zhe
光华	guang	hua
光合作用	guang	he	zuo	yong
光大	guang	da
光彩夺目	guang	cai	duo	mu
光栅	guang	shan
光波	guang	bo
光洁	guang	jie
光焰	guang	yan
光电子	guang	dian	zi
光纤	guang	xian
光绪	guang	xu
光荣榜	guang	rong	bang
光辉灿烂	guang	hui	can	lan
光风霁月	guang	feng	ji	yue
克扣	ke	kou
免职	mian	zhi
兑付	dui	fu
兑换券	dui	huan	quan
党中央	dang	zhong	yang
党代表	dang	dai	biao
党刊	dang	kan
党务	dang	wu
党史	dang	shi
党团	dang	tuan
党团员	dang	tuan	yuan
党委会	dang	wei	hui
党小组	dang	xiao	zu
党性	dang	xing
党总支	dang	zong	zhi
党报	dang	bao
党支部	dang	zhi	bu
党政军	dang	zheng	jun
党旗	dang	qi
党籍	dang	ji
党纪	dang	ji
党纪国法	dang	ji	guo	fa
党组织	dang	zu	zhi
党群	dang	qun
党规	dang	gui
党风	dang	feng
党龄	dang	ling
兜鍪	dou	mou
入世	ru	shi
入主	ru	zhu
入冬	ru	dong
入团	ru	tuan
入土	ru	tu
入场券	ru	chang	quan
入夏	ru	xia
入夜	ru	ye
入学	ru	xue
入托	ru	tuo
入时	ru	shi
入狱	ru	yu
入画	ru	hua
入神	ru	shen
入魔	ru	mo
全书	quan	shu
全优	quan	you
全党	quan	dang
全力	quan	li
全厂	quan	chang
全国性	quan	guo	xing
全境	quan	jing
全天候	quan	tian	hou
全套	quan	tao
全家福	quan	jia	fu
全市	quan	shi
全托	quan	tuo
全数	quan	shu
全日制	quan	ri	zhi
全歼	quan	jian
全球性	quan	qiu	xing
全盛	quan	sheng
全程	quan	cheng
全线	quan	xian
全身心	quan	shen	xin
全运会	quan	yun	hui
全长	quan	chang
全集	quan	ji
八卦掌	ba	gua	zhang
八方支援	ba	fang	zhi	yuan
八旗	ba	qi
八路军	ba	lu	jun
公事	gong	shi
公使	gong	shi
公元	gong	yuan
公公	gong	gong
公公	gong	gong
公共场所	gong	gong	chang	suo
公决	gong	jue
公判	gong	pan
公历	gong	li
公国	gong	guo
公婆	gong	po
公子	gong	zi
公安局	gong	an	ju
公安部	gong	an	bu
公审	gong	shen
公开信	gong	kai	xin
公开赛	gong	kai	sai
公式化	gong	shi	hua
公心	gong	xin
公愤	gong	fen
公房	gong	fang
公报	gong	bao
公敌	gong	di
公有	gong	you
公有制	gong	you	zhi
公案	gong	an
公检法	gong	jian	fa
公民权	gong	min	quan
公海	gong	hai
公物	gong	wu
公理	gong	li
公益金	gong	yi	jin
公示	gong	shi
公私	gong	si
公积金	gong	ji	jin
公粮	gong	liang
公认	gong	ren
公证	gong	zheng
公诉人	gong	su	ren
公路桥	gong	lu	qiao
公馆	gong	guan
公鸡	gong	ji
六书	liu	shu
六亲无靠	liu	qin	wu	kao
六畜	liu	chu
兰州市	lan	zhou	shi
共事	gong	shi
共产党人	gong	chan	dang	ren
共同体	gong	tong	ti
共和	gong	he
共和党	gong	he	dang
共度	gong	du
共生	gong	sheng
共管	gong	guan
共聚	gong	ju
共计	gong	ji
共识	gong	shi
共谋	gong	mou
共青团	gong	qing	tuan
共青团员	gong	qing	tuan	yuan
关怀备至	guan	huai	bei	zhi
关税	guan	shui
关系户	guan	xi	hu
关系网	guan	xi	wang
关节炎	guan	jie	yan
关键性	guan	jian	xing
关隘	guan	ai
兴亡	xing	wang
兴修	xing	xiu
兴冲冲	xing	chong	chong
兴学	xing	xue
兴许	xing	xu
兴起	xing	qi
兵力	bing	li
兵变	bing	bian
兵员	bing	yuan
兵家	bing	jia
兵工厂	bing	gong	chang
兵役	bing	yi
兵役法	bing	yi	fa
兵站	bing	zhan
其一	qi	yi
其后	qi	hou
其它	qi	ta
其间	qi	jian
典礼	dian	li
典章	dian	zhang
典籍	dian	ji
养子	yang	zi
养护	yang	hu
养殖业	yang	zhi	ye
养殖场	yang	zhi	chang
养母	yang	mu
养父	yang	fu
养生之道	yang	sheng	zhi	dao
养神	yang	shen
养老金	yang	lao	jin
养老院	yang	lao	yuan
养路	yang	lu
兼容并包	jian	rong	bing	bao
兼管	jian	guan
兼而有之	jian	er	you	zhi
兼职	jian	zhi
兼营	jian	ying
兼课	jian	ke
兼顾	jian	gu
兽医	shou	yi
兽类	shou	lei
内分泌	nei	fen	mi
内助	nei	zhu
内子	nei	zi
内河	nei	he
内海	nei	hai
内燃机	nei	ran	ji
内陆国	nei	lu	guo
内陆河	nei	lu	he
再不	zai	bu
再审	zai	shen
再生产	zai	sheng	chan
再而三	zai	er	san
冒进	mao	jin
写字台	xie	zi	tai
写意	xie	yi
写意	xie	yi
军乐团	jun	yue	tuan
军乐队	jun	yue	dui
军事家	jun	shi	jia
军令状	jun	ling	zhuang
军兵种	jun	bing	zhong
军分区	jun	fen	qu
军功	jun	gong
军功章	jun	gong	zhang
军务	jun	wu
军国主义	jun	guo	zhu	yi
军垦	jun	ken
军士	jun	shi
军委	jun	wei
军威	jun	wei
军属	jun	shu
军工	jun	gong
军师	jun	shi
军徽	jun	hui
军政	jun	zheng
军旗	jun	qi
军机	jun	ji
军法	jun	fa
军烈属	jun	lie	shu
军礼	jun	li
军粮	jun	liang
军职	jun	zhi
军衔	jun	xian
军衣	jun	yi
军部	jun	bu
军需	jun	xu
军马	jun	ma
军龄	jun	ling
农业国	nong	ye	guo
农业税	nong	ye	shui
农事	nong	shi
农产品	nong	chan	pin
农会	nong	hui
农副业	nong	fu	ye
农场主	nong	chang	zhu
农妇	nong	fu
农学	nong	xue
农学院	nong	xue	yuan
农家肥	nong	jia	fei
农工	nong	gong
农技	nong	ji
农时	nong	shi
农机	nong	ji
农机具	nong	ji	ju
农林	nong	lin
农牧业	nong	mu	ye
农膜	nong	mo
农舍	nong	she
农谚	nong	yan
农贷	nong	dai
农资	nong	zi
冠军赛	guan	jun	sai
冠心病	guan	xin	bing
冤家	yuan	jia
冤家	yuan	jia
冤枉	yuan	wang
冤枉路	yuan	wang	lu
冥王星	ming	wang	xing
冬令营	dong	ling	ying
冬泳	dong	yong
冬烘	dong	hong
冬衣	dong	yi
冬运会	dong	yun	hui
冰刀	bing	dao
冰峰	bing	feng
冰毒	bing	du
冲击波	chong	ji	bo
冲剂	chong	ji
冲压	chong	ya
冲压	chong	ya
冲开	chong	kai
冲撞	chong	zhuang
冲积	chong	ji
冲锋	chong	feng
冲锋枪	chong	feng	qiang
决不	jue	bu
决定论	jue	ding	lun
决意	jue	yi
决计	jue	ji
决赛权	jue	sai	quan
决非	jue	fei
决非偶然	jue	fei	ou	ran
冷不防	leng	bu	fang
冷不防	leng	bu	fang
冷库	leng	ku
冷板凳	leng	ban	deng
冻害	dong	hai
净值	jing	zhi
净利	jing	li
净化	jing	hua
净重	jing	zhong
凄婉	qi	wan
凄怆	qi	chuang
准确性	zhun	que	xing
凉山	liang	shan
凌空	ling	kong
减免	jian	mian
减刑	jian	xing
减灾	jian	zai
凝集	ning	ji
几何	ji	he
几内亚	ji	nei	ya
几时	ji	shi
几率	ji	lv
几种	ji	zhong
凡人	fan	ren
凡例	fan	li
凡是	fan	shi
凭陵	ping	ling
凶杀案	xiong	sha	an
凸出	tu	chu
凸起	tu	qi
出世	chu	shi
出乱子	chu	luan	zi
出乱子	chu	luan	zi
出事	chu	shi
出于	chu	yu
出人意外	chu	ren	yi	wai
出以公心	chu	yi	gong	xin
出价	chu	jia
出众	chu	zhong
出使	chu	shi
出出进进	chu	chu	jin	jin
出击	chu	ji
出力	chu	li
出厂	chu	chang
出厂价	chu	chang	jia
出发地	chu	fa	di
出发点	chu	fa	dian
出处	chu	chu
出外	chu	wai
出奇	chu	qi
出嫁	chu	jia
出局	chu	ju
出工	chu	gong
出师	chu	shi
出息	chu	xi
出息	chu	xi
出手	chu	shou
出操	chu	cao
出格	chu	ge
出毛病	chu	mao	bing
出气	chu	qi
出没	chu	mo
出海	chu	hai
出炉	chu	lu
出版物	chu	ban	wu
出狱	chu	yu
出生率	chu	sheng	lv
出界	chu	jie
出示	chu	shi
出神	chu	shen
出租车	chu	zu	che
出纳员	chu	na	yuan
出线	chu	xian
出线权	chu	xian	quan
出航	chu	hang
出苗	chu	miao
出血	chu	xie
出血	chu	xue
出行	chu	xing
出让	chu	rang
出访	chu	fang
出谋献策	chu	mou	xian	ce
出资	chu	zi
出车	chu	che
出轨	chu	gui
出阵	chu	zhen
出风头	chu	feng	tou
出风头	chu	feng	tou
击中	ji	zhong
击中	ji	zhong
击剑	ji	jian
击打	ji	da
击毁	ji	hui
击破	ji	po
击退	ji	tui
函件	han	jian
刀伤	dao	shang
刀具	dao	ju
刀刃	dao	ren
刀口	dao	kou
刀耕火种	dao	geng	huo	zhong
分之	fen	zhi
分公司	fen	gong	si
分册	fen	ce
分分秒秒	fen	fen	miao	miao
分列式	fen	lie	shi
分居	fen	ju
分房	fen	fang
分晓	fen	xiao
分期	fen	qi
分机	fen	ji
分校	fen	xiao
分母	fen	mu
分水岭	fen	shui	ling
分洪	fen	hong
分界	fen	jie
分米	fen	mi
分红	fen	hong
分设	fen	she
分赴	fen	fu
分部	fen	bu
分野	fen	ye
分门别类	fen	men	bie	lei
切切	qie	qie
切切实实	qie	qie	shi	shi
切削	qie	xiao
切实可行	qie	shi	ke	xing
切实有力	qie	shi	you	li
切忌	qie	ji
刊头	kan	tou
刊载	kan	zai
刍荛	chu	rao
刑事	xing	shi
刑事犯	xing	shi	fan
刑期	xing	qi
刑罚	xing	fa
刑讯	xing	xun
划不来	hua	bu	lai
划不来	hua	bu	lai
划界	hua	jie
划线	hua	xian
列国	lie	guo
列宁	lie	ning
列宁主义	lie	ning	zhu	yi
列强	lie	qiang
列车员	lie	che	yuan
刘少奇	liu	shao	qi
刘邦	liu	bang
刚直不阿	gang	zhi	bu	e
创伤	chuang	shang
创刊号	chuang	kan	hao
创利	chuang	li
创始人	chuang	shi	ren
创见	chuang	jian
创造力	chuang	zao	li
创造性	chuang	zao	xing
初中生	chu	zhong	sheng
初具规模	chu	ju	gui	mo
初创	chu	chuang
初四	chu	si
初夏	chu	xia
初始	chu	shi
初审	chu	shen
初小	chu	xiao
初战	chu	zhan
初版	chu	ban
初生	chu	sheng
初衷	chu	zhong
初试	chu	shi
初选	chu	xuan
删节	shan	jie
判例	pan	li
判决书	pan	jue	shu
判断力	pan	duan	li
判案	pan	an
判罪	pan	zui
利器	li	qi
利国	li	guo
利害	li	hai
利己	li	ji
利比亚	li	bi	ya
利物浦	li	wu	pu
利益均沾	li	yi	jun	zhan
利诱	li	you
别具匠心	bie	ju	jiang	xin
别动队	bie	dong	dui
到会	dao	hui
到点	dao	dian
到职	dao	zhi
制剂	zhi	ji
制动	zhi	dong
制备	zhi	bei
制导	zhi	dao
制度化	zhi	du	hua
制式	zhi	shi
制成	zhi	cheng
制成品	zhi	cheng	pin
制服	zhi	fu
制片厂	zhi	pian	chang
制版	zhi	ban
制药	zhi	yao
制订	zhi	ding
制造业	zhi	zao	ye
制造商	zhi	zao	shang
制高点	zhi	gao	dian
刺史	ci	shi
刺槐	ci	huai
刺激性	ci	ji	xing
刻毒	ke	du
刽子手	gui	zi	shou
剂型	ji	xing
前人	qian	ren
前夫	qian	fu
前头	qian	tou
前头	qian	tou
前奏曲	qian	zou	qu
前妻	qian	qi
前敌	qian	di
前科	qian	ke
前程似锦	qian	cheng	si	jin
前站	qian	zhan
前端	qian	duan
前线	qian	xian
前言	qian	yan
前驱	qian	qu
剑术	jian	shu
剔除	ti	chu
剥削阶级	bo	xue	jie	ji
剥离	bo	li
剥落	bo	luo
剥蚀	bo	shi
剧中人	ju	zhong	ren
剧作者	ju	zuo	zhe
剧变	ju	bian
剧种	ju	zhong
剪刀	jian	dao
剪刀差	jian	dao	cha
剪子	jian	zi
剪子	jian	zi
剪影	jian	ying
剪枝	jian	zhi
剪纸	jian	zhi
剪裁	jian	cai
副产品	fu	chan	pin
副作用	fu	zuo	yong
副官	fu	guan
副手	fu	shou
副教授	fu	jiao	shou
副职	fu	zhi
副题	fu	ti
副食	fu	shi
副食品	fu	shi	pin
割地	ge	di
割据	ge	ju
割断	ge	duan
力争上游	li	zheng	shang	you
力克	li	ke
力士	li	shi
劝慰	quan	wei
办事处	ban	shi	chu
办公桌	ban	gong	zhuo
办到	ban	dao
办厂	ban	chang
办班	ban	ban
功业	gong	ye
功利	gong	li
功名	gong	ming
功底	gong	di
功德	gong	de
功成不居	gong	cheng	bu	ju
功成名遂	gong	cheng	ming	sui
功用	gong	yong
功绩	gong	ji
加之	jia	zhi
加仑	jia	lun
加以	jia	yi
加价	jia	jia
加剧	jia	ju
加力	jia	li
加塞	jia	sai
加宽	jia	kuan
加工业	jia	gong	ye
加工厂	jia	gong	chang
加拿大	jia	na	da
加班加点	jia	ban	jia	dian
加班费	jia	ban	fei
加速器	jia	su	qi
加速度	jia	su	du
加高	jia	gao
务使	wu	shi
务农	wu	nong
务实	wu	shi
务虚	wu	xu
劣质品	lie	zhi	pin
动不动	dong	bu	dong
动不动	dong	bu	dong
动员令	dong	yuan	ling
动土	dong	tu
动机	dong	ji
动植物	dong	zhi	wu
动武	dong	wu
动物学	dong	wu	xue
动画片	dong	hua	pian
动画片	dong	hua	pian
动脑筋	dong	nao	jin
动议	dong	yi
助听器	zhu	ting	qi
助学金	zhu	xue	jin
助推器	zhu	tui	qi
助攻	zhu	gong
助教	zhu	jiao
助理员	zhu	li	yuan
助长	zhu	zhang
劫机	jie	ji
劲头	jin	tou
劳务费	lao	wu	fei
劳动力	lao	dong	li
劳动局	lao	dong	ju
劳动日	lao	dong	ri
劳动者	lao	dong	zhe
劳动节	lao	dong	jie
劳工	lao	gong
劳役	lao	yi
劳教所	lao	jiao	suo
劳资	lao	zi
势不可当	shi	bu	ke	dang
势利	shi	li
势力	shi	li
势单力薄	shi	dan	li	bo
势头	shi	tou
势态	shi	tai
勃勃	bo	bo
勇于	yong	yu
勘误	kan	wu
勤俭持家	qin	jian	chi	jia
勤务员	qin	wu	yuan
勤杂工	qin	za	gong
勤苦	qin	ku
勾搭	gou	da
勾搭	gou	da
勾通	gou	tong
包产	bao	chan
包修	bao	xiu
包围圈	bao	wei	quan
包工	bao	gong
包干制	bao	gan	zhi
包机	bao	ji
包涵	bao	han
包涵	bao	han
包钢	bao	gang
包销	bao	xiao
匈牙利	xiong	ya	li
化为泡影	hua	wei	pao	ying
化公为私	hua	gong	wei	si
化合物	hua	he	wu
化学家	hua	xue	jia
化工厂	hua	gong	chang
化肥	hua	fei
化装	hua	zhuang
化验室	hua	yan	shi
北伐	bei	fa
北伐军	bei	fa	jun
北大仓	bei	da	cang
北宋	bei	song
北极圈	bei	ji	quan
北极熊	bei	ji	xiong
北纬	bei	wei
北航	bei	hang
北面	bei	mian
北麓	bei	lu
匠心独运	jiang	xin	du	yun
匡算	kuang	suan
匣子	xia	zi
匣子	xia	zi
匹夫	pi	fu
匹夫有责	pi	fu	you	ze
区委	qu	wei
医书	yi	shu
医务	yi	wu
医嘱	yi	zhu
医学院	yi	xue	yuan
医师	yi	shi
医术	yi	shu
医治	yi	zhi
医科	yi	ke
医药费	yi	yao	fei
匾额	bian	e
十一月	shi	yi	yue
十三陵	shi	san	ling
十二分	shi	er	fen
十二指肠	shi	er	zhi	chang
十二月	shi	er	yue
十传百	shi	chuan	bai
十佳	shi	jia
十冬腊月	shi	dong	la	yue
十字	shi	zi
十字军	shi	zi	jun
十字路口	shi	zi	lu	kou
千伏	qian	fu
千千万万	qian	qian	wan	wan
千山万壑	qian	shan	wan	he
千岁	qian	sui
千差万别	qian	cha	wan	bie
千斤	qian	jin
千斤顶	qian	jin	ding
千百万	qian	bai	wan
千虑一失	qian	lv	yi	shi
千虑一得	qian	lv	yi	de
千载一时	qian	zai	yi	shi
千里之堤	qian	li	zhi	di
千里眼	qian	li	yan
千里马	qian	li	ma
千金	qian	jin
千难万险	qian	nan	wan	xian
千难万难	qian	nan	wan	nan
升堂入室	sheng	tang	ru	shi
升幅	sheng	fu
升旗	sheng	qi
升格	sheng	ge
升起	sheng	qi
升迁	sheng	qian
午夜	wu	ye
午宴	wu	yan
午时	wu	shi
午间	wu	jian
半价	ban	jia
半决赛	ban	jue	sai
半圆形	ban	yuan	xing
半壁江山	ban	bi	jiang	shan
半壁河山	ban	bi	he	shan
半导体	ban	dao	ti
半封建	ban	feng	jian
半成品	ban	cheng	pin
半文盲	ban	wen	mang
半旧	ban	jiu
半晌	ban	shang
半月刊	ban	yue	kan
半点	ban	dian
半球	ban	qiu
半自动	ban	zi	dong
半边天	ban	bian	tian
华尔兹	hua	er	zi
华工	hua	gong
华灯初上	hua	deng	chu	shang
华盛顿	hua	sheng	dun
华章	hua	zhang
华罗庚	hua	luo	geng
华语	hua	yu
华贵	hua	gui
华阴	hua	yin
协作	xie	zuo
协力	xie	li
协议书	xie	yi	shu
卓识	zhuo	shi
单个	dan	ge
单产	dan	chan
单体	dan	ti
单刀	dan	dao
单单	dan	dan
单子	dan	zi
单干	dan	gan
单打	dan	da
单机	dan	ji
单线	dan	xian
单细胞	dan	xi	bao
单行本	dan	xing	ben
单衣	dan	yi
单身汉	dan	shen	han
单边	dan	bian
单项	dan	xiang
卖主	mai	zhu
卖价	mai	jia
卖国贼	mai	guo	zei
卖方	mai	fang
南国	nan	guo
南岭	nan	ling
南海	nan	hai
南纬	nan	wei
南通	nan	tong
南阳	nan	yang
南面	nan	mian
南麓	nan	lu
博士后	bo	shi	hou
博士生	bo	shi	sheng
博大	bo	da
博学	bo	xue
博施济众	bo	shi	ji	zhong
博物院	bo	wu	yuan
博物馆	bo	wu	guan
博览	bo	lan
博采众长	bo	cai	zhong	chang
占先	zhan	xian
占有量	zhan	you	liang
占领区	zhan	ling	qu
卡塔尔	ka	ta	er
卡脖子	qia	bo	zi
卡脖子	qia	bo	zi
卢旺达	lu	wang	da
卢比	lu	bi
卤水	lu	shui
卧具	wo	ju
卧车	wo	che
卫兵	wei	bing
卫国	wei	guo
卫士	wei	shi
卫戍	wei	shu
卫戍区	wei	shu	qu
卫星城	wei	xing	cheng
卫生员	wei	sheng	yuan
卫生所	wei	sheng	suo
卫生纸	wei	sheng	zhi
卫生部	wei	sheng	bu
卫生间	wei	sheng	jian
卫生院	wei	sheng	yuan
卫队	wei	dui
印刷业	yin	shua	ye
印刷品	yin	shua	pin
印刷机	yin	shua	ji
印发	yin	fa
印数	yin	shu
印油	yin	you
印泥	yin	ni
印第安人	yin	di	an	ren
印行	yin	xing
印鉴	yin	jian
危亡	wei	wang
危及	wei	ji
危害性	wei	hai	xing
危局	wei	ju
危急	wei	ji
危重	wei	zhong
危难	wei	nan
即位	ji	wei
即便	ji	bian
即兴	ji	xing
即刻	ji	ke
即可	ji	ke
即时	ji	shi
即景	ji	jing
卵细胞	luan	xi	bao
卷子	juan	zi
卷子	juan	zi
卷子	juan	zi
厂子	chang	zi
厂子	chang	zi
厂方	chang	fang
厂矿	chang	kuang
厂规	chang	gui
厂部	chang	bu
历任	li	ren
历史剧	li	shi	ju
历史性	li	shi	xing
历史观	li	shi	guan
历届	li	jie
历年	li	nian
历时	li	shi
历法	li	fa
历险	li	xian
厉兵秣马	li	bing	mo	ma
压制	ya	zhi
压力锅	ya	li	guo
压岁钱	ya	sui	qian
压强	ya	qiang
压根儿	ya	gen	er
压根儿	ya	gen	er
压缩机	ya	suo	ji
压轴戏	ya	zhou	xi
厚实	hou	shi
原主	yuan	zhu
原则性	yuan	ze	xing
原动力	yuan	dong	li
原址	yuan	zhi
原型	yuan	xing
原委	yuan	wei
原子	yuan	zi
原子核	yuan	zi	he
原子钟	yuan	zi	zhong
原审	yuan	shen
原形	yuan	xing
原意	yuan	yi
原有	yuan	you
原木	yuan	mu
原样	yuan	yang
原油	yuan	you
原物	yuan	wu
原状	yuan	zhuang
原稿	yuan	gao
原粮	yuan	liang
原职	yuan	zhi
原著	yuan	zhu
去世	qu	shi
去处	qu	chu
去粗取精	qu	cu	qu	jing
去职	qu	zhi
县城	xian	cheng
县委	xian	wei
县志	xian	zhi
参事	can	shi
参战	can	zhan
参拜	can	bai
参照系	can	zhao	xi
参考书	can	kao	shu
参观团	can	guan	tuan
参议	can	yi
参议会	can	yi	hui
参议员	can	yi	yuan
参议院	can	yi	yuan
参谋部	can	mou	bu
参谋长	can	mou	chang
参谋长	can	mou	zhang
又惊又喜	you	jing	you	xi
又红又专	you	hong	you	zhuan
及其	ji	qi
及早	ji	zao
及时雨	ji	shi	yu
及格	ji	ge
及至	ji	zhi
友人	you	ren
友协	you	xie
友谊赛	you	yi	sai
双人床	shuang	ren	chuang
双人舞	shuang	ren	wu
双增双节	shuang	zeng	shuang	jie
双月刊	shuang	yue	kan
双簧管	shuang	huang	guan
双职工	shuang	zhi	gong
双轨	shuang	gui
反之	fan	zhi
反之亦然	fan	zhi	yi	ran
反党	fan	dang
反动派	fan	dong	pai
反响	fan	xiang
反对派	fan	dui	pai
反对票	fan	dui	piao
反应堆	fan	ying	dui
反悔	fan	hui
反攻	fan	gong
反潜	fan	qian
反观	fan	guan
反过来	fan	guo	lai
反过来说	fan	guo	lai	shuo
反霸	fan	ba
反革命	fan	ge	ming
发令	fa	ling
发令枪	fa	ling	qiang
发包	fa	bao
发型	fa	xing
发声	fa	sheng
发奋图强	fa	fen	tu	qiang
发展史	fa	zhan	shi
发布会	fa	bu	hui
发愤	fa	fen
发愤图强	fa	fen	tu	qiang
发愤忘食	fa	fen	wang	shi
发慌	fa	huang
发报	fa	bao
发掘	fa	jue
发明家	fa	ming	jia
发明者	fa	ming	zhe
发案	fa	an
发源	fa	yuan
发炎	fa	yan
发球	fa	qiu
发生器	fa	sheng	qi
发电厂	fa	dian	chang
发电机	fa	dian	ji
发电站	fa	dian	zhan
发电量	fa	dian	liang
发病率	fa	bing	lv
发端	fa	duan
发脾气	fa	pi	qi
发脾气	fa	pi	qi
发臭	fa	chou
发行量	fa	xing	liang
发言稿	fa	yan	gao
发达国家	fa	da	guo	jia
发迹	fa	ji
发问	fa	wen
发麻	fa	ma
叔父	shu	fu
取出	qu	chu
取景	qu	jing
取自	qu	zi
取道	qu	dao
取长补短	qu	chang	bu	duan
受刑	shou	xing
受命	shou	ming
受审	shou	shen
受害人	shou	hai	ren
受害者	shou	hai	zhe
受敌	shou	di
受权	shou	quan
受气	shou	qi
受灾	shou	zai
受理	shou	li
受益	shou	yi
受益者	shou	yi	zhe
受精	shou	jing
受罚	shou	fa
受贿	shou	hui
受辱	shou	ru
受阻	shou	zu
受降	shou	xiang
变化无常	bian	hua	wu	chang
变压器	bian	ya	qi
变幻	bian	huan
变废为宝	bian	fei	wei	bao
变异	bian	yi
变性	bian	xing
变戏法	bian	xi	fa
变电所	bian	dian	suo
变电站	bian	dian	zhan
变质	bian	zhi
变速器	bian	su	qi
叙事诗	xu	shi	shi
叙利亚	xu	li	ya
叙旧	xu	jiu
口型	kou	xing
口子	kou	zi
口子	kou	zi
口实	kou	shi
口形	kou	xing
口福	kou	fu
口香糖	kou	xiang	tang
口齿	kou	chi
古书	gu	shu
古井无波	gu	jing	wu	bo
古已有之	gu	yi	you	zhi
古拙	gu	zhuo
古文	gu	wen
古文字	gu	wen	zi
古时	gu	shi
古物	gu	wu
古生物	gu	sheng	wu
古稀	gu	xi
古籍	gu	ji
古董	gu	dong
古诗	gu	shi
古话	gu	hua
古迹	gu	ji
古道热肠	gu	dao	re	chang
古都	gu	du
古风	gu	feng
句式	ju	shi
另一方面	ling	yi	fang	mian
另行	ling	xing
叨唠	dao	lao
叨唠	dao	lao
只得	zhi	de
只是	zhi	shi
只见	zhi	jian
只身	zhi	shen
只限	zhi	xian
只需	zhi	xu
只顾	zhi	gu
叫做	jiao	zuo
叫嚣	jiao	xiao
叫好	jiao	hao
召回	zhao	hui
召集	zhao	ji
可亲可敬	ke	qin	ke	jing
可以攻玉	ke	yi	gong	yu
可信度	ke	xin	du
可卡因	ke	ka	yin
可可	ke	ke
可喜	ke	xi
可嘉	ke	jia
可望	ke	wang
可疑	ke	yi
可知	ke	zhi
可见光	ke	jian	guang
可观	ke	guan
可读性	ke	du	xing
可鄙	ke	bi
台子	tai	zi
台子	tai	zi
台属	tai	shu
台州	tai	zhou
台柱子	tai	zhu	zi
台柱子	tai	zhu	zi
台盟	tai	meng
台联	tai	lian
台资	tai	zi
史书	shi	shu
史册	shi	ce
史前	shi	qian
史学	shi	xue
史官	shi	guan
史实	shi	shi
史料	shi	liao
史籍	shi	ji
史记	shi	ji
史诗	shi	shi
史话	shi	hua
史迹	shi	ji
右倾	you	qing
右翼	you	yi
叶脉	ye	mai
叶面	ye	mian
号召力	hao	zhao	li
号子	hao	zi
号子	hao	zi
号手	hao	shou
号脉	hao	mai
司令官	si	ling	guan
司令部	si	ling	bu
司务长	si	wu	zhang
司法部	si	fa	bu
司长	si	zhang
吃一堑	chi	yi	qian
吃不消	chi	bu	xiao
吃不消	chi	bu	xiao
吃老本	chi	lao	ben
吃苦头	chi	ku	tou
吃请	chi	qing
吃香	chi	xiang
各个	ge	ge
各异	ge	yi
各自为政	ge	zi	wei	zheng
各行其是	ge	xing	qi	shi
吆呼	yao	hu
吆呼	yao	hu
合一	he	yi
合乎	he	hu
合伙人	he	huo	ren
合作化	he	zuo	hua
合作社	he	zuo	she
合剂	he	ji
合力	he	li
合同制	he	tong	zhi
合同制	he	tong	zhi
合同工	he	tong	gong
合同工	he	tong	gong
合唱团	he	chang	tuan
合围	he	wei
合家欢	he	jia	huan
合并症	he	bing	zheng
合成氨	he	cheng	an
合抱	he	bao
合格率	he	ge	lv
合流	he	liu
合理化	he	li	hua
合理性	he	li	xing
合璧	he	bi
合用	he	yong
合算	he	suan
合署	he	shu
合股	he	gu
合营	he	ying
合订本	he	ding	ben
合金钢	he	jin	gang
合龙	he	long
吉利	ji	li
吉庆	ji	qing
吉日	ji	ri
吉普车	ji	pu	che
吉林省	ji	lin	sheng
吉祥	ji	xiang
吉祥物	ji	xiang	wu
吊唁	diao	yan
吊环	diao	huan
同一性	tong	yi	xing
同义词	tong	yi	ci
同乡	tong	xiang
同事	tong	shi
同位素	tong	wei	su
同化	tong	hua
同室操戈	tong	shi	cao	ge
同年	tong	nian
同心	tong	xin
同志	tong	zhi
同性	tong	xing
同性恋	tong	xing	lian
同案犯	tong	an	fan
同治	tong	zhi
同生共死	tong	sheng	gong	si
同盟会	tong	meng	hui
同盟军	tong	meng	jun
同盟国	tong	meng	guo
同级	tong	ji
同胞	tong	bao
同道	tong	dao
名位	ming	wei
名医	ming	yi
名古屋	ming	gu	wu
名噪一时	ming	zao	yi	shi
名噪一时	ming	zao	yi	shi
名城	ming	cheng
名士	ming	shi
名山	ming	shan
名山大川	ming	shan	da	chuan
名手	ming	shou
名次	ming	ci
名胜	ming	sheng
名花	ming	hua
名著	ming	zhu
后世	hou	shi
后事	hou	shi
后事之师	hou	shi	zhi	shi
后任	hou	ren
后备军	hou	bei	jun
后援	hou	yuan
后撤	hou	che
后继有人	hou	ji	you	ren
后背	hou	bei
后脚	hou	jiao
后腿	hou	tui
后记	hou	ji
后辈	hou	bei
后进	hou	jin
吏治	li	zhi
向导	xiang	dao
向心力	xiang	xin	li
向日葵	xiang	ri	kui
向着	xiang	zhe
向着	xiang	zhe
向阳	xiang	yang
吓倒	xia	dao
君主立宪	jun	zhu	li	xian
吞吐量	tun	tu	liang
吞食	tun	shi
吟诗	yin	shi
否决权	fou	jue	quan
含冤	han	yuan
含意	han	yi
含水量	han	shui	liang
含笑	han	xiao
含糊其词	han	hu	qi	ci
含糊其词	han	hu	qi	ci
含羞	han	xiu
听诊器	ting	zhen	qi
吮吸	shun	xi
启事	qi	shi
启发性	qi	fa	xing
启明	qi	ming
启明星	qi	ming	xing
启示	qi	shi
启航	qi	hang
启运	qi	yun
吴牛喘月	wu	niu	chuan	yue
吸尘器	xi	chen	qi
吸附	xi	fu
吹吹打打	chui	chui	da	da
吻合	wen	he
吼声	hou	sheng
呆呆	dai	dai
呆板	dai	ban
呈报	cheng	bao
呈献	cheng	xian
呈请	cheng	qing
告急	gao	ji
告慰	gao	wei
告捷	gao	jie
告终	gao	zhong
告罄	gao	qing
呋喃	fu	nan
员额	yuan	e
呜咽	wu	ye
周恩来	zhou	en	lai
周易	zhou	yi
周期性	zhou	qi	xing
周章	zhou	zhang
呶呶	nao	nao
呼之欲出	hu	zhi	yu	chu
呼吸道	hu	xi	dao
命根子	ming	gen	zi
命案	ming	an
咀嚼	ju	jue
和会	he	hui
和平共处	he	ping	gong	chu
和平鸽	he	ping	ge
和煦	he	xu
和约	he	yue
和衷共济	he	zhong	gong	ji
和面	huo	mian
咏叹调	yong	tan	diao
咕咚	gu	dong
咕噜	gu	lu
咕噜	gu	lu
咖啡因	ka	fei	yin
咨文	zi	wen
咬牙切齿	yao	ya	qie	chi
咬紧牙关	yao	jin	ya	guan
咸丰	xian	feng
哀伤	ai	shang
品位	pin	wei
品名	pin	ming
品性	pin	xing
品级	pin	ji
哈萨克	ha	sa	ke
哈萨克族	ha	sa	ke	zu
响声	xiang	sheng
响应	xiang	ying
响当当	xiang	dang	dang
响彻	xiang	che
响音	xiang	yin
哑语	ya	yu
哗变	hua	bian
哗啦啦	hua	la	la
哥儿们	ge	er	men
哥儿们	ge	er	men
哥白尼	ge	bai	ni
哨位	shao	wei
哨兵	shao	bing
哨子	shao	zi
哭叫	ku	jiao
哲学家	zhe	xue	jia
哲理	zhe	li
哺乳	bu	ru
哺乳动物	bu	ru	dong	wu
哺育	bu	yu
唁函	yan	han
唆使	suo	shi
唇枪舌战	chun	qiang	she	zhan
售卖	shou	mai
售票员	shou	piao	yuan
售票处	shou	piao	chu
售票处	shou	piao	chu
售货	shou	huo
售货员	shou	huo	yuan
唯物	wei	wu
唯物史观	wei	wu	shi	guan
唯物论	wei	wu	lun
唱反调	chang	fan	diao
唱和	chang	he
唱段	chang	duan
唱法	chang	fa
唱片	chang	pian
唱词	chang	ci
唾面自干	tuo	mian	zi	gan
啁啾	zhou	jiu
啄木鸟	zhuo	mu	niao
商业界	shang	ye	jie
商会	shang	hui
商务	shang	wu
商品房	shang	pin	fang
商品粮	shang	pin	liang
商埠	shang	bu
商机	shang	ji
商界	shang	jie
商船	shang	chuan
商议	shang	yi
商贾	shang	gu
喀嚓	ka	cha
喀布尔	ka	bu	er
善人	shan	ren
善本	shan	ben
喊话	han	hua
喘气	chuan	qi
喜出望外	xi	chu	wang	wai
喜剧片	xi	ju	pian
喜报	xi	bao
喜气	xi	qi
喜洋洋	xi	yang	yang
喜滋滋	xi	zi	zi
喜雨	xi	yu
喜鹊	xi	que
喷吐	pen	tu
喷漆	pen	qi
喷雾器	pen	wu	qi
嗓子眼	sang	zi	yan
嗣后	si	hou
嘀咕	di	gu
嘀咕	di	gu
嘉兴	jia	xing
嘉峪关	jia	yu	guan
嘉陵	jia	ling
嘱咐	zhu	fu
器乐	qi	yue
器件	qi	jian
器物	qi	wu
器重	qi	zhong
嚎啕	hao	tao
囚室	qiu	shi
四下	si	xia
四世同堂	si	shi	tong	tang
四书	si	shu
四人帮	si	ren	bang
四化	si	hua
四周	si	zhou
四处奔波	si	chu	ben	bo
四季	si	ji
四川省	si	chuan	sheng
四时	si	shi
四边	si	bian
回乡	hui	xiang
回击	hui	ji
回响	hui	xiang
回填	hui	tian
回声	hui	sheng
回复	hui	fu
回头客	hui	tou	ke
回头路	hui	tou	lu
回忆	hui	yi
回收率	hui	shou	lv
回游	hui	you
回炉	hui	lu
回访	hui	fang
回路	hui	lu
回首	hui	shou
回马枪	hui	ma	qiang
因人制宜	yin	ren	zhi	yi
因子	yin	zi
因时制宜	yin	shi	zhi	yi
因由	yin	you
因缘	yin	yuan
囡囡	nan	nan
团中央	tuan	zhong	yang
团体操	tuan	ti	cao
团员	tuan	yuan
团拜	tuan	bai
团支部	tuan	zhi	bu
团旗	tuan	qi
团日	tuan	ri
团部	tuan	bu
园丁	yuan	ding
园地	yuan	di
园子	yuan	zi
园子	yuan	zi
园艺	yuan	yi
园长	yuan	zhang
围垦	wei	ken
围巾	wei	jin
围歼	wei	jian
围追	wei	zhui
囹圄	ling	yu
固定资产	gu	ding	zi	chan
固步自封	gu	bu	zi	feng
固沙林	gu	sha	lin
国书	guo	shu
国事	guo	shi
国产货	guo	chan	huo
国企	guo	qi
国会	guo	hui
国体	guo	ti
国内外	guo	nei	wai
国务卿	guo	wu	qing
国务院	guo	wu	yuan
国势	guo	shi
国史	guo	shi
国君	guo	jun
国境线	guo	jing	xian
国威	guo	wei
国宴	guo	yan
国宾馆	guo	bin	guan
国富民强	guo	fu	min	qiang
国库券	guo	ku	quan
国度	guo	du
国情	guo	qing
国政	guo	zheng
国教	guo	jiao
国文	guo	wen
国旗	guo	qi
国格	guo	ge
国民经济	guo	min	jing	ji
国界	guo	jie
国立	guo	li
国籍	guo	ji
国花	guo	hua
国语	guo	yu
国都	guo	du
国防军	guo	fang	jun
国防部	guo	fang	bu
国际主义	guo	ji	zhu	yi
国际法	guo	ji	fa
图书室	tu	shu	shi
图表	tu	biao
圆圈	yuan	quan
圆寂	yuan	ji
圆明园	yuan	ming	yuan
圆柱	yuan	zhu
圆珠笔	yuan	zhu	bi
圈阅	quan	yue
土专家	tu	zhuan	jia
土丘	tu	qiu
土坡	tu	po
土墙	tu	qiang
土家族	tu	jia	zu
土层	tu	ceng
土布	tu	bu
土库曼	tu	ku	man
土改	tu	gai
土政策	tu	zheng	ce
土星	tu	xing
土法	tu	fa
土石方	tu	shi	fang
土著	tu	zhu
土话	tu	hua
土质	tu	zhi
圣人	sheng	ren
圣地	sheng	di
圣旨	sheng	zhi
圣母	sheng	mu
圣水	sheng	shui
圣诞树	sheng	dan	shu
在先	zai	xian
在心	zai	xin
在押犯	zai	ya	fan
在教	zai	jiao
在校生	zai	xiao	sheng
在此	zai	ci
在读	zai	du
在逃犯	zai	tao	fan
在野党	zai	ye	dang
地下室	di	xia	shi
地下水	di	xia	shui
地中海	di	zhong	hai
地价	di	jia
地利	di	li
地力	di	li
地动仪	di	dong	yi
地势	di	shi
地区性	di	qu	xing
地块	di	kuai
地域	di	yu
地基	di	ji
地处	di	chu
地头	di	tou
地委	di	wei
地学	di	xue
地层	di	ceng
地形图	di	xing	tu
地心	di	xin
地摊	di	tan
地支	di	zhi
地方志	di	fang	zhi
地方戏	di	fang	xi
地方病	di	fang	bing
地方税	di	fang	shui
地狱	di	yu
地球仪	di	qiu	yi
地理学	di	li	xue
地界	di	jie
地痞	di	pi
地矿	di	kuang
地磁	di	ci
地租	di	zu
地窖	di	jiao
地膜	di	mo
地表水	di	biao	shui
地质	di	zhi
地道战	di	dao	zhan
地面水	di	mian	shui
场子	chang	zi
场子	chang	zi
场长	chang	zhang
场院	chang	yuan
均势	jun	shi
坎儿	kan	er
坎儿	kan	er
坎坷不平	kan	ke	bu	ping
坐像	zuo	xiang
坐商	zuo	shang
坐失	zuo	shi
坐视	zuo	shi
块状	kuai	zhuang
坚冰	jian	bing
坚定	jian	ding
坚实	jian	shi
坚忍不拔	jian	ren	bu	ba
坚持不渝	jian	chi	bu	yu
坚果	jian	guo
坚毅	jian	yi
坚苦卓绝	jian	ku	zhuo	jue
坚韧	jian	ren
坛子	tan	zi
坛子	tan	zi
坟头	fen	tou
坟茔	fen	ying
坦桑尼亚	tan	sang	ni	ya
坦诚相见	tan	cheng	xiang	jian
坦途	tan	tu
坷垃	ke	la
垫子	dian	zi
垫子	dian	zi
埋单	mai	dan
城关	cheng	guan
城根	cheng	gen
城郊	cheng	jiao
城郭	cheng	guo
城里	cheng	li
城里人	cheng	li	ren
城防	cheng	fang
城际	cheng	ji
培土	pei	tu
培植	pei	zhi
培训班	pei	xun	ban
基于	ji	yu
基围虾	ji	wei	xia
基址	ji	zhi
基干	ji	gan
基建	ji	jian
基数	ji	shu
基本上	ji	ben	shang
基本上	ji	ben	shang
基本功	ji	ben	gong
基本法	ji	ben	fa
基点	ji	dian
基督	ji	du
基石	ji	shi
基础课	ji	chu	ke
基线	ji	xian
基金会	ji	jin	hui
堂倌	tang	guan
堆放	dui	fang
堆砌	dui	qi
堤坝	di	ba
堤防	di	fang
堪称	kan	cheng
堪称一绝	kan	cheng	yi	jue
堵住	du	zhu
塌方	ta	fang
塑料布	su	liao	bu
塑料管	su	liao	guan
塔吉克	ta	ji	ke
塔吉克族	ta	ji	ke	zu
塔斯社	ta	si	she
塔里木	ta	li	mu
填平	tian	ping
填料	tian	liao
填空	tian	kong
填词	tian	ci
境地	jing	di
境遇	jing	yu
墒情	shang	qing
墓地	mu	di
墓室	mu	shi
墓志	mu	zhi
墓道	mu	dao
墙基	qiang	ji
墙报	qiang	bao
墙脚	qiang	jiao
增殖	zeng	zhi
增至	zeng	zhi
增速	zeng	su
增长率	zeng	zhang	lv
墨盒	mo	he
墨绿色	mo	lv	se
壁炉	bi	lu
壁画	bi	hua
壁纸	bi	zhi
壅蔽	yong	bi
士大夫	shi	da	fu
士气	shi	qi
壮士	zhuang	shi
壮实	zhuang	shi
壮实	zhuang	shi
壮志	zhuang	zhi
壮歌	zhuang	ge
声势	sheng	shi
声威	sheng	wei
声学	sheng	xue
声张	sheng	zhang
声息	sheng	xi
声浪	sheng	lang
声称	sheng	cheng
声符	sheng	fu
声誉	sheng	yu
声誉鹊起	sheng	yu	que	qi
声速	sheng	su
处世	chu	shi
处事	chu	shi
处决	chu	jue
处境	chu	jing
处女作	chu	nv	zuo
处女地	chu	nv	di
处方	chu	fang
处理机	chu	li	ji
处罚	chu	fa
备件	bei	jian
备忘录	bei	wang	lu
备料	bei	liao
备考	bei	kao
备耕	bei	geng
备课	bei	ke
备足	bei	zu
备齐	bei	qi
复信	fu	xin
复写	fu	xie
复函	fu	han
复刊	fu	kan
复制品	fu	zhi	pin
复印机	fu	yin	ji
复合	fu	he
复员	fu	yuan
复审	fu	shen
复旦	fu	dan
复杂性	fu	za	xing
复查	fu	cha
复核	fu	he
复种	fu	zhong
复线	fu	xian
复议	fu	yi
复试	fu	shi
复读	fu	du
复赛	fu	sai
复辟	fu	bi
复述	fu	shu
夏令营	xia	ling	ying
夏夜	xia	ye
夏收	xia	shou
夏种	xia	zhong
夏种	xia	zhong
夏粮	xia	liang
外乡	wai	xiang
外乡人	wai	xiang	ren
外交部	wai	jiao	bu
外伤	wai	shang
外侮	wai	wu
外向型	wai	xiang	xing
外地人	wai	di	ren
外埠	wai	bu
外带	wai	dai
外敌	wai	di
外敷	wai	fu
外来人	wai	lai	ren
外来户	wai	lai	hu
外汇券	wai	hui	quan
外甥	wai	sheng
外祖父	wai	zu	fu
外线	wai	xian
外貌	wai	mao
外逃	wai	tao
外遇	wai	yu
多于	duo	yu
多多少少	duo	duo	shao	shao
多多益善	duo	duo	yi	shan
多媒体	duo	mei	ti
多方面	duo	fang	mian
多样化	duo	yang	hua
多样性	duo	yang	xing
多种多样	duo	zhong	duo	yang
多糖	duo	tang
多级	duo	ji
多边	duo	bian
多面手	duo	mian	shou
夜宿	ye	su
夜市	ye	shi
夜幕低垂	ye	mu	di	chui
夜总会	ye	zong	hui
夜战	ye	zhan
夜明珠	ye	ming	zhu
夜景	ye	jing
夜校	ye	xiao
夜游	ye	you
夜莺	ye	ying
大一统	da	yi	tong
大专生	da	zhuan	sheng
大业	da	ye
大为	da	wei
大举	da	ju
大义	da	yi
大书特书	da	shu	te	shu
大事记	da	shi	ji
大人	da	ren
大人	da	ren
大人	da	ren
大伙	da	huo
大伙儿	da	huo	er
大伙儿	da	huo	er
大会堂	da	hui	tang
大作家	da	zuo	jia
大使	da	shi
大使馆	da	shi	guan
大侠	da	xia
大便	da	bian
大做文章	da	zuo	wen	zhang
大全	da	quan
大关	da	guan
大兴	da	xing
大兵	da	bing
大兵团	da	bing	tuan
大刀	da	dao
大别山	da	bie	shan
大副	da	fu
大力	da	li
大力士	da	li	shi
大办	da	ban
大动脉	da	dong	mai
大势	da	shi
大半	da	ban
大厅	da	ting
大叔	da	shu
大号	da	hao
大吃大喝	da	chi	da	he
大同	da	tong
大后方	da	hou	fang
大喜事	da	xi	shi
大器	da	qi
大团圆	da	tuan	yuan
大团结	da	tuan	jie
大坝	da	ba
大型机	da	xing	ji
大多数	da	duo	shu
大奖赛	da	jiang	sai
大妈	da	ma
大姐	da	jie
大姑娘	da	gu	niang
大嫂	da	sao
大字	da	zi
大字报	da	zi	bao
大客车	da	ke	che
大家庭	da	jia	ting
大寨	da	zhai
大将	da	jiang
大小便	da	xiao	bian
大展	da	zhan
大师	da	shi
大师傅	da	shi	fu
大师傅	da	shi	fu
大幅	da	fu
大幅度	da	fu	du
大干	da	gan
大干	da	gan
大志	da	zhi
大戏	da	xi
大手笔	da	shou	bi
大打出手	da	da	chu	shou
大抵	da	di
大拇指	da	mu	zhi
大拇指	da	mu	zhi
大捷	da	jie
大政	da	zheng
大敌	da	di
大新	da	xin
大旱	da	han
大智大勇	da	zhi	da	yong
大曲	da	qu
大有文章	da	you	wen	zhang
大杂院	da	za	yuan
大校	da	xiao
大案	da	an
大梁	da	liang
大棒	da	bang
大殿	da	dian
大气候	da	qi	hou
大水	da	shui
大汉	da	han
大汗淋漓	da	han	lin	li
大法	da	fa
大渡河	da	du	he
大漠	da	mo
大潮	da	chao
大猩猩	da	xing	xing
大猩猩	da	xing	xing
大班	da	ban
大理	da	li
大田	da	tian
大略	da	lue
大略	da	lve
大白	da	bai
大白菜	da	bai	cai
大礼堂	da	li	tang
大祸	da	huo
大笑	da	xiao
大肆	da	si
大脚	da	jiao
大腕	da	wan
大自然	da	zi	ran
大菜	da	cai
大蒜	da	suan
大虾	da	xia
大衣	da	yi
大西北	da	xi	bei
大要	da	yao
大观	da	guan
大规模	da	gui	mo
大计	da	ji
大败	da	bai
大跃进	da	yue	jin
大路	da	lu
大路货	da	lu	huo
大踏步	da	ta	bu
大轰大嗡	da	hong	da	weng
大过	da	guo
大道	da	dao
大部	da	bu
大部分	da	bu	fen
大都	da	dou
大都	da	du
大钱	da	qian
大阪	da	ban
大陆架	da	lu	jia
大雅	da	ya
大雨	da	yu
大雪	da	xue
大雪纷飞	da	xue	fen	fei
大雾	da	wu
大革命	da	ge	ming
大饼	da	bing
大麦	da	mai
大麻	da	ma
大鼓	da	gu
天不怕	tian	bu	pa
天主	tian	zhu
天井	tian	jing
天仙	tian	xian
天公	tian	gong
天兵天将	tian	bing	tian	jiang
天南海北	tian	nan	hai	bei
天命	tian	ming
天堑	tian	qian
天外有天	tian	wai	you	tian
天女散花	tian	nv	san	hua
天安门	tian	an	men
天府	tian	fu
天敌	tian	di
天数	tian	shu
天文学	tian	wen	xue
天文馆	tian	wen	guan
天时	tian	shi
天极	tian	ji
天梯	tian	ti
天棚	tian	peng
天津市	tian	jin	shi
天穹	tian	qiong
天职	tian	zhi
天象	tian	xiang
天资	tian	zi
天际	tian	ji
天险	tian	xian
天马行空	tian	ma	xing	kong
太原	tai	yuan
太原市	tai	yuan	shi
太守	tai	shou
太平天国	tai	ping	tian	guo
太庙	tai	miao
太行山	tai	hang	shan
夫子	fu	zi
央视	yang	shi
失业	shi	ye
失主	shi	zhu
失事	shi	shi
失利	shi	li
失地	shi	di
失声	shi	sheng
失学	shi	xue
失守	shi	shou
失实	shi	shi
失常	shi	chang
失态	shi	tai
失意	shi	yi
失掉	shi	diao
失控	shi	kong
失散	shi	san
失明	shi	ming
失火	shi	huo
失物	shi	wu
失真	shi	zhen
失礼	shi	li
失禁	shi	jin
失而复得	shi	er	fu	de
失职	shi	zhi
失聪	shi	cong
失血	shi	xue
失语	shi	yu
失误	shi	wu
失足	shi	zu
失身	shi	shen
失重	shi	zhong
头人	tou	ren
头儿	tou	er
头儿	tou	er
头头	tou	tou
头子	tou	zi
头子	tou	zi
头球	tou	qiu
头盔	tou	kui
头盖骨	tou	gai	gu
头羊	tou	yang
头雁	tou	yan
头面人物	tou	mian	ren	wu
头颅	tou	lu
头饰	tou	shi
夸父追日	kua	fu	zhui	ri
夹击	jia	ji
夹子	jia	zi
夹子	jia	zi
夹板	jia	ban
夹道	jia	dao
夺眶而出	duo	kuang	er	chu
夺魁	duo	kui
奇丽	qi	li
奇事	qi	shi
奇兵	qi	bing
奇功	qi	gong
奇峰	qi	feng
奇巧	qi	qiao
奇才	qi	cai
奇景	qi	jing
奇袭	qi	xi
奇观	qi	guan
奇遇	qi	yu
奇闻	qi	wen
奋力	fen	li
奋发	fen	fa
奋发有为	fen	fa	you	wei
奋笔疾书	fen	bi	ji	shu
奋起	fen	qi
奏折	zou	zhe
奏鸣曲	zou	ming	qu
契机	qi	ji
契税	qi	shui
契约	qi	yue
奔袭	ben	xi
奔走相告	ben	zou	xiang	gao
奖学金	jiang	xue	jin
奖罚分明	jiang	fa	fen	ming
套印	tao	yin
套房	tao	fang
套种	tao	zhong
套话	tao	hua
套购	tao	gou
套近乎	tao	jin	hu
奠基	dian	ji
奢侈品	she	chi	pin
奥地利	ao	di	li
女中音	nv	zhong	yin
女主人	nv	zhu	ren
女主人	nv	zhu	ren
女娲	nv	wa
女式	nv	shi
女真	nv	zhen
女高音	nv	gao	yin
奴隶	nu	li
奴隶制	nu	li	zhi
奴隶社会	nu	li	she	hui
奶制品	nai	zhi	pin
奸商	jian	shang
她们	ta	men
她们	ta	men
好不	hao	bu
好人好事	hao	ren	hao	shi
好使	hao	shi
好受	hao	shou
好处费	hao	chu	fei
好好先生	hao	hao	xian	sheng
好好先生	hao	hao	xian	sheng
好容易	hao	rong	yi
好强	hao	qiang
好找	hao	zhao
好日子	hao	ri	zi
好日子	hao	ri	zi
好消息	hao	xiao	xi
好端端	hao	duan	duan
好胜	hao	sheng
好话	hao	hua
如常	ru	chang
如故	ru	gu
如醉如痴	ru	zui	ru	chi
妄言	wang	yan
妇人	fu	ren
妇幼	fu	you
妊娠	ren	shen
妒嫉	du	ji
妓院	ji	yuan
妖冶	yao	ye
始发	shi	fa
始发站	shi	fa	zhan
始祖	shi	zu
始终不渝	shi	zhong	bu	yu
姑息	gu	xi
姓氏	xing	shi
委任	wei	ren
委员会	wei	yuan	hui
委员长	wei	yuan	zhang
委实	wei	shi
委托书	wei	tuo	shu
委托人	wei	tuo	ren
委曲	wei	qu
姗姗	shan	shan
姗姗来迟	shan	shan	lai	chi
姻娅	yin	ya
姿容	zi	rong
威吓	wei	he
威士忌	wei	shi	ji
威海	wei	hai
威逼	wei	bi
威风	wei	feng
娃子	wa	zi
娃子	wa	zi
娇小	jiao	xiao
娇气	jiao	qi
娇艳	jiao	yan
娓娓	wei	wei
娘子军	niang	zi	jun
娼妓	chang	ji
婉言	wan	yan
婕妤	jie	yu
婚丧嫁娶	hun	sang	jia	qu
婚姻法	hun	yin	fa
婵媛	chan	yuan
媒人	mei	ren
嫁人	jia	ren
嫁妆	jia	zhuang
嫁妆	jia	zhuang
嫡系	di	xi
嬉笑	xi	xiao
嬉闹	xi	nao
子公司	zi	gong	si
子午线	zi	wu	xian
子弟兵	zi	di	bing
子系统	zi	xi	tong
子集	zi	ji
孑孓	jie	jue
孔府	kong	fu
孔隙	kong	xi
孔雀	kong	que
孕期	yun	qi
字句	zi	ju
字号	zi	hao
字号	zi	hao
字幕	zi	mu
字形	zi	xing
字样	zi	yang
字迹	zi	ji
字音	zi	yin
存储器	cun	chu	qi
存栏	cun	lan
存货	cun	huo
孙中山	sun	zhong	shan
孝子	xiao	zi
孝心	xiao	xin
孟加拉国	meng	jia	la	guo
孢子	bao	zi
季刊	ji	kan
季节性	ji	jie	xing
季风	ji	feng
孤寂	gu	ji
孤寡老人	gu	gua	lao	ren
孤本	gu	ben
孤立	gu	li
孤身一人	gu	shen	yi	ren
学业	xue	ye
学习班	xue	xi	ban
学分制	xue	fen	zhi
学制	xue	zhi
学力	xue	li
学友	xue	you
学员	xue	yuan
学堂	xue	tang
学士	xue	shi
学好	xue	hao
学子	xue	zi
学时	xue	shi
学有专长	xue	you	zhuan	chang
学术性	xue	shu	xing
学术界	xue	shu	jie
学杂费	xue	za	fei
学生会	xue	sheng	hui
学生证	xue	sheng	zheng
学童	xue	tong
学籍	xue	ji
学而不厌	xue	er	bu	yan
学贯中西	xue	guan	zhong	xi
学部	xue	bu
孩儿	hai	er
孩子王	hai	zi	wang
孩子王	hai	zi	wang
孳生	zi	sheng
宅基地	zhai	ji	di
宇宙观	yu	zhou	guan
宇航员	yu	hang	yuan
守军	shou	jun
守势	shou	shi
守卫	shou	wei
守备	shou	bei
守宫	shou	gong
守敌	shou	di
守法	shou	fa
守经达权	shou	jing	da	quan
守门员	shou	men	yuan
安上	an	shang
安全带	an	quan	dai
安全帽	an	quan	mao
安全性	an	quan	xing
安全部	an	quan	bu
安卡拉	an	ka	la
安危	an	wei
安培	an	pei
安家费	an	jia	fei
安庆	an	qing
安徽省	an	hui	sheng
安步当车	an	bu	dang	che
安步当车	an	bu	dang	che
安民告示	an	min	gao	shi
安然	an	ran
安谧	an	mi
安身	an	shen
安阳	an	yang
宋庆龄	song	qing	ling
完好无损	wan	hao	wu	sun
完税	wan	shui
宏亮	hong	liang
宗师	zong	shi
宗旨	zong	zhi
宗法	zong	fa
官吏	guan	li
官商	guan	shang
官气	guan	qi
官职	guan	zhi
官衔	guan	xian
定夺	ding	duo
定局	ding	ju
定居点	ding	ju	dian
定性	ding	xing
定理	ding	li
定盘星	ding	pan	xing
定神	ding	shen
定级	ding	ji
定购	ding	gou
宜于	yi	yu
宜人	yi	ren
宜昌	yi	chang
宝刀	bao	dao
宝剑	bao	jian
宝岛	bao	dao
宝玉	bao	yu
宝珠	bao	zhu
实业	shi	ye
实习生	shi	xi	sheng
实事	shi	shi
实例	shi	li
实名	shi	ming
实地	shi	di
实处	shi	chu
实心	shi	xin
实情	shi	qing
实打实	shi	da	shi
实招	shi	zhao
实效	shi	xiao
实时	shi	shi
实测	shi	ce
实物	shi	wu
实用	shi	yong
实职	shi	zhi
实证	shi	zheng
实验室	shi	yan	shi
审判员	shen	pan	yuan
审判庭	shen	pan	ting
审察	shen	cha
审慎	shen	shen
审时度势	shen	shi	duo	shi
审校	shen	jiao
审校	shen	xiao
审稿	shen	gao
审美观	shen	mei	guan
审视	shen	shi
客体	ke	ti
客座	ke	zuo
客机	ke	ji
客流量	ke	liu	liang
客船	ke	chuan
客观性	ke	guan	xing
客货	ke	huo
客运站	ke	yun	zhan
宣传员	xuan	chuan	yuan
宣传品	xuan	chuan	pin
宣传画	xuan	chuan	hua
宣传部	xuan	chuan	bu
宣传队	xuan	chuan	dui
宣战	xuan	zhan
宣纸	xuan	zhi
宣统	xuan	tong
室内乐	shi	nei	yue
宪兵	xian	bing
宪政	xian	zheng
宪章	xian	zhang
宫殿	gong	dian
宴席	yan	xi
宴请	yan	qing
家丁	jia	ding
家世	jia	shi
家乡话	jia	xiang	hua
家书	jia	shu
家事	jia	shi
家什	jia	shi
家什	jia	shi
家信	jia	xin
家务活	jia	wu	huo
家史	jia	shi
家宴	jia	yan
家家	jia	jia
家小	jia	xiao
家居	jia	ju
家常便饭	jia	chang	bian	fan
家法	jia	fa
家访	jia	fang
家长制	jia	zhang	zhi
家风	jia	feng
容光	rong	guang
宽余	kuan	yu
宽大为怀	kuan	da	wei	huai
宽打窄用	kuan	da	zhai	yong
宿命论	su	ming	lun
宿将	su	jiang
宿愿	su	yuan
宿敌	su	di
寄予	ji	yu
寄信	ji	xin
寄宿	ji	su
寄居	ji	ju
寄语	ji	yu
寅吃卯粮	yin	chi	mao	liang
密不可分	mi	bu	ke	fen
密件	mi	jian
密友	mi	you
密密	mi	mi
密密匝匝	mi	mi	za	za
密密麻麻	mi	mi	ma	ma
密密麻麻	mi	mi	ma	ma
密布	mi	bu
密植	mi	zhi
密电	mi	dian
密闭	mi	bi
密集型	mi	ji	xing
富丽	fu	li
富于	fu	yu
富人	fu	ren
富余	fu	yu
富余	fu	yu
富士通	fu	shi	tong
富庶	fu	shu
富矿	fu	kuang
富豪	fu	hao
富饶	fu	rao
寒冬腊月	han	dong	la	yue
寒士	han	shi
寒夜	han	ye
寒意	han	yi
寒暑	han	shu
寒暑假	han	shu	jia
寒门	han	men
寓于	yu	yu
寓意	yu	yi
寓言	yu	yan
察看	cha	kan
寥寥	liao	liao
寨子	zhai	zi
寰宇	huan	yu
寰球	huan	qiu
寸心	cun	xin
寸步不让	cun	bu	bu	rang
对仗	dui	zhang
对劲	dui	jin
对唱	dui	chang
对外开放	dui	wai	kai	fang
对打	dui	da
对抗赛	dui	kang	sai
对换	dui	huan
对角	dui	jiao
对讲机	dui	jiang	ji
寻机	xun	ji
寻根	xun	gen
导出	dao	chu
导师	dao	shi
导报	dao	bao
导火线	dao	huo	xian
导言	dao	yan
寿险	shou	xian
封山	feng	shan
封山育林	feng	shan	yu	lin
封建主义	feng	jian	zhu	yi
封建社会	feng	jian	she	hui
封闭式	feng	bi	shi
射击	she	ji
射程	she	cheng
射线	she	xian
将士	jiang	shi
将官	jiang	guan
将就	jiang	jiu
将就	jiang	jiu
将才	jiang	cai
将近	jiang	jin
小两口	xiao	liang	kou
小事	xiao	shi
小人	xiao	ren
小人物	xiao	ren	wu
小伙子	xiao	huo	zi
小伙子	xiao	huo	zi
小传	xiao	zhuan
小兄弟	xiao	xiong	di
小兄弟	xiao	xiong	di
小册子	xiao	ce	zi
小刀	xiao	dao
小分队	xiao	fen	dui
小号	xiao	hao
小合唱	xiao	he	chang
小名	xiao	ming
小商品	xiao	shang	pin
小国	xiao	guo
小圈子	xiao	quan	zi
小圈子	xiao	quan	zi
小夜曲	xiao	ye	qu
小字	xiao	zi
小字辈	xiao	zi	bei
小学生	xiao	xue	sheng
小家庭	xiao	jia	ting
小将	xiao	jiang
小小说	xiao	xiao	shuo
小市民	xiao	shi	min
小康之家	xiao	kang	zhi	jia
小弟弟	xiao	di	di
小径	xiao	jing
小心谨慎	xiao	xin	jin	shen
小憩	xiao	qi
小户	xiao	hu
小日子	xiao	ri	zi
小日子	xiao	ri	zi
小时	xiao	shi
小曲	xiao	qu
小朋友	xiao	peng	you
小溪	xiao	xi
小燕子	xiao	yan	zi
小生	xiao	sheng
小生产	xiao	sheng	chan
小百货	xiao	bai	huo
小组长	xiao	zu	zhang
小结	xiao	jie
小节	xiao	jie
小费	xiao	fei
小道	xiao	dao
小金库	xiao	jin	ku
小钱	xiao	qian
小雨	xiao	yu
小雪	xiao	xue
小青年	xiao	qing	nian
小鞋	xiao	xie
小题大作	xiao	ti	da	zuo
少不了	shao	bu	liao
少不了	shao	bu	liao
少不得	shao	bu	de
少不得	shao	bu	de
少先队	shao	xian	dui
少先队员	shao	xian	dui	yuan
少壮派	shao	zhuang	pai
少尉	shao	wei
少年宫	shao	nian	gong
少年犯	shao	nian	fan
少有	shao	you
少而精	shao	er	jing
尔后	er	hou
尖兵	jian	bing
尖刀	jian	dao
尖刻	jian	ke
尖端	jian	duan
尖顶	jian	ding
尚书	shang	shu
尚方宝剑	shang	fang	bao	jian
尚武	shang	wu
就任	jiu	ren
就位	jiu	wei
就势	jiu	shi
就学	jiu	xue
就职	jiu	zhi
尸体	shi	ti
尸骨	shi	gu
尺子	chi	zi
尺子	chi	zi
尺牍	chi	du
尼克松	ni	ke	song
尼古丁	ni	gu	ding
尼泊尔	ni	bo	er
尽人皆知	jin	ren	jie	zhi
尽可能	jin	ke	neng
尽心尽力	jin	xin	jin	li
尽心竭力	jin	xin	jie	li
尽收眼底	jin	shou	yan	di
尽职	jin	zhi
尾翼	wei	yi
尾随	wei	sui
尿毒症	niao	du	zheng
局外人	ju	wai	ren
局限性	ju	xian	xing
层层叠叠	ceng	ceng	die	die
层峦叠嶂	ceng	luan	die	zhang
居于	ju	yu
居功	ju	gong
居士	ju	shi
居室	ju	shi
居民点	ju	min	dian
居留	ju	liu
居留权	ju	liu	quan
居留证	ju	liu	zheng
届时	jie	shi
屋子	wu	zi
屋脊	wu	ji
屋角	wu	jiao
屏息	bing	xi
屏气	bing	qi
展台	zhan	tai
展室	zhan	shi
展览会	zhan	lan	hui
展览馆	zhan	lan	guan
展评	zhan	ping
展销会	zhan	xiao	hui
属实	shu	shi
屠宰场	tu	zai	chang
屠户	tu	hu
屯兵	tun	bing
山东省	shan	dong	sheng
山乡	shan	xiang
山冈	shan	gang
山势	shan	shi
山包	shan	bao
山墙	shan	qiang
山山水水	shan	shan	shui	shui
山梁	shan	liang
山水画	shan	shui	hua
山洞	shan	dong
山海关	shan	hai	guan
山海经	shan	hai	jing
山涧	shan	jian
山脊	shan	ji
山腰	shan	yao
山芋	shan	yu
山药蛋	shan	yao	dan
山药蛋	shan	yao	dan
山西省	shan	xi	sheng
山货	shan	huo
山野	shan	ye
山陵	shan	ling
山高水长	shan	gao	shui	chang
山麓	shan	lu
屹立	yi	li
岂止	qi	zhi
岂非	qi	fei
岛国	dao	guo
岩浆	yan	jiang
岩画	yan	hua
岩石	yan	shi
岳家	yue	jia
峥嵘	zheng	rong
峨嵋	e	mei
峰值	feng	zhi
峻岭	jun	ling
峻峭	jun	qiao
崇敬	chong	jing
崔健	cui	jian
崔嵬	cui	wei
崔巍	cui	wei
崴嵬	wei	wei
嵯峨	cuo	e
嶙峋	lin	xun
巍巍	wei	wei
巍然	wei	ran
巡抚	xun	fu
巡洋舰	xun	yang	jian
巡游	xun	you
巡诊	xun	zhen
巡逻艇	xun	luo	ting
巡逻队	xun	luo	dui
工业化	gong	ye	hua
工业区	gong	ye	qu
工业品	gong	ye	pin
工业国	gong	ye	guo
工业界	gong	ye	jie
工业部	gong	ye	bu
工事	gong	shi
工人阶级	gong	ren	jie	ji
工伤	gong	shang
工余	gong	yu
工作台	gong	zuo	tai
工作团	gong	zuo	tuan
工作日	gong	zuo	ri
工作服	gong	zuo	fu
工作站	gong	zuo	zhan
工作组	gong	zuo	zu
工作者	gong	zuo	zhe
工作证	gong	zuo	zheng
工作量	gong	zuo	liang
工作间	gong	zuo	jian
工作队	gong	zuo	dui
工作面	gong	zuo	mian
工兵	gong	bing
工具书	gong	ju	shu
工农业	gong	nong	ye
工农兵	gong	nong	bing
工农联盟	gong	nong	lian	meng
工分	gong	fen
工区	gong	qu
工友	gong	you
工商业	gong	shang	ye
工商界	gong	shang	jie
工商联	gong	shang	lian
工头	gong	tou
工委	gong	wei
工学院	gong	xue	yuan
工工整整	gong	gong	zheng	zheng
工效	gong	xiao
工整	gong	zheng
工时	gong	shi
工潮	gong	chao
工种	gong	zhong
工科	gong	ke
工笔画	gong	bi	hua
工艺	gong	yi
左翼	zuo	yi
巧干	qiao	gan
巧干	qiao	gan
巧手	qiao	shou
巧立名目	qiao	li	ming	mu
巨响	ju	xiang
巨商	ju	shang
巨型	ju	xing
巨头	ju	tou
巨子	ju	zi
巨幅	ju	fu
巨星	ju	xing
巨细	ju	xi
巨著	ju	zhu
巨资	ju	zi
巫峡	wu	xia
巫师	wu	shi
巫术	wu	shu
差旅费	chai	lv	fei
差错率	cha	cuo	lv
己任	ji	ren
己方	ji	fang
已知	yi	zhi
巴士	ba	shi
巴格达	ba	ge	da
巴比伦	ba	bi	lun
巴解组织	ba	jie	zu	zhi
巴金	ba	jin
巷子	xiang	zi
巷子	xiang	zi
巷道	hang	dao
币值	bi	zhi
市价	shi	jia
市侩	shi	kuai
市值	shi	zhi
市内	shi	nei
市区	shi	qu
市委	shi	wei
市属	shi	shu
市府	shi	fu
市电	shi	dian
市盈率	shi	ying	lv
市辖区	shi	xia	qu
市郊	shi	jiao
市镇	shi	zhen
市集	shi	ji
市面	shi	mian
布什	bu	shi
布依族	bu	yi	zu
布告	bu	gao
布拉格	bu	la	ge
布料	bu	liao
布满	bu	man
布衣	bu	yi
布设	bu	she
布谷鸟	bu	gu	niao
布达佩斯	bu	da	pei	si
布防	bu	fang
布隆迪	bu	long	di
布雷	bu	lei
布鞋	bu	xie
帆板	fan	ban
师友	shi	you
师团	shi	tuan
师大	shi	da
师徒	shi	tu
师法	shi	fa
师父	shi	fu
师父	shi	fu
师爷	shi	ye
师生员工	shi	sheng	yuan	gong
师范	shi	fan
师资	shi	zi
师部	shi	bu
希冀	xi	ji
希特勒	xi	te	le
帘子	lian	zi
帘子	lian	zi
帝制	di	zhi
带兵	dai	bing
带头人	dai	tou	ren
带子	dai	zi
带宽	dai	kuan
带状	dai	zhuang
带电	dai	dian
带鱼	dai	yu
席子	xi	zi
席子	xi	zi
帮办	bang	ban
帮教	bang	jiao
帷幄	wei	wo
常事	chang	shi
常任	chang	ren
常会	chang	hui
常备不懈	chang	bei	bu	xie
常备不懈	chang	bei	bu	xie
常委	chang	wei
常委会	chang	wei	hui
常州	chang	zhou
常抓不懈	chang	zhua	bu	xie
常数	chang	shu
常理	chang	li
幅员	fu	yuan
干休所	gan	xiu	suo
干休所	gan	xiu	suo
干劲	gan	jin
干吗	gan	ma
干妈	gan	ma
干将	gan	jiang
干扰素	gan	rao	su
干支	gan	zhi
干果	gan	guo
干渠	gan	qu
干电池	gan	dian	chi
干系	gan	xi
干群	gan	qun
干脆利落	gan	cui	li	luo
干脆利落	gan	cui	li	luo
干草	gan	cao
干警	gan	jing
干预	gan	yu
干鲜果	gan	xian	guo
平价	ping	jia
平信	ping	xin
平分	ping	fen
平反	ping	fan
平均主义	ping	jun	zhu	yi
平均值	ping	jun	zhi
平均数	ping	jun	shu
平定	ping	ding
平实	ping	shi
平局	ping	ju
平平	ping	ping
平心静气	ping	xin	jing	qi
平房	ping	fang
平整	ping	zheng
平易	ping	yi
平正	ping	zheng
平正	ping	zheng
平炉	ping	lu
平视	ping	shi
平顶山	ping	ding	shan
年下	nian	xia
年下	nian	xia
年事已高	nian	shi	yi	gao
年产值	nian	chan	zhi
年产量	nian	chan	liang
年历	nian	li
年头	nian	tou
年岁	nian	sui
年成	nian	cheng
年成	nian	cheng
年景	nian	jing
年率	nian	lv
年画	nian	hua
年货	nian	huo
年轻气盛	nian	qing	qi	sheng
年鉴	nian	jian
年间	nian	jian
年青	nian	qing
年青人	nian	qing	ren
年饭	nian	fan
并发	bing	fa
并发症	bing	fa	zheng
并立	bing	li
并网	bing	wang
并行不悖	bing	xing	bu	bei
并行不悖	bing	xing	bu	bei
幸事	xing	shi
幸存者	xing	cun	zhe
幸运儿	xing	yun	er
幻影	huan	ying
幻灯片	huan	deng	pian
幼儿园	you	er	yuan
幼子	you	zi
幼小	you	xiao
幼师	you	shi
幼教	you	jiao
幼芽	you	ya
幽会	you	hui
幽幽	you	you
幽深	you	shen
幽门	you	men
幽雅	you	ya
幽香	you	xiang
幽默感	you	mo	gan
广东省	guang	dong	sheng
广交会	guang	jiao	hui
广博	guang	bo
广播剧	guang	bo	ju
广播员	guang	bo	yuan
庄园	zhuang	yuan
庄户人	zhuang	hu	ren
庄户人	zhuang	hu	ren
庄稼	zhuang	jia
庄稼	zhuang	jia
庄稼人	zhuang	jia	ren
庄稼人	zhuang	jia	ren
庄稼地	zhuang	jia	di
庄稼地	zhuang	jia	di
庄稼汉	zhuang	jia	han
庄稼汉	zhuang	jia	han
庆典	qing	dian
庆功	qing	gong
庆幸	qing	xing
序跋	xu	ba
库区	ku	qu
库容	ku	rong
应从	ying	cong
应允	ying	yun
应力	ying	li
应届	ying	jie
应得	ying	de
应得	ying	de
应战	ying	zhan
应有	ying	you
应试	ying	shi
应运	ying	yun
底下	di	xia
底下	di	xia
底子	di	zi
底子	di	zi
底板	di	ban
底气	di	qi
底盘	di	pan
底肥	di	fei
底部	di	bu
店员	dian	yuan
店堂	dian	tang
店家	dian	jia
庙会	miao	hui
庙宇	miao	yu
府上	fu	shang
府第	fu	di
府邸	fu	di
废弃物	fei	qi	wu
废料	fei	liao
废止	fei	zhi
废气	fei	qi
废油	fei	you
度假	du	jia
度数	du	shu
度数	du	shu
度量	du	liang
度量衡	du	liang	heng
度量衡	du	liang	heng
座右铭	zuo	you	ming
座次	zuo	ci
座谈会	zuo	tan	hui
庭园	ting	yuan
庭审	ting	shen
庭院	ting	yuan
康健	kang	jian
康宁	kang	ning
康庄大道	kang	zhuang	da	dao
康有为	kang	you	wei
庸中佼佼	yong	zhong	jiao	jiao
庸人	yong	ren
庸医	yong	yi
庸庸碌碌	yong	yong	lu	lu
廉正	lian	zheng
廉洁	lian	jie
延误	yan	wu
建交	jian	jiao
建制	jian	zhi
建国	jian	guo
建成	jian	cheng
建材	jian	cai
建树	jian	shu
建筑业	jian	zhu	ye
建设性	jian	she	xing
建设者	jian	she	zhe
建起	jian	qi
建都	jian	du
开刀	kai	dao
开列	kai	lie
开化	kai	hua
开发区	kai	fa	qu
开国	kai	guo
开市	kai	shi
开幕词	kai	mu	ci
开征	kai	zheng
开战	kai	zhan
开方	kai	fang
开架	kai	jia
开眼	kai	yan
开矿	kai	kuang
开禁	kai	jin
开脱	kai	tuo
开航	kai	hang
开讲	kai	jiang
开诚相见	kai	cheng	xiang	jian
开道	kai	dao
开镰	kai	lian
开门红	kai	men	hong
异乡	yi	xiang
异化	yi	hua
异味	yi	wei
异域	yi	yu
异己	yi	ji
异彩	yi	cai
异性	yi	xing
异族	yi	zu
异样	yi	yang
异步	yi	bu
异物	yi	wu
异端	yi	duan
异类	yi	lei
异议	yi	yi
弃旧图新	qi	jiu	tu	xin
弃权	qi	quan
弃置	qi	zhi
弄堂	long	tang
式微	shi	wei
弓箭	gong	jian
引人注意	yin	ren	zhu	yi
引人深思	yin	ren	shen	si
引信	yin	xin
引力	yin	li
引向	yin	xiang
引咎自责	yin	jiu	zi	ze
引子	yin	zi
引子	yin	zi
引水	yin	shui
引渡	yin	du
引申	yin	shen
引种	yin	zhong
引线	yin	xian
引航	yin	hang
引资	yin	zi
引路	yin	lu
引退	yin	tui
弟媳	di	xi
弧形	hu	xing
弯弯	wan	wan
弯弯曲曲	wan	wan	qu	qu
弹琴	dan	qin
弹琴	tan	qin
弹词	tan	ci
弹道	dan	dao
强人	qiang	ren
强健	qiang	jian
强占	qiang	zhan
强压	qiang	ya
强手	qiang	shou
强有力	qiang	you	li
强权政治	qiang	quan	zheng	zhi
强渡	qiang	du
强风	qiang	feng
归于	gui	yu
归公	gui	gong
归根结蒂	gui	gen	jie	di
归程	gui	cheng
归途	gui	tu
当做	dang	zuo
当做	dang	zuo
当地人	dang	di	ren
当家作主	dang	jia	zuo	zhu
当政	dang	zheng
当班	dang	ban
当道	dang	dao
录像机	lu	xiang	ji
录像片	lu	xiang	pian
录音带	lu	yin	dai
录音棚	lu	yin	peng
形势逼人	xing	shi	bi	ren
形容词	xing	rong	ci
形式主义	xing	shi	zhu	yi
彩卷	cai	juan
彩旗	cai	qi
彩灯	cai	deng
彩礼	cai	li
彩绘	cai	hui
彩车	cai	che
彩陶	cai	tao
彭德怀	peng	de	huai
彰善瘅恶	zhang	shan	dan	e
影业	ying	ye
影像	ying	xiang
影剧院	ying	ju	yuan
影印	ying	yin
影展	ying	zhan
影碟机	ying	die	ji
影评	ying	ping
影集	ying	ji
彳亍	chi	chu
往后	wang	hou
往复	wang	fu
征召	zheng	zhao
征文	zheng	wen
征服	zheng	fu
征购	zheng	gou
径流	jing	liu
径直	jing	zhi
待客	dai	ke
徇私	xun	si
律诗	lv	shi
徐悲鸿	xu	bei	hong
徒刑	tu	xing
徒弟	tu	di
得以	de	yi
得利	de	li
得势	de	shi
得名	de	ming
得志	de	zhi
得益	de	yi
得鱼忘筌	de	yu	wang	quan
循环赛	xun	huan	sai
微型	wei	xing
微处理器	wei	chu	li	qi
微小	wei	xiao
微循环	wei	xun	huan
微微	wei	wei
微服私访	wei	fu	si	fang
微机	wei	ji
微机室	wei	ji	shi
微波炉	wei	bo	lu
微生物	wei	sheng	wu
微电脑	wei	dian	nao
微米	wei	mi
微粒	wei	li
微细	wei	xi
微薄	wei	bo
微观	wei	guan
微词	wei	ci
微辞	wei	ci
德意志	de	yi	zhi
德政	de	zheng
德智体	de	zhi	ti
德治	de	zhi
德育	de	yu
德行	de	xing
德行	de	xing
德黑兰	de	hei	lan
徽剧	hui	ju
徽号	hui	hao
徽州	hui	zhou
心上人	xin	shang	ren
心事重重	xin	shi	chong	chong
心力	xin	li
心劲	xin	jin
心地	xin	di
心如刀绞	xin	ru	dao	jiao
心室	xin	shi
心弦	xin	xian
心怀	xin	huai
心悸	xin	ji
心想	xin	xiang
心慌意乱	xin	huang	yi	luan
心房	xin	fang
心手相应	xin	shou	xiang	ying
心曲	xin	qu
心曲	xin	qu
心气	xin	qi
心潮	xin	chao
心潮起伏	xin	chao	qi	fu
心理	xin	li
心理学	xin	li	xue
心电图	xin	dian	tu
心窝子	xin	wo	zi
心细	xin	xi
心绞痛	xin	jiao	tong
心绪	xin	xu
心肌	xin	ji
心腹	xin	fu
心血管	xin	xue	guan
心计	xin	ji
心迹	xin	ji
心酸	xin	suan
心里话	xin	li	hua
心静	xin	jing
心驰神往	xin	chi	shen	wang
必修课	bi	xiu	ke
必然性	bi	ran	xing
必需	bi	xu
忉忉	dao	dao
忌妒	ji	du
忌讳	ji	hui
忍痛	ren	tong
志向	zhi	xiang
志士	zhi	shi
志士仁人	zhi	shi	ren	ren
志愿	zhi	yuan
志愿兵	zhi	yuan	bing
志愿军	zhi	yuan	jun
志趣	zhi	qu
忘年交	wang	nian	jiao
忠义	zhong	yi
忠于	zhong	yu
忠实	zhong	shi
忠心	zhong	xin
忠良	zhong	liang
忠贞	zhong	zhen
忠骨	zhong	gu
忧心	you	xin
忧郁	you	yu
快板	kuai	ban
忽地	hu	di
怀古	huai	gu
态势	tai	shi
怜惜	lian	xi
思乡	si	xiang
思想家	si	xiang	jia
思想性	si	xiang	xing
怡然自得	yi	ran	zi	de
急不可耐	ji	bu	ke	nai
急事	ji	shi
急于	ji	yu
急件	ji	jian
急剧	ji	ju
急匆匆	ji	cong	cong
急急忙忙	ji	ji	mang	mang
急性	ji	xing
急性病	ji	xing	bing
急流	ji	liu
急电	ji	dian
急病	ji	bing
急行军	ji	xing	jun
急起直追	ji	qi	zhi	zhui
急速	ji	su
急难	ji	nan
急需	ji	xu
性命	xing	ming
性生活	xing	sheng	huo
怨气	yuan	qi
怯生生	qie	sheng	sheng
总书记	zong	shu	ji
总书记	zong	shu	ji
总产值	zong	chan	zhi
总产量	zong	chan	liang
总值	zong	zhi
总公司	zong	gong	si
总动员	zong	dong	yuan
总司令	zong	si	ling
总工	zong	gong
总工会	zong	gong	hui
总指挥	zong	zhi	hui
总揽	zong	lan
总攻	zong	gong
总政	zong	zheng
总方针	zong	fang	zhen
总机	zong	ji
总汇	zong	hui
总管	zong	guan
总经理	zong	jing	li
总罢工	zong	ba	gong
总署	zong	shu
总路线	zong	lu	xian
总长	zong	zhang
总队	zong	dui
总领事	zong	ling	shi
恃强凌弱	shi	qiang	ling	ruo
恋歌	lian	ge
恐吓信	kong	he	xin
恒山	heng	shan
恢弘	hui	hong
恩格斯	en	ge	si
恬静	tian	jing
恭听	gong	ting
息息相通	xi	xi	xiang	tong
恶人	e	ren
恶梦	e	meng
恶毒	e	du
恶狠狠	e	hen	hen
恶语	e	yu
恹恹	yan	yan
悄悄话	qiao	qiao	hua
悄悄话	qiao	qiao	hua
悉尼	xi	ni
悉心	xi	xin
悉数	xi	shu
悔之晚矣	hui	zhi	wan	yi
悔悟	hui	wu
悔过	hui	guo
悟性	wu	xing
悠然自得	you	ran	zi	de
悠长	you	chang
悠闲	you	xian
悬崖勒马	xuan	ya	le	ma
悬崖峭壁	xuan	ya	qiao	bi
悲凉	bei	liang
悲剧性	bei	ju	xing
悲喜剧	bei	xi	ju
悲愤	bei	fen
悻悻	xing	xing
悼词	dao	ci
情义	qing	yi
情势	qing	shi
情境	qing	jing
情意	qing	yi
情报所	qing	bao	suo
情理	qing	li
情结	qing	jie
情缘	qing	yuan
情话	qing	hua
情谊	qing	yi
情随事迁	qing	sui	shi	qian
惊人之举	jing	ren	zhi	ju
惊叹号	jing	tan	hao
惊异	jing	yi
惊蛇入草	jing	she	ru	cao
惊诧	jing	cha
惕厉	ti	li
惟恐	wei	kong
惟我独尊	wei	wo	du	zun
惟有	wei	you
惟独	wei	du
惠灵顿	hui	ling	dun
惦记	dian	ji
惨剧	can	ju
惨淡经营	can	dan	jing	ying
惨白	can	bai
惩办	cheng	ban
惩戒	cheng	jie
惯例	guan	li
惯用	guan	yong
想必	xiang	bi
想来	xiang	lai
想见	xiang	jian
想起	xiang	qi
惶惶	huang	huang
愈加	yu	jia
愈发	yu	fa
愈来愈	yu	lai	yu
愈演愈烈	yu	yan	yu	lie
愈益	yu	yi
意向	yi	xiang
意向书	yi	xiang	shu
意味	yi	wei
意境	yi	jing
意志	yi	zhi
意愿	yi	yuan
意旨	yi	zhi
意气	yi	qi
意见书	yi	jian	shu
意见箱	yi	jian	xiang
意见簿	yi	jian	bu
意识形态	yi	shi	xing	tai
意译	yi	yi
意象	yi	xiang
意趣	yi	qu
愚民	yu	min
感伤	gan	shang
感官	gan	guan
感慨万端	gan	kai	wan	duan
感染力	gan	ran	li
愤愤	fen	fen
愤愤不平	fen	fen	bu	ping
愤慨	fen	kai
慢性病	man	xing	bing
慧眼	hui	yan
慰问信	wei	wen	xin
慰问品	wei	wen	pin
慰问团	wei	wen	tuan
慰问电	wei	wen	dian
慷慨就义	kang	kai	jiu	yi
憬悟	jing	wu
懂事	dong	shi
懈怠	xie	dai
戈壁	ge	bi
戊辰	wu	chen
戋戋	jian	jian
戎马一生	rong	ma	yi	sheng
戎马倥偬	rong	ma	kong	zong
戎马倥偬	rong	ma	kong	zong
戎马生涯	rong	ma	sheng	ya
戏剧	xi	ju
戏剧家	xi	ju	jia
戏文	xi	wen
戏曲	xi	qu
戏曲界	xi	qu	jie
戏言	xi	yan
戏谑	xi	xue
戏迷	xi	mi
成事	cheng	shi
成人	cheng	ren
成像	cheng	xiang
成名作	cheng	ming	zuo
成年人	cheng	nian	ren
成年累月	cheng	nian	lei	yue
成心	cheng	xin
成方	cheng	fang
成材	cheng	cai
成法	cheng	fa
成活率	cheng	huo	lv
成灾	cheng	zai
成绩单	cheng	ji	dan
成色	cheng	se
成药	cheng	yao
成衣	cheng	yi
成见	cheng	jian
成风	cheng	feng
成龙配套	cheng	long	pei	tao
我党	wo	dang
我军	wo	jun
我方	wo	fang
戒严	jie	yan
戒备森严	jie	bei	sen	yan
戒毒	jie	du
戒除	jie	chu
或是	huo	shi
战书	zhan	shu
战事	zhan	shi
战例	zhan	li
战利品	zhan	li	pin
战区	zhan	qu
战史	zhan	shi
战国	zhan	guo
战士	zhan	shi
战天斗地	zhan	tian	dou	di
战将	zhan	jiang
战将	zhan	jiang
战局	zhan	ju
战斗力	zhan	dou	li
战斗员	zhan	dou	yuan
战时	zhan	shi
战机	zhan	ji
战略性	zhan	lve	xing
战祸	zhan	huo
战线	zhan	xian
截住	jie	zhu
截击	jie	ji
截断	jie	duan
截止	jie	zhi
截流	jie	liu
截肢	jie	zhi
截长补短	jie	chang	bu	duan
截面	jie	mian
户主	hu	zhu
户口簿	hu	kou	bu
户头	hu	tou
房价	fang	jia
房基	fang	ji
房客	fang	ke
房檐	fang	yan
所剩无几	suo	sheng	wu	ji
所在地	suo	zai	di
所有制	suo	you	zhi
所有权	suo	you	quan
所有者	suo	you	zhe
所部	suo	bu
扇动	shan	dong
扇区	shan	qu
扇子	shan	zi
扇子	shan	zi
手书	shou	shu
手势	shou	shi
手印	shou	yin
手工业	shou	gong	ye
手工艺	shou	gong	yi
手工艺品	shou	gong	yi	pin
手巾	shou	jin
手心	shou	xin
手指头	shou	zhi	tou
手指头	shou	zhi	tou
手推车	shou	tui	che
手提包	shou	ti	bao
手摇	shou	yao
手术刀	shou	shu	dao
手术台	shou	shu	tai
手术室	shou	shu	shi
手杖	shou	zhang
手柄	shou	bing
手榴弹	shou	liu	dan
手气	shou	qi
手电筒	shou	dian	tong
手笔	shou	bi
手艺	shou	yi
手记	shou	ji
手语	shou	yu
手迹	shou	ji
手雷	shou	lei
手风琴	shou	feng	qin
手鼓	shou	gu
才是	cai	shi
才智	cai	zhi
扑灭	pu	mie
扑簌	pu	su
扑面	pu	mian
打交道	da	jiao	dao
打交道	da	jiao	dao
打仗	da	zhang
打倒	da	dao
打假	da	jia
打印机	da	yin	ji
打压	da	ya
打响	da	xiang
打场	da	chang
打天下	da	tian	xia
打头	da	tou
打字机	da	zi	ji
打招呼	da	zhao	hu
打招呼	da	zhao	hu
打斗	da	dou
打枪	da	qiang
打架	da	jia
打气	da	qi
打气筒	da	qi	tong
打油诗	da	you	shi
打法	da	fa
打消	da	xiao
打游击	da	you	ji
打火	da	huo
打火机	da	huo	ji
打点	da	dian
打点	da	dian
打眼	da	yan
打药	da	yao
打赌	da	du
打转	da	zhuan
打量	da	liang
打量	da	liang
打靶	da	ba
托儿所	tuo	er	suo
托福	tuo	fu
执业	zhi	ye
执委	zhi	wei
执委会	zhi	wei	hui
执导	zhi	dao
执意	zhi	yi
执掌	zhi	zhang
执政党	zhi	zheng	dang
执教	zhi	jiao
执法如山	zhi	fa	ru	shan
执笔	zhi	bi
执著	zhi	zhuo
扩大化	kuo	da	hua
扬声器	yang	sheng	qi
扬子江	yang	zi	jiang
扬子鳄	yang	zi	e
扬弃	yang	qi
扬言	yang	yan
扬长	yang	chang
扬长而去	yang	chang	er	qu
扬长补短	yang	chang	bu	duan
扭亏增盈	niu	kui	zeng	ying
扳机	ban	ji
扶养	fu	yang
扶助	fu	zhu
扶弱抑强	fu	ruo	yi	qiang
扶摇	fu	yao
扶植	fu	zhi
扶疏	fu	shu
扶贫帮困	fu	pin	bang	kun
批件	pi	jian
批发商	pi	fa	shang
批号	pi	hao
批复	pi	fu
批转	pi	zhuan
找事	zhao	shi
承包	cheng	bao
承包制	cheng	bao	zhi
承建	cheng	jian
承继	cheng	ji
技击	ji	ji
技术员	ji	shu	yuan
技术性	ji	shu	xing
技校	ji	xiao
技法	ji	fa
技艺	ji	yi
技高一筹	ji	gao	yi	chou
技高一筹	ji	gao	yi	chou
抄件	chao	jian
把头	ba	tou
把子	ba	zi
把子	ba	zi
把式	ba	shi
把式	ba	shi
把手	ba	shou
把手	ba	shou
抑制	yi	zhi
抑强扶弱	yi	qiang	fu	ruo
抑或	yi	huo
抑止	yi	zhi
抒写	shu	xie
抒发	shu	fa
抒情诗	shu	qing	shi
投书	tou	shu
投向	tou	xiang
投宿	tou	su
投掷	tou	zhi
投机商	tou	ji	shang
投篮	tou	lan
投递员	tou	di	yuan
投降	tou	xiang
投降主义	tou	xiang	zhu	yi
抗原	kang	yuan
抗御	kang	yu
抗日战争	kang	ri	zhan	zheng
抗日救亡	kang	ri	jiu	wang
抗生素	kang	sheng	su
抗药性	kang	yao	xing
抗菌素	kang	jun	su
折中	zhe	zhong
折回	zhe	hui
折子戏	zhe	zi	xi
折子戏	zhe	zi	xi
折戟沉沙	zhe	ji	chen	sha
抚恤金	fu	xu	jin
抚慰	fu	wei
抚育	fu	yu
抛掷	pao	zhi
抠搜	kou	sou
抢劫犯	qiang	jie	fan
抢建	qiang	jian
抢手	qiang	shou
抢收	qiang	shou
抢种	qiang	zhong
抢购一空	qiang	gou	yi	kong
抢运	qiang	yun
抢险	qiang	xian
护卫舰	hu	wei	jian
护城河	hu	cheng	he
护肤品	hu	fu	pin
护身符	hu	shen	fu
报仇	bao	chou
报偿	bao	chang
报关	bao	guan
报到	bao	dao
报务	bao	wu
报告会	bao	gao	hui
报告团	bao	gao	tuan
报国	bao	guo
报头	bao	tou
报导	bao	dao
报捷	bao	jie
报效	bao	xiao
报时	bao	shi
报春花	bao	chun	hua
报晓	bao	xiao
报案	bao	an
报界	bao	jie
报章	bao	zhang
报账	bao	zhang
报载	bao	zai
披红戴花	pi	hong	dai	hua
抬爱	tai	ai
抬高	tai	gao
抱养	bao	yang
抱病	bao	bing
抱负	bao	fu
抵制	di	zhi
抵御	di	yu
抵押品	di	ya	pin
抵挡	di	dang
抵牾	di	wu
抹煞	mo	sha
押运	ya	yun
抽搐	chou	chu
抽检	chou	jian
抽泣	chou	qi
抽穗	chou	sui
抽验	chou	yan
担子	dan	zi
担子	dan	zi
担架	dan	jia
拉丁文	la	ding	wen
拉帮结派	la	bang	jie	pai
拉开	la	kai
拉拉队	la	la	dui
拉美	la	mei
拉锯战	la	ju	zhan
拍子	pai	zi
拍子	pai	zi
拍手叫好	pai	shou	jiao	hao
拍板	pai	ban
拒不	ju	bu
拒捕	ju	bu
拒收	ju	shou
拒腐防变	ju	fu	fang	bian
拓片	ta	pian
拔节	ba	jie
拔除	ba	chu
拖船	tuo	chuan
拘役	ju	yi
拘捕	ju	bu
拘禁	ju	jin
拙笨	zhuo	ben
招供	zhao	gong
招待会	zhao	dai	hui
招徕	zhao	lai
招手	zhao	shou
招摇	zhao	yao
招法	zhao	fa
招股	zhao	gu
招贴画	zhao	tie	hua
拜年	bai	nian
拜拜	bai	bai
拟订	ni	ding
拥军	yong	jun
拥军优属	yong	jun	you	shu
拥护	yong	hu
拥挤不堪	yong	ji	bu	kan
拦蓄	lan	xu
拨冗	bo	rong
拨动	bo	dong
拨叫	bo	jiao
择善而从	ze	shan	er	cong
拮据	jie	ju
拱形	gong	xing
拱手	gong	shou
拱门	gong	men
拳击手	quan	ji	shou
拳拳	quan	quan
拳拳服膺	quan	quan	fu	ying
拳术	quan	shu
拾掇	shi	duo
拾掇	shi	duo
拾遗	shi	yi
拾金不昧	shi	jin	bu	mei
拾金不昧	shi	jin	bu	mei
拿手戏	na	shou	xi
挂号信	gua	hao	xin
挂图	gua	tu
挂车	gua	che
挂钟	gua	zhong
指使	zhi	shi
指名	zhi	ming
指天誓日	zhi	tian	shi	ri
指定	zhi	ding
指尖	zhi	jian
指战员	zhi	zhan	yuan
指挥员	zhi	hui	yuan
指挥官	zhi	hui	guan
指挥所	zhi	hui	suo
指挥棒	zhi	hui	bang
指挥部	zhi	hui	bu
指明	zhi	ming
指正	zhi	zheng
指法	zhi	fa
指示	zhi	shi
指责	zhi	ze
按劳分配	an	lao	fen	pei
按理	an	li
按语	an	yu
按质论价	an	zhi	lun	jia
挑动	tiao	dong
挑拣	tiao	jian
挑灯夜战	tiao	deng	ye	zhan
挖潜	wa	qian
挚友	zhi	you
挟带	xie	dai
挡板	dang	ban
挡箭牌	dang	jian	pai
挤出	ji	chu
挤占	ji	zhan
挤压	ji	ya
挥手	hui	shou
挥舞	hui	wu
挫伤	cuo	shang
振振有辞	zhen	zhen	you	ci
振荡	zhen	dang
挺括	ting	gua
挺直	ting	zhi
挺立	ting	li
挽回	wan	hui
捉住	zhuo	zhu
捉拿归案	zhuo	na	gui	an
捉摸不定	zhuo	mo	bu	ding
捕食	bu	shi
捞取	lao	qu
换乘	huan	cheng
换届	huan	jie
换文	huan	wen
换气	huan	qi
换洗	huan	xi
换班	huan	ban
换言之	huan	yan	zhi
换钱	huan	qian
换防	huan	fang
捣蛋	dao	dan
据守	ju	shou
捷克	jie	ke
掀起	xian	qi
掂量	dian	liang
授奖	shou	jiang
授意	shou	yi
授粉	shou	fen
授精	shou	jing
授衔	shou	xian
掌上明珠	zhang	shang	ming	zhu
排坛	pai	tan
排头兵	pai	tou	bing
排字	pai	zi
排水管	pai	shui	guan
排水量	pai	shui	liang
排涝	pai	lao
排灌	pai	guan
掘进	jue	jin
掠夺性	lve	duo	xing
掠过	lve	guo
探伤	tan	shang
探家	tan	jia
探求	tan	qiu
探测器	tan	ce	qi
探照灯	tan	zhao	deng
探矿	tan	kuang
探询	tan	xun
接入	jie	ru
接力	jie	li
接力棒	jie	li	bang
接力赛	jie	li	sai
接办	jie	ban
接地	jie	di
接头	jie	tou
接手	jie	shou
接收站	jie	shou	zhan
接济	jie	ji
接点	jie	dian
接班人	jie	ban	ren
接生	jie	sheng
接种	jie	zhong
接线	jie	xian
接见	jie	jian
控制器	kong	zhi	qi
控制论	kong	zhi	lun
推出	tui	chu
推力	tui	li
推土机	tui	tu	ji
推导	tui	dao
推托	tui	tuo
推移	tui	yi
推诚相见	tui	cheng	xiang	jian
推进器	tui	jin	qi
推销员	tui	xiao	yuan
掩埋	yan	mai
掩映	yan	ying
掩蔽	yan	bi
提及	ti	ji
提审	ti	shen
提灌	ti	guan
提督	ti	du
提篮	ti	lan
提级	ti	ji
提纲挈领	ti	gang	qie	ling
插手	cha	shou
插花	cha	hua
插话	cha	hua
揭幕	jie	mu
揭批	jie	pi
揭短	jie	duan
揭示	jie	shi
揭秘	jie	mi
援外	yuan	wai
援建	yuan	jian
援引	yuan	yin
揽胜	lan	sheng
搅拌机	jiao	ban	ji
搏击	bo	ji
搏动	bo	dong
搜索引擎	sou	suo	yin	qing
搬迁户	ban	qian	hu
搭乘	da	cheng
搭伙	da	huo
搭桥	da	qiao
携手并肩	xie	shou	bing	jian
摄制	she	zhi
摄取	she	qu
摄影师	she	ying	shi
摄影机	she	ying	ji
摄氏	she	shi
摆手	bai	shou
摆放	bai	fang
摆架子	bai	jia	zi
摆样子	bai	yang	zi
摆渡	bai	du
摇头摆尾	yao	tou	bai	wei
摇曳	yao	ye
摇滚乐	yao	gun	yue
摇篮曲	yao	lan	qu
摇身一变	yao	shen	yi	bian
摊派	tan	pai
摒弃	bing	qi
摘发	zhai	fa
摘牌	zhai	pai
摘编	zhai	bian
摩托艇	mo	tuo	ting
摩挲	mo	sa
摩挲	mo	suo
摩顶放踵	mo	ding	fang	zhong
摸黑	mo	hei
摹写	mo	xie
撒播	sa	bo
撕下	si	xia
撤出	che	chu
撤消	che	xiao
播种机	bo	zhong	ji
播音员	bo	yin	yuan
播音室	bo	yin	shi
撰稿	zhuan	gao
撰稿人	zhuan	gao	ren
撰著	zhuan	zhu
撺掇	cuan	duo
撼动	han	dong
撼天动地	han	tian	dong	di
擂鼓	lei	gu
擂鼓	lei	gu
操作员	cao	zuo	yuan
操作系统	cao	zuo	xi	tong
操行	cao	xing
攀枝花	pan	zhi	hua
支书	zhi	shu
支农	zhi	nong
支前	zhi	qian
支吾	zhi	wu
支委	zhi	wei
支委会	zhi	wei	hui
支应	zhi	ying
支架	zhi	jia
支流	zhi	liu
支点	zhi	dian
支离	zhi	li
支线	zhi	xian
支边	zhi	bian
支部	zhi	bu
支队	zhi	dui
收兵	shou	bing
收割机	shou	ge	ji
收发	shou	fa
收场	shou	chang
收复	shou	fu
收审	shou	shen
收尾	shou	wei
收工	shou	gong
收录机	shou	lu	ji
收支	shou	zhi
收汇	shou	hui
收治	shou	zhi
收紧	shou	jin
收纳	shou	na
收编	shou	bian
收缴	shou	jiao
收藏家	shou	cang	jia
收集	shou	ji
收音	shou	yin
改任	gai	ren
改型	gai	xing
改天换地	gai	tian	huan	di
改弦更张	gai	xian	geng	zhang
改称	gai	cheng
改编	gai	bian
改选	gai	xuan
攻克	gong	ke
攻关	gong	guan
攻击机	gong	ji	ji
攻势	gong	shi
攻坚	gong	jian
攻坚战	gong	jian	zhan
攻陷	gong	xian
放大器	fang	da	qi
放大镜	fang	da	jing
放射性	fang	she	xing
放射线	fang	she	xian
放映机	fang	ying	ji
放晴	fang	qing
放火	fang	huo
放牛娃	fang	niu	wa
放疗	fang	liao
放眼	fang	yan
放空	fang	kong
放置	fang	zhi
放胆	fang	dan
放风	fang	feng
政事	zheng	shi
政企	zheng	qi
政企不分	zheng	qi	bu	fen
政体	zheng	ti
政党	zheng	dang
政出多门	zheng	chu	duo	men
政务	zheng	wu
政区	zheng	qu
政局	zheng	ju
政府军	zheng	fu	jun
政敌	zheng	di
政权	zheng	quan
政治家	zheng	zhi	jia
政治局	zheng	zhi	ju
政治犯	zheng	zhi	fan
政治课	zheng	zhi	ke
政治部	zheng	zhi	bu
政法	zheng	fa
政界	zheng	jie
政纪	zheng	ji
政绩	zheng	ji
政要	zheng	yao
政见	zheng	jian
政论	zheng	lun
政通人和	zheng	tong	ren	he
故事片	gu	shi	pian
故事片	gu	shi	pian
故人	gu	ren
故园	gu	yuan
故而	gu	er
故道	gu	dao
故都	gu	du
故里	gu	li
效仿	xiao	fang
效忠	xiao	zhong
敌伪	di	wei
敌占区	di	zhan	qu
敌国	di	guo
敌意	di	yi
敌我矛盾	di	wo	mao	dun
敌方	di	fang
敌机	di	ji
敌视	di	shi
救世主	jiu	shi	zhu
救亡	jiu	wang
救命之恩	jiu	ming	zhi	en
救急	jiu	ji
救护车	jiu	hu	che
救护队	jiu	hu	dui
救活	jiu	huo
救济粮	jiu	ji	liang
救济金	jiu	ji	jin
救生圈	jiu	sheng	quan
救生艇	jiu	sheng	ting
救生衣	jiu	sheng	yi
教主	jiao	zhu
教义	jiao	yi
教书匠	jiao	shu	jiang
教具	jiao	ju
教头	jiao	tou
教委	jiao	wei
教学法	jiao	xue	fa
教学片	jiao	xue	pian
教学相长	jiao	xue	xiang	zhang
教室	jiao	shi
教导员	jiao	dao	yuan
教工	jiao	gong
教廷	jiao	ting
教条主义	jiao	tiao	zhu	yi
教法	jiao	fa
教法	jiao	fa
教父	jiao	fu
教益	jiao	yi
教研	jiao	yan
教研	jiao	yan
教研室	jiao	yan	shi
教科书	jiao	ke	shu
教科文	jiao	ke	wen
教练员	jiao	lian	yuan
教练机	jiao	lian	ji
教职员工	jiao	zhi	yuan	gong
教职工	jiao	zhi	gong
教育学	jiao	yu	xue
教育家	jiao	yu	jia
教育局	jiao	yu	ju
教育部	jiao	yu	bu
教诲	jiao	hui
教鞭	jiao	bian
教龄	jiao	ling
敞亮	chang	liang
敢死队	gan	si	dui
散失	san	shi
散居	san	ju
散文家	san	wen	jia
散文诗	san	wen	shi
散记	san	ji
敦实	dun	shi
敦实	dun	shi
敬献	jing	xian
敬畏	jing	wei
敬礼	jing	li
敬老院	jing	lao	yuan
敬重	jing	zhong
数以百计	shu	yi	bai	ji
数学家	shu	xue	jia
数据库	shu	ju	ku
数理化	shu	li	hua
数量级	shu	liang	ji
敲诈勒索	qiao	zha	le	suo
敲门砖	qiao	men	zhuan
整党	zheng	dang
整地	zheng	di
整整齐齐	zheng	zheng	qi	qi
整机	zheng	ji
整治	zheng	zhi
整流	zheng	liu
整编	zheng	bian
整风	zheng	feng
整齐划一	zheng	qi	hua	yi
敷料	fu	liao
敷设	fu	she
文不加点	wen	bu	jia	dian
文传	wen	chuan
文体	wen	ti
文具盒	wen	ju	he
文化人	wen	hua	ren
文化宫	wen	hua	gong
文化界	wen	hua	jie
文化部	wen	hua	bu
文化馆	wen	hua	guan
文史	wen	shi
文告	wen	gao
文娱	wen	yu
文学界	wen	xue	jie
文山会海	wen	shan	hui	hai
文工团	wen	gong	tuan
文戏	wen	xi
文教	wen	jiao
文明礼貌	wen	ming	li	mao
文武	wen	wu
文法	wen	fa
文理	wen	li
文联	wen	lian
文艺界	wen	yi	jie
文苑	wen	yuan
文豪	wen	hao
斐然	fei	ran
斑痕	ban	hen
斑白	ban	bai
斗士	dou	shi
斗室	dou	shi
斗拱	dou	gong
斗智	dou	zhi
斗车	dou	che
料峭	liao	qiao
斜坡	xie	po
斥资	chi	zi
斧子	fu	zi
斧子	fu	zi
斩六将	zhan	liu	jiang
断代史	duan	dai	shi
断头	duan	tou
断炊	duan	chui
断线	duan	xian
断肢	duan	zhi
断语	duan	yu
断路	duan	lu
斯大林	si	da	lin
新人	xin	ren
新人新事	xin	ren	xin	shi
新任	xin	ren
新兴	xin	xing
新兵	xin	bing
新军	xin	jun
新华书店	xin	hua	shu	dian
新华社	xin	hua	she
新四军	xin	si	jun
新址	xin	zhi
新娘子	xin	niang	zi
新娘子	xin	niang	zi
新式	xin	shi
新意	xin	yi
新教	xin	jiao
新星	xin	xing
新法	xin	fa
新生	xin	sheng
新生事物	xin	sheng	shi	wu
新生儿	xin	sheng	er
新纪元	xin	ji	yuan
新老交替	xin	lao	jiao	ti
新苗	xin	miao
新西兰	xin	xi	lan
新诗	xin	shi
新近	xin	jin
新郎	xin	lang
新闻界	xin	wen	jie
新闻稿	xin	wen	gao
新风	xin	feng
新鲜事	xin	xian	shi
方便之门	fang	bian	zhi	men
方便面	fang	bian	mian
方子	fang	zi
方子	fang	zi
方家	fang	jia
方形	fang	xing
方方正正	fang	fang	zheng	zheng
方方面面	fang	fang	mian	mian
方法论	fang	fa	lun
方程式	fang	cheng	shi
方面军	fang	mian	jun
施压	shi	ya
施放	shi	fang
施政	shi	zheng
施用	shi	yong
施肥	shi	fei
施行	shi	xing
旁观者	pang	guan	zhe
旅伴	lv	ban
旅游团	lv	you	tuan
旅游地	lv	you	di
旅游者	lv	you	zhe
旅游鞋	lv	you	xie
旅行社	lv	xing	she
旋即	xuan	ji
旋涡	xuan	wo
旌旗	jing	qi
族长	zu	zhang
旗下	qi	xia
旗子	qi	zi
旗子	qi	zi
旗帜	qi	zhi
旗帜鲜明	qi	zhi	xian	ming
旗手	qi	shou
旗杆	qi	gan
旗舰	qi	jian
无不	wu	bu
无为	wu	wei
无价之宝	wu	jia	zhi	bao
无党派	wu	dang	pai
无则加勉	wu	ze	jia	mian
无力	wu	li
无可比拟	wu	ke	bi	ni
无可非议	wu	ke	fei	yi
无宁	wu	ning
无尽	wu	jin
无序	wu	xu
无庸讳言	wu	yong	hui	yan
无异	wu	yi
无意	wu	yi
无所不知	wu	suo	bu	zhi
无政府	wu	zheng	fu
无故	wu	gu
无暇	wu	xia
无期	wu	qi
无机	wu	ji
无比	wu	bi
无济于事	wu	ji	yu	shi
无烟	wu	yan
无烟煤	wu	yan	mei
无畏	wu	wei
无的放矢	wu	di	fang	shi
无益	wu	yi
无知	wu	zhi
无礼	wu	li
无神论	wu	shen	lun
无私无畏	wu	si	wu	wei
无线	wu	xian
无线电波	wu	xian	dian	bo
无色	wu	se
无花果	wu	hua	guo
无视	wu	shi
无记名	wu	ji	ming
无际	wu	ji
无须	wu	xu
既往	ji	wang
既是	ji	shi
既有	ji	you
日光灯	ri	guang	deng
日全食	ri	quan	shi
日复一日	ri	fu	yi	ri
日暮途穷	ri	mu	tu	qiong
日甚一日	ri	shen	yi	ri
日程表	ri	cheng	biao
日立	ri	li
日落西山	ri	luo	xi	shan
日间	ri	jian
日食	ri	shi
旧习	jiu	xi
旧事	jiu	shi
旧体诗	jiu	ti	shi
旧址	jiu	zhi
旧宅	jiu	zhai
旧式	jiu	shi
旧时	jiu	shi
旧物	jiu	wu
旧病复发	jiu	bing	fu	fa
旧调重弹	jiu	diao	chong	tan
旧货	jiu	huo
旨意	zhi	yi
早市	zao	shi
早泄	zao	xie
早稻	zao	dao
旭日东升	xu	ri	dong	sheng
旱冰	han	bing
旱情	han	qing
旱烟	han	yan
旱田	han	tian
旱船	han	chuan
旱象	han	xiang
旱路	han	lu
时不再来	shi	bu	zai	lai
时不时	shi	bu	shi
时事	shi	shi
时令	shi	ling
时值	shi	zhi
时兴	shi	xing
时分	shi	fen
时分	shi	fen
时势	shi	shi
时宜	shi	yi
时局	shi	ju
时差	shi	cha
时常	shi	chang
时序	shi	xu
时弊	shi	bi
时政	shi	zheng
时效	shi	xiao
时新	shi	xin
时时	shi	shi
时机	shi	ji
时紧时松	shi	jin	shi	song
时而	shi	er
时节	shi	jie
时评	shi	ping
时运	shi	yun
时钟	shi	zhong
时间差	shi	jian	cha
时限	shi	xian
时鲜	shi	xian
旷野	kuang	ye
旺季	wang	ji
昂然	ang	ran
昆仑山	kun	lun	shan
昆剧	kun	ju
昌平	chang	ping
昌盛	chang	sheng
明丽	ming	li
明代	ming	dai
明令	ming	ling
明净	ming	jing
明晃晃	ming	huang	huang
明晃晃	ming	huang	huang
明晰	ming	xi
明理	ming	li
明码	ming	ma
易于	yi	yu
易经	yi	jing
星云	xing	yun
星体	xing	ti
星夜	xing	ye
星星点点	xing	xing	dian	dian
星期一	xing	qi	yi
星期三	xing	qi	san
星期二	xing	qi	er
星期五	xing	qi	wu
星期六	xing	qi	liu
星期四	xing	qi	si
星期日	xing	qi	ri
星移斗转	xing	yi	dou	zhuan
星级	xing	ji
星罗棋布	xing	luo	qi	bu
星际	xing	ji
映像	ying	xiang
映射	ying	she
映照	ying	zhao
春华秋实	chun	hua	qiu	shi
春灌	chun	guan
春蚓秋蛇	chun	yin	qiu	she
春风化雨	chun	feng	hua	yu
昧心	mei	xin
昭然	zhao	ran
昭示	zhao	shi
是的	shi	de
显出	xian	chu
显微	xian	wei
显灵	xian	ling
显眼	xian	yan
显示屏	xian	shi	ping
显要	xian	yao
显露	xian	lu
晋升	jin	sheng
晋级	jin	ji
晌午	shang	wu
晚婚	wan	hun
晚稻	wan	dao
晚节	wan	jie
晚辈	wan	bei
晦涩	hui	se
晨星	chen	xing
普及本	pu	ji	ben
普及率	pu	ji	lv
普快	pu	kuai
景仰	jing	yang
景况	jing	kuang
景气	jing	qi
景泰蓝	jing	tai	lan
景点	jing	dian
景致	jing	zhi
景颇族	jing	po	zu
晴空	qing	kong
晶体	jing	ti
晶片	jing	pian
晶莹	jing	ying
智利	zhi	li
智力	zhi	li
智取	zhi	qu
智育	zhi	yu
暂住	zan	zhu
暑气	shu	qi
暑热	shu	re
暖气片	nuan	qi	pian
暖融融	nuan	rong	rong
暗伤	an	shang
暗器	an	qi
暗箱	an	xiang
暴利	bao	li
暴发	bao	fa
暴发户	bao	fa	hu
暴政	bao	zheng
暴涨	bao	zhang
暴风雨	bao	feng	yu
暴风雪	bao	feng	xue
暴风骤雨	bao	feng	zhou	yu
曲棍球	qu	gun	qiu
曲调	qu	diao
曲轴	qu	zhou
曲阜	qu	fu
更生	geng	sheng
更衣室	geng	yi	shi
最惠国	zui	hui	guo
月中	yue	zhong
月全食	yue	quan	shi
月历	yue	li
月夜	yue	ye
月宫	yue	gong
月明星稀	yue	ming	xing	xi
有为	you	wei
有事	you	shi
有余	you	yu
有利于	you	li	yu
有力	you	li
有增无减	you	zeng	wu	jian
有头无尾	you	tou	wu	wei
有如	you	ru
有始无终	you	shi	wu	zhong
有幸	you	xing
有底	you	di
有形	you	xing
有心人	you	xin	ren
有志者事竟成	you	zhi	zhe	shi	jing	cheng
有悖于	you	bei	yu
有情	you	qing
有意	you	yi
有意无意	you	yi	wu	yi
有成	you	cheng
有所不同	you	suo	bu	tong
有所作为	you	suo	zuo	wei
有方	you	fang
有时	you	shi
有时候	you	shi	hou
有机	you	ji
有机体	you	ji	ti
有机物	you	ji	wu
有板有眼	you	ban	you	yan
有点	you	dian
有理	you	li
有理有据	you	li	you	ju
有生力量	you	sheng	li	liang
有用	you	yong
有益	you	yi
有神论	you	shen	lun
有章可循	you	zhang	ke	xun
有线	you	xian
有罪	you	zui
有胆有识	you	dan	you	shi
有说有笑	you	shuo	you	xiao
有赖于	you	lai	yu
有鉴于此	you	jian	yu	ci
有限	you	xian
服侍	fu	shi
服侍	fu	shi
服刑	fu	xing
服务业	fu	wu	ye
服务员	fu	wu	yuan
服务器	fu	wu	qi
服毒	fu	du
服气	fu	qi
服膺	fu	ying
服输	fu	shu
朝乾夕惕	zhao	qian	xi	ti
朝圣	chao	sheng
朝政	chao	zheng
朝晖	zhao	hui
朝鲜族	chao	xian	zu
期中	qi	zhong
期满	qi	man
木乃伊	mu	nai	yi
木偶戏	mu	ou	xi
木兰	mu	lan
木床	mu	chuang
木版	mu	ban
木鱼	mu	yu
未了	wei	liao
未决	wei	jue
未知	wei	zhi
未经	wei	jing
末期	mo	qi
末班车	mo	ban	che
本世纪	ben	shi	ji
本义	ben	yi
本体	ben	ti
本原	ben	yuan
本县	ben	xian
本市	ben	shi
本本	ben	ben
本来面目	ben	lai	mian	mu
本源	ben	yuan
本溪	ben	xi
本相	ben	xiang
本科生	ben	ke	sheng
本职	ben	zhi
术语	shu	yu
机井	ji	jing
机位	ji	wei
机体	ji	ti
机关报	ji	guan	bao
机关枪	ji	guan	qiang
机具	ji	ju
机务	ji	wu
机动	ji	dong
机动性	ji	dong	xing
机动车	ji	dong	che
机器人	ji	qi	ren
机型	ji	xing
机头	ji	tou
机心	ji	xin
机时	ji	shi
机智	ji	zhi
机枪	ji	qiang
机械化	ji	xie	hua
机械厂	ji	xie	chang
机械手	ji	xie	shou
机油	ji	you
机理	ji	li
机电	ji	dian
机种	ji	zhong
机箱	ji	xiang
机群	ji	qun
机翼	ji	yi
机耕	ji	geng
机能	ji	neng
机要	ji	yao
机警	ji	jing
机身	ji	shen
机车	ji	che
机载	ji	zai
机长	ji	chang
机长	ji	zhang
杀人案	sha	ren	an
杀人犯	sha	ren	fan
杀伤力	sha	shang	li
杀手锏	sha	shou	jian
杀机	sha	ji
杂剧	za	ju
杂草丛生	za	cao	cong	sheng
杂记	za	ji
杂货店	za	huo	dian
权位	quan	wei
权力	quan	li
权威性	quan	wei	xing
杆子	gan	zi
杆子	gan	zi
杆菌	gan	jun
李先念	li	xian	nian
李四光	li	si	guang
李大钊	li	da	zhao
李子	li	zi
李子	li	zi
李时珍	li	shi	zhen
李白	li	bai
杏仁	xing	ren
村头	cun	tou
束缚	shu	fu
杠铃	gang	ling
条条框框	tiao	tiao	kuang	kuang
条理	tiao	li
条纹	tiao	wen
来势	lai	shi
来势汹汹	lai	shi	xiong	xiong
来意	lai	yi
来来往往	lai	lai	wang	wang
来源于	lai	yuan	yu
来讲	lai	jiang
杨树	yang	shu
杭州市	hang	zhou	shi
杯子	bei	zi
杯子	bei	zi
杰出	jie	chu
松劲	song	jin
松鼠	song	shu
板书	ban	shu
板块	ban	kuai
板子	ban	zi
板子	ban	zi
板报	ban	bao
板斧	ban	fu
板胡	ban	hu
板蓝根	ban	lan	gen
板车	ban	che
极乐	ji	le
极光	ji	guang
极其	ji	qi
极刑	ji	xing
极力	ji	li
极化	ji	hua
极地	ji	di
极度	ji	du
构件	gou	jian
枉法	wang	fa
枉费	wang	fei
枕戈待旦	zhen	ge	dai	dan
枕木	zhen	mu
林产	lin	chan
林区	lin	qu
林带	lin	dai
林檎	lin	qin
林海	lin	hai
林荫道	lin	yin	dao
果农	guo	nong
果实累累	guo	shi	lei	lei
果木	guo	mu
果酒	guo	jiu
枝叶	zhi	ye
枝头	zhi	tou
枝干	zhi	gan
枝干	zhi	gan
枝杈	zhi	cha
枝条	zhi	tiao
枝节	zhi	jie
枣树	zao	shu
枪声	qiang	sheng
枪弹	qiang	dan
枪战	qiang	zhan
枪支	qiang	zhi
枪杆子	qiang	gan	zi
枪杆子	qiang	gan	zi
枯水	ku	shui
架势	jia	shi
架势	jia	shi
架次	jia	ci
架设	jia	she
枸橘	gou	ju
柏树	bai	shu
柏油	bai	you
染料	ran	liao
柔媚	rou	mei
柠檬酸	ning	meng	suan
查勘	cha	kan
查号台	cha	hao	tai
查哨	cha	shao
查对	cha	dui
查禁	cha	jin
查访	cha	fang
柬埔寨	jian	bu	zhai
柬埔寨	jian	pu	zhai
柱子	zhu	zi
柱子	zhu	zi
柱石	zhu	shi
柳体	liu	ti
柴油机	chai	you	ji
柿子	shi	zi
柿子	shi	zi
标准件	biao	zhun	jian
标准化	biao	zhun	hua
标号	biao	hao
标明	biao	ming
标牌	biao	pai
标示	biao	shi
栈道	zhan	dao
栉风沐雨	zhi	feng	mu	yu
树大根深	shu	da	gen	shen
树枝	shu	zhi
树桩	shu	zhuang
树种	shu	zhong
树脂	shu	zhi
树身	shu	shen
栖息	qi	xi
栖身	qi	shen
校务	xiao	wu
校址	xiao	zhi
校官	xiao	guan
校徽	xiao	hui
校方	xiao	fang
校样	jiao	yang
校正	jiao	zheng
校规	xiao	gui
栲栳	kao	lao
样书	yang	shu
样机	yang	ji
核减	he	jian
核动力	he	dong	li
核反应	he	fan	ying
核反应堆	he	fan	ying	dui
核威胁	he	wei	xie
核子	he	zi
核实	he	shi
核弹头	he	dan	tou
核战争	he	zhan	zheng
核潜艇	he	qian	ting
核燃料	he	ran	liao
核物理	he	wu	li
核电	he	dian
核电站	he	dian	zhan
核糖	he	tang
核试验	he	shi	yan
核酸	he	suan
根据地	gen	ju	di
根本性	gen	ben	xing
格子	ge	zi
格子	ge	zi
格律	ge	lv
格陵兰	ge	ling	lan
格鲁吉亚	ge	lu	ji	ya
栽植	zai	zhi
栽种	zai	zhong
桂花	gui	hua
桃李	tao	li
案件	an	jian
案由	an	you
桑梓	sang	zi
桑榆暮景	sang	yu	mu	jing
桔子	ju	zi
档案馆	dang	an	guan
桥头堡	qiao	tou	bao
桥涵	qiao	han
桥身	qiao	shen
桫椤	suo	luo
梅花	mei	hua
梅花鹿	mei	hua	lu
梅雨	mei	yu
梆子	bang	zi
梆子	bang	zi
梗阻	geng	zu
梦乡	meng	xiang
梨子	li	zi
梨树	li	shu
梯形	ti	xing
梯次	ti	ci
梯级	ti	ji
梳子	shu	zi
梳子	shu	zi
梵蒂冈	fan	di	gang
检举	jian	ju
检字法	jian	zi	fa
检察	jian	cha
检察员	jian	cha	yuan
检察官	jian	cha	guan
检察长	jian	cha	zhang
检察院	jian	cha	yuan
检疫	jian	yi
检阅	jian	yue
棉农	mian	nong
棉布	mian	bu
棉田	mian	tian
棉纱	mian	sha
棉衣	mian	yi
棋友	qi	you
棋圣	qi	sheng
棋坛	qi	tan
棋子	qi	zi
棋盘	qi	pan
棋类	qi	lei
棋艺	qi	yi
棋迷	qi	mi
棺木	guan	mu
植保	zhi	bao
植树	zhi	shu
植树造林	zhi	shu	zao	lin
植株	zhi	zhu
植物园	zhi	wu	yuan
植物学	zhi	wu	xue
植物油	zhi	wu	you
椎间盘	zhui	jian	pan
椰子	ye	zi
椰子	ye	zi
楔子	xie	zi
楔子	xie	zi
楠木	nan	mu
楹联	ying	lian
楼堂馆所	lou	tang	guan	suo
楼宇	lou	yu
楼板	lou	ban
概莫能外	gai	mo	neng	wai
概貌	gai	mao
榆树	yu	shu
榜首	bang	shou
榴弹炮	liu	dan	pao
模拟器	mo	ni	qi
模棱	mo	leng
模模糊糊	mo	mo	hu	hu
模特儿	mo	te	er
模特儿	mo	te	er
横梁	heng	liang
横行	heng	xing
橄榄绿	gan	lan	lv
橘子	ju	zi
橘子	ju	zi
橙子	cheng	zi
橙子	cheng	zi
橡皮艇	xiang	pi	ting
欠薪	qian	xin
欠账	qian	zhang
次之	ci	zhi
次品	ci	pin
次大陆	ci	da	lu
次子	ci	zi
次第	ci	di
次长	ci	chang
次长	ci	zhang
欢声雷动	huan	sheng	lei	dong
欢宴	huan	yan
欢欢喜喜	huan	huan	xi	xi
欢欣	huan	xin
欢歌笑语	huan	ge	xiao	yu
欢蹦乱跳	huan	beng	luan	tiao
欢迎会	huan	ying	hui
欣喜	xin	xi
欣悉	xin	xi
欧体	ou	ti
欧安会	ou	an	hui
欺压	qi	ya
款子	kuan	zi
款待	kuan	dai
歇业	xie	ye
歇脚	xie	jiao
歉意	qian	yi
歉收	qian	shou
歉疚	qian	jiu
歌剧	ge	ju
歌剧院	ge	ju	yuan
歌星	ge	xing
歌舞剧	ge	wu	ju
歌舞团	ge	wu	tuan
止境	zhi	jing
止痛	zhi	tong
正中	zheng	zhong
正义	zheng	yi
正事	zheng	shi
正值	zheng	zhi
正儿八经	zheng	er	ba	jing
正儿八经	zheng	er	ba	jing
正剧	zheng	ju
正史	zheng	shi
正名	zheng	ming
正告	zheng	gao
正大	zheng	da
正常值	zheng	chang	zhi
正当防卫	zheng	dang	fang	wei
正房	zheng	fang
正方形	zheng	fang	xing
正是	zheng	shi
正气	zheng	qi
正气凛然	zheng	qi	lin	ran
正法	zheng	fa
正点	zheng	dian
正电子	zheng	dian	zi
正确性	zheng	que	xing
正职	zheng	zhi
正规军	zheng	gui	jun
正规化	zheng	gui	hua
正视	zheng	shi
正误	zheng	wu
正负	zheng	fu
正路	zheng	lu
正身	zheng	shen
正轨	zheng	gui
此事	ci	shi
此致	ci	zhi
此行	ci	xing
此言	ci	yan
步入	bu	ru
步行	bu	xing
步调一致	bu	diao	yi	zhi
步长	bu	chang
武力	wu	li
武士	wu	shi
武官	wu	guan
武将	wu	jiang
武戏	wu	xi
武断	wu	duan
武昌	wu	chang
武术	wu	shu
武生	wu	sheng
武艺	wu	yi
歧义	qi	yi
歧视	qi	shi
歧途	qi	tu
歪理	wai	li
死亡线	si	wang	xian
死人	si	ren
死地	si	di
死硬	si	ying
死记	si	ji
歼击	jian	ji
歼击机	jian	ji	ji
歼敌	jian	di
歼灭战	jian	mie	zhan
残余	can	yu
残垣断壁	can	yuan	duan	bi
残害	can	hai
残局	can	ju
残疾人	can	ji	ren
残联	can	lian
残部	can	bu
残酷无情	can	ku	wu	qing
残阳	can	yang
殖民地	zhi	min	di
殡仪馆	bin	yi	guan
殷墟	yin	xu
殷实	yin	shi
殷殷	yin	yin
毁弃	hui	qi
毁灭性	hui	mie	xing
毅然	yi	ran
毋宁	wu	ning
毋庸	wu	yong
母带	mu	dai
母本	mu	ben
母语	mu	yu
每每	mei	mei
毒气	du	qi
比价	bi	jia
比例尺	bi	li	chi
比值	bi	zhi
比划	bi	hua
比划	bi	hua
比如说	bi	ru	shuo
比拟	bi	ni
比翼齐飞	bi	yi	qi	fei
比试	bi	shi
毕业生	bi	ye	sheng
毕加索	bi	jia	suo
毕恭毕敬	bi	gong	bi	jing
毕生	bi	sheng
毙命	bi	ming
毛坯	mao	pi
毛纺	mao	fang
毛线	mao	xian
毛衣	mao	yi
毡房	zhan	fang
毫不犹豫	hao	bu	you	yu
毫不留情	hao	bu	liu	qing
毫不相干	hao	bu	xiang	gan
毫克	hao	ke
毫无例外	hao	wu	li	wai
毫无疑义	hao	wu	yi	yi
毯子	tan	zi
毯子	tan	zi
毵毵	san	san
氍毹	qu	shu
氏族	shi	zu
民主党派	min	zhu	dang	pai
民力	min	li
民品	min	pin
民团	min	tuan
民盟	min	meng
民革	min	ge
气冲牛斗	qi	chong	niu	dou
气力	qi	li
气动	qi	dong
气势	qi	shi
气垫	qi	dian
气壮如牛	qi	zhuang	ru	niu
气宇轩昂	qi	yu	xuan	ang
气性	qi	xing
气愤	qi	fen
气昂昂	qi	ang	ang
气概	qi	gai
气泡	qi	pao
气管	qi	guan
气管炎	qi	guan	yan
气象台	qi	xiang	tai
气贯长虹	qi	guan	chang	hong
气阀	qi	fa
气韵	qi	yun
氛围	fen	wei
氢弹	qing	dan
氤氲	yin	yun
氧化物	yang	hua	wu
氨基	an	ji
氮气	dan	qi
水产品	shui	chan	pin
水仙花	shui	xian	hua
水兵	shui	bing
水利局	shui	li	ju
水力	shui	li
水势	shui	shi
水印	shui	yin
水合物	shui	he	wu
水坑	shui	keng
水坝	shui	ba
水墨画	shui	mo	hua
水师	shui	shi
水平如镜	shui	ping	ru	jing
水彩画	shui	cai	hua
水性	shui	xing
水情	shui	qing
水手	shui	shou
水文	shui	wen
水文站	shui	wen	zhan
水旱	shui	han
水星	shui	xing
水晶宫	shui	jing	gong
水柱	shui	zhu
水汪汪	shui	wang	wang
水浇地	shui	jiao	di
水深	shui	shen
水渠	shui	qu
水火	shui	huo
水灵灵	shui	ling	ling
水电局	shui	dian	ju
水电站	shui	dian	zhan
水磨	shui	mo
水箱	shui	xiang
水粉画	shui	fen	hua
水系	shui	xi
水肿	shui	zhong
水蒸气	shui	zheng	qi
水警	shui	jing
水道	shui	dao
水陆	shui	lu
水面	shui	mian
水饺	shui	jiao
水龙	shui	long
永世	yong	shi
永久性	yong	jiu	xing
永垂不朽	yong	chui	bu	xiu
汁液	zhi	ye
求全	qiu	quan
求援	qiu	yuan
求是	qiu	shi
求知	qiu	zhi
求知欲	qiu	zhi	yu
汇价	hui	jia
汇合	hui	he
汇报会	hui	bao	hui
汇款单	hui	kuan	dan
汉代	han	dai
汉城	han	cheng
汉堡包	han	bao	bao
汉奸	han	jian
汉子	han	zi
汉子	han	zi
汉文	han	wen
汉白玉	han	bai	yu
汗牛充栋	han	niu	chong	dong
汛情	xun	qing
江北	jiang	bei
江水	jiang	shui
江苏省	jiang	su	sheng
江西省	jiang	xi	sheng
池子	chi	zi
池子	chi	zi
污水	wu	shui
污泥浊水	wu	ni	zhuo	shui
污秽	wu	hui
污蔑	wu	mie
污辱	wu	ru
汩汩	gu	gu
汪洋大海	wang	yang	da	hai
汲水	ji	shui
汽化	qi	hua
汽笛	qi	di
汽车站	qi	che	zhan
汽轮机	qi	lun	ji
沁人肺腑	qin	ren	fei	fu
沆瀣	hang	xie
沉没	chen	mo
沉甸甸	chen	dian	dian
沉积	chen	ji
沉郁	chen	yu
沐猴而冠	mu	hou	er	guan
沙俄	sha	e
沙地	sha	di
沙场	sha	chang
沙子	sha	zi
沙子	sha	zi
沙市	sha	shi
沙文主义	sha	wen	zhu	yi
沙沙	sha	sha
沙洲	sha	zhou
沙石	sha	shi
沙砾	sha	li
没什么	mei	shen	me
没什么	mei	shen	me
没命	mei	ming
没治	mei	zhi
沥青	li	qing
沦陷区	lun	xian	qu
沧海横流	cang	hai	heng	liu
沪剧	hu	ju
河北省	he	bei	sheng
河南省	he	nan	sheng
河堤	he	di
河套	he	tao
河山	he	shan
河水	he	shui
河滩	he	tan
河谷	he	gu
河面	he	mian
沸水	fei	shui
油井	you	jing
油嘴	you	zui
油坊	you	fang
油墨	you	mo
油彩	you	cai
油桶	you	tong
油气	you	qi
油水	you	shui
油污	you	wu
油滑	you	hua
油漆	you	qi
油灯	you	deng
油烟	you	yan
油画	you	hua
油矿	you	kuang
油管	you	guan
油箱	you	xiang
油罐	you	guan
油耗	you	hao
油脂	you	zhi
油船	you	chuan
油路	you	lu
治国安民	zhi	guo	an	min
治国安邦	zhi	guo	an	bang
治外法权	zhi	wai	fa	quan
治学	zhi	xue
治愈	zhi	yu
治本	zhi	ben
治标	zhi	biao
治罪	zhi	zui
沼气	zhao	qi
沼泽地	zhao	ze	di
沾满	zhan	man
沿岸	yan	an
沿江	yan	jiang
沿袭	yan	xi
沿边	yan	bian
沿革	yan	ge
泉源	quan	yuan
泔水	gan	shui
法书	fa	shu
法事	fa	shi
法典	fa	dian
法制	fa	zhi
法力	fa	li
法子	fa	zi
法子	fa	zi
法家	fa	jia
法师	fa	shi
法政	fa	zheng
法文	fa	wen
法新社	fa	xin	she
法权	fa	quan
法案	fa	an
法理	fa	li
法纪	fa	ji
法语	fa	yu
法郎	fa	lang
泛指	fan	zhi
泛泛	fan	fan
泠泠	ling	ling
波兰	bo	lan
波多黎各	bo	duo	li	ge
波尔卡	bo	er	ka
波幅	bo	fu
波谷	bo	gu
波音	bo	yin
泥人	ni	ren
泥水	ni	shui
泥瓦匠	ni	wa	jiang
泥石流	ni	shi	liu
注塑	zhu	su
注射器	zhu	she	qi
注目	zhu	mu
注目礼	zhu	mu	li
注脚	zhu	jiao
泰安	tai	an
泰山压顶	tai	shan	ya	ding
泰山移	tai	shan	yi
泱泱	yang	yang
泵房	beng	fang
泵站	beng	zhan
洁净	jie	jing
洋为中用	yang	wei	zhong	yong
洋洋大观	yang	yang	da	guan
洋洋得意	yang	yang	de	yi
洋行	yang	hang
洋货	yang	huo
洗劫	xi	jie
洗劫一空	xi	jie	yi	kong
洗手	xi	shou
洗涤剂	xi	di	ji
洗漱	xi	shu
洗礼	xi	li
洗练	xi	lian
洗衣	xi	yi
洛阳纸贵	luo	yang	zhi	gui
洞悉	dong	xi
洞房	dong	fang
津巴布韦	jin	ba	bu	wei
洪武	hong	wu
洪水猛兽	hong	shui	meng	shou
洪钟	hong	zhong
活儿	huo	er
活动家	huo	dong	jia
活化石	huo	hua	shi
活性	huo	xing
活性炭	huo	xing	tan
活期	huo	qi
活水	huo	shui
活生生	huo	sheng	sheng
活计	huo	ji
活计	huo	ji
活路	huo	lu
洽谈会	qia	tan	hui
派出所	pai	chu	suo
派性	pai	xing
派系	pai	xi
流下	liu	xia
流失	liu	shi
流弹	liu	dan
流星	liu	xing
流星雨	liu	xing	yu
流水线	liu	shui	xian
流沙	liu	sha
流浪汉	liu	lang	han
流离	liu	li
流窜犯	liu	cuan	fan
流线型	liu	xian	xing
流行色	liu	xing	se
流言	liu	yan
流逝	liu	shi
浅析	qian	xi
浅水	qian	shui
浅滩	qian	tan
浇水	jiao	shui
浇注	jiao	zhu
浇灌	jiao	guan
浇铸	jiao	zhu
浊流	zhuo	liu
测绘局	ce	hui	ju
济困扶危	ji	kun	fu	wei
济济一堂	ji	ji	yi	tang
浑俗和光	hun	su	he	guang
浑厚	hun	hou
浑水摸鱼	hun	shui	mo	yu
浓烟滚滚	nong	yan	gun	gun
浓眉大眼	nong	mei	da	yan
浙江省	zhe	jiang	sheng
浩劫	hao	jie
浩大	hao	da
浩气	hao	qi
浩渺	hao	miao
浩繁	hao	fan
浪头	lang	tou
浪漫主义	lang	man	zhu	yi
浮华	fu	hua
浮尘	fu	chen
浮标	fu	biao
浮沉	fu	chen
浮泛	fu	fan
浮浅	fu	qian
浮游	fu	you
浮萍	fu	ping
浴室	yu	shi
浴池	yu	chi
海事	hai	shi
海味	hai	wei
海地	hai	di
海堤	hai	di
海岛	hai	dao
海岸线	hai	an	xian
海平面	hai	ping	mian
海洛因	hai	luo	yin
海派	hai	pai
海淀	hai	dian
海潮	hai	chao
海疆	hai	jiang
海绵	hai	mian
海豹	hai	bao
海防	hai	fang
海难	hai	nan
浸入	jin	ru
浸染	jin	ran
浸润	jin	run
浸种	jin	zhong
浸透	jin	tou
消亡	xiao	wang
消协	xiao	xie
消暑	xiao	shu
消毒剂	xiao	du	ji
消火栓	xiao	huo	shuan
消瘦	xiao	shou
消融	xiao	rong
消退	xiao	tui
消逝	xiao	shi
消长	xiao	zhang
消闲	xiao	xian
消防车	xiao	fang	che
消防队	xiao	fang	dui
涉世	she	shi
涌浪	yong	lang
涝灾	lao	zai
涡轮机	wo	lun	ji
涤荡	di	dang
润滑油	run	hua	you
涨落	zhang	luo
液化	ye	hua
液化气	ye	hua	qi
涵义	han	yi
涵洞	han	dong
涵管	han	guan
淅沥	xi	li
淋巴结	lin	ba	jie
淋漓	lin	li
淋病	lin	bing
淘汰赛	tao	tai	sai
淙淙	cong	cong
淡季	dan	ji
淡水湖	dan	shui	hu
淡水鱼	dan	shui	yu
淡薄	dan	bo
淤塞	yu	se
淤积	yu	ji
淫威	yin	wei
淮南	huai	nan
深为	shen	wei
深信	shen	xin
深刻性	shen	ke	xing
深化	shen	hua
深受	shen	shou
深处	shen	chu
深处	shen	chu
深得民心	shen	de	min	xin
深情	shen	qing
深情厚谊	shen	qing	hou	yi
深意	shen	yi
深明大义	shen	ming	da	yi
深水港	shen	shui	gang
深知	shen	zhi
深谷	shen	gu
深远	shen	yuan
深透	shen	tou
深重	shen	zhong
深闺	shen	gui
淳厚	chun	hou
混交林	hun	jiao	lin
混养	hun	yang
混合物	hun	he	wu
混浊	hun	zhuo
混淆是非	hun	xiao	shi	fei
混血儿	hun	xue	er
添加剂	tian	jia	ji
添麻烦	tian	ma	fan
清亮	qing	liang
清亮	qing	liang
清偿	qing	chang
清冷	qing	leng
清净	qing	jing
清凉油	qing	liang	you
清剿	qing	jiao
清幽	qing	you
清明节	qing	ming	jie
清晰度	qing	xi	du
清正	qing	zheng
清河	qing	he
清洁	qing	jie
清洗	qing	xi
清淡	qing	dan
清瘦	qing	shou
清纯	qing	chun
清茶	qing	cha
清规戒律	qing	gui	jie	lv
清运	qing	yun
清香	qing	xiang
渊薮	yuan	sou
渐入佳境	jian	ru	jia	jing
渐变	jian	bian
渐次	jian	ci
渔人之利	yu	ren	zhi	li
渔具	yu	ju
渔区	yu	qu
渔场	yu	chang
渔夫	yu	fu
渔家	yu	jia
渔港	yu	gang
渔火	yu	huo
渔网	yu	wang
渔舟	yu	zhou
渔轮	yu	lun
渗入	shen	ru
渡过	du	guo
温厚	wen	hou
温哥华	wen	ge	hua
温室	wen	shi
温良恭俭让	wen	liang	gong	jian	rang
港务局	gang	wu	ju
游人	you	ren
游兴	you	xing
游击	you	ji
游击战	you	ji	zhan
游击队	you	ji	dui
游医	you	yi
游历	you	li
游园	you	yuan
游园会	you	yuan	hui
游子	you	zi
游弋	you	yi
游泳池	you	yong	chi
游泳馆	you	yong	guan
游离	you	li
游艺	you	yi
游艺机	you	yi	ji
游记	you	ji
湖北省	hu	bei	sheng
湖南省	hu	nan	sheng
湖州	hu	zhou
湛蓝	zhan	lan
湮没	yan	mo
湿地	shi	di
湿度	shi	du
湿气	shi	qi
湿漉漉	shi	lu	lu
湿漉漉	shi	lu	lu
溃于蚁穴	kui	yu	yi	xue
源流	yuan	liu
源源	yuan	yuan
溜冰场	liu	bing	chang
溢于言表	yi	yu	yan	biao
溯源	su	yuan
溶剂	rong	ji
溶化	rong	hua
滇池	dian	chi
滋事	zi	shi
滋补品	zi	bu	pin
滑动	hua	dong
滑梯	hua	ti
滑稽戏	hua	ji	xi
滑翔	hua	xiang
滑雪	hua	xue
滑雪板	hua	xue	ban
滚雪球	gun	xue	qiu
滞后	zhi	hou
滞销	zhi	xiao
满员	man	yuan
满城风雨	man	cheng	feng	yu
满天	man	tian
满山遍野	man	shan	bian	ye
满怀信心	man	huai	xin	xin
满文	man	wen
满族	man	zu
满满	man	man
满满当当	man	man	dang	dang
满眼	man	yan
满腔热情	man	qiang	re	qing
满腹牢骚	man	fu	lao	sao
滥觞	lan	shang
滩地	tan	di
滩头	tan	tou
滩涂	tan	tu
滴水	di	shui
滴水成冰	di	shui	cheng	bing
漂漂亮亮	piao	piao	liang	liang
漂移	piao	yi
漏税	lou	shui
漓江	li	jiang
演义	yan	yi
演习	yan	xi
演化	yan	hua
演唱会	yan	chang	hui
演奏员	yan	zou	yuan
演奏家	yan	zou	jia
演播室	yan	bo	shi
演示	yan	shi
演算	yan	suan
演艺	yan	yi
演进	yan	jin
漠视	mo	shi
漫天要价	man	tian	yao	jia
漫漫	man	man
漫漶	man	huan
漯河	luo	he
漳州	zhang	zhou
潆洄	ying	hui
潋滟	lian	yan
潜入	qian	ru
潜台词	qian	tai	ci
潜意识	qian	yi	shi
潜水员	qian	shui	yuan
潜水艇	qian	shui	ting
潜质	qian	zhi
潜返	qian	fan
潦倒	liao	dao
潮头	chao	tou
潮汐	chao	xi
激动人心	ji	dong	ren	xin
激化	ji	hua
激愤	ji	fen
激浊扬清	ji	zhuo	yang	qing
激起	ji	qi
激进	ji	jin
濒于	bin	yu
灌区	guan	qu
灌注	guan	zhu
灌浆	guan	jiang
灌渠	guan	qu
火力	huo	li
火势	huo	shi
火化	huo	hua
火器	huo	qi
火树银花	huo	shu	yin	hua
火海	huo	hai
火灾	huo	zai
火炕	huo	kang
火电厂	huo	dian	chang
火电站	huo	dian	zhan
火箭弹	huo	jian	dan
火箭炮	huo	jian	pao
火箭筒	huo	jian	tong
火花塞	huo	hua	sai
火药味	huo	yao	wei
火车头	huo	che	tou
火辣辣	huo	la	la
火险	huo	xian
火鸡	huo	ji
灯市	deng	shi
灯柱	deng	zhu
灰土	hui	tu
灰心	hui	xin
灰蒙蒙	hui	meng	meng
灰蒙蒙	hui	meng	meng
灰质	hui	zhi
灵性	ling	xing
灵敏度	ling	min	du
灶具	zao	ju
炉台	lu	tai
炉子	lu	zi
炉子	lu	zi
炉渣	lu	zha
炉膛	lu	tang
炊事	chui	shi
炊事员	chui	shi	yuan
炊事班	chui	shi	ban
炎夏	yan	xia
炎炎	yan	yan
炎症	yan	zheng
炒买炒卖	chao	mai	chao	mai
炒家	chao	jia
炮手	pao	shou
炮灰	pao	hui
炸鱼	zha	yu
点子	dian	zi
点子	dian	zi
点心	dian	xin
点拨	dian	bo
点明	dian	ming
点钟	dian	zhong
炼焦	lian	jiao
烂摊子	lan	tan	zi
烂摊子	lan	tan	zi
烂漫	lan	man
烈军属	lie	jun	shu
烈士	lie	shi
烈士墓	lie	shi	mu
烈属	lie	shu
烘云托月	hong	yun	tuo	yue
烟尘	yan	chen
烟波	yan	bo
烟波浩淼	yan	bo	hao	miao
烟灰	yan	hui
烟熏火燎	yan	xun	huo	liao
烟熏火燎	yan	xun	huo	liao
烟盒	yan	he
烟筒	yan	tong
烟筒	yan	tong
烟花	yan	hua
烟草业	yan	cao	ye
烟蒂	yan	di
烟雨	yan	yu
烟雾	yan	wu
烤烟	kao	yan
烦琐	fan	suo
烧碱	shao	jian
烧纸	shao	zhi
烧结	shao	jie
热乎乎	re	hu	hu
热心肠	re	xin	chang
热核	re	he
热气腾腾	re	qi	teng	teng
热水瓶	re	shui	ping
热源	re	yuan
热火	re	huo
热电厂	re	dian	chang
热轧	re	ya
热轧	re	zha
烽火台	feng	huo	tai
烽火连天	feng	huo	lian	tian
焊缝	han	feng
焚化	fen	hua
焚毁	fen	hui
焦化	jiao	hua
焦土	jiao	tu
焦油	jiao	you
焦炉	jiao	lu
焦炭	jiao	tan
焰火	yan	huo
煎饼	jian	bing
煞住	sha	zhu
煞住	sha	zhu
煤尘	mei	chen
煤层	mei	ceng
煤气罐	mei	qi	guan
煤油	mei	you
煤灰	mei	hui
煤烟	mei	yan
煤田	mei	tian
煤窑	mei	yao
照会	zhao	hui
照发	zhao	fa
照壁	zhao	bi
照搬	zhao	ban
熊熊	xiong	xiong
熔化	rong	hua
熔岩	rong	yan
熔炼	rong	lian
熟知	shu	zhi
熟识	shu	shi
熟识	shu	shi
熟透	shu	tou
熟食	shu	shi
熠熠	yi	yi
燃起	ran	qi
燎原之势	liao	yuan	zhi	shi
燎泡	liao	pao
燕京	yan	jing
燕山	yan	shan
燕语莺声	yan	yu	ying	sheng
燕麦	yan	mai
爆发力	bao	fa	li
爆满	bao	man
爆炒	bao	chao
爆炸性	bao	zha	xing
爆竹	bao	zhu
爬高	pa	gao
爱怜	ai	lian
爵士乐	jue	shi	yue
父女	fu	nv
父本	fu	ben
片剂	pian	ji
片子	pian	zi
片子	pian	zi
片断	pian	duan
版式	ban	shi
牌位	pai	wei
牌号	pai	hao
牌坊	pai	fang
牌照	pai	zhao
牙医	ya	yi
牛皮癣	niu	pi	xuan
牛皮纸	niu	pi	zhi
牛羊肉	niu	yang	rou
牛郎织女	niu	lang	zhi	nv
牝牡	pin	mu
牟取暴利	mou	qu	bao	li
牢牢	lao	lao
牧人	mu	ren
牧歌	mu	ge
牧童	mu	tong
牧羊	mu	yang
物主	wu	zhu
物力	wu	li
物欲	wu	yu
物理	wu	li
物理学	wu	li	xue
物证	wu	zheng
物资局	wu	zi	ju
牲畜	sheng	chu
牵制	qian	zhi
牵引力	qian	yin	li
牵线	qian	xian
特技	te	ji
特指	te	zhi
特效药	te	xiao	yao
特派员	te	pai	yuan
特种兵	te	zhong	bing
特赦	te	she
牺牲品	xi	sheng	pin
犄角	ji	jiao
犯愁	fan	chou
犰狳	qiu	yu
犹太人	you	tai	ren
犹太教	you	tai	jiao
狂犬病	kuang	quan	bing
狂草	kuang	cao
狍子	pao	zi
狍子	pao	zi
狐狸	hu	li
狐狸	hu	li
狐疑不决	hu	yi	bu	jue
狐群狗党	hu	qun	gou	dang
狒狒	fei	fei
狙击	ju	ji
狡黠	jiao	xia
独具匠心	du	ju	jiang	xin
独具特色	du	ju	te	se
独出心裁	du	chu	xin	cai
独到之处	du	dao	zhi	chu
独唱	du	chang
独善其身	du	shan	qi	shen
独子	du	zi
独木舟	du	mu	zhou
独生女	du	sheng	nv
独生子	du	sheng	zi
独角戏	du	jiao	xi
独资	du	zi
狭长	xia	chang
狴犴	bi	an
狸猫	li	mao
狻猊	suan	ni
猃狁	xian	yun
猕猴桃	mi	hou	tao
猛兽	meng	shou
猛将	meng	jiang
猛扑	meng	pu
猛犸	meng	ma
猛跌	meng	die
猛醒	meng	xing
猞猁	she	li
猩猩	xing	xing
猪仔	zhu	zai
猪场	zhu	chang
猪崽	zhu	zai
猪瘟	zhu	wen
猪舍	zhu	she
猪舍	zhu	she
献技	xian	ji
献礼	xian	li
献艺	xian	yi
献花	xian	hua
献血	xian	xue
献计	xian	ji
献词	xian	ci
献身	xian	shen
献辞	xian	ci
玄学	xuan	xue
玄虚	xuan	xu
玉兰	yu	lan
玉器	yu	qi
玉溪	yu	xi
玉石	yu	shi
玉米面	yu	mi	mian
玉雕	yu	diao
王位	wang	wei
王公	wang	gong
王冠	wang	guan
王室	wang	shi
王爷	wang	ye
王爷	wang	ye
王羲之	wang	xi	zhi
玎玲	ding	ling
玩意	wan	yi
玩意儿	wan	yi	er
玩意儿	wan	yi	er
玫瑰色	mei	gui	se
环卫	huan	wei
环城	huan	cheng
环形	huan	xing
环抱	huan	bao
环环相扣	huan	huan	xiang	kou
环行	huan	xing
现世	xian	shi
现今	xian	jin
现代化	xian	dai	hua
现代史	xian	dai	shi
现代戏	xian	dai	xi
现代派	xian	dai	pai
现代舞	xian	dai	wu
现任	xian	ren
现出	xian	chu
现场会	xian	chang	hui
现实主义	xian	shi	zhu	yi
现实性	xian	shi	xing
现役	xian	yi
现时	xian	shi
现汇	xian	hui
现眼	xian	yan
现职	xian	zhi
现金	xian	jin
现钱	xian	qian
现阶段	xian	jie	duan
玳瑁	dai	mao
玻利维亚	bo	li	wei	ya
玻璃瓶	bo	li	ping
珊瑚礁	shan	hu	jiao
珍本	zhen	ben
珍视	zhen	shi
珐琅	fa	lang
珞巴族	luo	ba	zu
珠子	zhu	zi
珠子	zhu	zi
班主任	ban	zhu	ren
班房	ban	fang
班机	ban	ji
球形	qiu	xing
球技	qiu	ji
球状	qiu	zhuang
球艺	qiu	yi
理事	li	shi
理事会	li	shi	hui
理事长	li	shi	zhang
理化	li	hua
理发	li	fa
理发师	li	fa	shi
理喻	li	yu
理学	li	xue
理工	li	gong
理工科	li	gong	ke
理所当然	li	suo	dang	ran
理睬	li	cai
理科	li	ke
理解力	li	jie	li
理论家	li	lun	jia
琉璃	liu	li
琉璃瓦	liu	li	wa
琉璃瓦	liu	li	wa
琥珀	hu	po
琴声	qin	sheng
琴师	qin	shi
琼瑶	qiong	yao
瑞金	rui	jin
瑰玮	gui	wei
璎珞	ying	luo
璞玉浑金	pu	yu	hun	jin
瓜农	gua	nong
瓦工	wa	gong
瓦当	wa	dang
瓮声瓮气	weng	sheng	weng	qi
甘于	gan	yu
甘油	gan	you
甘肃省	gan	su	sheng
甘苦	gan	ku
甘蓝	gan	lan
甚至于	shen	zhi	yu
甜菜	tian	cai
甜酸苦辣	tian	suan	ku	la
甜食	tian	shi
生于	sheng	yu
生产关系	sheng	chan	guan	xi
生产力	sheng	chan	li
生产率	sheng	chan	lv
生产线	sheng	chan	xian
生产者	sheng	chan	zhe
生产队	sheng	chan	dui
生人	sheng	ren
生前	sheng	qian
生力军	sheng	li	jun
生化	sheng	hua
生威	sheng	wei
生就	sheng	jiu
生态学	sheng	tai	xue
生性	sheng	xing
生意人	sheng	yi	ren
生意经	sheng	yi	jing
生意经	sheng	yi	jing
生机	sheng	ji
生机勃勃	sheng	ji	bo	bo
生死与共	sheng	si	yu	gong
生殖	sheng	zhi
生母	sheng	mu
生活费	sheng	huo	fei
生源	sheng	yuan
生父	sheng	fu
生物体	sheng	wu	ti
生物学	sheng	wu	xue
生物钟	sheng	wu	zhong
生猪	sheng	zhu
生理	sheng	li
生生	sheng	sheng
生疑	sheng	yi
生肖	sheng	xiao
生育	sheng	yu
生荣死哀	sheng	rong	si	ai
生菜	sheng	cai
生计	sheng	ji
生长期	sheng	zhang	qi
生长素	sheng	zhang	su
用之不竭	yong	zhi	bu	jie
用人	yong	ren
用作	yong	zuo
用尽	yong	jin
用工	yong	gong
用意	yong	yi
用材林	yong	cai	lin
用武	yong	wu
用语	yong	yu
用费	yong	fei
田园诗	tian	yuan	shi
田地	tian	di
田径赛	tian	jing	sai
田联	tian	lian
由头	you	tou
由头	you	tou
由此及彼	you	ci	ji	bi
由此可见	you	ci	ke	jian
甲午	jia	wu
甲午战争	jia	wu	zhan	zheng
甲壳	jia	qiao
甲子	jia	zi
甲板	jia	ban
甲烷	jia	wan
甲状腺	jia	zhuang	xian
甲级	jia	ji
甲虫	jia	chong
甲醇	jia	chun
甲鱼	jia	yu
申诉	shen	su
申请书	shen	qing	shu
申请人	shen	qing	ren
申辩	shen	bian
电令	dian	ling
电信业	dian	xin	ye
电信号	dian	xin	hao
电信局	dian	xin	ju
电光石火	dian	guang	shi	huo
电压	dian	ya
电告	dian	gao
电场	dian	chang
电声	dian	sheng
电子学	dian	zi	xue
电子束	dian	zi	shu
电子琴	dian	zi	qin
电子管	dian	zi	guan
电子邮件	dian	zi	you	jian
电容器	dian	rong	qi
电教	dian	jiao
电文	dian	wen
电机	dian	ji
电极	dian	ji
电气	dian	qi
电波	dian	bo
电炉	dian	lu
电瓶	dian	ping
电石	dian	shi
电码	dian	ma
电磁场	dian	ci	chang
电磁波	dian	ci	bo
电离层	dian	li	ceng
电视剧	dian	shi	ju
电视台	dian	shi	tai
电视塔	dian	shi	ta
电视机	dian	shi	ji
电视片	dian	shi	pian
电话机	dian	hua	ji
电贺	dian	he
电量	dian	liang
电钮	dian	niu
电风扇	dian	feng	shan
电饭煲	dian	fan	bao
男中音	nan	zhong	yin
男低音	nan	di	yin
男单	nan	dan
男声	nan	sheng
男女老少	nan	nv	lao	shao
男方	nan	fang
男男女女	nan	nan	nv	nv
男高音	nan	gao	yin
画像	hua	xiang
画坛	hua	tan
画室	hua	shi
画师	hua	shi
画板	hua	ban
画法	hua	fa
画片	hua	pian
画眉	hua	mei
画虎类狗	hua	hu	lei	gou
画院	hua	yuan
畅游	chang	you
畅达	chang	da
界桩	jie	zhuang
界河	jie	he
界碑	jie	bei
界线	jie	xian
畏缩	wei	suo
畏罪	wei	zui
畏首畏尾	wei	shou	wei	wei
留声机	liu	sheng	ji
留学生	liu	xue	sheng
留宿	liu	su
留成	liu	cheng
留有余地	liu	you	yu	di
留言簿	liu	yan	bu
留驻	liu	zhu
畜力	chu	li
畜牧	xu	mu
畜牧业	xu	mu	ye
略为	lue	wei
略为	lve	wei
略语	lue	yu
略语	lve	yu
畿辅	ji	fu
疆域	jiang	yu
疆界	jiang	jie
疏松	shu	song
疏财仗义	shu	cai	zhang	yi
疑义	yi	yi
疑似	yi	si
疑心	yi	xin
疑点	yi	dian
疗养院	liao	yang	yuan
疫区	yi	qu
疫病	yi	bing
疮痍	chuang	yi
疲乏	pi	fa
疾呼	ji	hu
疾步	ji	bu
疾风	ji	feng
疾驰	ji	chi
疾驶	ji	shi
痄腮	zha	sai
病倒	bing	dao
病危	bing	wei
病历	bing	li
病原体	bing	yuan	ti
病友	bing	you
病史	bing	shi
病员	bing	yuan
病愈	bing	yu
病案	bing	an
病灶	bing	zao
病理	bing	li
病程	bing	cheng
病虫害	bing	chong	hai
症结	zheng	jie
痛击	tong	ji
痛切	tong	qie
痛哭	tong	ku
痛处	tong	chu
痛心	tong	xin
痛悼	tong	dao
痛感	tong	gan
痛打	tong	da
痛斥	tong	chi
痢疾	li	ji
瘌痢	la	li
瘟疫	wen	yi
瘟神	wen	shen
瘦小	shou	xiao
瘰疬	luo	li
癌细胞	ai	xi	bao
癌肿	ai	zhong
癫痫	dian	xian
登基	deng	ji
登山队	deng	shan	dui
登机	deng	ji
登陆艇	deng	lu	ting
白云苍狗	bai	yun	cang	gou
白内障	bai	nei	zhang
白区	bai	qu
白发苍苍	bai	fa	cang	cang
白垩纪	bai	e	ji
白天鹅	bai	tian	e
白山黑水	bai	shan	hei	shui
白布	bai	bu
白开水	bai	kai	shui
白求恩	bai	qiu	en
白灰	bai	hui
白炽灯	bai	chi	deng
白班	bai	ban
白癜风	bai	dian	feng
白米	bai	mi
白细胞	bai	xi	bao
白茫茫	bai	mang	mang
白薯	bai	shu
白蚁	bai	yi
白血球	bai	xue	qiu
白血病	bai	xue	bing
白鳍豚	bai	qi	tun
白鹤	bai	he
百分之	bai	fen	zhi
百分制	bai	fen	zhi
百分比	bai	fen	bi
百分点	bai	fen	dian
百叶窗	bai	ye	chuang
百孔千疮	bai	kong	qian	chuang
百家争鸣	bai	jia	zheng	ming
百年不遇	bai	nian	bu	yu
百年大计	bai	nian	da	ji
百废俱兴	bai	fei	ju	xing
百慕大	bai	mu	da
百灵	bai	ling
百花园	bai	hua	yuan
的士	di	shi
皇历	huang	li
皇历	huang	li
皇太子	huang	tai	zi
皇权	huang	quan
皎皎	jiao	jiao
皖南	wan	nan
皮子	pi	zi
皮影戏	pi	ying	xi
皮条	pi	tiao
皮棉	pi	mian
皮肤病	pi	fu	bing
皮袋	pi	dai
皮货	pi	huo
皱褶	zhou	zhe
盈余	ying	yu
益友	yi	you
益发	yi	fa
益处	yi	chu
益处	yi	chu
盐城	yan	cheng
盐碱	yan	jian
盐碱地	yan	jian	di
监制	jian	zhi
监听	jian	ting
监察	jian	cha
监护人	jian	hu	ren
监测	jian	ce
监理	jian	li
监禁	jian	jin
监视器	jian	shi	qi
盒子	he	zi
盒子	he	zi
盒带	he	dai
盖世无双	gai	shi	wu	shuang
盗卖	dao	mai
盗窃犯	dao	qie	fan
盘桓	pan	huan
盘货	pan	huo
盘陀	pan	tuo
盘马弯弓	pan	ma	wan	gong
盛世	sheng	shi
盛事	sheng	shi
盛产	sheng	chan
盛名	sheng	ming
盛夏	sheng	xia
盛宴	sheng	yan
盛誉	sheng	yu
盟友	meng	you
盟员	meng	yuan
目不窥园	mu	bu	kui	yuan
目光如豆	mu	guang	ru	dou
目光短浅	mu	guang	duan	qian
目击	mu	ji
目击者	mu	ji	zhe
目力	mu	li
目视	mu	shi
盲人瞎马	mang	ren	xia	ma
盲动	mang	dong
直到	zhi	dao
直升机	zhi	sheng	ji
直属	zhi	shu
直拍	zhi	pai
直拨	zhi	bo
直流	zhi	liu
直立	zhi	li
直肠	zhi	chang
直视	zhi	shi
直角	zhi	jiao
直译	zhi	yi
直辖市	zhi	xia	shi
相交	xiang	jiao
相仿	xiang	fang
相关性	xiang	guan	xing
相宜	xiang	yi
相对论	xiang	dui	lun
相形见绌	xiang	xing	jian	chu
相思	xiang	si
相持不下	xiang	chi	bu	xia
相持不下	xiang	chi	bu	xia
相离	xiang	li
相继	xiang	ji
相距	xiang	ju
相较	xiang	jiao
相通	xiang	tong
省会	sheng	hui
省力	sheng	li
省去	sheng	qu
省城	sheng	cheng
省市	sheng	shi
省府	sheng	fu
省悟	xing	wu
省政府	sheng	zheng	fu
省界	sheng	jie
省直	sheng	zhi
省级	sheng	ji
省长	sheng	zhang
眉宇	mei	yu
看做	kan	zuo
看头	kan	tou
看守所	kan	shou	suo
看官	kan	guan
看轻	kan	qing
看透	kan	tou
看重	kan	zhong
真主	zhen	zhu
真人	zhen	ren
真人真事	zhen	ren	zhen	shi
真品	zhen	pin
真善美	zhen	shan	mei
真情实意	zhen	qing	shi	yi
真意	zhen	yi
真是	zhen	shi
真知	zhen	zhi
真谛	zhen	di
眼力	yan	li
眼巴巴	yan	ba	ba
眼帘	yan	lian
眼热	yan	re
眼疾手快	yan	ji	shou	kuai
眼睁睁	yan	zheng	zheng
眼窝	yan	wo
眼色	yan	se
眼镜	yan	jing
眼镜蛇	yan	jing	she
着意	zhuo	yi
着数	zhao	shu
着眼点	zhuo	yan	dian
睚眦	ya	zi
睡意	shui	yi
瞻顾	zhan	gu
矗立	chu	li
矢志	shi	zhi
矢志不移	shi	zhi	bu	yi
知了	zhi	liao
知名度	zhi	ming	du
知悉	zhi	xi
知情人	zhi	qing	ren
知情达理	zhi	qing	da	li
知晓	zhi	xiao
知法	zhi	fa
知法犯法	zhi	fa	fan	fa
知觉	zhi	jue
知识化	zhi	shi	hua
知识性	zhi	shi	xing
知识界	zhi	shi	jie
知识界	zhi	shi	jie
知识面	zhi	shi	mian
知识面	zhi	shi	mian
知趣	zhi	qu
知过必改	zhi	guo	bi	gai
知青	zhi	qing
知音	zhi	yin
矩形	ju	xing
矫形	jiao	xing
矫治	jiao	zhi
短平快	duan	ping	kuai
短讯	duan	xun
矮子	ai	zi
矮子	ai	zi
石像	shi	xiang
石刻	shi	ke
石化	shi	hua
石匠	shi	jiang
石匠	shi	jiang
石器	shi	qi
石墨	shi	mo
石子	shi	zi
石家庄	shi	jia	zhuang
石料	shi	liao
石棉	shi	mian
石榴	shi	liu
石榴	shi	liu
石沉大海	shi	chen	da	hai
石油气	shi	you	qi
石灰	shi	hui
石灰岩	shi	hui	yan
石灰石	shi	hui	shi
石狮	shi	shi
石磨	shi	mo
石磨	shi	mo
石英	shi	ying
石阶	shi	jie
矿业	kuang	ye
矿务局	kuang	wu	ju
矿坑	kuang	keng
砂浆	sha	jiang
砂石	sha	shi
砍伐	kan	fa
砍刀	kan	dao
研修生	yan	xiu	sheng
研磨	yan	mo
研究员	yan	jiu	yuan
研究室	yan	jiu	shi
研究所	yan	jiu	suo
研究生	yan	jiu	sheng
研究者	yan	jiu	zhe
研究院	yan	jiu	yuan
研讨会	yan	tao	hui
砖墙	zhuan	qiang
砚台	yan	tai
砚台	yan	tai
砥砺	di	li
破伤风	po	shang	feng
破例	po	li
破冰船	po	bing	chuan
破口大骂	po	kou	da	ma
破土	po	tu
破坏力	po	huai	li
破浪前进	po	lang	qian	jin
硅酸盐	gui	suan	yan
硅钢片	gui	gang	pian
硕果	shuo	guo
硝烟	xiao	yan
硫化	liu	hua
硬仗	ying	zhang
硬功	ying	gong
硬化	ying	hua
硬性	ying	xing
硬指标	ying	zhi	biao
硬是	ying	shi
硬气	ying	qi
硬汉	ying	han
硬汉子	ying	han	zi
硬笔	ying	bi
硬骨头	ying	gu	tou
硬骨头	ying	gu	tou
碌碌无为	lu	lu	wu	wei
碌碡	liu	zhou
碑刻	bei	ke
碧玉	bi	yu
碧空	bi	kong
碧空如洗	bi	kong	ru	xi
碧绿	bi	lv
碰头会	peng	tou	hui
碰杯	peng	bei
碰碰车	peng	peng	che
碰碰车	peng	peng	che
碱性	jian	xing
碾子	nian	zi
磁力	ci	li
磁化	ci	hua
磁头	ci	tou
磁性	ci	xing
磁石	ci	shi
磁针	ci	zhen
磨刀	mo	dao
磨杵成针	mo	chu	cheng	zhen
磨盘	mo	pan
磨穿铁砚	mo	chuan	tie	yan
磨练	mo	lian
礁石	jiao	shi
示众	shi	zhong
示例	shi	li
示意	shi	yi
礼仪	li	yi
礼帽	li	mao
礼教	li	jiao
礼节	li	jie
礼遇	li	yu
礼金	li	jin
社会化	she	hui	hua
社会性	she	hui	xing
社火	she	huo
社稷	she	ji
祁连山	qi	lian	shan
祈望	qi	wang
祈求	qi	qiu
祖坟	zu	fen
祖籍	zu	ji
祝寿	zhu	shou
祝词	zhu	ci
祝辞	zhu	ci
祝酒歌	zhu	jiu	ge
祝酒词	zhu	jiu	ci
祝酒辞	zhu	jiu	ci
神乎其神	shen	hu	qi	shen
神人	shen	ren
神力	shen	li
神化	shen	hua
神医	shen	yi
神妙	shen	miao
神威	shen	wei
神志	shen	zhi
神情	shen	qing
神明	shen	ming
神枪手	shen	qiang	shou
神气	shen	qi
神灵	shen	ling
神经元	shen	jing	yuan
神经病	shen	jing	bing
神色	shen	se
神通	shen	tong
神采	shen	cai
票号	piao	hao
票箱	piao	xiang
票证	piao	zheng
票额	piao	e
祭品	ji	pin
祭奠	ji	dian
祭祖	ji	zu
禀报	bing	bao
禁区	jin	qu
禁忌	jin	ji
禁毒	jin	du
禁锢	jin	gu
禁闭	jin	bi
福分	fu	fen
福分	fu	fen
福建省	fu	jian	sheng
福星	fu	xing
福气	fu	qi
福气	fu	qi
福音	fu	yin
离合器	li	he	qi
离境	li	jing
离奇	li	qi
离子	li	zi
离异	li	yi
离心力	li	xin	li
离职	li	zhi
离间	li	jian
秀丽	xiu	li
私了	si	liao
私事	si	shi
私交	si	jiao
私刑	si	xing
私心	si	xin
私房	si	fang
私房	si	fang
私有制	si	you	zhi
私欲	si	yu
私立	si	li
私货	si	huo
秉性	bing	xing
秋播	qiu	bo
秋收	qiu	shou
秋粮	qiu	liang
种姓	zhong	xing
种族主义	zhong	zu	zhu	yi
种植	zhong	zhi
种植业	zhong	zhi	ye
种畜	zhong	chu
种花	zhong	hua
科协	ke	xie
科员	ke	yuan
科大	ke	da
科委	ke	wei
科学性	ke	xue	xing
科学界	ke	xue	jie
科学院	ke	xue	yuan
科室	ke	shi
科工委	ke	gong	wei
科教片	ke	jiao	pian
科班	ke	ban
科盲	ke	mang
科研所	ke	yan	suo
秘书长	mi	shu	zhang
秘史	mi	shi
秘鲁	bi	lu
租户	zu	hu
租界	zu	jie
秤砣	cheng	tuo
秦始皇	qin	shi	huang
秦镜高悬	qin	jing	gao	xuan
积习	ji	xi
积劳成疾	ji	lao	cheng	ji
积存	ji	cun
积弊	ji	bi
积怨	ji	yuan
积木	ji	mu
积极分子	ji	ji	fen	zi
积极分子	ji	ji	fen	zi
积案	ji	an
积聚	ji	ju
积肥	ji	fei
积蓄	ji	xu
称为	cheng	wei
称之为	cheng	zhi	wei
称作	cheng	zuo
称誉	cheng	yu
称谓	cheng	wei
移居	yi	ju
移山倒海	yi	shan	dao	hai
移山填海	yi	shan	tian	hai
移栽	yi	zai
移植	yi	zhi
移樽就教	yi	zun	jiu	jiao
稀世	xi	shi
稀奇	xi	qi
稀泥	xi	ni
稀疏	xi	shu
稀释	xi	shi
程式	cheng	shi
程门立雪	cheng	men	li	xue
稍许	shao	xu
税利	shui	li
税制	shui	zhi
税源	shui	yuan
税目	shui	mu
税种	shui	zhong
稚气	zhi	qi
稳健	wen	jian
稳定性	wen	ding	xing
稳当	wen	dang
稳当	wen	dang
稳稳当当	wen	wen	dang	dang
稻子	dao	zi
稻子	dao	zi
稻穗	dao	sui
稼穑	jia	se
稿源	gao	yuan
稿纸	gao	zhi
穴位	xue	wei
穷根	qiong	gen
空中客车	kong	zhong	ke	che
空勤	kong	qin
空域	kong	yu
空子	kong	zi
空子	kong	zi
空当	kong	dang
空投	kong	tou
空架子	kong	jia	zi
空架子	kong	jia	zi
空白点	kong	bai	dian
空空荡荡	kong	kong	dang	dang
空袭	kong	xi
空车	kong	che
空转	kong	zhuan
空阔	kong	kuo
空防	kong	fang
空降兵	kong	jiang	bing
穿山甲	chuan	shan	jia
突击手	tu	ji	shou
突击队	tu	ji	dui
突破口	tu	po	kou
突破性	tu	po	xing
窑洞	yao	dong
窗棂	chuang	ling
窝窝头	wo	wo	tou
立宪	li	xian
立式	li	shi
立志	li	zhi
立意	li	yi
立方米	li	fang	mi
立时	li	shi
立案	li	an
立正	li	zheng
立秋	li	qiu
立论	li	lun
立足点	li	zu	dian
立项	li	xiang
竖立	shu	li
竖起	shu	qi
站住脚	zhan	zhu	jiao
竞争力	jing	zheng	li
竞技	jing	ji
竞技场	jing	ji	chang
竞投	jing	tou
竞相	jing	xiang
童声	tong	sheng
童心	tong	xin
童话	tong	hua
童趣	tong	qu
童音	tong	yin
竭尽	jie	jin
端端正正	duan	duan	zheng	zheng
竹排	zhu	pai
竹椅	zhu	yi
竹楼	zhu	lou
竹竿	zhu	gan
竹简	zhu	jian
竿子	gan	zi
竿子	gan	zi
笊篱	zhao	li
笑吟吟	xiao	yin	yin
笑容满面	xiao	rong	man	mian
笑意	xiao	yi
笑眯眯	xiao	mi	mi
笑语	xiao	yu
笑颜	xiao	yan
笔下	bi	xia
笔力	bi	li
笔势	bi	shi
笔尖	bi	jian
笔录	bi	lu
笔杆子	bi	gan	zi
笔杆子	bi	gan	zi
笔端	bi	duan
笔者	bi	zhe
笔触	bi	chu
笔记本	bi	ji	ben
笔译	bi	yi
笔试	bi	shi
笔迹	bi	ji
笔锋	bi	feng
笛子	di	zi
第一把手	di	yi	ba	shou
第一线	di	yi	xian
笸箩	po	luo
等次	deng	ci
等离子	deng	li	zi
等离子体	deng	li	zi	ti
筑路	zhu	lu
筒子楼	tong	zi	lou
答对	da	dui
答疑	da	yi
答疑	da	yi
答词	da	ci
答话	da	hua
答谢	da	xie
策源地	ce	yuan	di
筛子	shai	zi
筵席	yan	xi
筹备会	chou	bei	hui
筹委会	chou	wei	hui
签收	qian	shou
简介	jian	jie
简体字	jian	ti	zi
简便易行	jian	bian	yi	xing
简写	jian	xie
简化字	jian	hua	zi
简单易行	jian	dan	yi	xing
简历	jian	li
简史	jian	shi
简捷	jian	jie
简政放权	jian	zheng	fang	quan
简易	jian	yi
简章	jian	zhang
简练	jian	lian
简编	jian	bian
简装	jian	zhuang
简言之	jian	yan	zhi
简谱	jian	pu
箕踞	ji	ju
管区	guan	qu
管弦乐	guan	xian	yue
管材	guan	cai
管束	guan	shu
管理局	guan	li	ju
管窥	guan	kui
管风琴	guan	feng	qin
箭步	jian	bu
篆书	zhuan	shu
篆刻	zhuan	ke
篓子	lou	zi
篓子	lou	zi
篮板球	lan	ban	qiu
篷车	peng	che
簸箕	bo	ji
簸箕	bo	ji
米汤	mi	tang
米粒	mi	li
类人猿	lei	ren	yuan
籽棉	zi	mian
粉剂	fen	ji
粉红色	fen	hong	se
粒子	li	zi
粒子	li	zi
粒状	li	zhuang
粗线条	cu	xian	tiao
粘土	nian	tu
粘性	nian	xing
粘结	nian	jie
粘膜	nian	mo
粤剧	yue	ju
粪便	fen	bian
粪肥	fen	fei
粮价	liang	jia
粮商	liang	shang
粮库	liang	ku
粮店	liang	dian
粮棉	liang	mian
粮田	liang	tian
粮站	liang	zhan
粮食局	liang	shi	ju
粳米	jing	mi
粼粼	lin	lin
精到	jing	dao
精制	jing	zhi
精壮	jing	zhuang
精子	jing	zi
精干	jing	gan
精当	jing	dang
精液	jing	ye
精深	jing	shen
精疲力尽	jing	pi	li	jin
精疲力竭	jing	pi	li	jie
精确度	jing	que	du
精神抖擞	jing	shen	dou	sou
精神文明	jing	shen	wen	ming
精神病	jing	shen	bing
精神百倍	jing	shen	bai	bei
精练	jing	lian
精细	jing	xi
精英	jing	ying
精装本	jing	zhuang	ben
精诚	jing	cheng
精诚合作	jing	cheng	he	zuo
精诚团结	jing	cheng	tuan	jie
精读	jing	du
糊口	hu	kou
糖尿病	tang	niao	bing
糖葫芦	tang	hu	lu
糖葫芦	tang	hu	lu
糜烂	mi	lan
糟踏	zao	ta
系列剧	xi	lie	ju
系列化	xi	lie	hua
系列片	xi	lie	pian
系统性	xi	tong	xing
索贿	suo	hui
紧巴巴	jin	ba	ba
紧接	jin	jie
紧身	jin	shen
紧迫感	jin	po	gan
紧追不舍	jin	zhui	bu	she
紧邻	jin	lin
紫癜	zi	dian
紫禁城	zi	jin	cheng
絮语	xu	yu
繁复	fan	fu
繁星	fan	xing
繁育	fan	yu
繁花	fan	hua
纠察队	jiu	cha	dui
纠集	jiu	ji
红十字	hong	shi	zi
红十字会	hong	shi	zi	hui
红土	hong	tu
红场	hong	chang
红宝石	hong	bao	shi
红旗手	hong	qi	shou
红星	hong	xing
红白事	hong	bai	shi
红白喜事	hong	bai	xi	shi
红眼病	hong	yan	bing
红艳艳	hong	yan	yan
红领巾	hong	ling	jin
纤夫	qian	fu
纤维素	xian	wei	su
约数	yue	shu
约法	yue	fa
约稿	yue	gao
级差	ji	cha
纨绔	wan	ku
纪事	ji	shi
纪元	ji	yuan
纪委	ji	wei
纪实	ji	shi
纪年	ji	nian
纪录	ji	lu
纪念册	ji	nian	ce
纪念堂	ji	nian	tang
纪念塔	ji	nian	ta
纪念封	ji	nian	feng
纪念日	ji	nian	ri
纪念物	ji	nian	wu
纪念碑	ji	nian	bei
纪念章	ji	nian	zhang
纪念馆	ji	nian	guan
纪检	ji	jian
纪检委	ji	jian	wei
纪行	ji	xing
纪要	ji	yao
纬度	wei	du
纯收入	chun	shou	ru
纯熟	chun	shu
纱厂	sha	chang
纵使	zong	shi
纵横捭阖	zong	heng	bai	he
纵横驰骋	zong	heng	chi	cheng
纵览	zong	lan
纵贯	zong	guan
纵队	zong	dui
纷呈	fen	cheng
纷纭复杂	fen	yun	fu	za
纷纷扬扬	fen	fen	yang	yang
纸屑	zhi	xie
纸板	zhi	ban
纸片	zhi	pian
纸牌	zhi	pai
纸盒	zhi	he
纸箱	zhi	xiang
纸钱	zhi	qian
纺织	fang	zhi
纺织业	fang	zhi	ye
纺织厂	fang	zhi	chang
纺织品	fang	zhi	pin
纺锭	fang	ding
线头	xian	tou
线性	xian	xing
线材	xian	cai
线装书	xian	zhuang	shu
组件	zu	jian
组委会	zu	wei	hui
组歌	zu	ge
组织性	zu	zhi	xing
组织部	zu	zhi	bu
组阁	zu	ge
细微	xi	wei
细胞核	xi	bao	he
细胞膜	xi	bao	mo
细部	xi	bu
细长	xi	chang
细雨	xi	yu
织女	zhi	nv
织布	zhi	bu
织成	zhi	cheng
织机	zhi	ji
织物	zhi	wu
终南捷径	zhong	nan	jie	jing
终场	zhong	chang
终审	zhong	shen
终将	zhong	jiang
终年	zhong	nian
终极	zhong	ji
终点	zhong	dian
终身制	zhong	shen	zhi
绊倒	ban	dao
绊脚石	ban	jiao	shi
经久	jing	jiu
经委	jing	wei
经学	jing	xue
经常性	jing	chang	xing
经手	jing	shou
经济学	jing	ji	xue
经济林	jing	ji	lin
经济法	jing	ji	fa
经理	jing	li
经管	jing	guan
经纪	jing	ji
经纬	jing	wei
经线	jing	xian
经营不善	jing	ying	bu	shan
经贸委	jing	mao	wei
绒毛	rong	mao
绒线	rong	xian
结为	jie	wei
结伴	jie	ban
结余	jie	yu
结实	jie	shi
结实	jie	shi
结成	jie	cheng
结束语	jie	shu	yu
结束语	jie	shu	yu
结核	jie	he
结核病	jie	he	bing
结石	jie	shi
结结实实	jie	jie	shi	shi
结识	jie	shi
绘制	hui	zhi
给养	ji	yang
给水	ji	shui
绚丽多姿	xuan	li	duo	zi
绚丽多彩	xuan	li	duo	cai
络绎	luo	yi
绝处逢生	jue	chu	feng	sheng
绝处逢生	jue	chu	feng	sheng
绝对值	jue	dui	zhi
绝对化	jue	dui	hua
绝笔	jue	bi
绝经	jue	jing
绝迹	jue	ji
绝食	jue	shi
绞刑	jiao	xing
统一	tong	yi
统一体	tong	yi	ti
统一性	tong	yi	xing
统制	tong	zhi
统帅	tong	shuai
统治	tong	zhi
统治阶级	tong	zhi	jie	ji
统计学	tong	ji	xue
统计局	tong	ji	ju
统计表	tong	ji	biao
统配	tong	pei
统销	tong	xiao
绣品	xiu	pin
继之	ji	zhi
继承人	ji	cheng	ren
继承权	ji	cheng	quan
继父	ji	fu
绪言	xu	yan
绮丽	qi	li
绳趋尺步	sheng	qu	chi	bu
维吾尔	wei	wu	er
维吾尔族	wei	wu	er	zu
维和	wei	he
绵羊	mian	yang
绶带	shou	dai
综上所述	zong	shang	suo	shu
综合性	zong	he	xing
综观	zong	guan
综述	zong	shu
绿油油	lv	you	you
绿油油	lv	you	you
绿肥	lv	fei
绿茵茵	lv	yin	yin
绿荫	lv	yin
缉捕	ji	bu
缉毒	ji	du
缉私	ji	si
缓冲区	huan	chong	qu
缓刑	huan	xing
缓期	huan	qi
缓解	huan	jie
缔交	di	jiao
缔约国	di	yue	guo
缕缕	lv	lv
编委	bian	wei
编审	bian	shen
编年体	bian	nian	ti
编年史	bian	nian	shi
编成	bian	cheng
编目	bian	mu
编织	bian	zhi
编者按	bian	zhe	an
编辑部	bian	ji	bu
缘起	yuan	qi
缙绅	jin	shen
缝纫机	feng	ren	ji
缰绳	jiang	sheng
缴获	jiao	huo
缺额	que	e
罐子	guan	zi
罐子	guan	zi
网状	wang	zhuang
网罗	wang	luo
罗布泊	luo	bu	po
罗拉	luo	la
罗织	luo	zhi
罚球	fa	qiu
罢官	ba	guan
罢市	ba	shi
置于	zhi	yu
置于脑后	zhi	yu	nao	hou
置办	zhi	ban
置备	zhi	bei
置评	zhi	ping
置身	zhi	shen
羁勒	ji	le
羁押	ji	ya
羊城	yang	cheng
羊毛衫	yang	mao	shan
羊肠小道	yang	chang	xiao	dao
羊质虎皮	yang	zhi	hu	pi
美军	mei	jun
美容师	mei	rong	shi
美术家	mei	shu	jia
美术片	mei	shu	pian
美术界	mei	shu	jie
美术馆	mei	shu	guan
美洲	mei	zhou
美玉	mei	yu
美联社	mei	lian	she
美育	mei	yu
美谈	mei	tan
美貌	mei	mao
美金	mei	jin
美食	mei	shi
美餐	mei	can
羞答答	xiu	da	da
羞羞答答	xiu	xiu	da	da
羟基	qiang	ji
群众性	qun	zhong	xing
群像	qun	xiang
群威群胆	qun	wei	qun	dan
群峰	qun	feng
群情	qun	qing
群芳	qun	fang
群英会	qun	ying	hui
群落	qun	luo
群雄逐鹿	qun	xiong	zhu	lu
羽坛	yu	tan
羽绒服	yu	rong	fu
羽翼	yu	yi
翌年	yi	nian
翌日	yi	ri
翔实	xiang	shi
翩翩	pian	pian
翻云覆雨	fan	yun	fu	yu
翻动	fan	dong
翻地	fan	di
翻越	fan	yue
翻转	fan	zhuan
耀眼	yao	yan
老一辈	lao	yi	bei
老一辈	lao	yi	bei
老两口	lao	liang	kou
老伴	lao	ban
老农	lao	nong
老前辈	lao	qian	bei
老办法	lao	ban	fa
老大娘	lao	da	niang
老大爷	lao	da	ye
老太太	lao	tai	tai
老头儿	lao	tou	er
老头儿	lao	tou	er
老奶奶	lao	nai	nai
老奶奶	lao	nai	nai
老好人	lao	hao	ren
老婆婆	lao	po	po
老家	lao	jia
老小	lao	xiao
老帅	lao	shuai
老干部	lao	gan	bu
老年人	lao	nian	ren
老式	lao	shi
老搭档	lao	da	dang
老是	lao	shi
老朋友	lao	peng	you
老框框	lao	kuang	kuang
老框框	lao	kuang	kuang
老泪纵横	lao	lei	zong	heng
老爷爷	lao	ye	ye
老生	lao	sheng
老老少少	lao	lao	shao	shao
老花镜	lao	hua	jing
老蚌生珠	lao	bang	sheng	zhu
老规矩	lao	gui	ju
老话	lao	hua
老调	lao	diao
老路	lao	lu
老辣	lao	la
老酒	lao	jiu
老黄牛	lao	huang	niu
考据	kao	ju
考查	kao	cha
考绩	kao	ji
耐劳	nai	lao
耐酸	nai	suan
耕地	geng	di
耕牛	geng	niu
耕种	geng	zhong
耗子	hao	zi
耗子	hao	zi
耗电	hao	dian
耵聍	ding	ning
耶路撒冷	ye	lu	sa	leng
耸立	song	li
聋哑人	long	ya	ren
职业病	zhi	ye	bing
职代会	zhi	dai	hui
职别	zhi	bie
职守	zhi	shou
职称	zhi	cheng
职能	zhi	neng
职高	zhi	gao
联会	lian	hui
联办	lian	ban
联合会	lian	he	hui
联合国	lian	he	guo
联大	lian	da
联席	lian	xi
联欢会	lian	huan	hui
联系	lian	xi
联系人	lian	xi	ren
联结	lian	jie
联谊	lian	yi
联谊会	lian	yi	hui
聚光灯	ju	guang	deng
聚变	ju	bian
聚合物	ju	he	wu
聚宝盆	ju	bao	pen
聚居	ju	ju
聚拢	ju	long
聚酯	ju	zhi
聚首	ju	shou
肃反	su	fan
肄业	yi	ye
肇事者	zhao	shi	zhe
肉制品	rou	zhi	pin
肉猪	rou	zhu
肉联厂	rou	lian	chang
肉鸡	rou	ji
肌体	ji	ti
肌理	ji	li
肖像画	xiao	xiang	hua
肝火	gan	huo
肝部	gan	bu
肠梗阻	chang	geng	zu
肠炎	chang	yan
肠癌	chang	ai
肠衣	chang	yi
股利	gu	li
股市	gu	shi
股金	gu	jin
股长	gu	zhang
股骨	gu	gu
肢解	zhi	jie
肥力	fei	li
肥效	fei	xiao
肥水	fei	shui
肥田	fei	tian
肩头	jian	tou
肩章	jian	zhang
肯尼迪	ken	ni	di
育林	yu	lin
育种	yu	zhong
育苗	yu	miao
肺气肿	fei	qi	zhong
肺结核	fei	jie	he
胃溃疡	wei	kui	yang
胃炎	wei	yan
胃肠	wei	chang
胃镜	wei	jing
胆汁	dan	zhi
胆识	dan	shi
背书	bei	shu
背地里	bei	di	li
背地里	bei	di	li
背弃	bei	qi
背部	bei	bu
胜仗	sheng	zhang
胜似	sheng	si
胞弟	bao	di
胡同	hu	tong
胡同	hu	tong
胡椒	hu	jiao
胡琴	hu	qin
胭脂	yan	zhi
胰岛素	yi	dao	su
胰腺	yi	xian
胳臂	ge	bei
胳臂	ge	bei
胶印	jiao	yin
胶合板	jiao	he	ban
胶布	jiao	bu
胶带	jiao	dai
胶水	jiao	shui
胶皮	jiao	pi
胶鞋	jiao	xie
胼胝	pian	zhi
能事	neng	shi
能见度	neng	jian	du
脂肪酸	zhi	fang	suan
脊柱	ji	zhu
脊梁	ji	liang
脊梁	ji	liang
脊椎动物	ji	zhui	dong	wu
脊背	ji	bei
脊骨	ji	gu
脏器	zang	qi
脏器	zang	qi
脐带	qi	dai
脑力劳动	nao	li	lao	dong
脑溢血	nao	yi	xue
脑神经	nao	shen	jing
脑血栓	nao	xue	shuan
脚劲	jiao	jin
脚掌	jiao	zhang
脚板	jiao	ban
脚气	jiao	qi
脚趾	jiao	zhi
脚踏	jiao	ta
脱盲	tuo	mang
脱粒	tuo	li
脸颊	lian	jia
腈纶	jing	lun
腊八粥	la	ba	zhou
腊梅	la	mei
腐化	fu	hua
腐蚀	fu	shi
腔调	qiang	diao
腥膻	xing	shan
腰杆	yao	gan
腹地	fu	di
腹心	fu	xin
腹水	fu	shui
腹腔	fu	qiang
腽肭	wa	na
膀子	bang	zi
膀子	bang	zi
膳食	shan	shi
臆断	yi	duan
自不待言	zi	bu	dai	yan
自个儿	zi	ge	er
自主权	zi	zhu	quan
自习	zi	xi
自养	zi	yang
自决	zi	jue
自制	zi	zhi
自动化	zi	dong	hua
自助	zi	zhu
自勉	zi	mian
自卑感	zi	bei	gan
自卫	zi	wei
自备	zi	bei
自尽	zi	jin
自居	zi	ju
自幼	zi	you
自序	zi	xu
自恃	zi	shi
自愧弗如	zi	kui	fu	ru
自愿	zi	yuan
自慰	zi	wei
自成一体	zi	cheng	yi	ti
自成一体	zi	cheng	yi	ti
自成一家	zi	cheng	yi	jia
自成一家	zi	cheng	yi	jia
自我标榜	zi	wo	biao	bang
自找麻烦	zi	zhao	ma	fan
自有	zi	you
自治	zi	zhi
自治区	zi	zhi	qu
自治县	zi	zhi	xian
自治州	zi	zhi	zhou
自流	zi	liu
自然村	zi	ran	cun
自然界	zi	ran	jie
自燃	zi	ran
自由主义	zi	you	zhu	yi
自由度	zi	you	du
自由泳	zi	you	yong
自由港	zi	you	gang
自立	zi	li
自给	zi	ji
自绝	zi	jue
自荐	zi	jian
自豪感	zi	hao	gan
自贡	zi	gong
自费	zi	fei
自费生	zi	fei	sheng
自转	zi	zhuan
自述	zi	shu
自销	zi	xiao
臭氧	chou	yang
至上	zhi	shang
至亲	zhi	qin
至关紧要	zhi	guan	jin	yao
致以	zhi	yi
致使	zhi	shi
致力	zhi	li
致哀	zhi	ai
致密	zhi	mi
致富	zhi	fu
致意	zhi	yi
致敬	zhi	jing
致死	zhi	si
致电	zhi	dian
致病	zhi	bing
致癌	zhi	ai
致词	zhi	ci
舅舅	jiu	jiu
舆论界	yu	lun	jie
舍命	she	ming
舍死忘生	she	si	wang	sheng
舒坦	shu	tan
舒心	shu	xin
舒舒服服	shu	shu	fu	fu
舛错	chuan	cuo
舞会	wu	hui
舞剑	wu	jian
舞场	wu	chang
舞坛	wu	tan
舞姿	wu	zi
舞弊	wu	bi
舞曲	wu	qu
舞池	wu	chi
舞狮	wu	shi
舞蹈家	wu	dao	jia
舢板	shan	ban
航天器	hang	tian	qi
航天局	hang	tian	ju
航天部	hang	tian	bu
航次	hang	ci
航空兵	hang	kong	bing
航空器	hang	kong	qi
航空港	hang	kong	gang
航路	hang	lu
航迹	hang	ji
舰只	jian	zhi
舰船	jian	chuan
舰艇	jian	ting
舰长	jian	zhang
舱位	cang	wei
舳舻	zhu	lu
舷梯	xian	ti
舷窗	xian	chuang
船东	chuan	dong
船坞	chuan	wu
船头	chuan	tou
船工	chuan	gong
船老大	chuan	lao	da
船舶	chuan	bo
船身	chuan	shen
艨艟	meng	chong
良友	liang	you
良师	liang	shi
良田	liang	tian
良种	liang	zhong
良策	liang	ce
艰深	jian	shen
艰苦卓绝	jian	ku	zhuo	jue
艰苦朴素	jian	ku	pu	su
色彩斑斓	se	cai	ban	lan
色拉油	se	la	you
艳丽	yan	li
艳情	yan	qing
艳福	yan	fu
艳阳天	yan	yang	tian
艺员	yi	yuan
艺坛	yi	tan
艺术品	yi	shu	pin
艺术团	yi	shu	tuan
艺术家	yi	shu	jia
艺术性	yi	shu	xing
艺术界	yi	shu	jie
艺术馆	yi	shu	guan
艺校	yi	xiao
艺苑	yi	yuan
艾滋病	ai	zi	bing
节余	jie	yu
节俭	jie	jian
节假日	jie	jia	ri
节制	jie	zhi
节奏感	jie	zou	gan
节律	jie	lv
节支	jie	zhi
节水	jie	shui
节油	jie	you
节电	jie	dian
节目单	jie	mu	dan
节育	jie	yu
节节胜利	jie	jie	sheng	li
芊绵	qian	mian
芊芊	qian	qian
芙蕖	fu	qu
芥蒂	jie	di
芫荽	yan	sui
芭蕉	ba	jiao
花会	hua	hui
花农	hua	nong
花坛	hua	tan
花季	hua	ji
花岗岩	hua	gang	yan
花岗石	hua	gang	shi
花市	hua	shi
花布	hua	bu
花旦	hua	dan
花期	hua	qi
花果山	hua	guo	shan
花架子	hua	jia	zi
花灯	hua	deng
花生油	hua	sheng	you
花生米	hua	sheng	mi
花甲	hua	jia
花粉	hua	fen
花红柳绿	hua	hong	liu	lv
花花绿绿	hua	hua	lv	lv
花轿	hua	jiao
花鸟画	hua	niao	hua
花鼓戏	hua	gu	xi
芳菲	fang	fei
芳香	fang	xiang
苁蓉	cong	rong
苍莽	cang	mang
苏区	su	qu
苏维埃	su	wei	ai
苏联	su	lian
苛求	ke	qiu
苞米	bao	mi
苞谷	bao	gu
苤蓝	pie	lan
苤蓝	pie	lan
苦功	ku	gong
苦味	ku	wei
苦寒	ku	han
苦活	ku	huo
苦行	ku	xing
英勇	ying	yong
英名	ying	ming
英姿	ying	zi
英姿焕发	ying	zi	huan	fa
英杰	ying	jie
英武	ying	wu
英里	ying	li
茁壮	zhuo	zhuang
范文	fan	wen
茅台酒	mao	tai	jiu
茅盾	mao	dun
茉莉	mo	li
茏葱	long	cong
茧丝	jian	si
茧子	jian	zi
茧子	jian	zi
茯苓	fu	ling
茱萸	zhu	yu
茳芏	jiang	du
茶具	cha	ju
茶农	cha	nong
茶场	cha	chang
茶座	cha	zuo
茶炉	cha	lu
茶点	cha	dian
茶缸	cha	gang
茶话会	cha	hua	hui
茼蒿	tong	hao
荆州	jing	zhou
荆条	jing	tiao
荆棘	jing	ji
草场	cao	chang
草房	cao	fang
草皮	cao	pi
草绿色	cao	lv	se
草草	cao	cao
草长莺飞	cao	zhang	ying	fei
荒地	huang	di
荒山	huang	shan
荔枝	li	zhi
荡涤	dang	di
荣誉奖	rong	yu	jiang
荣誉感	rong	yu	gan
荣誉章	rong	yu	zhang
荣辱	rong	ru
荧光灯	ying	guang	deng
荫凉	yin	liang
药典	yao	dian
药到病除	yao	dao	bing	chu
药学	yao	xue
药店	yao	dian
药房	yao	fang
药理	yao	li
药用	yao	yong
药膳	yao	shan
荸荠	bi	qi
莪术	e	zhu
莪蒿	e	hao
莫明其妙	mo	ming	qi	miao
莫桑比克	mo	sang	bi	ke
莫衷一是	mo	zhong	yi	shi
莫衷一是	mo	zhong	yi	shi
莱菔	lai	fu
莲子	lian	zi
获释	huo	shi
菁菁	jing	jing
菌种	jun	zhong
菖蒲	chang	pu
菜园	cai	yuan
菜园子	cai	yuan	zi
菜市场	cai	shi	chang
菜窖	cai	jiao
菜篮子	cai	lan	zi
菜花	cai	hua
菜蔬	cai	shu
菡萏	han	dan
菩提树	pu	ti	shu
菲薄	fei	bo
萌动	meng	dong
萤火虫	ying	huo	chong
营业员	ying	ye	yuan
营业所	ying	ye	suo
营业税	ying	ye	shui
营业额	ying	ye	e
营养品	ying	yang	pin
营养素	ying	yang	su
营利	ying	li
营区	ying	qu
营口	ying	kou
营垒	ying	lei
营建	ying	jian
营生	ying	sheng
萧萧	xiao	xiao
萨拉热窝	sa	la	re	wo
落拓	luo	tuo
落泊	luo	bo
落选	luo	xuan
落马	luo	ma
著书	zhe	shu
著书	zhu	shu
著作权	zhu	zuo	quan
著录	zhu	lu
著文	zhe	wen
著文	zhu	wen
著者	zhu	zhe
著述	zhu	shu
葡萄干	pu	tao	gan
葡萄酒	pu	tao	jiu
董事会	dong	shi	hui
董事长	dong	shi	zhang
葭莩	jia	fu
葱头	cong	tou
葳蕤	wei	rui
蒙住	meng	zhu
蒙古包	meng	gu	bao
蒙古族	meng	gu	zu
蒙头转向	meng	tou	zhuan	xiang
蒙蒙	meng	meng
蒙蒙亮	meng	meng	liang
蒙难	meng	nan
蒲公英	pu	gong	ying
蒲葵	pu	kui
蒸气	zheng	qi
蒸汽	zheng	qi
蒸汽机	zheng	qi	ji
蒸馏水	zheng	liu	shui
蒺藜	ji	li
蓁蓁	zhen	zhen
蓄水池	xu	shui	chi
蓄电池	xu	dian	chi
蓄积	xu	ji
蓊郁	weng	yu
蓑衣	suo	yi
蓓蕾	bei	lei
蓖麻	bi	ma
蓝宝石	lan	bao	shi
蓝布	lan	bu
蓝皮书	lan	pi	shu
蓝藻	lan	zao
蓦地	mo	di
蓬蓬勃勃	peng	peng	bo	bo
蔓菁	man	jing
蔗农	zhe	nong
蔚为壮观	wei	wei	zhuang	guan
蔚为大观	wei	wei	da	guan
蔚成风气	wei	cheng	feng	qi
蔚蓝色	wei	lan	se
蕴涵	yun	han
蕴藉	yun	jie
薄利	bo	li
薄地	bo	di
薄幸	bo	xing
薄片	bao	pian
薄薄	bao	bao
薄雾	bao	wu
薄雾	bo	wu
薯类	shu	lei
薯蓣	shu	yu
藏历	zang	li
蘑菇云	mo	gu	yun
蘑菇云	mo	gu	yun
虎口	hu	kou
虎威	hu	wei
虎子	hu	zi
虚惊	xu	jing
虫害	chong	hai
虫灾	chong	zai
虱子	shi	zi
虱子	shi	zi
虾仁	xia	ren
蚊子	wen	zi
蚊子	wen	zi
蚍蜉	pi	fu
蚕丝	can	si
蚕茧	can	jian
蚰蜒	you	yan
蛇头	she	tou
蛙人	wa	ren
蛛网	zhu	wang
蛤蜊	ge	li
蛴螬	qi	cao
蜂拥而上	feng	yong	er	shang
蜂拥而至	feng	yong	er	zhi
蜂王浆	feng	wang	jiang
蜂窝煤	feng	wo	mei
蜈蚣	wu	gong
蜉蝣	fu	you
蜕化	tui	hua
蜚声	fei	sheng
蜚蠊	fei	lian
蜥蜴	xi	yi
蜿蜒	wan	yan
蝇头微利	ying	tou	wei	li
蝎子	xie	zi
蝎子	xie	zi
蝗灾	huang	zai
蝾螈	rong	yuan
螟蛉	ming	ling
螺丝钉	luo	si	ding
螺旋桨	luo	xuan	jiang
螺栓	luo	shuan
螺蛳	luo	si
蟾蜍	chan	chu
蠛蠓	mie	meng
血压计	xue	ya	ji
血吸虫	xue	xi	chong
血性	xue	xing
血流成河	xue	liu	cheng	he
血淋淋	xie	lin	lin
血红蛋白	xue	hong	dan	bai
血缘	xue	yuan
血肉相连	xue	rou	xiang	lian
行事	xing	shi
行会	hang	hui
行使	xing	shi
行径	xing	jing
行必果	xing	bi	guo
行政区	xing	zheng	qu
行政村	xing	zheng	cun
行星	xing	xing
行程	xing	cheng
行署	xing	shu
行装	xing	zhuang
行驶	xing	shi
衍生物	yan	sheng	wu
街区	jie	qu
街坊	jie	fang
街坊	jie	fang
街市	jie	shi
街道	jie	dao
街面	jie	mian
衡器	heng	qi
衣兜	yi	dou
衣冠	yi	guan
衣料	yi	liao
衣架	yi	jia
衣物	yi	wu
衣衫	yi	shan
衣袋	yi	dai
衣裳	yi	shang
衣裳	yi	shang
衣襟	yi	jin
衣角	yi	jiao
补习	bu	xi
补习班	bu	xi	ban
补发	bu	fa
补差	bu	cha
补救	bu	jiu
补给	bu	ji
补缺	bu	que
补药	bu	yao
补血	bu	xue
补课	bu	ke
补足	bu	zu
表决权	biao	jue	quan
表哥	biao	ge
表弟	biao	di
表征	biao	zheng
表演唱	biao	yan	chang
表里不一	biao	li	bu	yi
表面化	biao	mian	hua
衬里	chen	li
衰变	shuai	bian
衷心	zhong	xin
衷情	zhong	qing
衷肠	zhong	chang
袒露	tan	lu
被俘	bei	fu
被告人	bei	gao	ren
被害	bei	hai
被害人	bei	hai	ren
被害者	bei	hai	zhe
被捕	bei	bu
被服	bei	fu
被选举权	bei	xuan	ju	quan
裁剪	cai	jian
裁缝	cai	feng
裁缝	cai	feng
裂化	lie	hua
裂谷	lie	gu
裂隙	lie	xi
装机	zhuang	ji
装甲	zhuang	jia
装甲兵	zhuang	jia	bing
装甲车	zhuang	jia	che
装船	zhuang	chuan
装车	zhuang	che
装配线	zhuang	pei	xian
装饰品	zhuang	shi	pin
裙装	qun	zhuang
褒扬	bao	yang
褡裢	da	lian
褥疮	ru	chuang
襁褓	qiang	bao
襄樊	xiang	fan
襄阳	xiang	yang
西化	xi	hua
西北风	xi	bei	feng
西半球	xi	ban	qiu
西南风	xi	nan	feng
西头	xi	tou
西学	xi	xue
西安市	xi	an	shi
西式	xi	shi
西文	xi	wen
西方人	xi	fang	ren
西施	xi	shi
西服	xi	fu
西汉	xi	han
西洋	xi	yang
西洋参	xi	yang	shen
西端	xi	duan
西经	xi	jing
西非	xi	fei
要义	yao	yi
要事	yao	shi
要件	yao	jian
要冲	yao	chong
要务	yao	wu
要员	yao	yuan
要旨	yao	zhi
要目	yao	mu
要饭	yao	fan
覆盖率	fu	gai	lv
见习	jian	xi
见危授命	jian	wei	shou	ming
见地	jian	di
见得	jian	de
见怪不怪	jian	guai	bu	guai
见报	jian	bao
见效	jian	xiao
见状	jian	zhuang
见解	jian	jie
见识	jian	shi
见识	jian	shi
见长	jian	chang
见长	jian	zhang
见面礼	jian	mian	li
观众席	guan	zhong	xi
观察力	guan	cha	li
观察员	guan	cha	yuan
观察家	guan	cha	jia
观战	guan	zhan
观瞻	guan	zhan
观礼	guan	li
观者如云	guan	zhe	ru	yun
规例	gui	li
规律性	gui	lv	xing
规程	gui	cheng
规章制度	gui	zhang	zhi	du
规行矩步	gui	xing	ju	bu
规规矩矩	gui	gui	ju	ju
觅食	mi	shi
视为	shi	wei
视力	shi	li
视图	shi	tu
视点	shi	dian
视线	shi	xian
视网膜	shi	wang	mo
视野	shi	ye
觊觎	ji	yu
角钢	jiao	gang
解体	jie	ti
解开	jie	kai
解忧	jie	you
解放区	jie	fang	qu
解放后	jie	fang	hou
解放战争	jie	fang	zhan	zheng
解数	xie	shu
解构	jie	gou
解毒	jie	du
解渴	jie	ke
解禁	jie	jin
解衣推食	jie	yi	tui	shi
解说词	jie	shuo	ci
解调	jie	tiao
解除	jie	chu
解难	jie	nan
解难	jie	nan
触动	chu	dong
触及	chu	ji
触发	chu	fa
触媒	chu	mei
触礁	chu	jiao
觳觫	hu	su
言和	yan	he
言必信	yan	bi	xin
言教	yan	jiao
言词	yan	ci
誓师	shi	shi
誓死	shi	si
誓死不二	shi	si	bu	er
誓言	shi	yan
誓词	shi	ci
警力	jing	li
警卫员	jing	wei	yuan
警句	jing	ju
警备区	jing	bei	qu
警察局	jing	cha	ju
警戒	jing	jie
警戒线	jing	jie	xian
警报器	jing	bao	qi
警服	jing	fu
警种	jing	zhong
警笛	jing	di
警醒	jing	xing
计分	ji	fen
计划性	ji	hua	xing
计划生育	ji	hua	sheng	yu
计委	ji	wei
计数	ji	shu
计时	ji	shi
计酬	ji	chou
计量	ji	liang
订户	ding	hu
讣告	fu	gao
认清	ren	qing
认知	ren	zhi
认识论	ren	shi	lun
讥笑	ji	xiao
讨嫌	tao	xian
讨饭	tao	fan
训令	xun	ling
训练有素	xun	lian	you	su
训练班	xun	lian	ban
训诫	xun	jie
议事	yi	shi
议价	yi	jia
议会制	yi	hui	zhi
议员	yi	yuan
议和	yi	he
议定	yi	ding
议定书	yi	ding	shu
议席	yi	xi
议政	yi	zheng
议案	yi	an
议长	yi	zhang
议院	yi	yuan
议题	yi	ti
讯问	xun	wen
记事	ji	shi
记分	ji	fen
记功	ji	gong
记取	ji	qu
记叙	ji	xu
记叙文	ji	xu	wen
记忆力	ji	yi	li
记性	ji	xing
记要	ji	yao
记账	ji	zhang
记述	ji	shu
讲义	jiang	yi
讲堂	jiang	tang
讲学	jiang	xue
讲师	jiang	shi
讲理	jiang	li
讲解员	jiang	jie	yuan
许可证	xu	ke	zheng
许许多多	xu	xu	duo	duo
论处	lun	chu
论文集	lun	wen	ji
论理	lun	li
设伏	she	fu
设计师	she	ji	shi
设计者	she	ji	zhe
设计院	she	ji	yuan
证实	zheng	shi
证明书	zheng	ming	shu
证章	zheng	zhang
证言	zheng	yan
评为	ping	wei
评介	ping	jie
评剧	ping	ju
评功	ping	gong
评头品足	ping	tou	pin	zu
评头论足	ping	tou	lun	zu
评委会	ping	wei	hui
评弹	ping	tan
评比	ping	bi
评论员	ping	lun	yuan
评话	ping	hua
识字	shi	zi
诉状	su	zhuang
诉讼法	su	song	fa
诊室	zhen	shi
诊治	zhen	zhi
词人	ci	ren
词儿	ci	er
词句	ci	ju
词曲	ci	qu
词牌	ci	pai
译作	yi	zuo
译制	yi	zhi
译文	yi	wen
译本	yi	ben
译著	yi	zhu
试制	shi	zhi
试剂	shi	ji
试办	shi	ban
试听	shi	ting
试想	shi	xiang
试映	shi	ying
试用	shi	yong
试用期	shi	yong	qi
试看	shi	kan
试种	shi	zhong
试种	shi	zhong
试管	shi	guan
试行	shi	xing
试试看	shi	shi	kan
试金石	shi	jin	shi
试销	shi	xiao
试问	shi	wen
试题	shi	ti
试飞	shi	fei
试验田	shi	yan	tian
诖误	gua	wu
诗体	shi	ti
诗作	shi	zuo
诗圣	shi	sheng
诗坛	shi	tan
诗意	shi	yi
诗文	shi	wen
诗话	shi	hua
诗集	shi	ji
诚信	cheng	xin
诚实	cheng	shi
诚挚	cheng	zhi
诚聘	cheng	pin
诚邀	cheng	yao
诛杀	zhu	sha
话剧团	hua	ju	tuan
话务员	hua	wu	yuan
话匣子	hua	xia	zi
话头	hua	tou
话茬	hua	cha
话费	hua	fei
诠释	quan	shi
诤友	zheng	you
诤言	zheng	yan
详实	xiang	shi
详尽	xiang	jin
详解	xiang	jie
诧异	cha	yi
诬陷	wu	xian
语义	yu	yi
语境	yu	jing
语意	yu	yi
语气	yu	qi
语汇	yu	hui
语系	yu	xi
语词	yu	ci
误事	wu	shi
误导	wu	dao
误点	wu	dian
误用	wu	yong
误食	wu	shi
诱使	you	shi
诱因	you	yin
诱杀	you	sha
诱饵	you	er
说不上	shuo	bu	shang
说不上	shuo	bu	shang
说到底	shuo	dao	di
说和	shuo	he
说和	shuo	he
说大话	shuo	da	hua
说时迟	shuo	shi	chi
说是	shuo	shi
说服力	shuo	fu	li
说空话	shuo	kong	hua
说长道短	shuo	chang	dao	duan
请便	qing	bian
请功	qing	gong
请愿	qing	yuan
请战	qing	zhan
诸位	zhu	wei
诸如	zhu	ru
诸葛亮	zhu	ge	liang
读书人	du	shu	ren
读后感	du	hou	gan
课件	ke	jian
课余	ke	yu
课时	ke	shi
课目	ke	mu
课间	ke	jian
谁料	shei	liao
谁料	shui	liao
调令	diao	ling
调头	diao	tou
调幅	tiao	fu
调控	tiao	kong
调节器	tiao	jie	qi
调解	tiao	jie
调资	tiao	zi
调转	diao	zhuan
调运	diao	yun
谄谀	chan	yu
谆谆	zhun	zhun
谆谆告诫	zhun	zhun	gao	jie
谆谆教导	zhun	zhun	jiao	dao
谈兴	tan	xing
谈吐	tan	tu
谈天说地	tan	tian	shuo	di
谈心	tan	xin
谈笑	tan	xiao
谈虎色变	tan	hu	se	bian
谈起	tan	qi
谋取	mou	qu
谐和	xie	he
谐调	xie	tiao
谚语	yan	yu
谢意	xie	yi
谨言慎行	jin	yan	shen	xing
谱儿	pu	er
谱儿	pu	er
谷地	gu	di
谷物	gu	wu
谷雨	gu	yu
豁亮	huo	liang
豁口	huo	kou
豁达大度	huo	da	da	du
豆制品	dou	zhi	pin
豆汁	dou	zhi
豆油	dou	you
豆科	dou	ke
豆荚	dou	jia
豆饼	dou	bing
象牙之塔	xiang	ya	zhi	ta
豪气	hao	qi
豪赌	hao	du
豫剧	yu	ju
豹子	bao	zi
豹子	bao	zi
豺狼成性	chai	lang	cheng	xing
贝利	bei	li
贝多芬	bei	duo	fen
负债累累	fu	zhai	lei	lei
负数	fu	shu
负有	fu	you
负气	fu	qi
负荷	fu	he
负重	fu	zhong
财产权	cai	chan	quan
财政厅	cai	zheng	ting
财政部	cai	zheng	bu
财权	cai	quan
财源	cai	yuan
财物	cai	wu
财神爷	cai	shen	ye
责任制	ze	ren	zhi
责任心	ze	ren	xin
责任田	ze	ren	tian
责编	ze	bian
贤人	xian	ren
贤哲	xian	zhe
贤达	xian	da
败北	bai	bei
败者	bai	zhe
败血症	bai	xue	zheng
败露	bai	lu
货价	huo	jia
货场	huo	chang
货机	huo	ji
货畅其流	huo	chang	qi	liu
货车	huo	che
货郎	huo	lang
质子	zhi	zi
质朴无华	zhi	pu	wu	hua
质检	zhi	jian
贪大求全	tan	da	qiu	quan
贪大求洋	tan	da	qiu	yang
贪污犯	tan	wu	fan
贫困户	pin	kun	hu
贫困线	pin	kun	xian
贫弱	pin	ruo
贫民窟	pin	min	ku
贬义	bian	yi
贬值	bian	zhi
购买力	gou	mai	li
购价	gou	jia
贮备	zhu	bei
贮运	zhu	yun
贯串	guan	chuan
贲门	ben	men
贴心人	tie	xin	ren
贴画	tie	hua
贴金	tie	jin
贵国	gui	guo
贵州省	gui	zhou	sheng
贵金属	gui	jin	shu
贸促会	mao	cu	hui
贸易额	mao	yi	e
费事	fei	shi
费工	fei	gong
贺信	he	xin
贺函	he	han
贺年	he	nian
贺年片	he	nian	pian
贺电	he	dian
贺礼	he	li
贺辞	he	ci
贻误	yi	wu
资力	zi	li
资助	zi	zhu
资历	zi	li
资本论	zi	ben	lun
资财	zi	cai
赌具	du	ju
赎买	shu	mai
赎罪	shu	zui
赏识	shang	shi
赏赐	shang	ci
赘述	zhui	shu
赚头	zhuan	tou
赚头	zhuan	tou
赞语	zan	yu
赠书	zeng	shu
赠款	zeng	kuan
赡养	shan	yang
赢利	ying	li
赤卫队	chi	wei	dui
赤子	chi	zi
赤子之心	chi	zi	zhi	xin
赤峰	chi	feng
赤日炎炎	chi	ri	yan	yan
赤诚	chi	cheng
赤贫	chi	pin
赤道	chi	dao
赫哲族	he	zhe	zu
赫赫	he	he
走下坡路	zou	xia	po	lu
走失	zou	shi
走私犯	zou	si	fan
走道	zou	dao
走马看花	zou	ma	kan	hua
赵体	zhao	ti
赶到	gan	dao
赶时髦	gan	shi	mao
赶路	gan	lu
赶集	gan	ji
起义	qi	yi
起事	qi	shi
起价	qi	jia
起伏	qi	fu
起先	qi	xian
起名	qi	ming
起始	qi	shi
起居	qi	ju
起早摸黑	qi	zao	mo	hei
起火	qi	huo
起火	qi	huo
起用	qi	yong
起程	qi	cheng
起色	qi	se
起落架	qi	lao	jia
起落架	qi	luo	jia
起见	qi	jian
起跑	qi	pao
起跑线	qi	pao	xian
起运	qi	yun
起重	qi	zhong
趁势	chen	shi
超产	chao	chan
超低温	chao	di	wen
超低空	chao	di	kong
超值	chao	zhi
超声	chao	sheng
超声波	chao	sheng	bo
超导体	chao	dao	ti
超尘拔俗	chao	chen	ba	su
超市	chao	shi
超新星	chao	xin	xing
超期	chao	qi
超然物外	chao	ran	wu	wai
超级大国	chao	ji	da	guo
超音速	chao	yin	su
越剧	yue	ju
越境	yue	jing
越是	yue	shi
越狱	yue	yu
越界	yue	jie
越级	yue	ji
趋于	qu	yu
趋向	qu	xiang
趑趄	zi	ju
趣事	qu	shi
足下	zu	xia
足球队	zu	qiu	dui
跃跃欲试	yue	yue	yu	shi
跃进	yue	jin
跋山涉水	ba	shan	she	shui
跟头	gen	tou
跨上	kua	shang
跨国	kua	guo
跨年度	kua	nian	du
跪倒	gui	dao
路卡	lu	ka
路卡	lu	qia
路基	lu	ji
路透社	lu	tou	she
路风	lu	feng
跳马	tiao	ma
跷蹊	qiao	qi
踌躇	chou	chu
踟蹰	chi	chu
踪迹	zong	ji
踯躅	zhi	zhu
踽踽	ju	ju
蹀躞	die	xie
蹊径	xi	jing
蹭蹬	ceng	deng
蹼泳	pu	yong
身世	shen	shi
身亡	shen	wang
身分	shen	fen
身受	shen	shou
身后	shen	hou
身姿	shen	zi
身孕	shen	yun
身家	shen	jia
身手	shen	shou
身教	shen	jiao
身长	shen	chang
躯干	qu	gan
躲躲闪闪	duo	duo	shan	shan
车体	che	ti
车床	che	chuang
车皮	che	pi
车组	che	zu
车辙	che	zhe
轧制	ya	zhi
轧辊	zha	gun
轩轾	xuan	zhi
转业	zhuan	ye
转会	zhuan	hui
转体	zhuan	ti
转卖	zhuan	mai
转向	zhuan	xiang
转向	zhuan	xiang
转嫁	zhuan	jia
转干	zhuan	gan
转干	zhuan	gan
转机	zhuan	ji
转来转去	zhuan	lai	zhuan	qu
转正	zhuan	zheng
转炉	zhuan	lu
转用	zhuan	yong
转瞬间	zhuan	shun	jian
转赠	zhuan	zeng
转车	zhuan	che
转运站	zhuan	yun	zhan
转述	zhuan	shu
轮渡	lun	du
轮训	lun	xun
软弱无力	ruan	ruo	wu	li
软着陆	ruan	zhuo	lu
轰击	hong	ji
轰动一时	hong	dong	yi	shi
轰响	hong	xiang
轰炸机	hong	zha	ji
轻信	qing	xin
轻取	qing	qu
轻型	qing	xing
轻如鸿毛	qing	ru	hong	mao
轻工业	qing	gong	ye
轻武器	qing	wu	qi
轻生	qing	sheng
轻纺	qing	fang
轻视	qing	shi
轻音乐	qing	yin	yue
轻风	qing	feng
轻骑	qing	qi
载货	zai	huo
轿夫	jiao	fu
轿子	jiao	zi
轿子	jiao	zi
较之	jiao	zhi
较差	jiao	cha
辅导员	fu	dao	yuan
辈出	bei	chu
辈分	bei	fen
辈分	bei	fen
辉映	hui	ying
辑录	ji	lu
输卵管	shu	luan	guan
输家	shu	jia
输油管	shu	you	guan
输液	shu	ye
输电	shu	dian
输电线	shu	dian	xian
输血	shu	xue
辖区	xia	qu
辘轳	lu	lu
辛未	xin	wei
辞书	ci	shu
辞典	ci	dian
辞行	ci	xing
辨析	bian	xi
辨证	bian	zheng
辨识	bian	shi
辩护人	bian	hu	ren
辩解	bian	jie
辩证法	bian	zheng	fa
边区	bian	qu
边城	bian	cheng
边寨	bian	zhai
边民	bian	min
边界	bian	jie
边界线	bian	jie	xian
边线	bian	xian
边角料	bian	jiao	liao
边远	bian	yuan
边际	bian	ji
辽宁省	liao	ning	sheng
辽远	liao	yuan
达尔文	da	er	wen
达观	da	guan
迁徙	qian	xi
迂缓	yu	huan
过五关	guo	wu	guan
过人	guo	ren
过冬	guo	dong
过境	guo	jing
过大	guo	da
过失	guo	shi
过往	guo	wang
过得硬	guo	de	ying
过得硬	guo	de	ying
过快	guo	kuai
过敏	guo	min
过时	guo	shi
过来人	guo	lai	ren
过激	guo	ji
过火	guo	huo
过眼烟云	guo	yan	yan	yun
过硬	guo	ying
过秤	guo	cheng
过细	guo	xi
过街老鼠	guo	jie	lao	shu
过路	guo	lu
过路人	guo	lu	ren
过道	guo	dao
迈进	mai	jin
迎击	ying	ji
迎头赶上	ying	tou	gan	shang
迎宾曲	ying	bin	qu
迎宾馆	ying	bin	guan
迎送	ying	song
运力	yun	li
运动员	yun	dong	yuan
运动场	yun	dong	chang
运动战	yun	dong	zhan
运动衣	yun	dong	yi
运动量	yun	dong	liang
运动队	yun	dong	dui
运动鞋	yun	dong	xie
运斤成风	yun	jin	cheng	feng
运筹帷幄	yun	chou	wei	wo
运输机	yun	shu	ji
运输线	yun	shu	xian
运输费	yun	shu	fei
运销	yun	xiao
近些年	jin	xie	nian
近代史	jin	dai	shi
近在眉睫	jin	zai	mei	jie
近处	jin	chu
近处	jin	chu
近年	jin	nian
近日	jin	ri
近来	jin	lai
近海	jin	hai
近程	jin	cheng
近视眼	jin	shi	yan
返乡	fan	xiang
返修	fan	xiu
返销	fan	xiao
返销粮	fan	xiao	liang
返青	fan	qing
还乡	hai	xiang
还乡	huan	xiang
还愿	huan	yuan
还手	huan	shou
还清	huan	qing
这一下	zhe	yi	xia
这一来	zhe	yi	lai
这会儿	zhe	hui	er
这会儿	zhe	hui	er
这就是说	zhe	jiu	shi	shuo
进一步	jin	yi	bu
进一步	jin	yi	bu
进京	jin	jing
进出口	jin	chu	kou
进化论	jin	hua	lun
进发	jin	fa
进取	jin	qu
进口税	jin	kou	shui
进口货	jin	kou	huo
进城	jin	cheng
进士	jin	shi
进犯	jin	fan
进行曲	jin	xing	qu
进言	jin	yan
进贡	jin	gong
进逼	jin	bi
进项	jin	xiang
进食	jin	shi
远古	yuan	gu
远望	yuan	wang
远洋	yuan	yang
远涉重洋	yuan	she	chong	yang
远游	yuan	you
远离	yuan	li
远行	yuan	xing
远见	yuan	jian
远远	yuan	yuan
远销	yuan	xiao
违例	wei	li
违宪	wei	xian
违犯	wei	fan
违禁品	wei	jin	pin
违纪	wei	ji
连云港	lian	yun	gang
连任	lian	ren
连作	lian	zuo
连同	lian	tong
连环	lian	huan
连环画	lian	huan	hua
连用	lian	yong
连续不断	lian	xu	bu	duan
连绵	lian	mian
连衣裙	lian	yi	qun
连轴转	lian	zhou	zhuan
连连	lian	lian
连通	lian	tong
连部	lian	bu
连锁反应	lian	suo	fan	ying
连队	lian	dui
连阴雨	lian	yin	yu
迤逦	yi	li
迥然不同	jiong	ran	bu	tong
迪斯尼	di	si	ni
迪斯科	di	si	ke
迫击炮	pai	ji	pao
迭起	die	qi
述职	shu	zhi
述评	shu	ping
迷彩服	mi	cai	fu
迷漫	mi	man
追击	zhui	ji
追悼会	zhui	dao	hui
追肥	zhui	fei
追记	zhui	ji
追述	zhui	shu
退休金	tui	xiu	jin
退位	tui	wei
退守	tui	shou
退居	tui	ju
退换	tui	huan
送人情	song	ren	qing
适中	shi	zhong
适于	shi	yu
适宜	shi	yi
适应性	shi	ying	xing
适应症	shi	ying	zheng
适时	shi	shi
适用	shi	yong
适用性	shi	yong	xing
适销	shi	xiao
适龄	shi	ling
选举权	xuan	ju	quan
选修课	xuan	xiu	ke
选区	xuan	qu
选择题	xuan	ze	ti
选曲	xuan	qu
选本	xuan	ben
选段	xuan	duan
选矿	xuan	kuang
选种	xuan	zhong
选聘	xuan	pin
选育	xuan	yu
选读	xuan	du
选调	xuan	diao
选集	xuan	ji
透镜	tou	jing
逐一	zhu	yi
逐个	zhu	ge
逐级	zhu	ji
递补	di	bu
途经	tu	jing
通例	tong	li
通信员	tong	xin	yuan
通史	tong	shi
通商	tong	shang
通明	tong	ming
通晓	tong	xiao
通栏	tong	lan
通气	tong	qi
通用性	tong	yong	xing
通畅	tong	chang
通称	tong	cheng
通统	tong	tong
通缉	tong	ji
通航	tong	hang
通衢	tong	qu
通观	tong	guan
通讯员	tong	xun	yuan
通讯网	tong	xun	wang
通译	tong	yi
通货	tong	huo
通路	tong	lu
通辽	tong	liao
通通	tong	tong
通邮	tong	you
逝世	shi	shi
逞凶	cheng	xiong
速射	su	she
速成	su	cheng
速滑	su	hua
造反	zao	fan
造就	zao	jiu
造影	zao	ying
造物主	zao	wu	zhu
造纸厂	zao	zhi	chang
造诣	zao	yi
逡巡	qun	xun
逢年过节	feng	nian	guo	jie
逶迤	wei	yi
逸事	yi	shi
逸闻	yi	wen
逼人	bi	ren
逼和	bi	he
逼近	bi	jin
逾期	yu	qi
逾越	yu	yue
遁词	dun	ci
遇刺	yu	ci
遇险	yu	xian
遍及	bian	ji
遍地	bian	di
遏止	e	zhi
遐迩闻名	xia	er	wen	ming
道人	dao	ren
道光	dao	guang
道口	dao	kou
道士	dao	shi
道家	dao	jia
道岔	dao	cha
道班	dao	ban
遗书	yi	shu
遗传学	yi	chuan	xue
遗传性	yi	chuan	xing
遗体	yi	ti
遗作	yi	zuo
遗像	yi	xiang
遗址	yi	zhi
遗失	yi	shi
遗孤	yi	gu
遗容	yi	rong
遗弃	yi	qi
遗志	yi	zhi
遗愿	yi	yuan
遗物	yi	wu
遗训	yi	xun
遗迹	yi	ji
遗风	yi	feng
遥感	yao	gan
遥遥	yao	yao
遭遇战	zao	yu	zhan
遮羞布	zhe	xiu	bu
遮阳	zhe	yang
避孕药	bi	yun	yao
避实击虚	bi	shi	ji	xu
避实就虚	bi	shi	jiu	xu
避暑	bi	shu
避雷针	bi	lei	zhen
避风港	bi	feng	gang
邀集	yao	ji
邓小平	deng	xiao	ping
邢台	xing	tai
那会儿	na	hui	er
那会儿	na	hui	er
那时快	na	shi	kuai
邪气	xie	qi
邪说	xie	shuo
邪路	xie	lu
邮展	you	zhan
邮政局	you	zheng	ju
邮电	you	dian
邮电局	you	dian	ju
邮筒	you	tong
邮编	you	bian
邮袋	you	dai
邮资	you	zi
邮路	you	lu
邮车	you	che
邮递员	you	di	yuan
邻县	lin	xian
邻近	lin	jin
邻里	lin	li
郊游	jiao	you
部下	bu	xia
部优	bu	you
部委	bu	wei
部属	bu	shu
部族	bu	zu
部类	bu	lei
部级	bu	ji
郭沫若	guo	mo	ruo
都城	du	cheng
鄂豫皖	e	yu	wan
鄙夷	bi	yi
鄙薄	bi	bo
鄙陋	bi	lou
酋长国	qiu	zhang	guo
配制	pei	zhi
酒会	jiu	hui
酒精	jiu	jing
酒菜	jiu	cai
酣睡	han	shui
酥油	su	you
酥油茶	su	you	cha
酩酊	ming	ding
酬金	chou	jin
醍醐	ti	hu
采伐	cai	fa
采掘	cai	jue
采石	cai	shi
采购员	cai	gou	yuan
采风	cai	feng
释义	shi	yi
释文	shi	wen
释疑	shi	yi
里外	li	wai
里手	li	shou
里程	li	cheng
里程碑	li	cheng	bei
里里外外	li	li	wai	wai
重任	zhong	ren
重兵	zhong	bing
重利	zhong	li
重剑	zhong	jian
重印	chong	yin
重地	zhong	di
重型	zhong	xing
重奖	zhong	jiang
重工业	zhong	gong	ye
重心	zhong	xin
重武器	zhong	wu	qi
重油	zhong	you
重洋	chong	yang
重炮	zhong	pao
重物	zhong	wu
重重叠叠	chong	chong	die	die
重金属	zhong	jin	shu
野史	ye	shi
野战军	ye	zhan	jun
野猪	ye	zhu
野鸡	ye	ji
量刑	liang	xing
量力	liang	li
量变	liang	bian
金不换	jin	bu	huan
金不换	jin	bu	huan
金丝猴	jin	si	hou
金光闪闪	jin	guang	shan	shan
金刚石	jin	gang	shi
金发	jin	fa
金发	jin	fa
金文	jin	wen
金星	jin	xing
金灿灿	jin	can	can
金石	jin	shi
金矿	jin	kuang
金秋	jin	qiu
金笔	jin	bi
金箔	jin	bo
金质	jin	zhi
金门	jin	men
金鸡	jin	ji
鉴定会	jian	ding	hui
鉴戒	jian	jie
鉴赏力	jian	shang	li
针剂	zhen	ji
针头	zhen	tou
针头线脑	zhen	tou	xian	nao
针对性	zhen	dui	xing
针眼	zhen	yan
针线	zhen	xian
针线	zhen	xian
针织	zhen	zhi
针织品	zhen	zhi	pin
钟声	zhong	sheng
钟点	zhong	dian
钢丝绳	gang	si	sheng
钢材	gang	cai
钢枪	gang	qiang
钢渣	gang	zha
钢笔	gang	bi
钢筋铁骨	gang	jin	tie	gu
钢花	gang	hua
钦差大臣	qin	chai	da	chen
钱学森	qian	xue	sen
钱币	qian	bi
钱庄	qian	zhuang
钳制	qian	zhi
钳子	qian	zi
钳工	qian	gong
钻井队	zuan	jing	dui
钻塔	zuan	ta
钻机	zuan	ji
钻空子	zuan	kong	zi
钻空子	zuan	kong	zi
铁丝网	tie	si	wang
铁合金	tie	he	jin
铁心	tie	xin
铁树开花	tie	shu	kai	hua
铁桥	tie	qiao
铁水	tie	shui
铁流	tie	liu
铁索桥	tie	suo	qiao
铁路局	tie	lu	ju
铁路桥	tie	lu	qiao
铁道兵	tie	dao	bing
铁锨	tie	xian
铁骑	tie	qi
铅印	qian	yin
铅字	qian	zi
铅球	qian	qiu
铜像	tong	xiang
铜器	tong	qi
铜板	tong	ban
铜管乐	tong	guan	le
铜管乐	tong	guan	yue
铠甲	kai	jia
铭文	ming	wen
铮铮	zheng	zheng
铮铮铁骨	zheng	zheng	tie	gu
铲车	chan	che
铲除	chan	chu
铴锣	tang	luo
银元	yin	yuan
银发	yin	fa
银团	yin	tuan
银奖	yin	jiang
银币	yin	bi
银河系	yin	he	xi
银灰色	yin	hui	se
银耳	yin	er
银行业	yin	hang	ye
银行家	yin	hang	jia
银质奖	yin	zhi	jiang
铸件	zhu	jian
铸成	zhu	cheng
铸成大错	zhu	cheng	da	cuo
铺路石	pu	lu	shi
铺轨	pu	gui
链子	lian	zi
链子	lian	zi
链球菌	lian	qiu	jun
销价	xiao	jia
销假	xiao	jia
销售一空	xiao	shou	yi	kong
销售一空	xiao	shou	yi	kong
销售额	xiao	shou	e
销货	xiao	huo
销路	xiao	lu
销铄	xiao	shuo
锄头	chu	tou
锄头	chu	tou
锈蚀	xiu	shi
锒铛	lang	dang
错事	cuo	shi
错失	cuo	shi
锡伯族	xi	bo	zu
锣鼓喧天	luo	gu	xuan	tian
锥处囊中	zhui	chu	nang	zhong
锥形	zhui	xing
锦州	jin	zhou
锦旗	jin	qi
锦标赛	jin	biao	sai
锦绣	jin	xiu
锦绣前程	jin	xiu	qian	cheng
锦西	jin	xi
锭子	ding	zi
键入	jian	ru
锻压	duan	ya
镆铘	mo	ye
镇痛	zhen	tong
镇纸	zhen	zhi
镐头	gao	tou
镐头	gao	tou
镜像	jing	xiang
镜框	jing	kuang
长一智	zhang	yi	zhi
长假	chang	jia
长剑	chang	jian
长势	zhang	shi
长叹	chang	tan
长官	zhang	guan
长年	chang	nian
长成	zhang	cheng
长方形	chang	fang	xing
长明灯	chang	ming	deng
长椅	chang	yi
长河	chang	he
长法	chang	fa
长白山	chang	bai	shan
长眠	chang	mian
长矛	chang	mao
长笛	chang	di
长衫	chang	shan
长袍	chang	pao
长话	chang	hua
门外汉	men	wai	han
门将	men	jiang
门市部	men	shi	bu
门框	men	kuang
门牌	men	pai
门联	men	lian
门脸	men	lian
闪光灯	shan	guang	deng
闪动	shan	dong
闪失	shan	shi
闭会	bi	hui
闭幕式	bi	mu	shi
闭幕词	bi	mu	ci
闭目塞听	bi	mu	se	ting
闭门羹	bi	men	geng
问及	wen	ji
问好	wen	hao
问讯	wen	xun
问询	wen	xun
问鼎	wen	ding
闯劲	chuang	jin
闲事	xian	shi
闲置	xian	zhi
闲话	xian	hua
间不容发	jian	bu	rong	fa
间作	jian	zuo
间断	jian	duan
间架	jian	jia
间距	jian	ju
间隙	jian	xi
闷气	men	qi
闷气	men	qi
闹市	nao	shi
闹市区	nao	shi	qu
闻名	wen	ming
闻讯而来	wen	xun	er	lai
阀阅	fa	yue
阅兵	yue	bing
阅兵式	yue	bing	shi
阅览室	yue	lan	shi
阉割	yan	ge
阑尾炎	lan	wei	yan
阑干	lan	gan
队旗	dui	qi
队部	dui	bu
队长	dui	chang
队长	dui	zhang
防冻	fang	dong
防务	fang	wu
防化兵	fang	hua	bing
防卫	fang	wei
防护林	fang	hu	lin
防旱	fang	han
防汛	fang	xun
防治	fang	zhi
防波堤	fang	bo	di
防灾	fang	zai
防盗	fang	dao
防空洞	fang	kong	dong
防腐	fang	fu
防腐剂	fang	fu	ji
防震	fang	zhen
防风林	fang	feng	lin
阳萎	yang	wei
阴云	yin	yun
阴凉	yin	liang
阴性	yin	xing
阴暗面	yin	an	mian
阴道	yin	dao
阴雨连绵	yin	yu	lian	mian
阵势	zhen	shi
阵地战	zhen	di	zhan
阶下囚	jie	xia	qiu
阶梯	jie	ti
阶级性	jie	ji	xing
阶级斗争	jie	ji	dou	zheng
阻击	zu	ji
阻击战	zu	ji	zhan
阻截	zu	jie
阻滞	zu	zhi
阿盟	a	meng
陀螺	tuo	luo
陂陀	po	tuo
附中	fu	zhong
附件	fu	jian
附则	fu	ze
附加税	fu	jia	shui
附和	fu	he
附小	fu	xiao
附属物	fu	shu	wu
附庸	fu	yong
附录	fu	lu
附有	fu	you
附注	fu	zhu
附着物	fu	zhuo	wu
附言	fu	yan
附设	fu	she
际遇	ji	yu
陆上	lu	shang
陆战队	lu	zhan	dui
陆海空	lu	hai	kong
陈腐	chen	fu
陈迹	chen	ji
陋室	lou	shi
陌生人	mo	sheng	ren
降水量	jiang	shui	liang
降生	jiang	sheng
降职	jiang	zhi
降落伞	jiang	luo	san
降龙伏虎	xiang	long	fu	hu
限价	xian	jia
限期	xian	qi
限止	xian	zhi
陕甘宁	shan	gan	ning
陕西省	shan	xi	sheng
院墙	yuan	qiang
院士	yuan	shi
院子	yuan	zi
院校	yuan	xiao
除去	chu	qu
除名	chu	ming
除夕	chu	xi
除此以外	chu	ci	yi	wai
除法	chu	fa
陨星	yun	xing
险境	xian	jing
险峰	xian	feng
险恶	xian	e
险滩	xian	tan
险胜	xian	sheng
险象	xian	xiang
险阻	xian	zu
陪审员	pei	shen	yuan
陶器	tao	qi
陷于	xian	yu
随员	sui	yuan
随机性	sui	ji	xing
隐匿	yin	ni
隐忧	yin	you
隐晦	yin	hui
隐现	yin	xian
隐约	yin	yue
隐约可见	yin	yue	ke	jian
隐讳	yin	hui
障碍物	zhang	ai	wu
隶书	li	shu
难事	nan	shi
难以忘怀	nan	yi	wang	huai
难友	nan	you
难堪	nan	kan
雄关	xiong	guan
雄师	xiong	shi
雄赳赳	xiong	jiu	jiu
雄鸡	xiong	ji
雅加达	ya	jia	da
集中制	ji	zhong	zhi
集中营	ji	zhong	ying
集会	ji	hui
集体化	ji	ti	hua
集体舞	ji	ti	wu
集团军	ji	tuan	jun
集大成	ji	da	cheng
集子	ji	zi
集子	ji	zi
集市	ji	shi
集成度	ji	cheng	du
集成电路	ji	cheng	dian	lu
集散	ji	san
集权	ji	quan
集约	ji	yue
集结	ji	jie
集聚	ji	ju
集装箱	ji	zhuang	xiang
集训队	ji	xun	dui
集资	ji	zi
集邮	ji	you
集锦	ji	jin
集镇	ji	zhen
雇佣	gu	yong
雇佣军	gu	yong	jun
雇工	gu	gong
雨具	yu	ju
雨季	yu	ji
雨滴	yu	di
雨花石	yu	hua	shi
雨衣	yu	yi
雨露	yu	lu
雪原	xue	yuan
雪夜	xue	ye
雪峰	xue	feng
雪水	xue	shui
雪泥鸿爪	xue	ni	hong	zhao
零乱	ling	luan
零售商	ling	shou	shang
零售店	ling	shou	dian
零售额	ling	shou	e
零头	ling	tou
零打碎敲	ling	da	sui	qiao
零时	ling	shi
零花钱	ling	hua	qian
零部件	ling	bu	jian
零配件	ling	pei	jian
雷击	lei	ji
雷声大	lei	sheng	da
雷电交加	lei	dian	jiao	jia
雷达站	lei	da	zhan
雷阵雨	lei	zhen	yu
雾气	wu	qi
需求量	xu	qiu	liang
震中	zhen	zhong
震天	zhen	tian
震天动地	zhen	tian	dong	di
震情	zhen	qing
震级	zhen	ji
霉变	mei	bian
霉菌	mei	jun
霎时	sha	shi
霏霏	fei	fei
霜期	shuang	qi
露天矿	lu	tian	kuang
霸权主义	ba	quan	zhu	yi
霸王别姬	ba	wang	bie	ji
青丝	qing	si
青云	qing	yun
青云直上	qing	yun	zhi	shang
青光眼	qing	guang	yan
青史	qing	shi
青壮年	qing	zhuang	nian
青天	qing	tian
青少年	qing	shao	nian
青山绿水	qing	shan	lv	shui
青工	qing	gong
青年人	qing	nian	ren
青年团	qing	nian	tuan
青年宫	qing	nian	gong
青春期	qing	chun	qi
青松	qing	song
青海湖	qing	hai	hu
青海省	qing	hai	sheng
青灰	qing	hui
青石	qing	shi
青稞	qing	ke
青翠	qing	cui
青翠欲滴	qing	cui	yu	di
青色	qing	se
青苗	qing	miao
青草	qing	cao
青衣	qing	yi
青霉素	qing	mei	su
青青	qing	qing
青面獠牙	qing	mian	liao	ya
静寂	jing	ji
静悄悄	jing	qiao	qiao
静止	jing	zhi
静物	jing	wu
静电	jing	dian
静穆	jing	mu
非人	fei	ren
非暴力	fei	bao	li
非正式	fei	zheng	shi
非法所得	fei	fa	suo	de
非金属	fei	jin	shu
靠山吃山	kao	shan	chi	shan
靠水吃水	kao	shui	chi	shui
靠背	kao	bei
面世	mian	shi
面交	mian	jiao
面授	mian	shou
面无人色	mian	wu	ren	se
面目一新	mian	mu	yi	xin
面目一新	mian	mu	yi	xin
面筋	mian	jin
面议	mian	yi
面面观	mian	mian	guan
面食	mian	shi
革命军	ge	ming	jun
革命化	ge	ming	hua
革命家	ge	ming	jia
革命者	ge	ming	zhe
革故鼎新	ge	gu	ding	xin
革除	ge	chu
靶子	ba	zi
靶机	ba	ji
鞋子	xie	zi
鞋子	xie	zi
鞋带	xie	dai
鞍鞯	an	jian
鞭子	bian	zi
鞭子	bian	zi
鞭辟入里	bian	pi	ru	li
鞲鞴	gou	bei
韧性	ren	xing
音乐会	yin	yue	hui
音乐厅	yin	yue	ting
音乐家	yin	yue	jia
音乐界	yin	yue	jie
音像	yin	xiang
音响	yin	xiang
音域	yin	yu
音容笑貌	yin	rong	xiao	mao
音箱	yin	xiang
音色	yin	se
音质	yin	zhi
音速	yin	su
音阶	yin	jie
音韵	yin	yun
页码	ye	ma
顶住	ding	zhu
顶点	ding	dian
顶牛	ding	niu
顶风	ding	feng
顷刻	qing	ke
项羽	xiang	yu
顺义	shun	yi
顺口溜	shun	kou	liu
顺延	shun	yan
顺治	shun	zhi
顺风耳	shun	feng	er
顽固派	wan	gu	pai
顽症	wan	zheng
顾全	gu	quan
顾及	gu	ji
顾忌	gu	ji
预付款	yu	fu	kuan
预制	yu	zhi
预制板	yu	zhi	ban
预备役	yu	bei	yi
预备队	yu	bei	dui
预审	yu	shen
预展	yu	zhan
预应力	yu	ying	li
预支	yu	zhi
预演	yu	yan
预热	yu	re
预示	yu	shi
预科	yu	ke
预置	yu	zhi
预见	yu	jian
预见性	yu	jian	xing
预言	yu	yan
预订	yu	ding
预购	yu	gou
颅骨	lu	gu
领事	ling	shi
领事馆	ling	shi	guan
领养	ling	yang
领到	ling	dao
领受	ling	shou
领路	ling	lu
颇为	po	wei
颉颃	xie	hang
颐和园	yi	he	yuan
频带	pin	dai
颓势	tui	shi
题写	ti	xie
题名	ti	ming
题字	ti	zi
题诗	ti	shi
题跋	ti	ba
颜体	yan	ti
额定	e	ding
颞颥	nie	ru
颟顸	man	han
颠簸	dian	bo
颠覆	dian	fu
颤巍巍	chan	wei	wei
风云	feng	yun
风云人物	feng	yun	ren	wu
风云变幻	feng	yun	bian	huan
风俗画	feng	su	hua
风势	feng	shi
风化	feng	hua
风口	feng	kou
风吹日晒	feng	chui	ri	shai
风声	feng	sheng
风姿	feng	zi
风帆	feng	fan
风景区	feng	jing	qu
风景如画	feng	jing	ru	hua
风景画	feng	jing	hua
风沙	feng	sha
风洞	feng	dong
风湿病	feng	shi	bing
风箱	feng	xiang
风蚀	feng	shi
风行	feng	xing
风速	feng	su
风雪交加	feng	xue	jiao	jia
风风火火	feng	feng	huo	huo
风风雨雨	feng	feng	yu	yu
风驰电掣	feng	chi	dian	che
飘浮	piao	fu
飘渺	piao	miao
飞机场	fei	ji	chang
飞机票	fei	ji	piao
飞毛腿	fei	mao	tui
飞腾	fei	teng
飞舞	fei	wu
飞行器	fei	xing	qi
飞越	fei	yue
食品	shi	pin
食客	shi	ke
食宿	shi	su
食油	shi	you
食物链	shi	wu	lian
食用	shi	yong
食盐	shi	yan
食管	shi	guan
食粮	shi	liang
食糖	shi	tang
食言	shi	yan
食道	shi	dao
食量	shi	liang
餐馆	can	guan
饥民	ji	min
饥馑	ji	jin
饭钱	fan	qian
饭锅	fan	guo
饮品	yin	pin
饮片	yin	pian
饮用	yin	yong
饮用水	yin	yong	shui
饰演	shi	yan
饰物	shi	wu
饲养员	si	yang	yuan
饲草	si	cao
饽饽	bo	bo
饽饽	bo	bo
首例	shou	li
首倡	shou	chang
首富	shou	fu
首尾	shou	wei
首府	shou	fu
首日封	shou	ri	feng
首演	shou	yan
首长	shou	zhang
香喷喷	xiang	pen	pen
香椿	xiang	chun
香槟酒	xiang	bin	jiu
香气	xiang	qi
香油	xiang	you
香瓜	xiang	gua
香菜	xiang	cai
香蕉	xiang	jiao
馨香	xin	xiang
马克思	ma	ke	si
马刀	ma	dao
马匹	ma	pi
马头琴	ma	tou	qin
马德里	ma	de	li
马放南山	ma	fang	nan	shan
马灯	ma	deng
马赛克	ma	sai	ke
马铃薯	ma	ling	shu
马革裹尸	ma	ge	guo	shi
驯养	xun	yang
驯化	xun	hua
驰驱	chi	qu
驱使	qu	shi
驱逐舰	qu	zhu	jian
驱除	qu	chu
驳倒	bo	dao
驻守	zhu	shou
驻防	zhu	fang
驾驶员	jia	shi	yuan
驾驶室	jia	shi	shi
驾驶舱	jia	shi	cang
骁将	xiao	jiang
骂名	ma	ming
骄阳	jiao	yang
骄阳似火	jiao	yang	si	huo
骈体	pian	ti
验光	yan	guang
验方	yan	fang
验货	yan	huo
骐骥	qi	ji
骑士	qi	shi
骑手	qi	shou
骑车	qi	che
骑马	qi	ma
骡马	luo	ma
骤变	zhou	bian
骤起	zhou	qi
骨刺	gu	ci
骨朵	gu	duo
骨架	gu	jia
骨灰盒	gu	hui	he
骨碌	gu	lu
骨碌	gu	lu
骨科	gu	ke
骨骼	gu	ge
髑髅	du	lou
高个	gao	ge
高个子	gao	ge	zi
高个子	gao	ge	zi
高举	gao	ju
高产田	gao	chan	tian
高低杠	gao	di	gang
高分子	gao	fen	zi
高利	gao	li
高利贷	gao	li	dai
高加索	gao	jia	suo
高升	gao	sheng
高危	gao	wei
高压	gao	ya
高压电	gao	ya	dian
高压锅	gao	ya	guo
高地	gao	di
高坡	gao	po
高墙	gao	qiang
高寒	gao	han
高寿	gao	shou
高射炮	gao	she	pao
高小	gao	xiao
高山族	gao	shan	zu
高技术	gao	ji	shu
高效益	gao	xiao	yi
高教	gao	jiao
高材生	gao	cai	sheng
高校	gao	xiao
高楼大厦	gao	lou	da	sha
高歌猛进	gao	ge	meng	jin
高洁	gao	jie
高炉	gao	lu
高热	gao	re
高祖	gao	zu
高等教育	gao	deng	jiao	yu
高纬度	gao	wei	du
高见	gao	jian
高超	gao	chao
高足	gao	zu
高速	gao	su
高高低低	gao	gao	di	di
鬼子	gui	zi
鬼子	gui	zi
鬼话	gui	hua
魍魉	wang	liang
魏碑	wei	bei
魑魅	chi	mei
鱼水情	yu	shui	qing
鱼池	yu	chi
鱼群	yu	qun
鱼虾	yu	xia
鱼雷	yu	lei
鱼鳞	yu	lin
鱿鱼	you	yu
鲜卑	xian	bei
鲜果	xian	guo
鲜鱼	xian	yu
鲤鱼	li	yu
鲫鱼	ji	yu
鳝鱼	shan	yu
鸟尽弓藏	niao	jin	gong	cang
鸡肉	ji	rou
鸡舍	ji	she
鸡雏	ji	chu
鸣金收兵	ming	jin	shou	bing
鸭梨	ya	li
鸸鹋	li	miao
鸽子	ge	zi
鸽子	ge	zi
鸿雁	hong	yan
鸿鹄之志	hong	hu	zhi	zhi
鹅卵石	e	luan	shi
鹊巢鸠占	que	chao	jiu	zhan
鹦鹉学舌	ying	wu	xue	she
鹪鹩	jiao	liao
麝香	she	xiang
麦收	mai	shou
麦浪	mai	lang
麦田	mai	tian
麦秸	mai	jie
麦苗	mai	miao
麻利	ma	li
麻利	ma	li
麻布	ma	bu
麻绳	ma	sheng
麻醉品	ma	zui	pin
麻风	ma	feng
黄土地	huang	tu	di
黄埔	huang	pu
黄帝	huang	di
黄梅戏	huang	mei	xi
黄澄澄	huang	deng	deng
黄灿灿	huang	can	can
黄疸	huang	dan
黄花	huang	hua
黄褐色	huang	he	se
黄酒	huang	jiu
黄金时代	huang	jin	shi	dai
黄鳝	huang	shan
黎巴嫩	li	ba	nen
黎族	li	zu
黎民	li	min
黑乎乎	hei	hu	hu
黑匣子	hei	xia	zi
黑压压	hei	ya	ya
黑土	hei	tu
黑山	hei	shan
黑手党	hei	shou	dang
黑斑	hei	ban
黑板报	hei	ban	bao
黑洞洞	hei	dong	dong
黑猩猩	hei	xing	xing
黑社会	hei	she	hui
黑红	hei	hong
黑色素	hei	se	su
黑豆	hei	dou
黑黝黝	hei	you	you
黑龙江省	hei	long	jiang	sheng
黯淡	an	dan
鼎立	ding	li
鼓动	gu	dong
鼓劲	gu	jin
鼓手	gu	shou
鼓掌	gu	zhang
鼓起	gu	qi
鼓鼓囊囊	gu	gu	nang	nang
鼓鼓囊囊	gu	gu	nang	nang
鼠害	shu	hai
鼾声	han	sheng
齐刷刷	qi	shua	shua
齐名	qi	ming
齐步走	qi	bu	zou
齐白石	qi	bai	shi
齐集	qi	ji
齐鲁	qi	lu
龋齿	qu	chi
龙井茶	long	jing	cha
龙卷风	long	juan	feng
龙腾虎跃	long	teng	hu	yue
龙钟	long	zhong
龙骧虎步	long	xiang	hu	bu
