一下	yixx
一世	yiui
一世龙门	yulm
一个骨	yggu
一举	yiju
一了百当	ylbd
一仆一碌	ypyl
一介	yijp
一代	yidd
一代文宗	ydwz
一以当十	yydu
一传十	yiui
一体	yiti
一体同心	yttx
一傅众咻	yfvx
一元化	yyhx
一再	yizd
一刹那	yina
一刻	yike
一刻千金	ykqj
一前一后	yqyh
一半	yibj
一去不回	yqbh
一去不返	yqbf
一口价	ykjp
一口价	ykjx
一句话	yjhx
一只屐	yvji
一向	yixl
一味	yiww
一唱一和	yiyh
一啲	yidi
一块	yikk
一塌胡涂	ytht
一声令下	yulx
一夫当关万夫莫开	yfdk
一头烟	ytyj
一孔之见	ykvj
一字不苟	yzbg
一字之师	yzvu
一家子	yjzi
一寸丹心	ycdx
一对	yidv
一小撮	yxco
一展风采	yvfc
一己之私	yjvs
一带	yidd
一年到头	yndt
一式两份	yulf
一律	yilv
一德一心	ydyx
一心	yixb
一心一德	yxyd
一忍再忍	yrzr
一息尚存	yxuc
一手	yiuz
一把手	ybuz
一报还一报	ybhb
一担担	yddj
一拍两散	ypls
一撇嘢	ypye
一整套	yvtc
一无所成	ymsi
一无所成	ywsi
一日到黑	yrdh
一早	yizc
一时	yiui
一时时	yuui
一时间	yujm
一暴十寒	ypuh
一条心	ytxb
一来	yild
一枝公	yvgs
一气	yiqi
一水之隔	yuvg
一波又起	ybyq
一波未平	ybwp
一派	yipd
一流	yilq
一炮而红	ybeh
一炮而红	ypeh
一瓣心香	ybxx
一生	yiug
一番话	yfhx
一瘸一拐	yqyg
一盅两件	yvlj
一盘水	ypuv
一直	yivi
一相情愿	yxqy
一瞬间	yujm
一碧万顷	ybwq
一碧千里	ybql
一端	yidr
一级	yiji
一脉相承	ymxi
一脚踢	yjti
一般性	ybxk
一表人才	ybrc
一览表	ylbn
一角	yijn
一言一行	yyyx
一言堂	yyth
一语成谶	yyii
一身正气	yuvq
一身蚁	yuyi
一轮红日	ylhr
一边	yibm
一连	yilm
一连串	ylir
一针一线	yvyx
一镬熟	yhuu
一镬熟	yhuz
一面	yimm
一面之缘	ymvy
一颈血	ygxp
一颈血	ygxt
一颈血	yjxp
一颈血	yjxt
一馈十起	ykuq
一麟半爪	ylbv
一齐	yiqi
丁丑	dkiz
丁亥	dkhd
丁卯	dkmc
丁巳	dksi
丁未	dkww
丁酉	dkyz
丁香	dkxl
七一	qiyi
七七八八	qqbb
七国咁乱	qggl
七大	qida
七大	qidd
七巧板	qqbj
七年	qinm
七情上面	qqum
七成	qiig
七横八竖	qhbu
七步成诗	qbiu
七绝	qijt
万万	wjwj
万事	wjui
万事通	wuts
万嘱咐	wvfu
万夫不当	wfbd
万宝路	wblu
万家生佛	wjuf
万年	wjnm
万年青	wnqk
万念俱焚	wnjf
万木葱茏	wmcl
万死一生	wsyu
万水千山	wuqu
万物	wjwu
万物初醒	wwix
万物皆备于我	wwjw
万种	wjis
万种	wjvs
万籁	wjld
万里无云	wlwy
丈夫	vhfu
三伏	sjfu
三叉	sjia
三叉苏	sisu
三唔识七	swuq
三唔识七	swvq
三天打鱼两天晒网	stdw
三尖八角	sjbj
三幅被	sfbw
三幅被	sfpi
三废	sjfw
三座大山	szdu
三弦	sjxm
三扒两拨	sblb
三扒两拨	splb
三文治	swvi
三文鱼	swyu
三昧	sjmw
三民主义	smvy
三洋	sjyh
三粒星	slxk
三索	sjso
三维	sjww
三角洲	sjvz
上下班	uxbj
上下级	uxji
上不得台盘	ubdp
上乘	uhig
上书	uhuu
上任	uhrf
上冻	uhds
上告	uhgc
上品	uhpb
上善若水	uuru
上场	uhih
上契	uhqi
上契	uhxp
上好	uhhc
上家	uhjx
上尉	uhww
上届	uhjp
上山下乡	uuxx
上峰	uhfg
上工	uhgs
上昼	uhvz
上架	uhjx
上梁不正	ulbv
上水	uhuv
上溯	uhsu
上漏下湿	ulxu
上相	uhxl
上窜下跳	ucxt
上缴	uhjn
上肢	uhvi
上议院	uyyr
上访	uhfh
上蹿下跳	ucxt
上载	uhzd
上道	uhdc
上限	uhxm
上风	uhfg
下乡	xxxl
下人	xxrf
下任	xxrf
下低	xxdi
下功夫	xgfu
下地	xxdi
下工	xxgs
下扒	xxba
下扒	xxpa
下扒轻轻	xbqq
下扒轻轻	xpqq
下摆	xxbd
下放	xxfh
下水道	xudc
下滑	xxhx
下爬	xxpa
下级	xxji
下脚料	xjln
下蛋	xxdj
下议院	xyyr
下野	xxye
下限	xxxm
下陷	xxxm
下马威	xmww
不丹	budj
不为所动	bwsd
不乏	bufa
不仅仅	bjjb
不以为奇	bywj
不以为奇	bywq
不住	buvu
不依	buyi
不便	bubm
不值一文	bvyw
不再	buzd
不分皂白	bfzb
不列颠	bldm
不利	buli
不力	buli
不单	budj
不只	buvi
不可一世	bkyu
不可抗力	bkkl
不可收拾	bkuu
不可磨灭	bkmm
不可胜数	bkuu
不可计数	bkju
不可逾越	bkyy
不合	buhe
不同流俗	btls
不名一钱	bmyq
不周	buvz
不善	buuj
不定	budk
不对	budv
不已	buyi
不幸	buxk
不得善终	bduv
不得要领	bdyl
不忘沟壑	bwgh
不忠	buvs
不急之务	bjvw
不怨	buyr
不恭	bugs
不息	buxi
不恶而严	beey
不恶而严	bwey
不愧为	bkww
不愧屋漏	bkwl
不成方圆	bify
不扶自直	bfzv
不拘	buju
不教而杀	bjeu
不敢旁鹜	bgpw
不无遗憾	bmyh
不无遗憾	bwyh
不时	buui
不易	buyi
不易一字	byyz
不服	bufu
不期而然	bqer
不次之迁	bcvq
不止	buvi
不死不活	bsbh
不比	bubi
不求有功	bqyg
不法	bufa
不溜	bulq
不独	budu
不甘	bugj
不甘后人	bghr
不甘雌伏	bgcf
不甚了了	bull
不由得	byde
不畏	buww
不畏强暴	bwqb
不疾不徐	bjbx
不看	bukj
不眠	bumm
不着	buvc
不着	buve
不着	buvo
不瞒	bumj
不矜不伐	bgbf
不矜不伐	bjbf
不矜不伐	bqbf
不知其可	bvqk
不知去向	bvqx
不知肉味	bvrw
不确定性	bqdx
不禁	bujb
不移	buyi
不稳	buwf
不端	budr
不等式	bdui
不纯	buiy
不结盟	bjmg
不胜枚举	bumj
不能不	bnbu
不致	buvi
不致于	bvyu
不苟言笑	bgyx
不虞之誉	byvy
不见	bujm
不见泰山	bjtu
不解之缘	bjvy
不言而信	byex
不言自明	byzm
不语	buyu
不误	buwu
不谋而同	bmet
不谋而和	bmeh
不贞	buvf
不负	bufu
不足为怪	bzwg
不轨	bugv
不辞辛劳	bcxl
不辞辛苦	bcxk
不辱使命	brum
不远千里	byql
不适	buui
不通	buts
不道德	bdde
不避斧钺	bbfy
不锈钢	bxgh
不长	buih
不长	buvh
不间断	bjdr
不闻	buwf
不需	buxu
不露	bulu
不露	bulz
不靠	bukc
不须	buxu
不预则废	byzf
不食之地	bsvd
不食之地	buvd
不食之地	byvd
不食周粟	bsvs
不食周粟	buvs
不食周粟	byvs
不饮盗泉	bydq
不齿	buii
与之	yuvi
与人	yurf
与他	yuta
与会	yuhv
与你	yuni
与其	yuqi
与其说	yquo
与其说	yquv
与其说	yqyt
与年俱增	ynjz
与此	yuci
与此同时	yctu
丑事	izui
丑剧	izju
丑化	izhx
丑样	izyh
专一	vryi
专业化	vyhx
专业课	vyke
专为	vrww
专书	vruu
专利局	vlju
专利权	vlqr
专制	vrvi
专区	vrqu
专号	vrhc
专场	vrih
专攻	vrgs
专机	vrji
专款	vrkr
专治	vrvi
专电	vrdm
专稿	vrgc
专署	vruu
专著	vrvu
专门利人	vmlr
专集	vrji
且听	qptk
世上无难事只怕有心人	uumr
世上无难事只怕有心人	uuwr
世世代代	uudd
世事	uiui
世人	uirf
世代	uidd
世代相传	udxi
世俗	uisu
世务	uiwu
世博	uibo
世卫	uiww
世嘉	uijx
世家	uijx
世尊	uizy
世态	uitd
世情	uiqk
世故	uigu
世族	uizu
世界仔	ujzd
世界仔	ujzi
世界性	ujxk
世界杯	ujbw
世界语	ujyu
世相	uixl
世纪	uiji
世纪初	ujiu
世行	uihh
世行	uixk
世袭	uixi
世说新语	uuxy
世说新语	uyxy
世贸	uimc
世间	uijm
世面	uimm
丙午	bkwu
丙子	bkzi
丙寅	bkyb
丙戌	bkxu
丙申	bkuf
丙级	bkji
丙纶	bkly
丙辰	bkif
丙醇	bkiy
业大	yeda
业经	yejk
业障	yevh
丛书	csuu
丛刊	cskj
东东	dsds
东临	dslb
东乡	dsxl
东京	dsjk
东北风	dbfg
东吴	dswu
东头	dstz
东夷	dsyi
东宫	dsgs
东扶西倒	dfxd
东方欲晓	dfyx
东洋	dsyh
东经	dsjk
东芝	dsvi
东逃西散	dtxs
东道	dsdc
东道国	ddgo
东面	dsmm
东鳞西爪	dlxv
丝线	sixm
丝织	sivi
丝织品	svpb
丞相	igxl
丢卒保车	dzbj
丢生	dqug
丢面子	dmzi
两便	llbm
两头唔到岸	ltwa
两性	llxk
两抠	llkz
两极	llji
两栖	llqi
两睇	lldi
两重性	lixk
两面性	lmxk
两鬓	llbb
严严实实	yyuu
严于	yjyu
严于律己	yylj
严以律己宽以待人	yylr
严刑	yjxk
严历	yjli
严守	yjuz
严实	yjui
严寒	yjhj
严惩不贷	yibd
严整	yjvg
严正	yjvg
严气正性	yqvx
严词	yjci
严辞	yjci
丧事	shui
丧家之狗	sjvg
丧葬费	szfw
个个	gege
个人	gerf
个人主义	grvy
个人所得税	grsu
个体户	gthu
个唱	geih
个喎	gewd
个噃	gebo
个子	gezi
中下游	vxyz
中世纪	vuji
中伤	vsuh
中低档	vddh
中信	vsxb
中兴	vsxk
中农	vsns
中医师	vyui
中医院	vyyr
中华民国	vhmg
中南	vsnj
中卫	vsww
中原逐鹿	vyvl
中和	vshe
中国海	vghd
中国画	vghx
中国话	vghx
中坚	vsjm
中型	vsxk
中子	vszi
中宣部	vxbu
中将	vsjl
中小	vsxn
中小企	vxqi
中小型	vxxk
中小学校	vxxx
中小学生	vxxu
中山装	vuvl
中师	vsui
中年人	vnrf
中庸	vsys
中式	vsui
中成药	viyc
中指	vsvi
中日	vsri
中暑	vsuu
中标	vsbn
中止	vsvi
中法	vsfa
中流击楫	vljj
中用	vsys
中的	vsde
中看	vskj
中程	vsig
中空	vsks
中立	vsli
中立国	vlgo
中策	vsce
中篇	vspm
中纪委	vjww
中继	vsji
中继线	vjxm
中苏	vssu
中草药	vcyc
中药	vsyc
中药材	vycd
中行	vshh
中行	vsxk
中装	vsvl
中褛	vslv
中转	vsvr
中选	vsxr
中速	vssu
中间商	vjuh
中间派	vjpd
中队长	vdvh
中青年	vqnm
中风	vsfg
中饭	vsfj
中饱私囊	vbsn
中高级	vgji
丰产	fgij
丰台	fgtd
丰姿	fgzi
丰年	fgnm
丰沛	fgpw
丰裕	fgyu
丰采	fgcd
串连	irlm
串通	irts
临事而惧	luej
临场	lbih
临安	lban
临幸	lbxk
临时工	lugs
临江	lbjl
临沂	lbyi
临深履薄	lulb
临界点	ljdm
临老学吹打	llxd
临街	lbjp
临难不惧	lnbj
丹书	djuu
丹尼尔	dner
丹心	djxb
丹红	djhs
丹药	djyc
为之	wwvi
为伍	wwwu
为例	wwli
为公	wwgs
为名	wwmk
为咗	wwzo
为数	wwuu
为数不多	wubd
为数众多	wuvd
为时	wwui
为期	wwqi
为止	wwvi
为民请命	wmqm
为生	wwug
为由	wwyz
为皮	wwpi
为辅	wwfu
主义	vuyi
主人	vurf
主人公	vrgs
主人家	vrjx
主人翁	vrwg
主刑	vuxk
主力	vuli
主力军	vljy
主动性	vdxk
主动权	vdqr
主动脉	vdmd
主外	vuwd
主妇	vufu
主官	vugr
主客观	vkgr
主宰	vuzd
主将	vujl
主峰	vufg
主席团	vxtr
主心骨	vxgu
主意	vuyi
主战场	vvih
主持人	virf
主攻手	vguz
主教	vujn
主教练	vjlm
主旨	vuvi
主权国	vqgo
主板	vubj
主治	vuvi
主犯	vufj
主航道	vhdc
主见	vujm
主观主义	vgvy
主讲	vujl
主课	vuke
主轴	vuvz
主队	vudv
主题歌	vtge
主题词	vtci
主食	vuui
丽日临空	lrlk
丽水	liuv
举不胜举	jbuj
举世	juui
举人	jurf
举例	juli
举报人	jbrf
举杯	jubw
举步维艰	jbwj
举袖为云	jxwy
举重	juvs
乃是	ndui
久久	jqjq
久别重逢	jbif
久安	jqan
久居	jqju
久已	jqyi
久悬不决	jxbj
久拖不决	jtbj
久经	jqjk
久经沙场	jjui
久远	jqyr
义举	yiju
义乌	yiwu
义务兵	ywbk
义务教育	ywjy
义勇军	yyjy
义卖	yimd
义和团	yhtr
义士	yiui
义愤	yiff
义无返顾	ymfg
义无返顾	ywfg
义正词严	yvcy
义气	yiqi
义演	yiyj
义理	yili
之上	viuh
之下	vixx
之不过	vbgo
之久	vijq
之争	vivg
之余	viyu
之势	viui
之嘛	vima
之声	viug
之处	viiu
之嫌	vixm
之家	vijx
之情	viqk
之时	viui
之星	vixk
之最	vizv
之死靡它	vsmt
之称	viif
之称	viig
之窗	viil
之行	vihh
之行	vixk
之际	viji
乌云翻滚	wyfg
乌兹别克斯坦	wcbt
乌兹别克斯坦	wzbt
乌卒卒	wccu
乌卒卒	wczu
乌卒卒	wzcu
乌卒卒	wzzu
乌发	wufa
乌喱单刀	wldd
乌喱单刀	wlid
乌喱单刀	wlud
乌江	wujl
乌眉瞌睡	wmku
乌纱帽	wumc
乏力	fali
乐呵呵	lhhe
乐声	ytug
乐府	ytfu
乐滋滋	lzzi
乐舞	ytwu
乐融融	lrrs
乐音	ytyb
乒乓波	ppbo
乒乓球	ppqq
乒坛	pktj
乒铃唪唥	plfl
乔丹	qndj
乔治	qnvi
乖舛	gkir
乖迕	gkwu
乘兴	igxk
乘务员	iwyr
乘势	igui
乘员	igyr
乘数	iguu
乘机	igji
乘法	igfa
乘积	igji
乘长风破万里浪	iifl
乘长风破万里浪	ivfl
乘长风破万里浪	uifl
乘长风破万里浪	uvfl
乘除	igiu
乘隙	igxi
乘风破浪	ifpl
乙丑	yiiz
乙亥	yihd
乙卯	yimc
乙型	yixk
乙巳	yisi
乙未	yiww
乙烯	yixi
乙等	yidg
乙类	yilw
乙级	yiji
乙酉	yiyz
乙醇	yiiy
乜嘢话	myhx
乜嘢话	nyhx
乜滞	mpvi
乜滞	npvi
乜都假	mdjx
乜都假	ndjx
九九金	jjjb
九儒十丐	jrug
九唔搭八	jwdb
九大簋	jdgv
九尾狐	jwhu
九泉	jqqr
九泉之下	jqvx
九洲	jqvz
九牛二虎	jneh
乞人憎	qrzg
乞儿	qier
乞嗤	qiii
乞求	qiqq
乞浆得酒	qjdj
习习	xixi
习气	xiqi
乡下	xlxx
乡下人	xxrf
乡亲	xlqb
乡勇	xlys
乡巴佬	xblc
乡思	xlsi
乡级	xlji
乡邻	xllb
乡里	xlli
书名	uumk
书后	uuhz
书展	uuvj
书市	uuui
书报	uubc
书摘	uuvd
书架	uujx
书橱	uuiu
书法家	ufjx
书法展	ufvj
书目	uumu
书箱	uuxl
书记	uuji
书院	uuyr
书香	uuxl
买位	mdww
买壳	mdke
买壳	mdqn
买帐	mdvh
买方	mdfh
买春	mdiy
乱丢	lrdq
乱哄哄	lhhs
乱嗡	lrwg
乱象	lrxl
乱龙	lrls
乳业	ruye
乳晕	ruyy
乳白色	rbse
乳类	rulw
乳虎	ruhu
乸型	naxk
乾州	qmvz
了不得	lbde
了望	lewh
了望	lnwh
了结	lnjp
争办	vgbj
争当	vgdh
争执	vgvi
争斤论两	vjll
争权	vgqr
争气	vgqi
争相	vgxl
争胜	vgug
争衡	vghg
争论不休	vlbx
争鸣	vgmk
事不师古	ubug
事业心	uyxb
事主	uivu
事事	uiui
事例	uili
事先	uixm
事典	uidm
事务	uiwu
事后	uihz
事头	uitz
事头婆	utpo
事宜	uiyi
事实上	uuuh
事急马行田	ujmt
事无不可对人言	umby
事无不可对人言	uwby
事物	uiwu
事理	uili
事由	uiyz
事端	uidr
事过境迁	ugjq
事迹	uiji
事隔	uige
二人同心其利断金	ertj
二打六	edlq
二打六	edlu
二桃杀三士	etuu
二泉映月	eqyy
二门	ermf
于今	yujb
于归	yugv
于心何忍	yxhr
于是乎	yuhu
于此	yuci
亏得	kvde
云中白鹤	yvbh
云南省	ynug
云团	yytr
云母	yymu
云浮	yyfu
云消雨散	yxys
云端	yydr
云行雨施	yhyu
云行雨施	yxyu
云集	yyji
云雨	yyyu
云龙	yyls
互保	hubc
互利	huli
互助组	hvzu
互帮互学	hbhx
互换	huhr
互联网	hlwh
五一	wuyi
五保户	wbhu
五台山	wtuj
五味	wuww
五四	wusi
五官	wugr
五岳	wuyt
五指	wuvi
五星	wuxk
五笔	wubi
五笔加加	wbjj
五行	wuxk
五角大楼	wjdl
五角星	wjxk
五讲四美	wjsm
五谷	wugu
五金	wujb
五雷轰顶	wlhd
五黄六月	whly
井架	jkjx
亚东	yads
亚热带	yrdd
亚特兰大	ytld
亚视	yaui
亚运	yayy
亚运会	yyhv
亚运村	yycy
亚里士多德	ylud
亚马逊	ymxy
亚齐	yaqi
亡命	whmk
亡国	whgo
亡戟得矛	wjdm
交口	jnkz
交口称赞	jkiz
交响乐	jxyt
交响曲	jxqu
交响诗	jxui
交好	jnhc
交工	jngs
交底	jndi
交待	jndd
交心	jnxb
交情	jnqk
交手	jnuz
交换机	jhji
交接班	jjbj
交易会	jyhv
交更	jngg
交流会	jlhv
交火	jnho
交点	jndm
交班	jnbj
交电	jndm
交税	jnuv
交纳	jnna
交谊舞	jywu
交费	jnfw
交还	jnhr
交通线	jtxm
交通网	jtwh
交通费	jtfw
交道	jndc
交际	jnji
亦可	yike
亦然	yirj
亦算	yisr
产业界	iyjp
产妇	ijfu
亨利	hgli
享年	xlnm
享有盛誉	xyuy
享誉	xlyu
京东	jkds
京九	jkjq
京华	jkhx
京哈	jkha
京师	jkui
京广	jkgl
京戏	jkxi
京沪	jkhu
京胡	jkhu
京郊	jkjn
亮出	lliu
亮晶晶	ljjk
亮红灯	lhdg
亲事	qbui
亲传	qbir
亲传	qbvr
亲传	qkir
亲传	qkvr
亲兄弟	qxdi
亲切感	qqgj
亲如	qbru
亲如	qkru
亲如兄弟	qrxd
亲密无间	qmwj
亲手	qbuz
亲朋戚友	qpqy
亲民	qbmb
亲民	qkmb
亲痛仇快	qtik
亲笔信	qbxb
亲缘	qbyr
亲美	qbmw
亲美	qkmw
亳州	bovz
亵玩	xpwj
人不知	rbvi
人世	rfui
人世间	rujm
人为	rfww
人事	rfui
人事处	ruiu
人事局	ruju
人事部	rubu
人代会	rdhv
人伦	rfly
人力车	rlie
人名	rfmk
人命	rfmk
人哋	rfdi
人士	rfui
人声	rfug
人声喧哗	ruxh
人声嘈杂	rucz
人外有人	rwyr
人多手杂	rduz
人头涌涌	rtyy
人如潮涌	rriy
人尽可夫	rjkf
人工湖	rghu
人强马壮	rjmv
人强马壮	rqmv
人微权轻	rwqq
人心	rfxb
人心浮动	rxfd
人心涣散	rxhs
人心齐	rxqi
人手	rfuz
人手一册	ruyc
人数	rfuu
人有我有	rywy
人机	rfji
人梯	rfti
人次	rfci
人武部	rwbu
人氏	rfui
人治	rfvi
人物	rfwu
人物画	rwhx
人生观	rugr
人祸	rfho
人缘	rfyr
人证	rfvg
人质	rfvi
人贩	rffj
人身	rfuf
人造卫星	rzwx
人逢喜事精神爽	rfxu
亿万	yiwj
亿元	yiyr
什么样	umyh
什锦	uijb
仁义	rfyi
仁人志士	rrvu
仁川	rfir
仁心仁闻	rxrw
仁科	rfke
仁言利博	rylb
仅供	jbgs
仇口	izkz
仇口	qqkz
今人	jbrf
今冬	jbds
今春	jbiy
今译	jbyi
介子	jpzi
介绍人	jurf
介绍信	juxb
介词	jpci
介质	jpvi
介面	jpmm
仍有	rgyz
从从容容	ccrr
从化市	chui
从后	cshz
从命	csmk
从善如登	curd
从头至尾	ctvw
从师	csui
从恶如崩	cerb
从恶如崩	cwrb
从新	csxb
从未有过	cwyg
从艺	csyi
仓猝	chcu
仓鼠	chuu
仔乸	zdna
仔乸	zina
仔仔细细	zzxx
仔大仔世界	zdzj
仔猪	zivu
仔细老婆嫩	zxln
仕女	uinv
他乡	taxl
他们	tamf
付之东流	fvdl
付印	fuyb
付帐	fuvh
付账	fuvh
付费	fufw
仙人	xmrf
仙人掌	xrvh
仙境	xmjk
仙姿玉貌	xzym
仙童	xmts
仙逝	xmui
仙都唔仙下	xdwx
仙鹤	xmhe
仟眠	qmmm
代之	ddvi
代名词	dmci
代培	ddpw
代序	ddxu
代数	dduu
代理人	dlrf
代用品	dypb
代职	ddvi
代表团	dbtr
代表性	dbxk
代购	ddgz
令人注目	lrvm
以一当十	yydu
以东	yids
以儆效尤	yjxy
以北	yibw
以南	yinj
以外	yiwd
以太	yitd
以太网	ytwh
以少胜多	yuud
以往	yiwh
以德报德	ydbd
以文会友	ywhy
以文会友	ywky
以期	yiqi
以来	yild
以此	yici
以沫相濡	ymxr
以泪洗面	ylxm
以疏间亲	yujq
以直报怨	yvby
以简驭繁	yjyf
以绝后患	yjhh
以至	yivi
以至于	yvyu
以致	yivi
以蠡测海	ylch
以西	yixi
仪仗	yivh
仪仗队	yvdv
仪器	yiqi
仪式	yiui
仰不愧天	ybkt
仰屋着书	ywvu
仲夏	vsxx
仲尼	vsni
仲涛	vstc
仳离	pili
仵工	wugs
价值观	jvgr
价码	jxma
任君	rfjy
任期	rfqi
份内	ffnw
份量	ffll
仿佯	fhyh
仿制	fhvi
仿制品	fvpb
仿古	fhgu
仿生	fhug
仿真	fhvf
仿真度	fvdo
仿真度	fvdu
企业主	qyvu
企业化	qyhx
企业家	qyjx
企业界	qyjp
企事业	quye
企人边	qrbm
企堂	qith
企望	qiwh
企求	qiqq
企盼	qipj
伊利	yili
伊利诺斯	ylns
伊始	yiui
伊宁	yink
伊斯兰	yslj
伊斯兰教	yslj
伊甸	yidm
伊甸园	ydyr
伊肯	yikf
伏击战	fjvj
伏匿匿	fnni
伏法	fufa
伏法受诛	ffuv
伏特	fute
伏罪	fuzv
伏羲	fuxi
伏魔	fumo
伏龙凤雏	flfi
休会	xqhv
休养	xqyh
休市	xqui
休憩	xqqi
休整	xqvg
休斯敦	xsdy
休止符	xvfu
众擎易举	vqyj
众议员	vyyr
众议院	vyyr
优于	yzyu
优先权	yxqr
优哉游哉	yzyz
优异	yzyi
优待	yzdd
优抚	yzfu
优派	yzpd
优游	yzyz
优生	yzug
优生优育	yuyy
优育	yzyu
优胜	yzug
优胜者	yuve
优裕	yzyu
优越性	yyxk
优越感	yygj
优选	yzxr
伙头	hotz
伙食费	hufw
会上	hvuh
会会	hvhv
会会	hvkk
会会	kkhv
会会	kkkk
会刊	hvkj
会务	hvwu
会友	hvyz
会合	hvhe
会员国	hygo
会员证	hyvg
会址	hvvi
会客室	hkui
会师	hvui
会心	hvxb
会意	hvyi
会战	hvvj
会操	hvcc
会旗	hvqi
会期	hvqi
会标	hvbn
会演	hvyj
会理	hvli
会理	kkli
会社	hvue
会社	kkue
会聚	hvju
会计师	kjui
会议室	hyui
会议桌	hyvo
会议桌	kyvo
会长	hvih
会长	hvvh
会风	hvfg
伛偻	yulv
伛偻	yulz
伟人	wwrf
伟力	wwli
伟男	wwnj
伟绩	wwji
传动	irds
传家宝	ijbc
传导	irdc
传感器	igqi
传染病	irbk
传略	vrlt
传票	irpn
传记	vrji
传诵	irss
传达室	idui
传送带	isdd
传阅	iryt
传颂	irss
伤亡	uhwh
伤兵	uhbk
伤势	uhui
伤及	uhji
伤害	uhhd
伤残人	ucrf
伤病员	ubyr
伤筋动骨	ujdg
伦巴	lyba
伦理学	llxt
伪币	wwbi
伪证	wwvg
伫立	vuli
伯仲	bovs
伯娘	bdnl
伯娘	bonl
伯父	bofu
伯爷	bdye
伯爷	boye
伯爷公	bygs
估价	gujx
伴月	bjyt
伶俐	lkli
伸曲	ufqu
伸长	ufih
伺候	cihz
伺机	siji
似是	uiui
似模似样	umuy
似水流年	uuln
似的	uide
伽利略	jllt
伾伾	pipi
但又	djyz
位居	wwju
位移	wwyi
低下	dixx
低产	diij
低产田	ditm
低压	diya
低回	dihv
低威	diww
低年级	dnji
低微	diww
低效	dixn
低波	dibo
低端	didr
低胸	dixs
低腰	diyc
低谷	digu
低贱	dijm
住地	vudi
住宅区	vvqu
住家工	vjgs
住家男人	vjnr
住手	vuuz
住持	vuii
住院	vuyr
佐证	zovg
体例	tili
体协	tixp
体型	tixk
体委	tiww
体式	tiui
体形	tixk
体彩	ticd
体罚	tifa
体育课	tyke
体表	tibn
体裁	ticd
何妨	hefh
何尝	heih
何许	hexu
佗佗拧	ttnk
佗衰家	tujx
余力	yuli
余年	yunm
余粮	yull
余音	yuyb
余韵	yuyy
佛教徒	fjtu
佛罗里达	flld
佛都有火	fdyh
作东	zods
作主	zovu
作价	zojx
作假	zojx
作到	zodc
作协	zoxp
作大	zoda
作大	zodd
作成	zoig
作曲家	zqjx
作法	zofa
作用力	zyli
你一言	nyyj
你哋	nidi
佢哋	kodi
佢哋	qudi
佣兵	ysbk
佩剑	pwjm
佩带	pwdd
佳丽	jxli
佳人	jxrf
佳句	jxju
佳品	jxpb
佳境	jxjk
佳期	jxqi
佳绩	jxji
佳节	jxjp
佳话	jxhx
佼佼者	jjve
使之	uivi
使乜	uimp
使乜	uinp
使乜讲	umjl
使乜讲	unjl
使人	uirf
使徒	uitu
使用权	uyqr
使节	uijp
侁侁	ufuf
侃侃	kjkj
例举	liju
例会	lihv
例汤	lith
例程	liig
例行	lixk
例行公事	lxgu
例证	livg
例题	liti
侍候	uihz
侍奉	uifg
侏儒	vuru
侘傺	iaii
供书教学	gujx
供品	gspb
供应量	gyll
供稿	gsgc
供给	gsji
供认	gsrf
供销	gsxn
供销社	gxue
供需	gsxu
依仗	yivh
依依惜别	yyxb
依倚	yiyi
依存	yicy
依山傍水	yubu
依次	yici
依违	yiww
依附	yifu
侠客	xxke
侦察兵	vibk
侦察员	viyr
侦察机	viji
侧侧膊	ccbo
侧侧膊	cvbo
侧侧膊	czbo
侧侧膊	vcbo
侧侧膊	vvbo
侧侧膊	vzbo
侧侧膊	zcbo
侧侧膊	zvbo
侧侧膊	zzbo
侧重点	cvdm
侨乡	qnxl
侨兴	qnxk
侨务	qnwu
侨商	qnuh
侨属	qnuu
侨汇	qnhv
侨界	qnjp
侨眷	qnjr
侵略者	qlve
侵蚀	qbui
便娟	bmjr
便娟	pmjr
便携	bmxp
便携	pmxp
便携式	bxui
便服	bmfu
便衣	bmyi
便道	bmdc
促织	cuvi
促进会	cjhv
俄亥俄	ehee
俄勒冈	elgh
俄国	eego
俄语	eeyu
俏媚	qnmw
俏货	qnho
俗名	sumk
俗话说	shuo
俘获	fuho
俚语	liyu
保住	bcvu
保值	bcvi
保守党	budh
保守派	bupd
保密性	bmxk
保护伞	bhsj
保时捷	bujp
保有	bcyz
保温瓶	bwpk
保皇派	bhpd
保监会	bjhv
保监会	bjkk
保票	bcpn
保管员	bgyr
保育员	byyr
保育院	byyr
保苗	bcmn
保荐	bcjm
保证书	bvuu
保送	bcss
保释	bcui
保量	bcll
保镖	bcbn
保险柜	bxgv
保险箱	bxxl
保驾	bcjx
保鲜	bcxm
信义	xbyi
信件	xbjm
信任感	xrgj
信使	xbui
信号弹	xhdj
信号灯	xhdg
信天游	xtyz
信奉	xbfg
信守	xbuz
信心百倍	xxbb
信念	xbnm
信息量	xxll
信手	xbuz
信教	xbjn
信条	xbtn
信用卡	xyka
信用社	xyue
信笔	xbbi
信笺	xbjm
信誓	xbui
信访	xbfh
信贷员	xdyr
信赏必罚	xubf
信阳	xbyh
信马由缰	xmyj
俣俣	yuyu
俭可养廉	jkyl
俭朴	jmpu
修剪	xqjm
修定	xqdk
修整	xqvg
修旧利废	xjlf
修正主义	xvvy
修水	xquv
修理业	xlye
修理厂	xlih
修葺	xqqi
修身洁行	xujh
修身洁行	xujx
修道院	xdyr
俯仰	fuyh
俯仰之间	fyvj
俯拾即是	fuju
俯拾皆市	fuju
俯瞰	fukj
俯视	fuui
俯首听命	futm
俺们	anmf
俾倪	bini
倍受	bwuz
倍数	bwuu
倏地	uudi
倏忽	uuhu
倒伏	dcfu
倒汗水	dhuv
倒泻	dcxp
倒泻箩蟹	dxlx
倒班	dcbj
倒立	dcli
倒米	dcmi
倒置	dcvi
倔头巷	jthh
倔头巷	jtxl
倔头路	jtlu
倔擂槌	jliv
倔犟	jtjl
倘能	thng
候机室	hjui
候车室	hiui
候选人	hxrf
候镬	hzho
候驾	hzjx
倚仗	yivh
倚势凌人	yulr
倚天	yitm
借一借	jyjp
借以	jpyi
借古喻今	jgyj
借咗聋耳陈只耳	jzle
借啲意	jdyi
借据	jpju
借支	jpvi
借故	jpgu
借机	jpji
借歪	jpwd
借箸代筹	jvdi
借读	jpdu
借调	jpdn
借贷	jpdd
借道	jpdc
倡议书	iyuu
倥偬	kszs
债券	vdqr
债务人	vwrf
债权人	vqrf
值勤	viqb
值日	viri
值此	vici
值班室	vbui
值钱	viqm
倾倒	qkdc
倾向性	qxxk
倾心	qkxb
倾心吐胆	qxtd
倾泄	qkxp
倾注	qkvu
倾泻	qkxp
倾耳注目	qevm
倾耳而听	qeet
倾覆	qkfu
倾角	qkjn
偃蹇	yjjm
假作	jxzo
假使	jxui
假借	jxjp
假假地	jjde
假假地	jjdi
假大空	jdks
假如	jxru
假想	jxxl
假戏	jxxi
假手于人	juyr
假扮	jxbj
假牙	jxya
假痴不癫	jibd
假肢	jxvi
假药	jxyc
假证	jxvg
假象	jxxl
假账	jxvh
假货	jxho
假途灭虢	jtmg
假释	jxui
偏听偏信	ptpx
偏好	pmhc
偏废	pmfw
偏瘫	pmtj
偓佺	woqr
偓促	wocu
做七	zoqi
做世界	zujp
做为	zoww
做乜	zomp
做乜	zonp
做人世	zrui
做低	zodi
做假	zojx
做出	zoiu
做功	zogs
做嘢	zoye
做客	zoke
做活	zoho
做生不如做熟	zubu
做绝	zojt
做账	zovh
做鬼做马	zgzm
停办	tkbj
停息	tkxi
停机坪	tjpk
停歇	tkxp
停滞	tkvi
停职	tkvi
停航	tkhh
停课	tkke
健身房	jufh
偲偲	sisi
偷人	tzrf
偷腥	tzxk
偷运	tzyy
偷鸡唔到蚀楂米	tjwm
傥荡	thdh
储值票	ivpn
储户	iuhu
储蓄所	ixso
储藏室	icui
储藏量	icll
傲人	aorf
傲游	aoyz
傲然矗立	aril
傲睨万物	anww
傻下傻下	uxux
傻事	uaui
傻傻更更	uugg
傻气	uaqi
像片	xlpm
像章	xlvh
僵化	jlhx
僵死	jlsi
僻价	pijp
僻价	pijx
儒将	rujl
儒教	rujn
兀自	wuzi
元件	yrjm
元曲	yrqu
充气	isqi
充盈	isyk
充饥	isji
先人	xmrf
先公后私	xghs
先哲	xmve
先嗰排	xgpd
先声	xmug
先天下之忧而忧后天下之乐而乐	xtxl
先天下之忧而忧后天下之乐而乐	xtxy
先导	xmdc
先手	xmuz
先是	xmui
先期	xmqi
先河	xmhe
先知	xmvi
先行	xmxk
先行者	xxve
先贤	xmxm
先进性	xjxk
先遣	xmqm
先遣队	xqdv
先锋队	xfdv
先驱者	xqve
光华	glhx
光合作用	ghzy
光大	glda
光彩夺目	gcdm
光明灿烂	gmcl
光暗掣	gaie
光栅	gluj
光波	glbo
光洁	gljp
光热	glre
光焰	glyj
光电子	gdzi
光纤	glxm
光绪	glxu
光脱脱	gtto
光荣榜	grbh
光趟	glth
光辉灿烂	ghcl
光风霁月	gfjy
克戟	keji
克扣	kekz
克林顿	kldy
克雷	kelw
免职	mmvi
兑付	dvfu
兑换券	dhqr
党中央	dvyh
党产	dhij
党代表	ddbn
党刊	dhkj
党务	dhwu
党史	dhui
党团	dhtr
党团员	dtyr
党委会	dwhv
党小组	dxzu
党性	dhxk
党总支	dzvi
党报	dhbc
党支部	dvbu
党政军	dvjy
党旗	dhqi
党禁	dhjb
党籍	dhji
党纪	dhji
党纪国法	djgf
党组织	dzvi
党群	dhqy
党规	dhgv
党锢	dhgu
党阀	dhfa
党风	dhfg
党龄	dhlk
兜鍪	dzmz
入世	ruui
入主	ruvu
入便	rubm
入便	rupm
入冬	ruds
入团	rutr
入土	rutu
入场券	riqr
入墙柜	rqgv
入墙柜	rqju
入夏	ruxx
入夜	ruye
入学	ruxt
入息	ruxi
入托	ruto
入时	ruui
入狱	ruyu
入画	ruhx
入神	ruuf
入肉	rurz
入魔	rumo
全乡	qrxl
全书	qruu
全优	qryz
全党	qrdh
全力	qrli
全区	qrou
全区	qrqu
全厂	qrih
全国性	qgxk
全境	qrjk
全天候	qthz
全套	qrtc
全家福	qjfu
全州	qrvz
全市	qrui
全托	qrto
全数	qruu
全日制	qrvi
全歼	qrjm
全球性	qqxk
全盛	qrug
全程	qrig
全线	qrxm
全路	qrlu
全身心	quxb
全运会	qyhv
全长	qrih
全集	qrji
全靠	qrkc
八卦掌	bgvh
八方支援	bfvy
八旗	baqi
八路军	bljy
公事	gsui
公仔书	gzuu
公使	gsui
公信	gsxb
公元	gsyr
公公	gsgs
公公婆婆	ggpp
公共场所	ggis
公决	gsjt
公判	gspj
公历	gsli
公器	gsqi
公国	gsgo
公婆	gspo
公子	gszi
公审	gsuf
公开信	gkxb
公开赛	gksd
公式化	guhx
公心	gsxb
公愤	gsff
公房	gsfh
公才公望	gcgw
公报	gsbc
公敌	gsdi
公有	gsyz
公有制	gyvi
公检法	gjfa
公民权	gmqr
公海	gshd
公物	gswu
公理	gsli
公益金	gyjb
公示	gsui
公私	gssi
公积金	gjjb
公粮	gsll
公认	gsrf
公证	gsvg
公诉人	gsrf
公路桥	glqn
公馆	gsgr
公鸡	gsji
六书	lquu
六亲无靠	lqwk
六月飞霜	lyfu
六畜	lqiu
兰州市	lvui
共事	gsui
共产党人	gidr
共同体	gtti
共和	gshe
共和党	ghdh
共度	gsdu
共推	gstv
共渡	gsdu
共生	gsug
共用	gsys
共管	gsgr
共聚	gsju
共舞	gswu
共计	gsji
共识	gsui
共谋	gsmz
共赏	gsuh
共进	gsjb
共需	gsxu
共青团	gqtr
共青团员	gqty
关怀备注	ghbv
关怀备至	ghbv
关汉卿	ghqk
关税	gruv
关系户	gxhu
关系网	gxwh
关节炎	gjyj
关键性	gjxk
兴云致雨	xyvy
兴亡	xkwh
兴修	xkxq
兴冲冲	xiis
兴利除害	xlih
兴味盎然	xwar
兴学	xkxt
兴许	xkxu
兴起	xkqi
兴高彩烈	xgcl
兵乱	bklr
兵力	bkli
兵变	bkbm
兵员	bkyr
兵家	bkjx
兵工厂	bgih
兵役	bkyi
兵役法	byfa
兵微将寡	bwjg
兵操	bkcc
兵站	bkvj
其一	qiyi
其义自见	qyzj
其势汹汹	quxx
其后	qihz
其奈我何	qnwh
其它	qita
其间	qijm
其馀	qiyu
典礼	dmli
典章	dmvh
典籍	dmji
养子	yhzi
养护	yhhu
养殖业	yvye
养殖场	yvih
养母	yhmu
养父	yhfu
养生之道	yuvd
养神	yhuf
养老金	yljb
养老院	ylyr
养路	yhlu
养身	yhuf
兼修	jmxq
兼具	jmju
兼听	jmtk
兼夹	jmga
兼夹	jmjx
兼容并包	jrbb
兼收	jmuz
兼管	jmgr
兼职	jmvi
兼营	jmyk
兼课	jmke
兼顾	jmgu
兽交	uzjn
兽医	uzyi
兽疫	uzyi
兽类	uzlw
冀南	jinj
内分泌	nfmi
内助	nwvu
内子	nwzi
内有	nwyz
内河	nwhe
内海	nwhd
内燃机	nrji
内经	nwjk
内脂	nwvi
内陆国	nlgo
内陆河	nlhe
内顾之忧	ngvy
冇乜	mcmp
冇乜	mcnp
冇交易	mjyi
冇修	mcxq
冇几何	mjhe
冇厘搭霎	mldu
冇厘神气	mluq
冇口齿	mkii
冇啖好食	mdhs
冇啖好食	mdhu
冇啖好食	mdhy
冇声气	muqi
冇尾飞砣	mwft
冇得	mcde
冇得	mcdw
冇得倾	mdqk
冇得顶	mddk
冇心机	mxji
冇手尾	muww
冇掩鸡笼	myjl
冇料	mcln
冇时定	mudk
冇晒表情	mubq
冇有怕	mypa
冇理由	mlyz
冇瘾	mcyb
冇相干	mxgj
冇眼睇	mydi
冇穿冇烂	miml
冇符	mcfu
冇米粥	mmvz
冇耳性	mexk
冇脑	mcnc
冇行	mchh
冇行	mcxk
冇计	mcji
冇记性	mjxk
冇谱	mcpu
冇走鸡	mzji
冇雷公咁远	mlgy
再不	zdbu
再审	zduf
再生产	zuij
再聊	zdln
再起	zdqi
冒进	mcjb
写字台	xztd
写意	xpyi
写手	xpuz
冚唪唥	kflh
冚家铲	kjij
冚旗	kjqi
冚档	kjdh
军中	jyvs
军乐团	jytr
军乐队	jydv
军事家	jujx
军令状	jlvl
军体	jyti
军兵种	jbvs
军分区	jfqu
军功	jygs
军功章	jgvh
军务	jywu
军国	jygo
军国主义	jgvy
军垦	jykf
军士	jyui
军委	jyww
军威	jyww
军属	jyuu
军工	jygs
军师	jyui
军徽	jyhv
军操	jycc
军政	jyvg
军旗	jyqi
军机	jyji
军法	jyfa
军烈属	jluu
军界	jyjp
军礼	jyli
军粮	jyll
军统	jyts
军职	jyvi
军衔	jyxm
军衣	jyyi
军装警员	jvjy
军资	jyzi
军转	jyvr
军转办	jvbj
军部	jybu
军需	jyxu
军马	jyma
军龄	jylk
农业国	nygo
农业税	nyuv
农事	nsui
农产品	nipb
农会	nshv
农副业	nfye
农场主	nivu
农妇	nsfu
农学	nsxt
农学院	nxyr
农家肥	njfw
农工	nsgs
农技	nsji
农时	nsui
农机	nsji
农机具	njju
农林	nslb
农牧业	nmye
农膜	nsmo
农舍	nsue
农谚	nsyj
农贷	nsdd
农资	nszi
冠军赛	gjsd
冠心病	gxbk
冠捷	grjp
冠绝一时	gjyu
冠群	grqy
冤家	yrjx
冤枉	yrwh
冤枉嚟瘟疫去	ywlq
冤枉路	ywlu
冤鬼	yrgv
冥王	mkwh
冥王星	mwxk
冧巴	lfba
冧庄	lfvl
冧歌	lfge
冧篷头	lptz
冬令营	dlyk
冬常服	difu
冬景	dsjk
冬暖夏凉	dnxl
冬泳	dsys
冬烘	dshs
冬瓜豆腐	dgdf
冬节	dsjp
冬衣	dsyi
冬运会	dyhv
冰刀	bkdc
冰壶秋月	bhqy
冰封大地	bfdd
冰封雪盖	bfxg
冰峰	bkfg
冰毒	bkdu
冰清玉润	bqyr
冲击波	ijbo
冲剂	isji
冲压	isya
冲开	iskd
冲撞	isvl
冲灯	isdg
冲积	isji
冲绳	isug
冲锋	isfg
冲锋枪	ifql
决不	jtbu
决定论	jdly
决意	jtyi
决无	jtmo
决无	jtwu
决案	jtan
决计	jtji
决赛权	jsqr
决非	jtfw
冷不防	lbfh
冷库	lgku
冷板凳	lbdg
冷语冰人	lybr
冻亲	dsqb
冻亲	dsqk
冻冰冰	dbbk
冻害	dshd
冻过水	dguv
净值	jkvi
净利	jkli
净化	jkhx
净重	jkvs
净面	jkmm
凄婉	qiwj
凄怆	qiil
准格尔	vger
准确性	vqxk
凉山	lluj
凉浸浸	ljjb
凉透	lltz
凌夷	lkyi
凌空	lkks
减仓	jmch
减免	jmmm
减刑	jmxk
减持	jmii
减灾	jmzd
凑啱	cznj
凑啱	czyj
凑效	czxn
凝胶	nkjn
凝药	nkyc
凝集	nkji
几何	jihe
几内亚	jnya
几时	jiui
几率	jilv
几种	jivs
凡人	fjrf
凡例	fjli
凡属	fjuu
凡属	fjvu
凡是	fjui
凤头猪肚	ftvd
凭陵	pklk
凯西	kdxi
凸出	tuiu
凸起	tuqi
出世	iuui
出世纸	iuvi
出乱子	ilzi
出事	iuui
出于	iuyu
出人意外	iryw
出以公心	iygx
出价	iujx
出众	iuvs
出使	iuui
出出进进	iijj
出击	iuji
出力	iuli
出厂	iuih
出厂价	iijx
出发地	ifdi
出发点	ifdm
出处	iuiu
出外	iuwd
出奇	iuqi
出嫁	iujx
出尽八宝	ijbb
出局	iuju
出工	iugs
出师	iuui
出师不利	iubl
出得厅堂入得厨房	idtf
出息	iuxi
出手	iuuz
出操	iucc
出术	iuuu
出术	iuvu
出格	iuge
出毛病	imbk
出气	iuqi
出污泥而不染	iwnr
出没	iumo
出浴	iuyu
出海	iuhd
出炉	iulu
出版物	ibwu
出狱	iuyu
出猫	iumc
出生率	iulv
出界	iujp
出监	iujm
出示	iuui
出神	iuuf
出租车	izie
出站	iuvj
出纳员	inyr
出线	iuxm
出线权	ixqr
出航	iuhh
出苗	iumn
出蛊惑	igho
出血	iuxp
出血	iuxt
出行	iuxk
出让	iurh
出访	iufh
出谋献策	imxc
出资	iuzi
出车	iuie
出轨	iugv
出阵	iuvf
出风头	iftz
击中	jivs
击剑	jijm
击打	jida
击毁	jihv
击破	jipo
击节叹赏	jjtu
击退	jitv
凼凼转	ddvr
函件	hjjm
凿空	zcks
凿穿	zcir
刀下	dcxx
刀仔锯大树	dzju
刀伤	dcuh
刀具	dcju
刀刃	dcrf
刀刻	dcke
刀削	dcxn
刀削	dcxt
刀口	dckz
刀耕火种	dghv
刁侨扭拧	dqnn
分之	ffvi
分公司	fgsi
分册	ffce
分分秒秒	ffmm
分分钟	ffvs
分列式	flui
分场	ffih
分居	ffju
分房	fffh
分晓	ffxn
分期	ffqi
分机	ffji
分析师	fxui
分校	ffxn
分母	ffmu
分水岭	fulk
分洪	ffhs
分界	ffjp
分等	ffdg
分米	ffmi
分红	ffhs
分给	ffgw
分给	ffji
分脏	ffzh
分设	ffue
分赴	fffu
分辩率	fblv
分辩率	fbuk
分部	ffbu
分野	ffye
分门别户	fmbh
分门别类	fmbl
切切	qpqp
切切实实	qquu
切削	qpxn
切实可行	qukx
切实有力	quyl
切忌	qpji
刊号	kjhc
刊头	kjtz
刊文	kjwf
刊载	kjzd
刍荛	iurc
刎颈	wfgg
刎颈	wfjk
刑事	xkui
刑事犯	xufj
刑戮	xklu
刑期	xkqi
刑罚	xkfa
刑讯	xkxy
划不来	hbld
划出	hxiu
划界	hxjp
划线	hxxm
列国	lpgo
列宁	lpnk
列宁主义	lnvy
列宁格勒	lngl
列强	lpql
列车员	liyr
刘伯承	lbig
刘伯温	lbwf
刘墉	lqys
刘备	lqbw
刘少奇	luqi
刘德华	ldhx
刘欢	lqhr
刘禅	lqij
刘禅	lquj
刘禹锡	lyxi
刘秀	lqxq
刘翔	lqxl
刘邦	lqbh
刚直不阿	gvbe
刚肠嫉恶	gije
刚肠嫉恶	gijw
创世	ilui
创伤	iluh
创刊号	ikhc
创利	illi
创始人	iurf
创维	ilww
创见	iljm
创造力	izli
创造性	izxk
初中生	ivug
初具	iuju
初具规模	ijgm
初创	iuil
初四	iusi
初夏	iuxx
初始	iuui
初审	iuuf
初小	iuxn
初战	iuvj
初战告捷	ivgj
初版	iubj
初生	iuug
初衷	iuvs
初试	iuui
初选	iuxr
删节	ujjp
判例	pjli
判决书	pjuu
判断力	pdli
判涣	pjhr
判罪	pjzv
利利是是	lluu
利利索索	llss
利器	liqi
利国	ligo
利害	lihd
利己	liji
利是封	lufg
利比亚	lbya
利物浦	lwpu
利益均沾	lyjv
利盟	limg
利诱	liyz
别具匠心	bjjx
别动队	bddv
别风淮雨	bfhy
刮龙	gxls
到会	dchv
到其时	dqui
到喉唔到肺	dhwf
到点	dcdm
到职	dcvi
到账	dcvh
制剂	viji
制动	vids
制备	vibw
制导	vidc
制度化	vdhx
制式	viui
制得过	vdgo
制成	viig
制成品	vipb
制服	vifu
制法	vifa
制片厂	vpih
制版	vibj
制盐	viyj
制程	viig
制药	viyc
制衣	viyi
制订	vidk
制造业	vzye
制造商	vzuh
制高点	vgdm
刹住	iavu
刹住	uavu
刺史	ciui
刺头	citz
刺戳	ciio
刺槐	cihk
刺激性	cjxk
刻划	kehx
刻毒	kedu
刽子手	gzuz
剂型	jixk
剃眼眉	tymw
剃须	tixu
削尖	xnjm
削尖	xtjm
削成	xnig
削成	xtig
前个排	qgpd
前人	qmrf
前人栽树后人乘凉	qrzl
前夫	qmfu
前头	qmtz
前奏曲	qzqu
前妻	qmqi
前敌	qmdi
前科	qmke
前程万里	qiwl
前程似锦	qisj
前站	qmvj
前端	qmdr
前线	qmxm
前苏联	qslm
前言	qmyj
前车可鉴	qikj
前车可鉴	qjkj
前送	qmss
前驱	qmqu
剑指	jmvi
剑术	jmuu
剔手边	tubm
剔除	tiiu
剞劂	jijt
剥光猪	bgvu
剥削阶级	bxjj
剥离	boli
剥落	bolo
剥蚀	boui
剦狗	yjgz
剧中人	jvrf
剧作者	jzve
剧变	jubm
剧种	juvs
剩番	ugfj
剩番	ugpj
剪刀	jmdc
剪刀差	jdia
剪子	jmzi
剪影	jmyk
剪枝	jmvi
剪纸	jmvi
剪裁	jmcd
副产品	fipb
副作用	fzys
副官	fugr
副手	fuuz
副教授	fjuz
副职	fuvi
副题	futi
副食	fuui
副食品	fupb
割地	gedi
割据	geju
割断	gedr
割禾青	ghqk
劏死牛	tsnq
力争上游	lvuy
力克	like
力士	liui
劝慰	qrww
办事处	buiu
办公桌	bgvo
办到	bjdc
办厂	bjih
办房	bjfh
办班	bjbj
办馆	bjgr
功业	gsye
功利	gsli
功名	gsmk
功底	gsdi
功德	gsde
功成不居	gibj
功成名遂	gims
功标青史	gbqu
功用	gsys
功绩	gsji
功薄蝉翼	gbiy
加之	jxvi
加仑	jxly
加以	jxyi
加价	jxjx
加元	jxyr
加剧	jxju
加力	jxli
加勒比	jlbi
加塞	jxsd
加宽	jxkr
加尔各答	jegd
加尔文	jewf
加州	jxvz
加工业	jgye
加工厂	jgih
加底	jxdi
加拿大	jnda
加沙	jxua
加班加点	jbjd
加班费	jbfw
加精	jxjk
加速器	jsqi
加速度	jsdu
加靳比	jjbi
加餸	jxss
加高	jxgc
务使	wuui
务农	wuns
务实	wuui
务虚	wuxu
劣质品	lvpb
动不动	dbds
动员令	dylk
动土	dstu
动机	dsji
动植物	dvwu
动武	dswu
动物学	dwxt
动画片	dhpm
动脑筋	dnjb
动议	dsyi
助听器	vtqi
助学金	vxjb
助我张目	vwvm
助推器	vtqi
助攻	vugs
助教	vujn
助理员	vlyr
助长	vuvh
努尔哈赤	nehi
劫机	jpji
劲头	jbtz
劳务费	lwfw
劳动力	ldli
劳动局	ldju
劳动日	ldri
劳动者	ldve
劳动节	ldjp
劳工	lcgs
劳役	lcyi
劳拉	lcla
劳教所	ljso
劳资	lczi
势不可当	ubkd
势凶夹狼	uxgl
势凶夹狼	uxjl
势利	uili
势力	uili
势单力薄	udlb
势头	uitz
势态	uitd
勃勃	bobo
勇于	ysyu
勇冠	ysgr
勇猛果敢	ymgg
勇猛精进	ymjj
勘误	kjwu
勤俭持家	qjij
勤务员	qwyr
勤杂工	qzgs
勤苦	qbku
勾地	gzde
勾地	gzdi
勾搭	gzda
勾通	gzts
匀巡	yyxy
匀循	yyxy
包产	bcij
包修	bcxq
包剪抌	bjvf
包围圈	bwqr
包工	bcgs
包干制	bgvi
包机	bcji
包涵	bchj
包租婆	bzpo
包钢	bcgh
包销	bcxn
包顶颈	bdgg
包顶颈	bdjk
匈牙利	xyli
化为泡影	hwpy
化公为私	hgws
化合物	hhwu
化学家	hxjx
化工厂	hgih
化肥	hxfw
化装	hxvl
化验单	hydj
化验单	hyij
化验单	hyuj
化验室	hyui
化骨龙	hgls
北伐	bwfa
北伐军	bfjy
北大仓	bdch
北宋	bwss
北极圈	bjqr
北极熊	bjxs
北电	bwdm
北纬	bwww
北航	bwhh
北芪	bwqi
北雁南飞	bynf
北面	bwmm
北风呼啸	bfhx
北麓	bwlu
匠心独运	jxdy
匡算	klsr
匣子	xxzi
匹夫	pifu
匹夫有责	pfyz
区委	quww
医书	yiuu
医保	yibc
医务	yiwu
医嘱	yivu
医大	yida
医大	yidd
医学院	yxyr
医师	yiui
医术	yiuu
医治	yivi
医用	yiys
医科	yike
医肚	yidu
医药费	yyfw
匼匝	keza
匼匝	qxza
匾额	bmee
匿埋	nimd
匿埋	nimj
十一月	uyyt
十三陵	uslk
十传百	uibd
十佳	uijx
十冬腊月	udly
十字	uizi
十字军	uzjy
十字路口	uzlk
十字车	uzie
十字车	uzju
十足十	uzui
十载寒窗	uzhi
千伏	qmfu
千千万万	qqww
千古绝唱	qgji
千叮咛	qdnk
千山万壑	quwh
千岁	qmsv
千差万别	qiwb
千斤	qmjb
千斤顶	qjdk
千百万	qbwj
千祁	qmqi
千虑一失	qlyu
千虑一得	qlyd
千载一时	qzyu
千里之堤	qlvd
千里眼	qlyj
千里马	qlma
千金	qmjb
千门万户	qmwh
千难万险	qnwx
千难万难	qnwn
升堂入室	utru
升幅	ugfu
升旗	ugqi
升格	ugge
升起	ugqi
升迁	ugqm
午夜	wuye
午宴	wuyj
午时	wuui
午间	wujm
半价	bjjx
半决赛	bjsd
半唐番	btfj
半唐番	btpj
半圆形	byxk
半壁江山	bbju
半壁河山	bbhu
半天吊	btdn
半导体	bdti
半封建	bfjm
半成品	bipb
半文盲	bwmh
半旧	bjjq
半晌	bjuh
半月刊	bykj
半点	bjdm
半球	bjqq
半自动	bzds
半边天	bbtm
华为	hxww
华工	hxgs
华灯初上	hdiu
华盛顿	hudy
华硕	hxuo
华章	hxvh
华罗庚	hlgg
华语	hxyu
华贵	hxgv
华阴	hxyb
协作	xpzo
协力	xpli
协议书	xyuu
卓识	voui
卓跞	voli
卓跞	volo
单个	djge
单产	djij
单企人	dqrf
单企人	iqrf
单企人	uqrf
单体	djti
单刀	djdc
单单	djdj
单吊西	ddxi
单吊西	idxi
单吊西	udxi
单子	djzi
单干	djgj
单打	djda
单打独斗	dddd
单打独斗	iddd
单打独斗	uddd
单机	djji
单片机	dpji
单片机	ipji
单片机	upji
单线	djxm
单细胞	dxbc
单行本	dxbf
单衣	djyi
单身汉	duhj
单车径	dijk
单车径	djjk
单车径	iijk
单车径	ijjk
单车径	uijk
单车径	ujjk
单边	djbm
单项	djxl
卖主	mdvu
卖仔莫摸头	mzmt
卖价	mdjx
卖儿鬻女	meyn
卖剩蔗	muve
卖咸鸭蛋	mxyd
卖国贼	mgzw
卖埠	mdbu
卖大包	mdbc
卖家	mdjx
卖方	mdfh
卖猪仔	mvzd
卖猪仔	mvzi
卖飞	mdfw
卖鱼佬洗身	mylu
南乳花生	nrhu
南京市	njui
南国	njgo
南宁市	nnui
南安	njan
南岭	njlk
南平	njpk
南昌市	niui
南朝鲜	nixm
南朝鲜	nvxm
南海	njhd
南纬	njww
南通	njts
南阳	njyh
南面	njmm
南麓	njlu
博古知今	bgvj
博命	bomk
博士后	buhz
博士生	buug
博大	boda
博学	boxt
博施济众	bujv
博物院	bwyr
博物馆	bwgr
博览	bolj
博采众长	bcvi
卜卜脆	bbcv
占先	vjxm
占有量	vyll
占领区	vlqu
卡特	kate
卡特	qxte
卡罅	kaxx
卡罅	qxxx
卡脖子	qbzi
卡莉	kali
卡莉	qxli
卢旺达	lwda
卢比	lubi
卢氏	luui
卤水	luuv
卧具	woju
卧车	woie
卫兵	wwbk
卫国	wwgo
卫士	wwui
卫戍	wwuu
卫戍区	wuqu
卫星城	wxig
卫生员	wuyr
卫生所	wuso
卫生纸	wuvi
卫生部	wubu
卫生间	wujm
卫生院	wuyr
卫队	wwdv
卬卬	ahah
卬卬	ahyh
卬卬	yhah
卬卬	yhyh
印刷业	yuye
印刷品	yupb
印刷机	yuji
印加	ybjx
印发	ybfa
印巴	ybba
印数	ybuu
印油	ybyz
印泥	ybni
印第安纳	ydan
印行	ybxk
印鉴	ybjm
危亡	wwwh
危危乎	wwhu
危及	wwji
危害性	whxk
危局	wwju
危急	wwji
危言危行	wywh
危言危行	wywx
危重	wwvs
危难	wwnj
即位	jiww
即便	jibm
即兴	jixk
即刻	jike
即可	jike
即时	jiui
即映即有	jyjy
即景	jijk
即系	jiji
即系	jixi
卵细胞	lxbc
卷子	jrzi
卸膊	xpbo
厂主	ihvu
厂子	ihzi
厂方	ihfh
厂矿	ihkl
厂规	ihgv
厂部	ihbu
历任	lirf
历史剧	luju
历史性	luxk
历史观	lugr
历届	lijp
历年	linm
历时	liui
历法	lifa
历险	lixm
厉兵秣马	lbmm
压制	yavi
压力锅	ylgo
压岁钱	ysqm
压强	yaql
压缩机	ysji
压轴戏	yvxi
厘印	liyb
厘印税	lyuv
厚实	hzui
厚德载物	hdzw
原主	yrvu
原则性	yzxk
原动力	ydli
原址	yrvi
原型	yrxk
原委	yrww
原子	yrzi
原子核	yzhe
原子钟	yzvs
原审	yruf
原形	yrxk
原意	yryi
原故	yrgu
原有	yryz
原木	yrmu
原样	yryh
原油	yryz
原点	yrdm
原物	yrwu
原状	yrvl
原稿	yrgc
原粮	yrll
原职	yrvi
原著	yrvu
去世	quui
去处	quiu
去粗取精	qcqj
去职	quvi
厾背脊	dbji
县城	xmig
县委	xmww
县市	xmui
县志	xmvi
县政	xmvg
县级	xmji
参事	cjui
参战	cjvj
参拜	cjbd
参照系	cvxi
参编	cjbm
参编	ufbm
参考书	ckuu
参观团	cgtr
参议	cjyi
参议会	cyhv
参议员	cyyr
参议院	cyyr
参谋部	cmbu
参谋长	cmih
参谋长	cmvh
参预	cjyu
参预	ufyu
叆叇	aidd
又惊又喜	yjyx
又红又专	yhyv
叉电	iadm
及其	jiqi
及早	jizc
及时雨	juyu
及格	jige
及至	jivi
友人	yzrf
友协	yzxp
友谊赛	yysd
友达	yzda
双人床	uril
双人舞	urwu
双企人	uqrf
双增双节	uzuj
双月刊	uykj
双格床	ugil
双皮奶	upnd
双程证	uivg
双簧管	uhgr
双职工	uvgs
双轨	ulgv
反之	fjvi
反之亦然	fvyr
反党	fjdh
反动派	fdpd
反叼	fjdn
反响	fjxl
反对派	fdpd
反对票	fdpn
反应堆	fydv
反悔	fjhv
反攻	fjgs
反潜	fjqm
反观	fjgr
反过来	fgld
反过来说	fglu
反霸	fjba
反革命	fgmk
反黑组	fhzu
发令	falk
发令枪	flql
发包	fabc
发吽哣	fhdz
发吽哣	fhpz
发嗡风	fwfg
发型	faxk
发声	faug
发奋图强	fftq
发姣	fajn
发姣	faxn
发嬲	fann
发展史	fvui
发布会	fbhv
发开口梦	fkkm
发愤	faff
发愤图强	fftq
发愤忘食	ffwu
发慌	fahl
发抆憎	fmzg
发抆憎	fwzg
发报	fabc
发掘	fajt
发改委	fgww
发明家	fmjx
发明者	fmve
发泡胶	fpjn
发源	fayr
发炎	fayj
发烂渣	flva
发球	faqq
发生器	fuqi
发电厂	fdih
发电机	fdji
发电站	fdvj
发电量	fdll
发病率	fblv
发端	fadr
发羊吊	fydn
发脚	fajn
发脾气	fpqi
发臭	faiz
发花癫	fhdm
发茅	famc
发行量	fxll
发言稿	fygc
发证	favg
发达国家	fdgj
发迹	faji
发钱寒	fqhj
发问	fawf
发青光	fqgl
发鸡盲	fjmh
发麻	fama
叔仔	uuzd
叔仔	uuzi
叔父	uufu
取出	quiu
取景	qujk
取次	quci
取自	quzi
取道	qudc
取长补短	qibd
受刑	uzxk
受命	uzmk
受审	uzuf
受害人	uhrf
受害者	uhve
受敌	uzdi
受权	uzqr
受气	uzqi
受灾	uzzd
受理	uzli
受益	uzyi
受益者	uyve
受精	uzjk
受精卵	ujlr
受罚	uzfa
受贿	uzhv
受辱	uzru
受阻	uzzu
受降	uzxl
变化无常	bhwi
变压器	byqi
变幻	bmhr
变废为宝	bfwb
变异	bmyi
变性	bmxk
变戏法	bxfa
变电所	bdso
变电站	bdvj
变质	bmvi
变速器	bsqi
叙事诗	xuui
叙利亚	xlya
叙旧	xujq
口响	kzxl
口哑哑	kyya
口型	kzxk
口子	kzzi
口实	kzui
口形	kzxk
口水溦	kuww
口水肩	kujm
口疏	kzuu
口痕	kzhf
口福	kzfu
口花花	khhx
口香糖	kxth
口齿	kzii
古书	guuu
古井无波	gjwb
古仔	guzd
古仔	guzi
古已有之	gyyv
古拙	guvo
古文	guwf
古文字	gwzi
古时	guui
古月粉	gyff
古灵精怪	gljg
古物	guwu
古生物	guwu
古稀	guxi
古籍	guji
古老石山	gldu
古老石山	gluu
古董	guds
古诗	guui
古话	guhx
古迹	guji
古道热肠	gdri
古都	gudu
古风	gufg
句式	juui
句钟	gzvs
句钟	juvs
另一方面	lyfm
另行	lkxk
叨唠	dclc
只得	vide
只想	vixl
只揪	vijq
只是	viui
只眼开只眼闭	vykb
只见	vijm
只许	vixu
只身	viuf
只限	vixm
只需	vixu
只须	vixu
只顾	vigu
叫作	jnzo
叫做	jnzo
叫嚣	jnxn
叫好	jnhc
叫糊	jnhu
召回	vchv
召妓	ucji
召妓	vcji
召集	vcji
叮叮当当	dddd
可亲可敬	kqkj
可以攻玉	kygy
可使	keui
可信度	kxdu
可卡因	kkyb
可可	keke
可喜	kexi
可嘉	kejx
可怒也	knye
可按	kean
可望	kewh
可疑	keyi
可知	kevi
可见光	kjgl
可观	kegr
可视	keui
可读性	kdxk
可鄙	kebi
台中	tdvs
台子	tdzi
台属	tduu
台州	tdvz
台柱子	tvzi
台港	tdgh
台湾省	twug
台湾省	twxk
台独	tddu
台盟	tdmg
台积电	tjdm
台联	tdlm
台资	tdzi
史书	uiuu
史册	uice
史前	uiqm
史努比	unbi
史学	uixt
史官	uigr
史实	uiui
史密斯	umsi
史料	uiln
史籍	uiji
史记	uiji
史诗	uiui
史话	uihx
史迹	uiji
右便	yzbm
右便	yzpm
右倾	yzqk
右翼	yzyi
右键	yzjm
叶脉	yemd
叶面	yemm
号召力	hvli
号子	hczi
号手	hcuz
号脉	hcmd
司令官	slgr
司令部	slbu
司务长	swvh
司法部	sfbu
司长	sivh
叹世界	tujp
叻唔切	lwqp
吁嗟	xujp
吁嗟	yujp
吃一堑	iyqm
吃不消	ibxn
吃老本	ilbf
吃苦头	iktz
吃请	iiqk
吃香	iixl
各业	geye
各个	gege
各县	gexm
各大	geda
各大	gedd
各异	geyi
各式	geui
各施各法	gugf
各省	geug
各省	gexk
各科	geke
各自为政	gzwv
各行其是	gxqu
吆呼	ychu
合一	heyi
合乎	hehu
合伙人	hhrf
合作化	hzhx
合作社	hzue
合剂	heji
合力	heli
合同制	htvi
合同工	htgs
合同期	gtqi
合同期	htqi
合唱团	hitr
合围	heww
合家欢	hjhr
合并症	hbvg
合心水	gxuv
合心水	hxuv
合抱	hebc
合格率	hglv
合流	helq
合理化	hlhx
合理性	hlxk
合璧	hebi
合用	heys
合眼缘	gyyr
合眼缘	hyyr
合算	hesr
合署	heuu
合股	hegu
合肥市	gfui
合肥市	hfui
合营	heyk
合订本	hdbf
合金钢	hjgh
合龙	hels
吉信	jixb
吉凶祸福	jxhf
吉利	jili
吉它	jita
吉安	jian
吉庆	jiqk
吉日	jiri
吉普车	jpie
吉林省	jlug
吉祥	jixl
吉祥物	jxwu
吉隆	jils
吉首	jiuz
吊味	dnww
吊命	dnmk
吊唁	dnyj
吊威也	dwye
吊尾	dnww
吊环	dnhr
吊瘾	dnyb
吊盐水	dyuv
吊起嚟卖	dqlm
同一性	tyxk
同义词	tyci
同乡	tsxl
同事	tsui
同位素	twsu
同化	tshx
同城	tsig
同安	tsan
同室操戈	tucg
同年	tsnm
同心	tsxb
同心合意	txgy
同心合意	txhy
同志	tsvi
同性	tsxk
同性恋	txlm
同捞同煲	tltb
同方	tsfh
同治	tsvi
同济	tsji
同生共死	tugs
同盟会	tmhv
同盟军	tmjy
同盟国	tmgo
同级	tsji
同胞	tsbc
同船	tsir
同道	tsdc
名位	mkww
名医	mkyi
名古屋	mgwu
名噪一时	mzyu
名城	mkig
名士	mkui
名山	mkuj
名山大川	mudi
名手	mkuz
名次	mkci
名胜	mkug
名花	mkhx
名著	mkvu
后世	hzui
后事	hzui
后事之师	huvu
后仔乸	hzna
后任	hzrf
后备军	hbjy
后尾枕	hwvf
后援	hzyr
后撤	hzie
后生仔	huzd
后生仔	huzi
后生女	hunv
后继有人	hjyr
后背	hzbw
后脚	hzjn
后腿	hztv
后记	hzji
后辈	hzbw
后进	hzjb
吏治	livi
向北	xlbw
向导	xldc
向心力	xxli
向日葵	xrkv
向着	xlve
向阳	xlyh
吓倒	xxdc
君主立宪	jvlx
吞吐量	ttll
吞拿鱼	tnyu
吞食	tyui
吟沉	ybif
吟诗	ybui
否决权	fjqr
含冤	hjyr
含垢纳污	hgnw
含意	hjyi
含氧量	hyll
含水量	hull
含笑	hjxn
含糊其词	hhqc
含羞	hjxq
听晚	tkwj
听朝	tkic
听朝	tkvc
听朝早	tizc
听朝早	tvzc
听诊器	tvqi
吮吸	uyxi
启事	qiui
启功	qigs
启发性	qfxk
启明	qimk
启明星	qmxk
启示	qiui
启航	qihh
启运	qiyy
吱吱斟斟	vvvv
吴江	wujl
吴牛喘月	wniy
吸尘器	xiqi
吸附	xifu
吹吹打打	iidd
吻合	wfhe
吼声	hzug
吽哣	hsdz
吽哣	hspz
呃呃骗骗	eepp
呃神骗鬼	eupg
呃秤	eeig
呆呆	dddd
呆帐	ddvh
呆板	ddbj
呈报	igbc
呈献	igxm
呈请	igqk
告急	gcji
告慰	gcww
告捷	gcjp
告终	gcvs
告罄	gcqk
呋喃	funj
呔盘	ddpj
呔盘	tdpj
员额	yree
呜咽	wuye
呢度	nedo
呢度	nedu
呢度	nido
呢度	nidu
呢排	nepd
呢排	nipd
呢道	nedc
呢道	nidc
周口	vzkz
周易	vzyi
周期性	vqxk
周界	vzjp
周章	vzvh
周身刀冇张利	vudl
周身蚁	vuyi
呶呶	ncnc
呼之欲出	hvyi
呼吸道	hxdc
呼牛呼马	hnhm
命根子	mgzi
命水	mkuv
咀嚼	jujt
咁上下	guxx
咁上近	gujb
咁好	gjhc
咁样	gjyh
咁滞	gjvi
和会	hehv
和头酒	htjq
和平共处	hpgi
和平鸽	hpge
和煦	hexu
和约	heyt
和衷共济	hvgj
和记	heji
和记	hoji
和记	huji
和面	homm
和黄	hehl
和黄	hohl
和黄	huhl
咏叹调	ytdn
咕咚	guds
咕哩	guli
咕噜	gulu
咖啡因	kfyb
咨文	ziwf
咪住	mivu
咪嘴	mizv
咬唔入	ywru
咬牙切齿	yyqi
咬紧牙关	yjyg
咸丰	xmfg
咸唪唥	xflh
咸宁	xmnk
咸湿	xmui
咸湿佬	xulc
咸肉粽	xrzs
咸苦	xmku
咸虾	xmxx
咸鱼翻生	xyfu
咿哑	yiya
咿唔	yiwu
品位	pbww
品名	pbmk
品性	pbxk
品级	pbji
哈萨克	hske
哈萨克族	hskz
响声	xlug
响应	xlyk
响当当	xddh
响彻	xlie
响音	xlyb
哑语	yayu
哗变	hxbm
哗啦啦	hlla
哥白尼	gbni
哨位	ucww
哨兵	ucbk
哨子	uczi
哭叫	kujn
哲学家	vxjx
哲理	veli
哺乳	buru
哺乳动物	brdw
哺育	buyu
唁函	yjhj
唆使	soui
唇枪舌战	iquv
唐棣	thdd
唐棣	thdi
唐棣	thti
唐餐	thcj
唔中用	wvys
唔争在	wvzd
唔似	wuui
唔似样	wuyh
唔使	wuui
唔使恨	wuhf
唔使慌	wuhl
唔使指拟	wuvn
唔使问阿贵	wuwg
唔关事	wgui
唔制	wuvi
唔化	wuhx
唔化算	whsr
唔单只	wdvi
唔单只	wivi
唔单只	wuvi
唔啱	wunj
唔啱	wuyj
唔嗲唔吊	wdwd
唔在讲	wzjl
唔够喉	wghz
唔定	wudk
唔开胃	wkww
唔得掂	wddm
唔得闲	wdxm
唔志在	wvzd
唔忿气	wfqi
唔怪之得	wgvd
唔抵得	wdde
唔抵得	wddw
唔拘	wuju
唔捞	wulc
唔汤唔水	wtwu
唔清唔楚	wqwi
唔熟唔食	wuws
唔熟唔食	wuwu
唔熟唔食	wuwy
唔熟性	wuxk
唔特止	wtvi
唔生性	wuxk
唔知丑	wviz
唔等使	wdui
唔精神	wjuf
唔系人噉品	wjrp
唔系人噉品	wxrp
唔系嘅话	wjgh
唔系嘅话	wxgh
唔系路	wjlu
唔系路	wxlu
唔紧要	wjyc
唔经唔觉	wjwj
唔自在	wzzd
唔觉意	wjyi
唔觉眼	wjyj
唔话得	whde
唔话得	whdw
唔该你	wgni
唔通气	wtqi
唞气	dzqi
唞气	tcqi
唧嘛	jima
售予	uzyu
售前	uzqm
售卖	uzmd
售票员	upyr
售票处	upiu
售货	uzho
售货员	uhyr
唯命是听	wmut
唯我	wwwo
唯物	wwwu
唯物史观	wwug
唯物论	wwly
唱作人	izrf
唱反调	ifdn
唱口	ihkz
唱和	ihhe
唱喏	ihno
唱喏	ihre
唱段	ihdr
唱法	ihfa
唱片	ihpm
唱词	ihci
唾面自干	tmzg
啁啾	vzjq
啄木鸟	vmnn
商业界	uyjp
商会	uhhv
商住两用	uvly
商务	uhwu
商品房	upfh
商品粮	upll
商埠	uhbu
商报	uhbc
商机	uhji
商界	uhjp
商船	uhir
商议	uhyi
商贾	uhgu
啦啦声	llug
啦啦队	lldv
啰啰挛	lllr
啰噃	lobo
啰柚	loyz
啱先	njxm
啱先	yjxm
啱听	njtk
啱听	yjtk
啱啱	njnj
啱啱	njyj
啱啱	yjnj
啱啱	yjyj
啲咁多	dgdo
喀嚓	kaia
善人	ujrf
善有善报	uyub
善本	ujbf
善气迎人	uqyr
善长仁翁	uirw
善长仁翁	uvrw
喊包	hjbc
喊惊	hjjk
喊苦喊忽	hkhh
喊话	hjhx
喐亲	yuqb
喐亲	yuqk
喐手	yuuz
喘气	irqi
喜出望外	xiww
喜剧片	xjpm
喜报	xibc
喜气	xiqi
喜洋洋	xyyh
喜滋滋	xzzi
喜闻	xiwf
喜雨	xiyu
喜鹊	xiqt
喷吐	pftu
喷漆	pfqi
喷雾器	pwqi
喽口	lzkz
嗓子眼	szyj
嗣后	sihz
嗰头近	gtjb
嗰度	gedo
嗰度	gedu
嗰排	gepd
嗰道	gedc
嗰阵	gevf
嘀咕	digu
嘅啫	geui
嘅啫	geve
嘅嗻	geve
嘅嗻	gevu
嘈喧巴闭	cxbb
嘈嘈闭	ccbi
嘈生晒	cuud
嘉兴	jxxk
嘉峪关	jygr
嘉陵	jxlk
嘥心机	sxji
嘥气	sdqi
嘱咐	vufu
嘲哳	icva
嘲哳	vcva
噉样	djyh
噍噍	jnjn
器乐	qiyt
器件	qijm
器物	qiwu
器重	qivs
嚆矢	hcui
嚎啕	hctc
嚎啕大哭	htdk
囊萤照读	nyvd
囚室	qqui
四下	sixx
四世同堂	sutt
四书	siuu
四人帮	srbh
四化	sihx
四周	sivz
四块半	skbj
四处奔波	sibb
四季	siji
四川省	siug
四平	sipk
四时	siui
四眼佬	sylc
四边	sibm
回乡	hvxl
回击	hvji
回南	hvnj
回响	hvxl
回填	hvtm
回声	hvug
回复	hvfu
回头客	htke
回头路	htlu
回忆	hvyi
回收率	hulv
回游	hvyz
回炉	hvlu
回访	hvfh
回路	hvlu
回首	hvuz
回马枪	hmql
因人制宜	yrvy
因子	ybzi
因时制宜	yuvy
因由	ybyz
因缘	ybyr
囡囡	njnj
团中央	tvyh
团体操	ttcc
团员	tryr
团拜	trbd
团支部	tvbu
团旗	trqi
团日	trri
团职	trvi
团部	trbu
园丁	yrdk
园地	yrdi
园子	yrzi
园艺	yryi
园长	yrvh
困难户	knhu
围垦	wwkf
围巾	wwjb
围歼	wwjm
围追	wwvv
囹圄	lkyu
固之然	gvrj
固始	guui
固定资产	gdzi
固步自封	gbzf
固沙林	gulb
固然之	grvi
固话	guhx
固顶	gudk
国书	gouu
国事	goui
国产货	giho
国企	goqi
国会	gohv
国体	goti
国内外	gnwd
国务卿	gwqk
国务院	gwyr
国势	goui
国史	goui
国君	gojy
国境线	gjxm
国威	goww
国宴	goyj
国宾馆	gbgr
国富民强	gfmq
国库券	gkqr
国度	godu
国情	goqk
国政	govg
国教	gojn
国文	gowf
国旗	goqi
国格	goge
国民军	gmjy
国民经济	gmjj
国界	gojp
国立	goli
国籍	goji
国美	gomw
国花	gohx
国语	goyu
国都	godu
国防军	gfjy
国防部	gfbu
国际主义	gjvy
国际法	gjfa
图书室	tuui
图表	tubn
图象	tuxl
圆圆	yryr
圆圈	yrqr
圆寂	yrji
圆明园	ymyr
圆木警枕	ymjv
圆柱	yrvu
圆珠笔	yvbi
圆蹄	yrti
圈阅	qryt
土专家	tvjx
土丘	tuqq
土坡	tupo
土墙	tuql
土家族	tjzu
土层	tucg
土布	tubu
土库曼	tkmj
土改	tugd
土政策	tvce
土星	tuxk
土法	tufa
土石方	tufh
土著	tuvu
土话	tuhx
土质	tuvi
圣人	ugrf
圣地	ugdi
圣旨	ugvi
圣母	ugmu
圣水	uguv
圣诞树	uduu
在先	zdxm
在华	zdhx
在心	zdxb
在押犯	zyfj
在教	zdjn
在校生	zxug
在此	zdci
在读	zddu
在逃犯	ztfj
在野党	zydh
圪垯	geda
地下室	dxui
地下水	dxuv
地中海	dvhd
地价	dijx
地利	dili
地力	dili
地动仪	ddyi
地势	diui
地区性	dqxk
地图集	dtji
地块	dikk
地域	diyu
地基	diji
地处	diiu
地头	ditz
地头虫	dtis
地委	diww
地学	dixt
地层	dicg
地市	deui
地市	diui
地形图	dxtu
地心	dixb
地摊	ditj
地支	divi
地方志	dfvi
地方戏	dfxi
地方病	dfbk
地方税	dfuv
地狱	diyu
地球仪	dqyi
地理学	dlxt
地界	dijp
地痞	dipi
地矿	dikl
地磁	dici
地租	dizu
地空	deks
地空	diks
地窖	dijn
地胆	dedj
地胆	didj
地膜	dimo
地表水	dbuv
地质	divi
地道战	ddvj
地面水	dmuv
圹埌	kllh
场子	ihzi
场站	ihvj
场长	ihvh
场院	ihyr
均势	jyui
均居	jyju
均应	jyyk
均真	jyvf
坎坎坷坷	kkkk
坎坷不平	kkbp
坎头埋墙	ktmq
坏书	hkuu
坐以待旦	zydd
坐像	zoxl
坐商	zouh
坐坐	zozo
坐失	zoui
坐定粒六	zdll
坐视	zoui
坐霸王车	zbwi
坐霸王车	zbwj
块状	kkvl
坚冰	jmbk
坚定	jmdk
坚实	jmui
坚忍不拔	jrbb
坚持不渝	jiby
坚果	jmgo
坚毅	jmyi
坚苦卓绝	jkvj
坚韧	jmrf
坛子	tjzi
坟头	fftz
坟茔	ffyk
坦桑尼亚	tsny
坦诚相见	tixj
坦途	tjtu
坷垃	kela
垃圾参	ljcj
垃圾参	ljuf
垓埏	gduj
垓埏	gdyj
垫子	dmzi
埋便	mdbm
埋便	mdpm
埋便	mjbm
埋便	mjpm
埋单	mddj
埋尾	mdww
埋尾	mjww
埋数	mduu
埋数	mjuu
埋站	mdvj
埋站	mjvj
城关	iggr
城根	iggf
城郊	igjn
城郭	iggo
城里	igli
城里人	ilrf
城防	igfh
城际	igji
埕埕塔塔	iitt
培土	pwtu
培植	pwvi
培训班	pxbj
基于	jiyu
基围虾	jwxx
基址	jivi
基干	jigj
基建	jijm
基数	jiuu
基本上	jbuh
基本功	jbgs
基本法	jbfa
基点	jidm
基督	jidu
基石	jiui
基础课	jike
基站	jivj
基线	jixm
基诺	jino
基辅	jifu
基金会	jjhv
堂倌	thgr
堂吃	thii
堂座	thzo
堆放	dvfh
堆砌	dvqi
堤坝	diba
堤溃蚁穴	dkyx
堤防	difh
堪称	kjig
堪称一绝	kiyj
堵住	duvu
塌方	tafh
塑料布	slbu
塑料管	slgr
塔吉克	tjke
塔吉克族	tjkz
塔斯社	tsue
塔里木	tlmu
塞失马盲人瞎马	summ
塞浦露斯	spls
填平	tmpk
填料	tmln
填空	tmks
填词	tmci
境地	jkdi
境遇	jkyu
墒情	uhqk
墓地	mudi
墓室	muui
墓志	muvi
墓道	mudc
墙基	qlji
墙报	qlbc
墙脚	qljn
增常	zgih
增殖	zgvi
增至	zgvi
增速	zgsu
增长率	zvlv
墟冚	xukj
墨盒	mohe
墨绿色	mlse
壁炉	bilu
壁画	bihx
壁纸	bivi
壅蔽	ysbi
士多啤梨	udpl
士多房	udfh
士大夫	udfu
士巴拿	ubna
士担	uidj
士气	uiqi
士碌架	uljx
士达胆	uddj
壬午	rfwu
壬子	rfzi
壬寅	rfyb
壬戌	rfxu
壬申	rfuf
壬辰	rfif
壮士	vlui
壮实	vlui
壮志	vlvi
壮歌	vlge
声势	ugui
声名大振	umdv
声威	ugww
声学	ugxt
声张	ugvh
声息	ugxi
声振寰宇	uvhy
声浪	uglh
声称	ugig
声符	ugfu
声誉	ugyu
声誉鹊起	uyqq
声速	ugsu
处世	iuui
处事	iuui
处决	iujt
处境	iujk
处女作	inzo
处女地	indi
处方	iufh
处理机	ilji
处罚	iufa
备件	bwjm
备忘录	bwlu
备料	bwln
备考	bwkc
备耕	bwgg
备课	bwke
备足	bwzu
备齐	bwqi
复信	fuxb
复写	fuxp
复函	fuhj
复刊	fukj
复制品	fvpb
复印机	fyji
复合	fuhe
复员	fuyr
复审	fuuf
复旦	fudj
复杂性	fzxk
复查	fuia
复核	fuhe
复种	fuvs
复线	fuxm
复议	fuyi
复试	fuui
复读	fudu
复赛	fusd
复辟	fubi
复述	fuuu
夏令营	xlyk
夏利	xxli
夏夜	xxye
夏收	xxuz
夏新	xxxb
夏种	xxvs
夏粮	xxll
夏雨雨人	xyyr
夕阳西斜	xyxx
外乡	wdxl
外乡人	wxrf
外交部	wjbu
外伤	wduh
外侮	wdwu
外向型	wxxk
外地人	wdrf
外埠	wdbu
外带	wddd
外敌	wddi
外敷	wdfu
外来人	wlrf
外来户	wlhu
外柔中刚	wrvg
外母	wdmu
外汇券	whqr
外甥	wdug
外相	wdxl
外祖父	wzfu
外线	wdxm
外经	wdjk
外貌	wdmc
外逃	wdtc
外遇	wdyu
多一尐	dydi
多于	doyu
多价	dojp
多价	dojx
多位	doww
多办	dobj
多只香炉多只鬼	dvxg
多哥	doge
多国	dogo
多多少少	dduu
多多益善	ddyu
多媒体	dmti
多得	dode
多得	dodw
多方面	dfmm
多样化	dyhx
多样性	dyxk
多民族	dmzu
多种多样	dvdy
多糖	doth
多级	doji
多边	dobm
多面手	dmuz
夜冷	yelg
夜宿	yesu
夜市	yeui
夜幕低垂	ymdi
夜总会	yzhv
夜战	yevj
夜明珠	ymvu
夜晚黑	ywhw
夜景	yejk
夜校	yexn
夜游	yeyz
夜色柔美	ysrm
夜色柔美	yurm
夜色迷人	ysmr
夜色迷人	yumr
夜莺	yeyk
夜麻麻	ymma
够照	gzvc
够皮	gzpi
够胆死	gdsi
大一统	dyts
大专生	dvug
大业	daye
大个仔	dgzd
大个仔	dgzi
大为	daww
大举	daju
大义	dayi
大乡里	dxli
大书特书	dutu
大事记	duji
大人	darf
大人大姐	drdj
大件事	djui
大任	darf
大任	ddrf
大伙	daho
大会堂	dhth
大作家	dzjx
大使	daui
大使馆	dugr
大侠	daxx
大便	dabm
大信封	dxfg
大做文章	dzwv
大光灯	dgdg
大全	daqr
大关	dagr
大兴	daxk
大兵	dabk
大兵团	dbtr
大刀	dadc
大别山	dbuj
大剂	daji
大剂	ddji
大副	dafu
大力	dali
大力士	dlui
大办	dabj
大动脉	ddmd
大势	daui
大半	dabj
大厅	datk
大叔	dauu
大只佬	dvlc
大只讲	dvjl
大只骡骡	dvll
大号	dahc
大吃大喝	didh
大同	dats
大后方	dhfh
大后日	dhri
大唐	dath
大唐	ddth
大唔透	dwtz
大喊十	dhui
大喜事	dxui
大嘥	dasd
大嘥	ddsd
大器	daqi
大团圆	dtyr
大团结	dtjp
大坝	daba
大型机	dxji
大声公	dugs
大处着眼	divy
大多数	dduu
大大小小	ddxx
大大话话	ddhh
大头佛	dtfo
大头佛	dtfu
大头虾	dtxx
大奖赛	djsd
大好山河	dhuh
大妈	dama
大妗姐	djjp
大姐	dajp
大姐仔	djzd
大姐仔	djzi
大姑娘	dgnl
大婆	dapo
大婆	ddpo
大嫂	dasc
大字	dazi
大字报	dzbc
大客车	dkie
大家庭	djtk
大寨	davd
大将	dajl
大小便	dxbm
大展	davj
大师	daui
大师傅	dufu
大帝	dadi
大帝	dddi
大幅	dafu
大幅度	dfdu
大干	dagj
大床	dail
大床	ddil
大志	davi
大懵	damg
大懵	ddmg
大戏	daxi
大手笔	dubi
大打出手	ddiu
大抵	dadi
大拇指	dmvi
大拿拿	dnna
大捷	dajp
大政	davg
大敌	dadi
大新	daxb
大旱	dahj
大智大勇	dvdy
大曲	daqu
大有文章	dywv
大杀三方	dusf
大杂院	dzyr
大校	daxn
大梁	dall
大棒	dabh
大模斯样	dmsy
大殿	dadm
大气候	dqhz
大水	dauv
大汉	dahj
大汗淋漓	dhll
大法	dafa
大渡河	ddhe
大漠	damo
大潮	daic
大炮友	dbyz
大炮友	dpyz
大牌档	dpdh
大猩猩	dxxk
大班	dabj
大理	dali
大田	datm
大略	dalt
大癫大废	dddf
大白	dabd
大白菜	dbcd
大石责死蟹	ddzx
大石责死蟹	duzx
大破悭囊	dpqn
大礼堂	dlth
大祸	daho
大禹	dayu
大禹	ddyu
大笑	daxn
大笑姑婆	dxgp
大粒佬	dllc
大细超	dxic
大老倌	dlgr
大耳窿	dels
大肆	dasi
大脚	dajn
大腕	dawj
大自然	dzrj
大花大朵	dhdd
大花筒	dhts
大茶饭	difj
大菜	dacd
大葵扇	dkuj
大蒜	dasr
大虾	daxx
大衣	dayi
大西北	dxbw
大要	dayc
大观	dagr
大规模	dgmo
大觉瞓	djff
大觉瞓	djxy
大计	daji
大豆芽	ddya
大败	dabd
大跃进	dyjb
大路	dalu
大路货	dlho
大踏步	dtbu
大轰大嗡	dhdw
大过	dago
大道	dadc
大部	dabu
大部分	dbff
大都	dadu
大都	dadz
大钱	daqm
大镬饭	dhfj
大阪	dabj
大阵仗	dvvh
大陆架	dljx
大雅	daya
大雨	dayu
大雨滂沱	dypt
大雪	daxt
大雪封山	dxfu
大雪纷飞	dxff
大雾	dawu
大革命	dgmk
大飞	dafw
大飞	ddfw
大食会	dshv
大食会	dskk
大食会	duhv
大食会	dukk
大食会	dyhv
大食会	dykk
大食懒	dslj
大食懒	dulj
大食懒	dylj
大饼	dabk
大髀	dabi
大髀	ddbi
大鱼	dayu
大鱼	ddyu
大鸡唔食细米	djwm
大麦	damd
大麻	dama
大鼓	dagu
天上人间	turj
天不怕	tbpa
天主	tmvu
天井	tmjk
天仙	tmxm
天仙局	txju
天公	tmgs
天兵天将	tbtj
天南海北	tnhb
天命	tmmk
天堂尿壶全神贯注	ttnv
天堑	tmqm
天外有天	twyt
天女散花	tnsh
天崩地塌	tbdt
天府	tmfu
天敌	tmdi
天数	tmuu
天文学	twxt
天文馆	twgr
天时	tmui
天时冷	tulg
天时暑热	tuur
天时热	ture
天极	tmji
天梯	tmti
天棚	tmpg
天津市	tjui
天涯比邻	tybl
天生天养	tuty
天穹	tmqs
天网恢恢疏而不漏	twhl
天职	tmvi
天脚底	tjdi
天象	tmxl
天资	tmzi
天遂人愿	tsry
天际	tmji
天险	tmxm
天马行空	tmxk
天高云淡	tgyd
太原	tdyr
太原市	tyui
太和	tdhe
太和	tdho
太和	tdhu
太子爷	tzye
太守	tduz
太平天国	tptg
太平绅士	tpuu
太庙	tdmn
太行山	thuj
夫子	fuzi
央视	yhui
失业	uiye
失主	uivu
失事	uiui
失利	uili
失地	uidi
失声	uiug
失学	uixt
失守	uiuz
失实	uiui
失常	uiih
失态	uitd
失惊无神	ujmu
失惊无神	ujwu
失意	uiyi
失掉	uidn
失控	uiks
失散	uisj
失明	uimk
失火	uiho
失物	uiwu
失真	uivf
失礼	uili
失禁	uijb
失职	uivi
失聪	uics
失血	uixt
失觉	uijn
失觉	uijt
失语	uiyu
失误	uiwu
失足	uizu
失身	uiuf
失重	uivs
失魂鱼	uhyu
头人	tzrf
头啖汤	tdth
头壳顶	tkdk
头壳顶	tqdk
头大冇脑	tdmn
头头	tztz
头子	tzzi
头崩额裂	tbel
头拧拧	tnnk
头槌	tziv
头球	tzqq
头盔	tzkv
头盖骨	tggu
头羊	tzyh
头耷耷	tdda
头蜡	tzla
头赤	tzii
头雁	tzyj
头面人物	tmrw
头颅	tzlu
头饰	tzui
夸父追日	kfvr
夹份	gaff
夹份	jxff
夹击	jxji
夹子	jxzi
夹手夹脚	gugj
夹手夹脚	gujj
夹手夹脚	jugj
夹手夹脚	jujj
夹板	jxbj
夹硬	gayk
夹硬	jxyk
夹道	jxdc
夺魁	dokv
奀瘦	enuz
奀瘦	nfuz
奀袅鬼命	engm
奀袅鬼命	nngm
奀雌雌	ecci
奀雌雌	ncci
奄列	yjlp
奄尖	yjjm
奇丽	qili
奇事	qiui
奇兵	qibk
奇功	qigs
奇境	jijk
奇境	qijk
奇峰	qifg
奇巧	qiqn
奇才	qicd
奇景	qijk
奇瑞	jirv
奇瑞	qirv
奇花异果	jhyg
奇花异果	qhyg
奇袭	qixi
奇观	qigr
奇遇	qiyu
奇闻	qiwf
奉之	fgvi
奉命唯谨	fmwj
奉旨成婚	fvih
奋力	ffli
奋发	fffa
奋发有为	ffyw
奋发蹈厉	ffdl
奋笔疾书	fbju
奋起	ffqi
奏折	zzve
奏鸣曲	zmqu
契弟	qidi
契弟	xpdi
契机	qiji
契税	qiuv
契约	qiyt
契阔	qiko
契阔	xpko
奔扑	bfpu
奔袭	bfxi
奔走相告	bzxg
奖学金	jxjb
奖罚分明	jffm
套印	tcyb
套房	tcfh
套种	tcvs
套话	tchx
套购	tcgz
套近乎	tjhu
奠基	dmji
奢侈品	uipb
奥美	aomw
女中音	nvyb
女主人	nvrf
女仔之家	nzvj
女娲	nvwa
女式	nvui
女星	nvxk
女界	nvjp
女真	nvvf
女童院	ntyr
女高音	ngyb
奴隶	nuli
奴隶制	nlvi
奴隶社会	nluh
奶制品	nvpb
奸商	jmuh
奸猫	jmmc
奸赖	jmld
她们	tamf
好不	hcbu
好人事	hrui
好人好事	hrhu
好使	hcui
好受	hcuz
好嘅	hcge
好嘢	hcye
好地地	hdde
好地地	hddi
好处费	hifw
好多时	hdui
好夹	hcga
好夹	hcjx
好好先生	hhxu
好容易	hryi
好强	hcql
好心机	hxji
好找	hcvc
好日子	hrzi
好消息	hxxi
好眼界	hyjp
好端端	hddr
好翻	hcfj
好胜	hcug
好话	hchx
好象	hcxl
好问则裕	hwzy
好闲	hcxm
如临探渊	rlty
如常	ruih
如故	rugu
如醉如痴	rzri
妄言	whyj
妇人	furf
妇幼	fuyz
妈妈声	mmug
妊娠	rfuf
妒嫉	duji
妓院	jiyr
妖冶	ycye
妙曼	mnmj
妲己	daji
妹钉	mwdk
姊夫	zifu
始于	uiyu
始发	uifa
始发站	ufvj
始建	uijm
始祖	uizu
始终不渝	uvby
姐手姐脚	jujj
姑勿论	gwly
姑息	guxi
姑爷仔	gyzd
姑爷仔	gyzi
姓氏	xkui
姓赖	xkld
委任	wwrf
委员会	wyhv
委员长	wyvh
委实	wwui
委托书	wtuu
委托人	wtrf
委曲	wwqu
委蛇	wwue
姗姗	ujuj
姗姗来迟	uuli
姚明	ycmk
姜酌	jlvo
姜醋	jlcu
姣尸扽笃	judd
姣尸扽笃	xudd
姨仔	yizd
姨仔	yizi
姨甥	yiug
姻娅	ybya
姽婳	gvhx
姿容	zirs
威化饼	whbk
威吓	wwhe
威士	wwui
威士忌	wuji
威廉	wwlm
威望素着	wwsv
威海	wwhd
威盛	wwig
威盛	wwug
威逼	wwbi
威震天下	wvtx
威风	wwfg
威风八面	wfbm
娃子	wazi
娇小	jnxn
娇气	jnqi
娇艳	jnyj
娓娓	wwww
娘子军	nzjy
娼妓	ihji
婉娩	wjmm
婉言	wjyj
婕妤	jpyu
婚丧嫁娶	hsjq
婚姻法	hyfa
婞直	xkvi
婵媛	ijyr
婵连	ijlm
媒人	mwrf
媞媞	titi
嫁人	jxrf
嫁妆	jxvl
嫁衣	jxyi
嫖赌饮吹	pdyi
嫡系	dixi
嬉笑	xixn
嬉闹	xinc
嬲爆爆	nbbc
子公司	zgsi
子午线	zwxm
子姜	zijl
子弟兵	zdbk
子母床	zmil
子系统	zxts
子集	ziji
孑孓	jpjt
孔府	ksfu
孔隙	ksxi
孔雀	ksqt
孕期	yyqi
孖公仔	mgzd
孖公仔	mgzi
孖公仔	zgzd
孖公仔	zgzi
孖女	manv
孖女	zinv
孖烟通	myts
孖烟通	zyts
孖生	maug
孖生	ziug
孖辫	mabm
孖辫	zibm
孖铺	mapu
孖铺	zipu
字句	ziju
字号	zihc
字幕	zimu
字序	zixu
字形	zixk
字样	ziyh
字粒	zili
字花	zihx
字距	ziju
字迹	ziji
字集	ziji
字音	ziyb
存储器	ciqi
存栏	cylj
存货	cyho
孙中山	svuj
孙文	sywf
孙权	syqr
孙武	sywu
孙氏	syui
孙膑	sybb
孝子	xnzi
孝心	xnxb
孟加拉国	mjlg
孢子	bczi
季刊	jikj
季节性	jjxk
季风	jifg
孤云野鹤	gyyh
孤寂	guji
孤寡老人	gglr
孤拐	gugk
孤本	gubf
孤立	guli
孤身一人	guyr
学业	xtye
学习班	xxbj
学分制	xfvi
学制	xtvi
学力	xtli
学友	xtyz
学员	xtyr
学堂	xtth
学士	xtui
学好	xthc
学子	xtzi
学师仔	xuzd
学师仔	xuzi
学时	xtui
学有专长	xyvi
学有所成	xysi
学术性	xuxk
学术界	xujp
学杂费	xzfw
学生会	xuhv
学生哥	xuge
学生证	xuvg
学童	xtts
学籍	xtji
学而不倦	xebj
学贯中西	xgvx
学部	xtbu
孩子王	hzwh
孰不可忍	ubkr
孳生	ziug
宁为玉碎不为瓦全	nwyq
宁折不弯	nubw
宁折不弯	nvbw
宅基地	vjdi
宇宙观	yvgr
宇航员	yhyr
守军	uzjy
守势	uzui
守卫	uzww
守土有责	utyz
守备	uzbw
守宫	uzgs
守敌	uzdi
守正不阿	uvba
守正不阿	uvbe
守法	uzfa
守经达权	ujdq
守行为	uhww
守行为	uxww
守门员	umyr
安份守己	afuj
安保	anbc
安内攘外	anrw
安南	annj
安士	anui
安妮	anni
安徒生	atug
安老院	alyr
安腾	antg
安达	anda
宋庆龄	sqlk
宋明理学	smlx
宋楚瑜	siyu
完好无损	whws
完小	wjxn
完税	wjuv
宏亮	hsll
宏基	hsji
宗师	zsui
宗旨	zsvi
宗法	zsfa
官仔骨骨	gzgg
官吏	grli
官商	gruh
官气	grqi
官渡	grdu
官职	grvi
官衔	grxm
宙斯	vzsi
定单	dkdj
定单	dkij
定单	dkuj
定夺	dkdo
定局	dkju
定居点	djdm
定性	dkxk
定晒形	duxk
定理	dkli
定盘星	dpxk
定神	dkuf
定级	dkji
定西	dkxi
定货	dkho
定购	dkgz
定过抬油	dgty
宜于	yiyu
宜人	yirf
宜兴	yixk
宜得	yide
宜得	yidw
宜昌	yiih
宝刀	bcdc
宝剑	bcjm
宝安	bcan
宝岛	bcdc
宝洁	bcjp
宝玉	bcyu
宝珠	bcvu
实业	uiye
实习生	uxug
实事	uiui
实例	uili
实净	uijk
实名	uimk
实地	uidi
实处	uiiu
实心	uixb
实情	uiqk
实打实	udui
实招	uivc
实效	uixn
实时	uiui
实测	uice
实牙实齿	uyui
实物	uiwu
实用	uiys
实职	uivi
实证	uivg
实达	uida
实验室	uyui
审判员	upyr
审判庭	uptk
审察	ufia
审慎	ufuf
审时度势	uudu
审校	ufjn
审校	ufxn
审稿	ufgc
审美观	umgr
审视	ufui
客体	keti
客座	kezo
客服	kefu
客机	keji
客流量	klll
客船	keir
客观性	kgxk
客货	keho
客运站	kyvj
宣传员	xiyr
宣传品	xipb
宣传画	xihx
宣传部	xibu
宣传队	xidv
宣战	xrvj
宣纸	xrvi
宣统	xrts
室内乐	unyt
宪兵	xmbk
宪政	xmvg
宪章	xmvh
宫殿	gsdm
宴席	yjxi
宴请	yjqk
家丁	jxdk
家世	jxui
家中	jxvs
家乡话	jxhx
家书	jxuu
家事	jxui
家什	jxui
家信	jxxb
家俬	jxsi
家务活	jwho
家史	jxui
家婆	jxpo
家嫂	jxsc
家宴	jxyj
家家	jxjx
家小	jxxn
家居	jxju
家常便饭	jibf
家法	jxfa
家访	jxfh
家长制	jvvi
家风	jxfg
容光	rsgl
宽余	kryu
宽大为怀	kdwh
宽打窄用	kdvy
宾妹	bbmw
宿命论	smly
宿将	sujl
宿愿	suyr
宿敌	sudi
寂然无声	jrmu
寂然无声	jrwu
寄予	jiyu
寄信	jixb
寄宿	jisu
寄居	jiju
寄语	jiyu
寅吃卯粮	yiml
密不可分	mbkf
密件	mijm
密友	miyz
密密	mimi
密密匝匝	mmzz
密密麻麻	mmmm
密布	mibu
密底算盘	mdsp
密植	mivi
密歇根	mxgf
密电	midm
密笼	mils
密质质	mvvi
密闭	mibi
密集型	mjxk
富丽	fuli
富于	fuyu
富人	furf
富余	fuyu
富士	fuui
富士康	fukh
富士通	futs
富庶	fuuu
富矿	fukl
富豪	fuhc
富贵浮云	fgfy
富饶	furc
寒冬腊月	hdly
寒士	hjui
寒夜	hjye
寒底	hjdi
寒意	hjyi
寒暑	hjuu
寒暑假	hujx
寒背	hjbw
寒花晚节	hhwj
寒门	hjmf
寒风刺骨	hfcg
寓于	yuyu
寓意	yuyi
寓言	yuyj
察看	iakj
寡佬	gxlc
寡母婆	gmpo
寤寐	wumw
寥寥	lnln
寨子	vdzi
寰宇	hryu
寰球	hrqq
寸心	cyxb
寸步不让	cbbr
对仗	dvvh
对劲	dvjb
对华	dvhx
对唔住	dwvu
对唱	dvih
对外开放	dwkf
对打	dvda
对抗赛	dksd
对换	dvhr
对角	dvjn
对讲机	djji
寻医	xyyi
寻机	xyji
寻根	xygf
导出	dciu
导师	dcui
导报	dcbc
导火线	dhxm
导言	dcyj
寿光	uzgl
寿星公	uxgs
寿险	uzxm
封山	fguj
封山育林	fuyl
封建主义	fjvy
封建社会	fjuh
封豕长蛇	fuiu
封豕长蛇	fuvu
封闭式	fbui
射击	ueji
射程	ueig
射线	uexm
将于	jlyu
将伯之助	jbvv
将士	jlui
将官	jlgr
将就	jljq
将才	jlcd
将有	jlyz
将近	jljb
小两口	xlkz
小事	xnui
小人	xnrf
小人物	xrwu
小伙	xnho
小伙子	xhzi
小传	xnvr
小兄弟	xxdi
小册子	xczi
小刀	xndc
小分队	xfdv
小厣	xnyj
小号	xnhc
小合唱	xhih
小名	xnmk
小商品	xupb
小国	xngo
小圈子	xqzi
小夜曲	xyqu
小字	xnzi
小字辈	xzbw
小学生	xxug
小家庭	xjtk
小将	xnjl
小小	xnxn
小小说	xxuo
小市民	xumb
小康之家	xkvj
小弟弟	xddi
小径	xnjk
小心谨慎	xxju
小憩	xnqi
小户	xnhu
小数怕长计	xupj
小日子	xrzi
小时	xnui
小曲	xnqu
小朋友	xpyz
小溪	xnxi
小燕子	xyzi
小生	xnug
小生产	xuij
小百货	xbho
小组长	xzvh
小结	xnjp
小节	xnjp
小费	xnfw
小资	xnzi
小道	xndc
小金库	xjku
小钱	xnqm
小雨	xnyu
小雪	xnxt
小青年	xqnm
小鞋	xnxp
小题大作	xtdz
少不了	ubln
少不得	ubde
少先队	uxdv
少先队员	uxdy
少壮派	uvpd
少尉	ucww
少年宫	ungs
少年犯	unfj
少有	ucyz
尖兵	jmbk
尖刀	jmdc
尖刻	jmke
尖尖	jmjm
尖端	jmdr
尖笔甩	jbuk
尖顶	jmdk
尚书	uhuu
尚属	uhuu
尚属	uhvu
尚方宝剑	ufbj
尚无	uhmo
尚无	uhwu
尚武	uhwu
尨茸	lsrs
尨茸	mgrs
尨茸	mhrs
尨茸	phrs
就任	jqrf
就位	jqww
就势	jqui
就嚟	jqli
就嚟	jqlw
就学	jqxt
就已	jqyi
就职	jqvi
就脚	jqjn
就说	jquo
就说	jquv
就说	jqyt
尸体	uiti
尸骨	uigu
尺子	iizi
尺牍	iidu
尼克松	nkss
尼古丁	ngdk
尽人皆知	jrjv
尽可能	jkng
尽地一煲	jdyb
尽如	jbru
尽心尽力	jxjl
尽心竭力	jxjl
尽收眼底	juyd
尽职	jbvi
尾声	wwug
尾翼	wwyi
尾随	wwsv
尾龙骨	wlgu
尿毒症	ndvg
局外人	jwrf
局限性	jxxk
层层叠叠	ccdd
层峦叠嶂	cldv
居于	juyu
居功	jugs
居士	juui
居室	juui
居民点	jmdm
居留	julq
居留权	jlqr
居留证	jlvg
屈尾十	qwui
屈戌	quxu
屈节辱命	qjrm
屈蛇	quue
屈质	quvi
届时	jpui
屋契	wuqi
屋契	wuxp
屋子	wuzi
屋脊	wuji
屋角	wujn
屎坑关刀	ukgd
屎坑关刀文唔得武唔得	ukgd
屎片	uipm
屎计	uiji
屏息	bkxi
屏气	bkqi
屏气敛息	pqlx
展台	vjtd
展室	vjui
展览会	vlhv
展览馆	vlgr
展评	vjpk
展销会	vxhv
屘二	mier
屘二	mjer
属实	uuui
屠宰场	tzih
屠户	tuhu
屯兵	tybk
山东省	udug
山中宰相	uvzx
山乡	ujxl
山冈	ujgh
山势	ujui
山包	ujbc
山墙	ujql
山大斩埋有柴	udvi
山山水水	uuuu
山明水秀山穷水尽	umuj
山梁	ujll
山水画	uuhx
山泥倾泻	unqx
山洞	ujds
山海关	uhgr
山海经	uhjk
山涧	ujjm
山窿	ujls
山脊	ujji
山腰	ujyc
山芋	ujyu
山草药噏得就噏	ucyh
山草药噏得就噏	ucyx
山药蛋	uydj
山西省	uxug
山货	ujho
山重水复	uiuf
山重水复	uvuf
山野	ujye
山陵	ujlk
山高水长	ugui
山麓	ujlu
屹立	yili
岁寒松柏	shsb
岂止	qivi
岂非	qifw
岌岌贡	jjgs
岛国	dcgo
岛礁	dcjn
岩浆	yjjl
岩溶	yjrs
岩画	yjhx
岩石	yjui
岳家	ytjx
岳飞	ytfw
岳高头	ygtz
岸防	anfh
峥嵘	vgrs
峨嵋	eemw
峨嵋山	emuj
峰值	fgvi
峰峦雄伟	flxw
峻岭	jylk
峻峭	jyqn
崄巇	xmxi
崇敬	isjk
崇文	iswf
崔健	cvjm
崔嵬	cvww
崔巍	cvww
崖广	yagl
崚嶒	lgcg
崚嶒	lkcg
崦嵫	yjzi
崩沙	bgua
崴嵬	wwww
嵇康	jikh
嵚崟	qbyb
嵯峨	coee
嶙峋	lbxy
巉岩	ijyj
巉眼	ijyj
巍巍	wwww
巍然	wwrj
州立	vzli
巡抚	xyfu
巡洋舰	xyjm
巡游	xyyz
巡诊	xyvf
巡逻艇	xltk
巡逻队	xldv
工业化	gyhx
工业区	gyqu
工业品	gypb
工业国	gygo
工业界	gyjp
工业部	gybu
工事	gsui
工人阶级	grjj
工伤	gsuh
工余	gsyu
工作台	gztd
工作团	gztr
工作日	gzri
工作服	gzfu
工作站	gzvj
工作组	gzzu
工作者	gzve
工作证	gzvg
工作量	gzll
工作间	gzjm
工作队	gzdv
工作面	gzmm
工兵	gsbk
工具书	gjuu
工农业	gnye
工农兵	gnbk
工农联盟	gnlm
工分	gsff
工区	gsqu
工友	gsyz
工商业	guye
工商界	gujp
工商联	gulm
工头	gstz
工委	gsww
工学院	gxyr
工工整整	ggvv
工效	gsxn
工整	gsvg
工时	gsui
工潮	gsic
工种	gsvs
工科	gske
工笔画	gbhx
工联	gslm
工艺	gsyi
工资制	gzvi
左传	zoir
左传	zovr
左便	zobm
左便	zopm
左手便	zubm
左手便	zupm
左提右挈	zdyq
左提右挈	ztyq
左翼	zoyi
左軚车	ztie
左軚车	ztju
巧干	qngj
巧手	qnuz
巧立名目	qlmm
巨响	juxl
巨商	juuh
巨型	juxk
巨头	jutz
巨子	juzi
巨幅	jufu
巨星	juxk
巨细	juxi
巨著	juvu
巨资	juzi
巩俐	gsli
巫峡	wuxx
巫师	wuui
巫术	wuuu
差佬	cilc
差佬	ialc
差佬	idlc
差唔多	cwdo
差唔多	iwdo
差旅费	ilfw
差迟	ciii
差迟	iaii
差迟	idii
差错率	iclv
己丑	jiiz
己亥	jihd
己任	jirf
己卯	jimc
己巳	jisi
己方	jifh
己未	jiww
己酉	jiyz
已久	yijq
已知	yivi
已获	yiho
巴士	baui
巴格达	bgda
巴比伦	bbly
巴解组织	bjzv
巴金	bajb
巷子	xlzi
巷道	hhdc
币值	bivi
市价	uijx
市侩	uikk
市值	uivi
市内	uinw
市区	uiqu
市县	uixm
市委	uiww
市属	uiuu
市布	uibu
市府	uifu
市电	uidm
市盈率	uylv
市辖区	uxqu
市郊	uijn
市镇	uivf
市集	uiji
市面	uimm
布什	buui
布依族	byzu
布冧	bulf
布升	buug
布告	bugc
布帛蔬栗	bbul
布拉格	blge
布料	buln
布朗	bulh
布满	bumj
布网	buwh
布衣	buyi
布衣蔬食	byus
布衣蔬食	byuu
布衣蔬食	byuy
布设	buue
布谷鸟	bgnn
布达佩斯	bdps
布防	bufh
布隆迪	bldi
布雷	bulw
布鞋	buxp
帆板	fjbj
师友	uiyz
师团	uitr
师大	uida
师徒	uitu
师法	uifa
师父	uifu
师爷	uiye
师生员工	uuyg
师职	uivi
师范	uifj
师资	uizi
师部	uibu
希冀	xiji
希区柯克	xokk
希区柯克	xqkk
希特勒	xtle
帐户	vhhu
帐目	vhmu
帕森	pasf
帘子	lmzi
帝制	divi
帡幪	pkmg
带兵	ddbk
带头人	dtrf
带子	ddzi
带宽	ddkr
带状	ddvl
带电	dddm
带眼识人	dyur
带眼识人	dyvr
带鱼	ddyu
席子	xizi
帮下眼	bxyj
帮办	bhbj
帮教	bhjn
帷幄	wwwo
常事	ihui
常任	ihrf
常会	ihhv
常备不懈	ibbx
常委	ihww
常委会	iwhv
常州	ihvz
常抓不懈	ivbx
常数	ihuu
常理	ihli
幅员	fuyr
干休所	gxso
干劲	gjjb
干吗	gjma
干妈	gjma
干将	gjjl
干扰素	grsu
干支	gjvi
干果	gjgo
干渠	gjqu
干湿褛	gulv
干电池	gdii
干系	gjxi
干群	gjqy
干脆利落	gcll
干草	gjcc
干警	gjjk
干预	gjyu
干鲜果	gxgo
平价	pkjx
平信	pkxb
平分	pkff
平反	pkfj
平均主义	pjvy
平均值	pjvi
平均数	pjuu
平安米	pami
平定	pkdk
平实	pkui
平局	pkju
平平	pkpk
平平常常	ppii
平心静气	pxjq
平房	pkfh
平整	pkvg
平易	pkyi
平正	pkvg
平沽	pkgu
平炉	pklu
平视	pkui
平顶山	pduj
年下	nmxx
年事已高	nuyg
年产值	nivi
年产量	nill
年历	nmli
年头	nmtz
年岁	nmsv
年成	nmig
年景	nmjk
年率	nmlv
年画	nmhx
年货	nmho
年轻气盛	nqqu
年鉴	nmjm
年间	nmjm
年青	nmqk
年青人	nqrf
年饭	nmfj
并发	bkfa
并发症	bfvg
并立	bkli
并网	bkwh
并能	bkng
并行不悖	bxbb
并请	bkqk
幸事	xkui
幸存者	xcve
幻影	hryk
幻灯片	hdpm
幼子	yzzi
幼学壮行	yxvh
幼学壮行	yxvx
幼小	yzxn
幼师	yzui
幼教	yzjn
幼芽	yzya
幽会	yzhv
幽幽	yzyz
幽深	yzuf
幽门	yzmf
幽雅	yzya
幽香	yzxl
幽默感	ymgj
广东省	gdug
广交会	gjhv
广博	glbo
广州市	gvui
广播剧	gbju
广播员	gbyr
广电	gldm
广达	glda
庄园	vlyr
庄户人	vhrf
庄稼	vljx
庄稼人	vjrf
庄稼地	vjdi
庄稼汉	vjhj
庆典	qkdm
庆功	qkgs
庆幸	qkxk
床下底	ixdi
床笫	ilzi
序跋	xuba
库区	kuqu
库容	kurs
应从	ykcs
应允	ykyy
应力	ykli
应届	ykjp
应得	ykde
应战	ykvj
应有	ykyz
应试	ykui
应运	ykyy
底下	dixx
底子	dizi
底板	dibj
底气	diqi
底盘	dipj
底肥	difw
底衫	diuj
底衫裤	duku
底部	dibu
店员	dmyr
店堂	dmth
店家	dmjx
庙会	mnhv
庙宇	mnyu
庚午	ggwu
庚子	ggzi
庚寅	ggyb
庚戌	ggxu
庚申	gguf
庚辰	ggif
府上	fuuh
府第	fudi
府邸	fudi
废弃物	fqwu
废料	fwln
废止	fwvi
废气	fwqi
废油	fwyz
度假	dujx
度假屋	djwu
度数	duuu
度身订造	dudz
度量	dull
度量衡	dlhg
座右铭	zymk
座次	zoci
座谈会	zthv
庭园	tkyr
庭审	tkuf
庭院	tkyr
康健	khjm
康宁	khnk
康庄大道	kvdd
康有为	kyww
庸中佼佼	yvjj
庸人	ysrf
庸医	ysyi
庸庸碌碌	yyll
廉正	lmvg
廉洁	lmjp
廉记	lmji
延吉	yjji
延误	yjwu
建于	jmyu
建交	jmjn
建制	jmvi
建国	jmgo
建工	jmgs
建成	jmig
建材	jmcd
建树	jmuu
建站	jmvj
建筑业	jvye
建设性	juxk
建设者	juve
建起	jmqi
建都	jmdu
开便	kdbm
开便	kdpm
开出	kdiu
开刀	kddc
开列	kdlp
开化	kdhx
开发区	kfqu
开喉	kdhz
开国	kdgo
开市	kdui
开幕词	kmci
开征	kdvg
开心见诚	kxji
开战	kdvj
开方	kdfh
开曼	kdmj
开架	kdjx
开眼	kdyj
开矿	kdkl
开禁	kdjb
开脱	kdto
开航	kdhh
开讲	kdjl
开诚相见	kixj
开道	kddc
开镰	kdlm
开门红	kmhs
异乡	yixl
异化	yihx
异味	yiww
异域	yiyu
异己	yiji
异彩	yicd
异性	yixk
异族	yizu
异样	yiyh
异步	yibu
异物	yiwu
异端	yidr
异类	yilw
异议	yiyi
弃旧图新	qjtx
弃权	qiqr
弃置	qivi
弃若敝屐	qrbj
弄堂	lsth
式微	uiww
弓箭	gsjm
引人	ybrf
引人注意	yrvy
引人深思	yrus
引信	ybxb
引力	ybli
引向	ybxl
引咎自责	yjzz
引子	ybzi
引水	ybuv
引渡	ybdu
引申	ybuf
引种	ybvs
引线	ybxm
引航	ybhh
引资	ybzi
引路	yblu
引退	ybtv
引锥刺股	yvcg
弘毅	hsyi
弟媳	dixi
张大	vhda
张大	vhdd
张天师遇鬼迷	vtum
张家界	vjjp
弧形	huxk
弯弯	wjwj
弯弯曲曲	wwqq
弹琴	djqb
弹琴	tjqb
弹词	tjci
弹道	djdc
强人	qlrf
强健	qljm
强占	qlvj
强压	qlya
强手	qluz
强有力	qyli
强权政治	qqvv
强渡	qldu
强风	qlfg
归于	gvyu
归入	gvru
归公	gvgs
归根结蒂	ggjd
归程	gvig
归途	gvtu
当佢冇到	dkmd
当佢冇到	dqmd
当做	dhzo
当地人	ddrf
当家作主	djzv
当政	dhvg
当班	dhbj
当衰	dhuk
当道	dhdc
录像机	lxji
录像片	lxpm
录音带	lydd
录音棚	lypg
形势逼人	xubr
形容词	xrci
形式主义	xuvy
彤云密布九霄云外	tymw
彩云满天	cymt
彩卷	cdjr
彩数	cduu
彩旗	cdqi
彩灯	cddg
彩画	cdhx
彩礼	cdli
彩绘	cdhv
彩车	cdie
彩陶	cdtc
彪炳千秋	bbqq
彭德怀	pdhk
彰善瘅恶	vude
影业	ykye
影像	ykxl
影剧院	yjyr
影印	ykyb
影展	ykvj
影相机	yxji
影碟机	ydji
影评	ykpk
影集	ykji
彳亍	iiiu
彷佛	fhfo
彷佛	fhfu
彷佛	phfo
彷佛	phfu
彻里彻外	iliw
往后	whhz
往复	whfu
征召	vgvc
征文	vgwf
征服	vgfu
征购	vggz
径流	jklq
径直	jkvi
待客	ddke
徇众要求	xvyq
徇私	xysi
律师楼	lulz
律诗	lvui
徐悲鸿	xbhs
徒刑	tuxk
徒弟	tudi
徒费唇舌	tfiu
得个吉	dgji
得人惊	drjk
得以	deyi
得利	deli
得势	deui
得名	demk
得哥	dege
得哥	dwge
得啖笑	ddxn
得志	devi
得戚	deqi
得戚	dwqi
得把口	dbkz
得把声	dbug
得敕	deii
得敕	dwii
得益	deyi
得米	demi
得米	dwmi
得鱼忘筌	dywq
徙倚	xiyi
循环赛	xhsd
微型	wwxk
微处理器	wilq
微小	wwxn
微循环	wxhr
微微	wwww
微星	wwxk
微服私访	wfsf
微机	wwji
微机室	wjui
微波炉	wblu
微生物	wuwu
微电脑	wdnc
微米	wwmi
微粒	wwli
微细	wwxi
微薄	wwbo
微观	wwgr
微词	wwci
微辞	wwci
微风习习	wfxx
德厚流光	dhlg
德意志	dyvi
德政	devg
德智体	dvti
德治	devi
德育	deyu
德行	dexk
德黑兰	dhlj
徽剧	hvju
徽号	hvhc
徽州	hvvz
心上人	xurf
心事重重	xuii
心力	xbli
心劲	xbjb
心口翳	xkyi
心口针	xkvf
心喐喐	xyyu
心地	xbdi
心坚石穿	xjdi
心坚石穿	xjui
心多多	xddo
心大心细	xdxx
心如刀绞	xrdj
心室	xbui
心小志大	xxvd
心弦	xbxm
心怀	xbhk
心思思	xssi
心息	xbxi
心悸	xbji
心情靓	xqjk
心情靓	xqll
心想	xbxl
心意咭	xyji
心意咭	xyka
心慈面善	xcmu
心慌意乱	xhyl
心房	xbfh
心手相应	xuxy
心抱	xbbc
心挂挂	xggx
心曲	xbqu
心气	xbqi
心淡	xbdj
心潮	xbic
心潮起伏	xiqf
心熄	xbxi
心理	xbli
心理学	xlxt
心电图	xdtu
心窝子	xwzi
心细	xbxi
心绞痛	xjts
心绪	xbxu
心罨	xbyj
心肌	xbji
心肺	xbfw
心腹	xbfu
心虔志诚	xqvi
心血管	xxgr
心计	xbji
心迹	xbji
心郁郁	xyyu
心酸	xbsr
心里话	xlhx
心静	xbjk
心驰神往	xiuw
必修课	bxke
必有近忧	byjy
必然性	brxk
必需	bixu
忉忉	dcdc
忉怛	dcda
忌妒	jidu
忌讳	jihv
忍痛	rfts
忍辱含羞	rrhx
志向	vixl
志坚行苦	vjhk
志坚行苦	vjxk
志士	viui
志士仁人	vurr
志愿	viyr
志愿兵	vybk
志愿军	vyjy
志趣	viqu
忘年交	wnjn
忝列	tmlp
忠义	vsyi
忠于	vsyu
忠实	vsui
忠心	vsxb
忠良	vsll
忠贞	vsvf
忠骨	vsgu
忧心	yzxb
忧郁	yzyu
快劳	kklc
快板	kkbj
快脆	kkcv
快过打针	kgdv
忽地	hudi
忿恨	ffhf
怀仁	hkrf
怀化	hkhx
怀古	hkgu
怀远	hkyr
态势	tdui
怊怅	icih
怔营	vgyk
怜惜	lmxi
思乡	sixl
思思缩缩	ssss
思想家	sxjx
思想性	sxxk
思科	sike
怡然自得	yrzd
急不可耐	jbkn
急事	jiui
急于	jiyu
急件	jijm
急剧	jiju
急匆匆	jccs
急急忙忙	jjmm
急急脚	jjjn
急性	jixk
急性病	jxbk
急流	jilq
急电	jidm
急病	jibk
急行军	jxjy
急起直追	jqvv
急速	jisu
急难	jinj
急需	jixu
性命	xkmk
性生活	xuho
性药	xkyc
怨气	yrqi
怪唔知	gwvi
怯生生	quug
总书记	zuji
总产值	zivi
总产量	zill
总值	zsvi
总公司	zgsi
总动员	zdyr
总司令	zslk
总后	zshz
总工	zsgs
总工会	zghv
总指挥	zvhv
总揽	zslj
总攻	zsgs
总政	zsvg
总方针	zfvf
总机	zsji
总汇	zshv
总管	zsgr
总经理	zjli
总罢工	zbgs
总署	zsuu
总路线	zlxm
总长	zsvh
总队	zsdv
总领事	zlui
恃强凌弱	uqlr
恋歌	lmge
恐吓信	khxb
恒山	hguj
恢弘	hvhs
恤发	xufa
恩恩怨怨	eeyy
恪守不渝	kuby
恫赫	dshe
恬静	tmjk
恭听	gstk
息息相通	xxxt
恳谈会	kthv
恳谈会	ktkk
恶人	eerf
恶梦	eemg
恶死	eesi
恶死	wusi
恶死能登	esnd
恶死能登	wsnd
恶毒	eedu
恶狠狠	ehhf
恶衣恶食	eyes
恶衣恶食	eyeu
恶衣恶食	eyey
恶衣恶食	eyws
恶衣恶食	eywu
恶衣恶食	eywy
恶衣恶食	wyes
恶衣恶食	wyeu
恶衣恶食	wyey
恶衣恶食	wyws
恶衣恶食	wywu
恶衣恶食	wywy
恶语	eeyu
恹恹	yjyj
恺悌	kdti
悄悄话	qqhx
悉尼	xini
悉心	xixb
悉数	xiuu
悔之晚矣	hvwy
悔悟	hvwu
悔过	hvgo
悟性	wuxk
悠然自得	yrzd
悠长	yzih
悠闲	yzxm
悬崖勒马	xylm
悬崖峭壁	xyqb
悭皮	qmpi
悲凉	bwll
悲剧性	bjxk
悲喜剧	bxju
悲愤	bwff
悲欣交集	bxjj
悻悻	xkxk
悼怵	dciu
悼词	dcci
情义	qkyi
情势	qkui
情境	qkjk
情怨理遣	qylq
情意	qkyi
情报所	qbso
情理	qkli
情结	qkjp
情缘	qkyr
情话	qkhx
情谊	qkyi
情随事迁	qsuq
惊人之举	jrvj
惊住	jkvu
惊叹号	jthc
惊异	jkyi
惊惶失措	jhuc
惊蛇入草	jurc
惊诧	jkia
惊青	jkqk
惕厉	tili
惝恍	ihhl
惝恍	thhl
惟恐	wwks
惟我独尊	wwdz
惟有	wwyz
惟独	wwdu
惠灵顿	hldy
惠而浦	hepu
惦记	dmji
惨剧	cjju
惨淡经营	cdjy
惨白	cjbd
惩办	igbj
惩戒	igjp
惩教署	ijuu
惯例	grli
惯用	grys
想像	xlxl
想出	xliu
想必	xlbi
想想	xlxl
想来	xlld
想见	xljm
想话	xlhx
想起	xlqi
惶惶	hlhl
愁眉紧锁	imjs
愈加	yujx
愈发	yufa
愈来愈	ylyu
愈演愈烈	yyyl
愈益	yuyi
意向	yixl
意向书	yxuu
意味	yiww
意在	yizd
意境	yijk
意头	yitz
意志	yivi
意愿	yiyr
意旨	yivi
意气	yiqi
意淫	yiyb
意见书	yjuu
意见箱	yjxl
意见簿	yjbu
意识形态	yuxt
意译	yiyi
意象	yixl
意趣	yiqu
愚民	yumb
感伤	gjuh
感化官	ghgr
感官	gjgr
感慨万端	gkwd
感染力	grli
愤世疾俗	fujs
愤愤	ffff
愤愤不平	ffbp
愤慨	ffkd
愤青	ffqk
慌失失	huui
慌怕	hlpa
慎终追远	uvvy
慢性病	mxbk
慥慥	zczc
慧眼	hvyj
慭慭	ybyb
慰问信	wwxb
慰问品	wwpb
慰问团	wwtr
慰问电	wwdm
慷慨就义	kkjy
憬悟	jkwu
懂事	dsui
懈怠	xpdd
懒佬鞋	llxp
懵到上心口	mduk
懵盛盛	miig
懵盛盛	miug
懵盛盛	muig
懵盛盛	muug
懵闭闭	mbbi
戆居居	gjju
戆居居	vjju
戈壁	gebi
戊午	wuwu
戊子	wuzi
戊寅	wuyb
戊戌	wuxu
戊申	wuuf
戊辰	wuif
戋戋	jmjm
戎马一生	rmyu
戎马倥偬	rmkz
戎马生涯	rmuy
戏剧	xiju
戏剧家	xjjx
戏文	xiwf
戏曲	xiqu
戏曲界	xqjp
戏肉	xirz
戏言	xiyj
戏谑	xixt
戏迷	ximi
成事	igui
成人	igrf
成人电影	irdy
成像	igxl
成名作	imzo
成年人	inrf
成年累月	inly
成心	igxb
成方	igfh
成材	igcd
成村人	icrf
成法	igfa
成活率	ihlv
成灾	igzd
成盘	igpj
成绩单	ijdj
成色	igse
成药	igyc
成衣	igyi
成见	igjm
成风	igfg
成龙配套	ilpt
我一语	wyyu
我党	wodh
我军	wojy
我哋	wodi
我方	wofh
我条仔	wtzd
我条仔	wtzi
我条女	wtnv
我条菜	wtcd
我校	wojn
我校	woxn
我武惟扬	wwwy
戒严	jpyj
戒口	jpkz
戒备森严	jbsy
戒奶	jpnd
戒毒	jpdu
戒除	jpiu
戒骄戒操	jjjc
或是	houi
战书	vjuu
战事	vjui
战例	vjli
战利品	vlpb
战区	vjqu
战史	vjui
战国	vjgo
战士	vjui
战天斗地	vtdd
战将	vjjl
战局	vjju
战斗力	vdli
战斗员	vdyr
战时	vjui
战机	vjji
战略性	vlxk
战祸	vjho
战线	vjxm
戙笃企	ddqi
戛纳	gana
戛纳	jxna
戟指怒目	jvnm
戥穿石	didj
戥穿石	diui
戥脚	dgjn
截住	jpvu
截击	jpji
截断	jpdr
截止	jpvi
截流	jplq
截肢	jpvi
截长补短	jibd
截面	jpmm
戴夫	ddfu
戴维	ddww
户主	huvu
户口簿	hkbu
户头	hutz
房价	fhjx
房基	fhji
房客	fhke
房檐	fhyj
房龙	fhls
所剩无几	suwj
所向无前	sxmq
所向无前	sxwq
所在地	szdi
所有制	syvi
所有权	syqr
所有者	syve
所知	sovi
所见	sojm
所部	sobu
扇动	ujds
扇区	ujqu
扇子	ujzi
扊扅	yjyi
手上	uzuh
手书	uzuu
手势	uzui
手印	uzyb
手多多	uddo
手工业	ugye
手工艺	ugyi
手工艺品	ugyp
手巾	uzjb
手巾仔	ujzd
手巾仔	ujzi
手心	uzxb
手指公	uvgs
手指头	uvtz
手指尾	uvww
手指模	uvmo
手指模	uvmu
手指罅	uvxx
手推车	utie
手提包	utbc
手揗脚震	uujv
手摇	uzyc
手术刀	uudc
手术台	uutd
手术室	uuui
手杖	uzvh
手柄	uzbk
手榴弹	uldj
手气	uzqi
手瓜	uzgx
手甲	uzjx
手电筒	udts
手痕	uzhf
手笔	uzbi
手艺	uzyi
手记	uzji
手语	uzyu
手误	uzwu
手足情深	uzqu
手踭	uzvg
手迹	uzji
手雷	uzlw
手风琴	ufqb
手鼓	uzgu
才是	cdui
才智	cdvi
扎扎跳	vvtn
扎马	vama
扑水	puuv
扑灭	pump
扑簌	pusu
扑面	pumm
扑飞	pufw
打乞嗤	dqii
打交道	djdc
打仔	dazd
打仔	dazi
打仗	davh
打倒	dadc
打倒褪	ddtv
打倒褪	ddty
打假	dajx
打关斗	dgdz
打冷	dalg
打冷震	dlvf
打功夫	dgfu
打占	davj
打印机	dyji
打压	daya
打反	dafj
打同通	dtts
打咭	daji
打咭	daka
打响	daxl
打喊露	dhlu
打喊露	dhlz
打场	daih
打大赤肋	ddil
打天下	dtxx
打头	datz
打孖	dama
打孖	dazi
打字机	dzji
打思噎	dsye
打招呼	dvhu
打掂	dadm
打搏成	dbig
打斋	davd
打斗	dadz
打斧头	dftz
打枪	daql
打架	dajx
打横嚟	dhli
打横嚟	dhlw
打死狗讲价	dsgj
打气	daqi
打气筒	dqts
打油诗	dyui
打法	dafa
打消	daxn
打游击	dyji
打火	daho
打火机	dhji
打点	dadm
打烂沙盘问到笃	dlud
打牙铰	dyjn
打眼	dayj
打簿	dabu
打脚骨	djgu
打芡	daqm
打药	dayc
打荷包	dhbc
打蛇随棍上	dusu
打蛇饼	dubk
打赌	dadu
打赤肋	dile
打赤肋	dilw
打转	davr
打边炉	dblu
打醒精神	dxju
打量	dall
打雀噉眼	dqdy
打靶	daba
打骂	dama
打骰	datz
打麻雀	dmqt
打鼻鼾	dbhj
托大脚	tdjn
托尔金	tejb
托手踭	tuvg
托福	tofu
托赖	told
托马斯	tmsi
执业	viye
执人口水溦	vrkw
执到宝	vdbc
执到正	vdvg
执到都喊三声	vddu
执包袱	vbfu
执头执尾	vtvw
执委	viww
执委会	vwhv
执导	vidc
执意	viyi
执手尾	vuww
执掌	vivh
执政党	vvdh
执教	vijn
执条袜带累身家	vtwj
执死鸡	vsji
执法如山	vfru
执漏	vilz
执番条命	vftm
执番条命	vptm
执番身彩	vfuc
执番身彩	vpuc
执笔	vibi
执药	viyc
执著	vivo
执输行头惨过败家	vuhj
执输行头惨过败家	vuxj
扩大化	kdhx
扪心无愧	mxmk
扪心无愧	mxwk
扬声器	yuqi
扬子江	yzjl
扬子鳄	yzee
扬弃	yhqi
扬榷	yhqt
扬言	yhyj
扬长	yhih
扬长补短	yibd
扭亏增盈	nkzy
扭拧	nqnk
扭纹	nqwf
扭计师爷	njuy
扭计骰	njtz
扭軚	nqtd
扮嘢	bjye
扮猪食老虎	bvsh
扮猪食老虎	bvuh
扮猪食老虎	bvyh
扯猫尾	imww
扳机	bjji
扶养	fuyh
扶助	fuvu
扶弱抑强	fryq
扶摇	fuyc
扶植	fuvi
扶疏	fuuu
扶贫帮困	fpbk
批件	pijm
批发商	pfuh
批号	pihc
批复	pifu
批转	pivr
找事	vcui
找晦气	vhqi
找续	vcxu
承你贵言	ingy
承包	igbc
承包制	ibvi
承建	igjm
承继	igji
承销	igxn
技击	jiji
技术员	juyr
技术性	juxk
技校	jixn
技法	jifa
技艺	jiyi
技高一筹	jgyi
抄件	icjm
抄牌	icpd
把头	batz
把子	bazi
把屁	bapi
把式	baui
把手	bauz
把炮	babc
把炮	bapc
把鬼	bagv
抌心口	vxkz
抑制	yivi
抑强扶弱	yqfr
抑或	yiho
抑止	yivi
抒写	uuxp
抒发	uufa
抒情诗	uqui
抓车	vxie
抓车	vxju
投书	tzuu
投向	tzxl
投宿	tzsu
投掷	tzvi
投机商	tjuh
投篮	tzlj
投递员	tdyr
投降	tzxl
投降主义	txvy
抖凉	dzll
抗原	khyr
抗御	khyu
抗日战争	krvv
抗日救亡	krjw
抗生素	kusu
抗药性	kyxk
抗菌素	kjsu
折中	vevs
折台	uetd
折台	vetd
折回	vehv
折子戏	vzxi
折戟沉沙	vjiu
折节读书	ujdu
折节读书	vjdu
折衷	uevs
折衷	vevs
抚恤金	fxjb
抚慰	fuww
抚育	fuyu
抛掷	pcvi
抛浪头	pltz
抠乱	kzlr
抠搜	kzsz
抢劫犯	qjfj
抢建	qljm
抢手	qluz
抢收	qluz
抢种	qlvs
抢购一空	qgyk
抢运	qlyy
抢闸	igva
抢闸	qlva
抢险	qlxm
护卫舰	hwjm
护城河	hihe
护士长	huih
护士长	huvh
护肤品	hfpb
护身符	hufu
报串	bcir
报仇	bciz
报偿	bcih
报关	bcgr
报到	bcdc
报务	bcwu
报告会	bghv
报告团	bgtr
报国	bcgo
报头	bctz
报导	bcdc
报捷	bcjp
报收	bcuz
报效	bcxn
报时	bcui
报春花	bihx
报晓	bcxn
报界	bcjp
报章	bcvh
报账	bcvh
报载	bczd
披心相付	pxxf
披红戴花	phdh
抬高	tdgc
抱养	bcyh
抱病	bcbk
抱诚守真	biuv
抱负	bcfu
抵制	divi
抵得谂	dduf
抵御	diyu
抵押品	dypb
抵挡	didh
抵牾	diwu
抵谂	diuf
抹台布	mtbu
抹煞	moua
押运	yayy
抽搐	iziu
抽检	izjm
抽泣	izqi
抽穗	izsv
抽验	izyj
担子	djzi
担搁	djge
担架	djjx
拆家	idjx
拆招牌	ivpd
拆解	idjp
拆解	idxp
拆骨	idgu
拉丁文	ldwf
拉匀	layy
拉埋天窗	lmti
拉头马	ltma
拉帮结派	lbjp
拉开	lakd
拉拉队	lldv
拉柴	laid
拉美	lamw
拉臣	laif
拉萨市	lsui
拉锯战	ljvj
拍乌蝇	pwyk
拍乸	pdna
拍友	pdyz
拍子	pdzi
拍得住	pdvu
拍心口	pxkz
拍手叫好	pujh
拍板	pdbj
拍硬档	pydh
拐子佬	gzlc
拒不	jubu
拒捕	jubu
拒收	juuz
拒腐防变	jffb
拓片	tapm
拔山举鼎	bujd
拔节	bajp
拔除	baiu
拖人下水	trxu
拖卡	toka
拖卡	toqx
拖手仔	tuzd
拖手仔	tuzi
拖肥糖	tfth
拖船	toir
拖苏	tosu
拗手瓜	augx
拗手瓜	nugx
拗撬	aoqn
拗撬	nqqn
拗数	aouu
拗数	nquu
拗腰	aoyc
拗腰	nqyc
拗颈	aogg
拗颈	aojk
拗颈	nqgg
拗颈	nqjk
拘役	juyi
拘捕	jubu
拘禁	jujb
拙笨	vobf
拚命	pbmk
拚搏	pbbo
招供	vcgs
招待会	vdhv
招徕	vcld
招手	vcuz
招摇	vcyc
招法	vcfa
招积	vcji
招纸	vcvi
招股	vcgu
招贴画	vthx
拜年	bdnm
拜拜	bdbd
拟订	nidk
拣饮择食	jyvs
拣饮择食	jyvu
拣饮择食	jyvy
拣饮择食	jyzs
拣饮择食	jyzu
拣饮择食	jyzy
拥军	ysjy
拥军优属	yjyu
拥护	yshu
拥挤不堪	yjbk
拦蓄	ljxu
拧头	nktz
拧转	nkvr
拧转头	nvtz
拨冗	bors
拨出	boiu
拨剌	bola
拨动	bods
拨叫	bojn
拮据	jpju
拱形	gsxk
拱手	gsuz
拱门	gsmf
拳击手	qjuz
拳拳	qrqr
拳拳服膺	qqfy
拳术	qruu
拾掇	uido
拾遗	uiyi
拾金不昧	ujbm
拿手戏	nuxi
挂号信	ghxb
挂图	gxtu
挂车	gxie
挂钟	gxvs
指事	viui
指使	viui
指名	vimk
指天椒	vtjn
指天誓日	vtur
指定	vidk
指定动作	vddz
指尖	vijm
指归	vigv
指战员	vvyr
指拟	vini
指挥员	vhyr
指挥官	vhgr
指挥所	vhso
指挥棒	vhbh
指挥部	vhbu
指明	vimk
指正	vivg
指法	vifa
指示	viui
指责	vize
挑动	tnds
挑拣	tnjm
挑灯夜战	tdyv
挑通眼眉	ttym
挖潜	waqm
挖肉罗疮生	wrlu
挚友	viyz
挞沙鱼	tuyu
挞订	tadk
挟带	xpdd
挡板	dhbj
挡箭牌	djpd
挣揣	vgik
挣揣	vgtr
挣揣	vgvv
挤出	jiiu
挤占	jivj
挤压	jiya
挥手	hvuz
挥舞	hvwu
挨年近晚	anjw
挨拼	aipb
挫伤	couh
振振	vfvf
振振有辞	vvyc
振荡	vfdh
挺括	tkgx
挺直	tkvi
挺立	tkli
挽回	wjhv
捉人痛脚	vrtj
捉住	vovu
捉到鹿唔识脱角	vdlj
捉字虱	vzui
捉摸不定	vmbd
捉棋	voqi
捉黄脚鸡	vhjj
捕镬	buho
捕食	buui
捞偏门	lpmf
捞取	lcqu
捞边行	lbhh
捞边行	lbxk
损之又损	svys
损手烂脚	sulj
换乘	hrig
换届	hrjp
换文	hrwf
换气	hrqi
换洗	hrxi
换班	hrbj
换画	hrhx
换言之	hyvi
换钱	hrqm
换防	hrfh
捣蛋	dcdj
据守	juuz
据报	jubc
捱世界	aujp
捱夜	aiye
捱更抵夜	agdy
捷克	jpke
捷达	jpda
捻手	nmuz
掀起	xmqi
掂掇	dmdo
掂量	dmll
授奖	uzjl
授意	uzyi
授粉	uzff
授精	uzjk
授衔	uzxm
掌上压	vuya
掌上明珠	vumv
排坛	pdtj
排头兵	ptbk
排字	pdzi
排它	pdta
排水管	pugr
排水量	pull
排涝	pdlc
排灌	pdgr
掘头路	jtlu
掘进	jtjb
掘金	jtjb
掠夺性	ldxk
掠过	ltgo
探伤	tjuh
探家	tjjx
探求	tjqq
探测器	tcqi
探热针	trvf
探照灯	tvdg
探班	tjbj
探盘	tjpj
探矿	tjkl
探询	tjxy
接二连胜	jelu
接入	jpru
接力	jpli
接力棒	jlbh
接力赛	jlsd
接办	jpbj
接地	jpdi
接头	jptz
接手	jpuz
接收站	juvj
接济	jpji
接点	jpdm
接班人	jbrf
接生	jpug
接种	jpvs
接线	jpxm
接见	jpjm
控制器	kvqi
控制论	kvly
推出	tviu
推力	tvli
推土机	ttji
推导	tvdc
推托	tvto
推移	tvyi
推诚相见	tixj
推进器	tjqi
推送	tvss
推销员	txyr
掩埋	yjmd
掩映	yjyk
掩蔽	yjbi
措措埋埋	ccmm
掬气	juqi
提及	tiji
提审	tiuf
提拨	dibo
提拨	tibo
提灌	tigr
提督	tidu
提篮	tilj
提级	tiji
提纲挈领	tgql
插手	iauz
插花	iahx
插话	iahx
揗揗震	uuvf
揗鸡	uyji
揣测不安	icba
揣测不安	tcba
揣测不安	vcba
揭幕	jpmu
揭批	jppi
揭短	jpdr
揭示	jpui
揭秘	jpmi
援外	yrwd
援建	yrjm
援引	yryb
揸主意	vvyi
揸兜	vadz
揸大葵扇	vdku
揸手	vauz
揸正来做	vvlz
揸腰	vayc
揸车	vaie
揸车	vaju
揽头揽颈	ltlg
揽头揽颈	ltlj
揽胜	ljug
揾人	wfrf
揾食	wfsi
揾食	wfui
揾食	wfyi
揿机	qbji
揿钉	qbdk
搅屎棍	jugy
搅拌机	jbji
搅珠	jnvu
搏乱	bolr
搏击	boji
搏到尽	bdjb
搏动	bods
搏命	bomk
搏彩	bocd
搏懵	bomg
搜索引擎	ssyq
搞弯	gcwj
搞搞震	ggvf
搞边科	gbke
搬迁户	bqhu
搭乘	daig
搭伙	daho
搭挡	dadh
搭桥	daqn
搭错线	dcxm
携手并肩	xubj
摄制	uevi
摄取	uequ
摄影师	uyui
摄影机	uyji
摄氏	ueui
摄灶罅	nzxx
摄灶罅	uzxx
摄石	npdj
摄石	npui
摄石	uedj
摄石	ueui
摆乌龙	bwls
摆手	bduz
摆放	bdfh
摆架子	bjzi
摆样子	byzi
摆档	bddh
摆渡	bddu
摆甫士	bfui
摇头摆尾	ytbw
摇曳	ycye
摇滚乐	ygyt
摇篮曲	ylqu
摇身一变	yuyb
摊位游戏	twyx
摊派	tjpd
摒弃	bkqi
摘发	vdfa
摘牌	vdpd
摘编	vdbm
摩尼	moni
摩托艇	mttk
摩挲	mosa
摩挲	moso
摩顶放踵	mdfv
摸门钉	mmdk
摸黑	mohw
摹写	moxp
撑竿跳	igtn
撒播	sabo
撕下	sixx
撞啱	vlnj
撞啱	vlyj
撞彩	vlcd
撞手神	vuuf
撞板	vlbj
撞火	vlho
撞聋	vlls
撞邪	vlxp
撞邪	vlye
撤出	ieiu
撤消	iexn
撩是斗非	ludf
撬墙脚	qqjn
播客	boke
播种机	bvji
播音员	byyr
播音室	byui
撰稿	vrgc
撰稿人	vgrf
撰著	vrvu
撺掇	crdo
撼动	hjds
撼天动地	htdd
擂鼓	lwgu
操作员	czyr
操作系统	czxt
操行	ccxk
擒青	qbqk
擗炮	pibc
擗炮	pipc
擘大口	bdkz
擘面	bomm
擦纸胶	cvjn
攀枝花	pvhx
支书	viuu
支农	vins
支前	viqm
支吾	viwu
支委	viww
支委会	vwhv
支应	viyk
支支整整	vvvv
支整	vivg
支架	vijx
支流	vilq
支点	vidm
支离	vili
支线	vixm
支边	vibm
支部	vibu
支队	vidv
收买人命	umrm
收买佬	umlc
收兵	uzbk
收割机	ugji
收发	uzfa
收场	uzih
收复	uzfu
收审	uzuf
收尾	uzww
收工	uzgs
收录机	ulji
收支	uzvi
收档	uzdh
收汇	uzhv
收治	uzvi
收爹	uzdp
收科	uzke
收紧	uzjb
收纳	uzna
收编	uzbm
收缴	uzjn
收藏家	ucjx
收集	uzji
收音	uzyb
改任	gdrf
改型	gdxk
改天换地	gthd
改弦更张	gxgv
改称	gdig
改编	gdbm
改选	gdxr
攻克	gske
攻关	gsgr
攻击机	gjji
攻势	gsui
攻坚	gsjm
攻坚战	gjvj
攻城掠地	gild
攻苦食淡	gksd
攻苦食淡	gkud
攻苦食淡	gkyd
攻陷	gsxm
放声气	fuqi
放大器	fdqi
放大镜	fdjk
放射性	fuxk
放射线	fuxm
放数	fhuu
放映机	fyji
放晴	fhqk
放火	fhho
放牛娃	fnwa
放疗	fhln
放眼	fhyj
放眼世界	fyuj
放空	fhks
放缓	fhhr
放置	fhvi
放胆	fhdj
放风	fhfg
放飞机	ffji
政事	vgui
政企	vgqi
政企不分	vqbf
政体	vgti
政党	vgdh
政出多门	vidm
政务	vgwu
政区	vgqu
政局	vgju
政府军	vfjy
政敌	vgdi
政权	vgqr
政治家	vvjx
政治局	vvju
政治犯	vvfj
政治课	vvke
政治部	vvbu
政法	vgfa
政界	vgjp
政纪	vgji
政绩	vgji
政要	vgyc
政见	vgjm
政论	vgly
政通人和	vtrh
故事片	gupm
故人	gurf
故剑情深	gjqu
故园	guyr
故旧不弃	gjbq
故道	gudc
故都	gudu
故里	guli
效仿	xnfh
效忠	xnvs
敌伪	diww
敌占区	dvqu
敌国	digo
敌意	diyi
敌我矛盾	dwmd
敌方	difh
敌机	diji
敌视	diui
救世主	juvu
救亡	jqwh
救困扶危	jkfw
救急	jqji
救护车	jhie
救护队	jhdv
救活	jqho
救济粮	jjll
救济金	jjjb
救生圈	juqr
救生艇	jutk
救生衣	juyi
教主	jnvu
教义	jnyi
教书匠	jujl
教具	jnju
教头	jntz
教委	jnww
教学法	jxfa
教学片	jxpm
教学相长	jxxv
教室	jnui
教导员	jdyr
教工	jngs
教廷	jntk
教条主义	jtvy
教法	jnfa
教父	jnfu
教益	jnyi
教研	jnyj
教研室	jyui
教科书	jkuu
教科文	jkwf
教练员	jlyr
教练机	jlji
教职员工	jvyg
教职工	jvgs
教育学	jyxt
教育家	jyjx
教育局	jyju
教育部	jybu
教诲	jnhv
教鞭	jnbm
教龄	jnlk
敞亮	ihll
敢死队	gsdv
散仔	sjzd
散仔	sjzi
散失	sjui
散居	sjju
散收收	suuz
散文家	swjx
散文诗	swui
散档	sjdh
散纸	sjvi
散记	sjji
敦实	dyui
敬献	jkxm
敬畏	jkww
敬礼	jkli
敬老慈幼	jlcy
敬老院	jlyr
敬重	jkvs
数万	uuwj
数亿	uuyi
数以百计	uybj
数位	uuww
数十	uuui
数千	uuqm
数周	uuvz
数学家	uxjx
数学课	uxke
数家	uujx
数尾	uuww
数据库	ujku
数数	uuuu
数次	uuci
数理化	ulhx
数量级	ulji
敲诈勒索	qvls
敲门砖	qmvr
整党	vgdh
整古做怪	vgzg
整地	vgdi
整整吓	vvhe
整整吓	vvxx
整整齐齐	vvqq
整机	vgji
整治	vgvi
整流	vglq
整编	vgbm
整色水	vsuv
整色水	vuuv
整风	vgfg
整齐划一	vqhy
敷料	fuln
敷设	fuue
文不加点	wbjd
文丛字顺	wczu
文传	wfir
文体	wfti
文具盒	wjhe
文化人	whrf
文化宫	whgs
文化界	whjp
文化部	whbu
文化馆	whgr
文史	wfui
文告	wfgc
文娱	wfyu
文学界	wxjp
文山会海	wuhh
文工团	wgtr
文戏	wfxi
文教	wfjn
文教局	wjju
文明礼貌	wmlm
文武	wfwu
文法	wffa
文理	wfli
文联	wflm
文艺界	wyjp
文苑	wfyr
文豪	wfhc
斋啡	vdfw
斐然	fwrj
斑痕	bjhf
斑白	bjbd
斗士	dzui
斗室	dzui
斗拱	dzgs
斗智	dzvi
斗木	dzmu
斗车	dzie
料峭	lnqn
斜坡	xppo
斜风细雨未雨绸缪	xfxm
斥资	iizi
斧子	fuzi
斩下眼	vxyj
斩六将	vljl
斩到一颈血	vdyx
斩料	vjln
斩眉斩眼	vmvy
斩眼	vjyj
斩缆	vjlj
斩脚趾避沙虫	vjvi
断代史	ddui
断估	drgu
断头	drtz
断尾	drww
断炊	driv
断线	drxm
断肢	drvi
断语	dryu
断路	drlu
斯坦利	stli
斯大林	sdlb
斯文淡定	swdd
新事	xbui
新人	xbrf
新人新事	xrxu
新任	xbrf
新兴	xbxk
新兵	xbbk
新军	xbjy
新净	xbjk
新办	xbbj
新华书店	xhud
新华社	xhue
新县	xbxm
新四军	xsjy
新址	xbvi
新城	xbig
新奇士	xjui
新奇士	xqui
新娘子	xnzi
新式	xbui
新意	xbyi
新成	xbig
新教	xbjn
新星	xbxk
新村	xbcy
新法	xbfa
新生	xbug
新生事物	xuuw
新纪元	xjyr
新老交替	xljt
新苗	xbmn
新蓝	xblj
新西兰	xxlj
新诗	xbui
新近	xbjb
新进	xbjb
新郎	xblh
新郎哥	xlge
新闻界	xwjp
新闻稿	xwgc
新风	xbfg
新鲜事	xxui
新鲜滚热辣	xxgl
方便之门	fbvm
方便面	fbmm
方城	fhig
方子	fhzi
方家	fhjx
方形	fhxk
方方正正	ffvv
方方面面	ffmm
方法论	ffly
方程式	fiui
方面军	fmjy
施乐	uile
施乐	uiyt
施压	uiya
施放	uifh
施政	uivg
施施然	uurj
施用	uiys
施肥	uifw
施行	uixk
旁观者	pgve
旅伴	lvbj
旅游团	lytr
旅游地	lydi
旅游者	lyve
旅游鞋	lyxp
旅行社	lxue
旋即	xrji
旋涡	xrwo
旌旗	jkqi
族长	zuvh
旗下	qixx
旗子	qizi
旗帜	qivi
旗帜鲜明	qvxm
旗手	qiuz
旗杆	qigj
旗舰	qijm
无不	wubu
无为	wuww
无价之宝	wjvb
无党派	wdpd
无则加勉	wzjm
无力	wuli
无可比拟	wkbn
无可非议	wkfy
无宁	wunk
无尽	wujb
无序	wuxu
无庸讳言	wyhy
无异	wuyi
无忌	moji
无忌	wuji
无意	wuyi
无所不知	wsbv
无政府	wvfu
无故	wugu
无暇	wuxx
无期	wuqi
无机	wuji
无比	wubi
无济于事	wjyu
无烟	wuyj
无烟煤	wymw
无畏	wuww
无的放矢	wdfu
无益	wuyi
无知	wuvi
无礼	wuli
无神论	wuly
无私无畏	wsww
无端白事	mdbu
无端白事	wdbu
无端端	mddr
无端端	wddr
无线	wuxm
无线电波	wxdb
无色	wuse
无花果	whgo
无视	wuui
无记名	wjmk
无际	wuji
无须	wuxu
既便	jibm
既便	jipm
既往	jiwh
既是	jiui
既有	jiyz
既能	jing
日光灯	rgdg
日全食	rqui
日出而作	riez
日复一日	rfyr
日影西斜	ryxx
日暮途穷	rmtq
日甚一日	ruyr
日程表	ribn
日立	rili
日营	riyk
日落西山	rlxu
日间	rijm
日食	riui
日高三尺	rgsi
旧习	jqxi
旧事	jqui
旧体诗	jtui
旧址	jqvi
旧宅	jqvd
旧式	jqui
旧时	jqui
旧物	jqwu
旧病复发	jbff
旧调重弹	jdit
旧货	jqho
旧阵时	jvui
旨意	viyi
早唞	zcdz
早唞	zctc
早市	zcui
早排	zcpd
早泄	zcxp
早稻	zcdc
早走早着	zzzv
旭日东升	xrdu
旯旮	laga
旱冰	hjbk
旱情	hjqk
旱烟	hjyj
旱田	hjtm
旱船	hjir
旱象	hjxl
旱路	hjlu
时不再来	ubzl
时不时	ubui
时事	uiui
时代华纳	udhn
时令	uilk
时值	uivi
时兴	uixk
时分	uiff
时势	uiui
时宜	uiyi
时局	uiju
时差	uiia
时常	uiih
时序	uixu
时弊	uibi
时政	uivg
时效	uixn
时新	uixb
时时	uiui
时机	uiji
时紧时松	ujus
时节	uijp
时评	uipk
时运	uiyy
时钟	uivs
时间差	ujia
时限	uixm
时隔	uige
时鲜	uixm
旷野	klye
旺季	whji
昂居	ahju
昂然	agrj
昆仑山	kluj
昆剧	kyju
昆山	kyuj
昆山片玉	kupy
昆明市	kmui
昌平	ihpk
昌盛	ihug
明丽	mkli
明代	mkdd
明令	mklk
明净	mkjk
明基	mkji
明德惟馨	mdwx
明斯克	mske
明晃晃	mhhl
明晰	mkxi
明理	mkli
明码	mkma
昒昕	huxb
易事	yiui
易于	yiyu
易得	yide
易得	yidw
易经	yijk
易趣	yiqu
易过借火	ygjh
星云	xkyy
星体	xkti
星夜	xkye
星星点灯	xxdd
星星点点	xxdd
星期一	xqyi
星期三	xqsj
星期五	xqwu
星期六	xqlq
星期四	xqsi
星期日	xqri
星移斗转	xydv
星级	xkji
星罗棋布	xlqb
星际	xkji
映像	ykxl
映射	ykue
映月读书	yydu
映照	ykvc
映雪读书	yxdu
春华秋实	ihqu
春回大地	ihdd
春意正浓	iyvn
春晚	iywj
春灌	iygr
春色满圆	ismy
春色满圆	iumy
春花秋月	ihqy
春蚓秋蛇	iyqu
春雷滚滚	ilgg
春风化雨	ifhy
昧心	mwxb
昨日黄花	zrhh
昭然	vcrj
昭示	vcui
昭阳	vcyh
是以	uiyi
是的	uide
昳丽	dpli
昳丽	yili
显出	xmiu
显微	xmww
显灵	xmlk
显眼	xmyj
显示屏	xupk
显要	xmyc
显露	xmlu
晋升	jbug
晋城	jbig
晋江	jbjl
晋级	jbji
晌午	uhwu
晏衍	yjyj
晏觉	yjjn
晏觉	yjjt
晒命	udmk
晒士	udui
晕酡酡	ytto
晚些	wjxp
晚婚	wjhy
晚稻	wjdc
晚节	wjjp
晚辈	wjbw
晚黑	wjhw
晦涩	hvse
晨光绚丽	igxl
晨星	ifxk
晨雾弥漫	iwmm
普京	pujk
普及本	pjbf
普及率	pjlv
普快	pukk
普金	pujb
普鲁士	plui
景仰	jkyh
景况	jkkl
景气	jkqi
景泰蓝	jtlj
景点	jkdm
景致	jkvi
景轰	jkhs
景颇族	jpzu
晴空	qkks
晶体	jkti
晶圆	jkyr
晶片	jkpm
晶莹	jkyk
智利	vili
智力	vili
智取	viqu
智育	viyu
暂住	zjvu
暑气	uuqi
暑热	uure
暖气片	nqpm
暖粒粒	nlli
暖融融	nrrs
暗室不欺	aubq
暴利	bcli
暴发	bcfa
暴发户	bfhu
暴政	bcvg
暴涨	bcvh
暴雨如注	byrv
暴风雨	bfyu
暴风雪	bfxt
暴风骤雨	bfvy
曚昽	mgls
曲棍球	qgqq
曲调	qudn
曲轴	quvz
曲阜	qufu
曲靖	quqk
更生	ggug
更衣室	gyui
更难	ggnj
曹雪芹	cxqb
最不安的饭局	zbaj
最不花钱的白吃	zbhi
最安静的地方	zajf
最宝贵的话	zbgh
最悲惨的世界	zbcj
最惠国	zhgo
最爱面子的人	zamr
最肮脏的财产	zazi
月中	ytvs
月全食	yqui
月历	ytli
月夜	ytye
月宫	ytgs
月明星稀	ymxx
有为	yzww
有事	yzui
有交易	yjyi
有余	yzyu
有几何	yjhe
有分数	yfuu
有则改之无则加勉	yzgm
有利于	ylyu
有力	yzli
有咗	yzzo
有型有款	yxyk
有增无减	yzwj
有声气	yuqi
有头无尾	ytww
有如	yzru
有始无终	yuwv
有幸	yzxk
有底	yzdi
有形	yzxk
有心人	yxrf
有志者事竟成	yvvi
有悖于	ybyu
有情	yzqk
有意	yzyi
有意无意	yywy
有成	yzig
有所不同	ysbt
有所作为	yszw
有方	yzfh
有时	yzui
有时候	yuhz
有期	yzqi
有机	yzji
有机体	yjti
有机物	yjwu
有板有眼	ybyy
有毛有翼	ymyy
有源	yzyr
有点	yzdm
有理	yzli
有理冇理	ylml
有理有据	ylyj
有生力量	yull
有用	yzys
有益	yzyi
有着数	yvuu
有神论	yuly
有章可循	yvkx
有线	yzxm
有线电	yxdm
有罪	yzzv
有胆有识	ydyu
有误	yzwu
有说有笑	yuyx
有赖于	ylyu
有路数	yluu
有轨	yzgv
有鉴于此	yjyc
有限	yzxm
服侍	fuui
服刑	fuxk
服务业	fwye
服务员	fwyr
服务器	fwqi
服待	fudd
服毒	fudu
服气	fuqi
服膺	fuyk
服输	fuuu
朗讯	lhxy
望天打卦	wtdg
望望	whwh
望洋	whyh
朝乾夕惕	vqxt
朝圣	icug
朝头早	itzc
朝头早	vtzc
朝政	icvg
朝晖	vchv
朝鲜族	ixzu
期中	qivs
期满	qimj
木乃伊	mnyi
木兰	mulj
木口木面	mkmm
木嘴	muzv
木头车	mtie
木头车	mtju
木床	muil
木版	mubj
木独	mudu
木质	muvi
木鱼	muyu
未了	wwln
未决	wwjt
未完	wwwj
未成	wwig
未有耐	wynd
未知	wwvi
未经	wwjk
未遭	wwzc
末期	moqi
末班车	mbie
本世纪	buji
本义	bfyi
本体	bfti
本原	bfyr
本县	bfxm
本地姜唔辣	bdjl
本市	bfui
本本	bfbf
本来面目	blmm
本源	bfyr
本溪	bfxi
本相	bfxl
本科生	bkug
本职	bfvi
术语	uuyu
朱德	vude
朱熹	vuxi
机井	jijk
机位	jiww
机体	jiti
机关报	jgbc
机关枪	jgql
机具	jiju
机务	jiwu
机动	jids
机动性	jdxk
机动车	jdie
机器人	jqrf
机型	jixk
机头	jitz
机心	jixb
机时	jiui
机智	jivi
机枪	jiql
机械化	jxhx
机械厂	jxih
机械手	jxuz
机油	jiyz
机理	jili
机电	jidm
机种	jivs
机箱	jixl
机群	jiqy
机翼	jiyi
机耕	jigg
机能	jing
机要	jiyc
机警	jijk
机身	jiuf
机车	jiie
机载	jizd
机长	jiih
机长	jivh
机顶盒	jdhe
杀人犯	urfj
杀伤力	uuli
杀手锏	uujm
杀敌致果	udvg
杀机	uaji
杀猪宰羊	uvzy
杂剧	zaju
杂草丛生	zccu
杂记	zaji
杂货店	zhdm
权位	qrww
权力	qrli
权威性	qwxk
杆子	gjzi
杆菌	gjjy
李先念	lxnm
李商隐	luyb
李嘉诚	ljig
李四光	lsgl
李大钊	ldvc
李子	lizi
李宁	link
李敖	liao
李时珍	luvf
李清照	lqvc
李白	libd
李逵	likv
李鹏	lipg
杏仁	xkrf
村头	cytz
杜志民	dvmb
杜若	duro
束缚	uufu
束身自好	uuzh
杠铃	ghlk
条型码	txma
条条框框	ttkk
条气唔顺	tqwu
条理	tnli
条纹	tnwf
来京	ldjk
来势	ldui
来势汹汹	luxx
来意	ldyi
来来往往	llww
来源于	lyyu
来袭	ldxi
来讲	ldjl
来踪去迹	lzqj
杨树	yhuu
杭州市	hvui
杯子	bwzi
杰出	jpiu
松人	ssrf
松劲	ssjb
松化	sshx
松骨	ssgu
松鼠	ssuu
板书	bjuu
板块	bjkk
板子	bjzi
板报	bjbc
板斧	bjfu
板胡	bjhu
板蓝根	blgf
板车	bjie
板载	bjzd
极乐	jile
极光	jigl
极其	jiqi
极具	jiju
极刑	jixk
极力	jili
极化	jihx
极地	jidi
极好	jihc
极度	jidu
极易	jiyi
构件	gzjm
枉法	whfa
枉费	whfw
枕住	vfvu
枕戈待旦	vgdd
枕木	vfmu
林产	lbij
林区	lbqu
林带	lbdd
林檎	lbqb
林海	lbhd
林海雪原	lhxy
林荫道	lydc
果农	gons
果占	govj
果园飘香	gypx
果实累累	gull
果实饱满	gubm
果木	gomu
果栏	golj
果酒	gojq
枝叶	viye
枝头	vitz
枝干	vigj
枝杈	viia
枝条	vitn
枝节	vijp
枣树	zcuu
枧液	jmye
枧粉	jmff
枨鸡	igji
枪声	qlug
枪弹	qldj
枪战	qlvj
枪支	qlvi
枪杆子	qgzi
枯水	kuuv
架世	jxui
架势	jxui
架次	jxci
架设	jxue
枸橘	gzju
枸橼	gzyr
枸橼	juyr
柏树	bduu
柏油	bdyz
染料	rjln
柔媚	rzmw
柠檬酸	nmsr
查勘	iakj
查号台	ihtd
查哨	iauc
查对	iadv
查禁	iajb
查访	iafh
柬埔寨	jbvd
柬埔寨	jpvd
柱子	vuzi
柱石	vuui
柳传志	livi
柳传志	lvvi
柳体	lqti
柴可夫	ikfu
柴台	idtd
柴哇哇	iwwa
柴油机	iyji
柿子	uizi
标准件	bvjm
标准化	bvhx
标准普尔	bvpe
标参	bncj
标参	bnuf
标号	bnhc
标明	bnmk
标牌	bnpd
标示	bnui
标青	bnqk
栈道	vjdc
栉风沐雨	vfmy
栋梁之才	dlvc
栏河	ljhe
树大根深	udgu
树枝	uuvi
树桩	uuvl
树种	uuvs
树脂	uuvi
树身	uuuf
栖息	qixi
栖栖	qiqi
栖栖	qixi
栖栖	xiqi
栖栖	xixi
栖身	qiuf
栖迟	qiii
栖迟	xiii
栝楼	gxlz
栝楼	kolz
栝楼	tmlz
校务	xnwu
校区	jnou
校区	jnqu
校区	xnou
校区	xnqu
校址	xnvi
校官	xngr
校徽	xnhv
校方	xnfh
校样	jnyh
校正	jnvg
校规	xngv
栲栳	kclc
样书	yhuu
样机	yhji
核减	hejm
核动力	hdli
核反应	hfyk
核反应堆	hfyd
核威胁	hwxp
核子	hezi
核实	heui
核弹头	hdtz
核战争	hvvg
核潜艇	hqtk
核燃料	hrln
核物理	hwli
核电	hedm
核电站	hdvj
核糖	heth
核试验	huyj
核酸	hesr
根据地	gjdi
根本性	gbxk
格子	gezi
格律	gelv
格格	gege
格陵兰	gllj
格鲁吉亚	gljy
栽植	zdvi
栽种	zdvs
桂花	gvhx
桃李	tcli
桄榔	gllh
桑梓	shzi
桑榆暮景	symj
桔子	juzi
桔槔	jpgc
桔槔	jugc
桔红色	jhse
桔红色	jhud
桥头堡	qtbc
桥涵	qnhj
桥溜	qnlq
桥身	qnuf
桫椤	solo
梅花	mwhx
梅花鹿	mhlu
梅菜	mwcd
梅雨	mwyu
梆子	bhzi
梗房	ggfh
梗阻	ggzu
梦乡	mgxl
梦秋	mgqq
梨子	lizi
梨树	liuu
梯形	tixk
梯次	tici
梯级	tiji
梳子	uuzi
梳芙	uufu
梵蒂冈	fdgh
梼昧	dcmw
梼昧	izmw
梼昧	tcmw
梼杌	dcwu
梼杌	izwu
梼杌	tcwu
检举	jmju
检字法	jzfa
检察	jmia
检察员	jiyr
检察官	jigr
检察长	jivh
检察院	jiyr
检疫	jmyi
检阅	jmyt
棉农	mmns
棉布	mmbu
棉田	mmtm
棉纱	mmua
棉衣	mmyi
棉衲	mmna
棋友	qiyz
棋圣	qiug
棋坛	qitj
棋子	qizi
棋盘	qipj
棋类	qilw
棋艺	qiyi
棋迷	qimi
棹忌	vcji
棹忌	voji
棺木	grmu
植保	vibc
植树	viuu
植树造林	vuzl
植株	vivu
植物园	vwyr
植物学	vwxt
植物油	vwyz
椎间盘	vjpj
椰丝	yesi
椰子	yezi
椰菜花	ychx
楔子	xpzi
楠木	njmu
楹联	yklm
楼堂馆所	ltgs
楼宇	lzyu
楼板	lzbj
概莫能外	gmnw
概貌	gdmc
榆林	yulb
榆树	yuuu
榜首	bhuz
榴弹炮	ldpc
樗蒲	iupu
模拟器	mnqi
模棱	molg
模模糊糊	mmhh
横丫肠	hyih
横梁	hgll
横眉立目	hmlm
横行	hgxk
横街窄巷	hjvh
横街窄巷	hjvx
樽枳	zyvi
橄榄绿	gllv
橘子	juzi
橙子	igzi
橡皮艇	xptk
檐蛇	yjue
欠薪	qmxb
欠账	qmvh
次之	civi
次品	cipb
次大陆	cdlu
次子	cizi
次次	cici
次第	cidi
次长	ciih
次长	civh
欢声雷动	huld
欢宴	hryj
欢欢喜喜	hhxx
欢欣	hrxb
欢歌笑语	hgxy
欢蹦乱跳	hblt
欢迎会	hyhv
欣喜	xbxi
欣悉	xbxi
欧阳询	oyxy
欸乃	aind
欸乃	eind
欸乃	vdnd
欺压	qiya
款子	krzi
款待	krdd
歇业	xpye
歇暑	xpuu
歇歇	xpxp
歇脚	xpjn
歉意	qmyi
歉收	qmuz
歉疚	qmjq
歌剧	geju
歌剧院	gjyr
歌星	gexk
歌舞剧	gwju
歌舞团	gwtr
止境	vijk
止痛	vits
正中	vgvs
正义	vgyi
正义凛然	vylr
正事	vgui
正值	vgvi
正剧	vgju
正副	vgfu
正史	vgui
正名	vgmk
正告	vggc
正嘢	vgye
正大	vgda
正常值	vivi
正当防卫	vdfw
正房	vgfh
正教	vgjn
正方形	vfxk
正是	vgui
正气	vgqi
正气凛然	vqlr
正法	vgfa
正点	vgdm
正电子	vdzi
正确性	vqxk
正职	vgvi
正规军	vgjy
正规化	vghx
正视	vgui
正解	vgjp
正解	vgxp
正误	vgwu
正负	vgfu
正路	vglu
正身	vguf
正轨	vggv
此事	ciui
此地无银	cdmy
此地无银	cdwy
此致	civi
此行	cixk
此言	ciyj
此项	cixl
步入	buru
步步	bubu
步步登高	bbdg
步行	buxk
步调一致	bdyv
步长	buih
武力	wuli
武士	wuui
武威	wuww
武官	wugr
武将	wujl
武戏	wuxi
武断	wudr
武昌	wuih
武术	wuuu
武汉市	whui
武生	wuug
武艺	wuyi
武装部	wvbu
歧义	qiyi
歧视	qiui
歧途	qitu
歪理	wdli
死亡线	swxm
死人	sirf
死估估	sggu
死地	sidi
死死下	ssxx
死死气	ssqi
死气喉	sqhz
死牛一便颈	snyg
死牛一便颈	snyj
死硬	siyk
死蛇烂蟮	sulu
死蛇烂鳝	sulu
死蠢	siiy
死记	siji
死鸡撑饭盖	sjig
歼击	jmji
歼击机	jjji
歼敌	jmdi
歼灭战	jmvj
残余	cjyu
残垣断壁	cydb
残害	cjhd
残局	cjju
残疾人	cjrf
残联	cjlm
残部	cjbu
残酷无情	ckwq
残阳	cjyh
残阳如血	cyrx
殖民地	vmdi
殡仪馆	bygr
殷墟	ybxu
殷实	ybui
殷殷	ybyb
毁弃	hvqi
毁灭性	hmxk
毅然	yirj
毋宁	wunk
毋庸	wuys
母带	mudd
母本	mubf
母语	muyu
每位	mwww
每台	mwtd
每期	mwqi
每每	mwmw
每隔	mwge
毒气	duqi
毒霸	duba
比价	bijx
比例尺	blii
比值	bivi
比划	bihx
比如说	bruo
比尔	bier
比拟	bini
比翼齐飞	byqf
比试	biui
毕业生	byug
毕加索	bjso
毕恭毕敬	bgbj
毕生	biug
毕节	bijp
毙命	bimk
毛公仔	mgzd
毛公仔	mgzi
毛坯	mcpi
毛纺	mcfh
毛线	mcxm
毛衣	mcyi
毡房	vjfh
毫不利己	hblj
毫不犹豫	hbyy
毫不留情	hblq
毫不相干	hbxg
毫克	hcke
毫无例外	hwlw
毫无疑义	hwyy
毯子	tjzi
毵毵	sjsj
氍毹	quuu
氏族	uizu
民主党派	mvdp
民力	mbli
民品	mbpb
民团	mbtr
民委	mbww
民盟	mbmg
民进	mbjb
民革	mbge
气冲牛斗	qind
气力	qili
气动	qids
气势	qiui
气咳	qike
气垫	qidm
气壮如牛	qvrn
气宇轩昂	qyxa
气性	qixk
气愤	qiff
气昂昂	qaag
气概	qigd
气泡	qipc
气管	qigr
气管炎	qgyj
气罗气喘	qlqi
气象台	qxtd
气贯长虹	qgih
气阀	qifa
气韵	qiyy
氛围	ffww
氢弹	qkdj
氤氲	ybyy
氧化物	yhwu
氮气	djqi
氰化	qkhx
水产品	uipb
水仙花	uxhx
水兵	uvbk
水利局	ulju
水力	uvli
水势	uvui
水印	uvyb
水合物	uhwu
水喉铁	uhtp
水坑	uvkg
水坝	uvba
水墨画	umhx
水尾	uvww
水师	uvui
水平如镜	uprj
水彩画	uchx
水性	uvxk
水情	uvqk
水手	uvuz
水文	uvwf
水文站	uwvj
水旱	uvhj
水星	uvxk
水晶宫	ujgs
水柱	uvvu
水汪汪	uwwh
水流湍急	ultj
水浇地	ujdi
水深	uvuf
水渠	uvqu
水火	uvho
水灵灵	ullk
水电局	udju
水电站	udvj
水皮	uvpi
水磨	uvmo
水箱	uvxl
水粉画	ufhx
水系	uvxi
水肿	uvvs
水蒸气	uvqi
水蛋	uvdj
水警	uvjk
水道	uvdc
水陆	uvlu
水面	uvmm
水饺	uvjn
水龙	uvls
永世	ysui
永中	ysvs
永久性	yjxk
永垂不朽	yibx
汁液	viye
汁都捞埋	vdlm
求全	qqqr
求援	qqyr
求是	qqui
求知	qqvi
求知欲	qvyu
汇价	hvjx
汇合	hvhe
汇报会	hbhv
汇款单	hkdj
汉书	hjuu
汉代	hjdd
汉城	hjig
汉堡包	hbbc
汉奸	hjjm
汉子	hjzi
汉文	hjwf
汉白玉	hbyu
汍澜	wjlj
汗牛充栋	hnid
汛情	xyqk
江北	jlbw
江民	jlmb
江水	jluv
江苏省	jsug
江西省	jxug
江陵	jllk
池子	iizi
污水	wuuv
污水渠	wuqu
污泥浊水	wnvu
污秽	wuhv
污糟邋遢	wzlt
污蔑	wump
污辱	wuru
汤姆	thmu
汩汩	gugu
汩没	gumo
汩没	gumw
汩没	yumo
汩没	yumw
汪延	whyj
汪洋大海	wydh
汲水	jiuv
汽化	qihx
汽笛	qidi
汽车站	qivj
汽轮机	qlji
沁人肺腑	qrff
沁阳	qbyh
沃尔玛	wema
沃达丰	wdfg
沄沄	yyyy
沆瀣	hhxp
沈从文	ucwf
沈阳市	uyui
沉没	ifmo
沉甸甸	iddm
沉积	ifji
沉郁	ifyu
沓正	davg
沓正	tavg
沙俄	uaee
沙地	uadi
沙场	uaih
沙子	uazi
沙市	uaui
沙文主义	uwvy
沙沙	uaua
沙沙滚	uugy
沙河粉	uhff
沙洲	uavz
沙石	uaui
沙砾	uali
沙胆	uadj
沙茶酱	uijl
没什么	mume
没命	mwmk
没治	mwvi
沥青	liqk
沦陷区	lxqu
沧浪	chlh
沧海横流	chhl
沪剧	huju
沮洳	juru
河北省	hbug
河南省	hnug
河堤	hedi
河套	hetc
河山	heuj
河水	heuv
河滩	hetj
河神	heuf
河谷	hegu
河面	hemm
沸水	fwuv
油井	yzjk
油嘴	yzzv
油坊	yzfh
油墨	yzmo
油多	yzdo
油彩	yzcd
油桶	yzts
油气	yzqi
油水	yzuv
油污	yzwu
油滑	yzhx
油漆	yzqi
油灯	yzdg
油烟	yzyj
油画	yzhx
油矿	yzkl
油管	yzgr
油箱	yzxl
油类	yzlw
油罐	yzgr
油耗	yzhc
油脂	yzvi
油船	yzir
油角	yzjn
油角	yzjt
油路	yzlu
治外法权	vwfq
治学	vixt
治愈	viyu
治本	vibf
治标	vibn
治罪	vizv
沼气	vcqi
沼泽地	vzdi
沾满	vjmj
沿江	yjjl
沿袭	yjxi
沿边	yjbm
沿革	yjge
泄欲	xpyu
泉源	qryr
泔水	gjuv
法书	fauu
法事	faui
法典	fadm
法制	favi
法力	fali
法子	fazi
法家	fajx
法师	faui
法拉利	flli
法政	favg
法文	fawf
法新社	fxue
法权	faqr
法理	fali
法纪	faji
法语	fayu
法郎	falh
泛指	fjvi
泛泛	fjfj
泠泠	lklk
波兰	bolj
波多黎各	bdlg
波幅	bofu
波牛	bonq
波经	bojk
波谷	bogu
波霸	boba
波音	boyb
波饼	bobk
泣涕	qiti
泥人	nirf
泥水	niuv
泥湴	nibj
泥湴	nipj
泥瓦匠	nwjl
泥石流	nulq
注塑	vusu
注射器	vuqi
注目	vumu
注目礼	vmli
注脚	vujn
泰乐	tdle
泰乐	tdyt
泰山压顶	tuyd
泰山移	tuyi
泱泱	yhyh
泵房	bgfh
泵站	bgvj
洁净	jpjk
洋为中用	ywvy
洋洋大观	yydg
洋洋得意	yydy
洋烛	yhvu
洋行	yhhh
洋货	yhho
洗劫	xijp
洗劫一空	xjyk
洗大饼	xdbk
洗手	xiuz
洗手奉职	xufv
洗楼	xilz
洗涤剂	xdji
洗湿个头	xugt
洗漱	xiuu
洗礼	xili
洗练	xilm
洗脚唔抹脚	xjwj
洗衣	xiyi
洗衫板	xubj
洗黑钱	xhqm
洛阳纸贵	lyvg
洞悉	dsxi
洞房	dsfh
津巴布韦	jbbw
洪武	hswu
洪水猛兽	humu
洪钟	hsvs
洪魔	hsmo
活动家	hdjx
活化石	hhui
活性	hoxk
活性炭	hxtj
活期	hoqi
活水	houv
活生生	huug
活脱脱	htto
活计	hoji
活路	holu
洽谈会	qthv
派出所	piso
派性	pdxk
派息	pdxi
派拉蒙	plmg
派筹	pdiz
派系	pdxi
派街坊	pjfh
流下	lqxx
流失	lqui
流弹	lqdj
流星	lqxk
流星雨	lxyu
流水线	luxm
流沙	lqua
流浪汉	llhj
流离	lqli
流窜犯	lcfj
流线型	lxxk
流行榜	lhbh
流行榜	lxbh
流行色	lxse
流行语	lhyu
流行语	lxyu
流言	lqyj
流言飞语	lyfy
流逝	lqui
浅析	qmxi
浅水	qmuv
浅滩	qmtj
浇水	jnuv
浇注	jnvu
浇灌	jngr
浇铸	jnvu
浊亲	voqb
浊亲	voqk
浊流	volq
测绘局	chju
济南市	jnui
济困扶危	jkfw
济宁	jink
济弱扶倾	jrfq
济济一堂	jjyt
济源	jiyr
浑俗和光	hshg
浑厚	hyhz
浑水摸鱼	humy
浓烟滚滚	nygg
浓眉大眼	nmdy
浙江省	vjug
浩劫	hcjp
浩大	hcda
浩气	hcqi
浩浩长空	hhik
浩浩长空	hhvk
浩渺	hcmn
浩繁	hcfj
浪头	lhtz
浪漫主义	lmvy
浮华	fuhx
浮尘	fuif
浮标	fubn
浮沉	fuif
浮泛	fufj
浮浅	fuqm
浮游	fuyz
浮萍	fupk
浴室	yuui
浴池	yuii
海事	hdui
海伦	hdly
海信	hdxb
海味	hdww
海地	hddi
海堤	hddi
海岛	hddc
海平面	hpmm
海归	hdgv
海洛因	hlyb
海派	hdpd
海淀	hddm
海潮	hdic
海疆	hdjl
海皮	hdpi
海绵	hdmm
海豹	hdbc
海防	hdfh
海陆空	hlks
海难	hdnj
海顿	hddy
浸入	jbru
浸染	jbrj
浸润	jbry
浸猪笼	jvls
浸种	jbvs
浸透	jbtz
消亡	xnwh
消协	xnxp
消息人士	xxru
消暑	xnuu
消毒剂	xdji
消滞	xnvi
消火栓	xhur
消瘦	xnuz
消融	xnrs
消退	xntv
消逝	xnui
消长	xnvh
消闲	xnxm
消防喉	xfhz
消防车	xfie
消防队	xfdv
涉世	ueui
涉黄	uehl
涉黑	uehw
涌浪	yslh
涓滴归公	jdgg
涕泗	tisi
涝灾	lczd
涡轮机	wlji
涤荡	didh
润滑油	rhyz
涨至	vhvi
涨落	vhlo
液化	yehx
液化气	yhqi
涵义	hjyi
涵洞	hjds
涵管	hjgr
淅沥	xili
淅淅沥沥	xxll
淋巴结	lbjp
淋漓	lbli
淋病	lbbk
淘汰赛	ttsd
淙淙	cscs
淟涊	tmnm
淡季	djji
淡水湖	duhu
淡水鱼	duyu
淡茂茂	dmmc
淡薄	djbo
淤塞	yuse
淤积	yuji
淫威	ybww
淫溢	ybyi
淮南	hknj
淮阴	hkyb
深为	ufww
深信	ufxb
深切治疗	uqvl
深刻性	ukxk
深化	ufhx
深受	ufuz
深处	ufiu
深得民心	udmx
深情	ufqk
深情厚意	uqhy
深情厚谊	uqhy
深意	ufyi
深明大义	umdy
深水港	uugh
深知	ufvi
深谷	ufgu
深远	ufyr
深透	uftz
深重	ufvs
深闺	ufgv
淳厚	iyhz
混交林	hjlb
混养	hyyh
混合物	hhwu
混吉	hyji
混浊	hyvo
混淆是非	hxuf
添加剂	tjji
添麻烦	tmfj
清亮	qkll
清代	qkdd
清偿	qkih
清冷	qklg
清净	qkjk
清凉油	qlyz
清剿	qkjn
清幽	qkyz
清明节	qmjp
清晰度	qxdu
清正	qkvg
清河	qkhe
清洁	qkjp
清洗	qkxi
清淡	qkdj
清瘦	qkuz
清纯	qkiy
清茶	qkia
清补凉	qbll
清规戒律	qgjl
清运	qkyy
清香	qkxl
清香鲜嫩	qxxn
渊薮	yrsz
渐入佳境	jrjj
渐变	jmbm
渐次	jmci
渐至佳境	jvjj
渔人之利	yrvl
渔具	yuju
渔区	yuqu
渔场	yuih
渔夫	yufu
渔家	yujx
渔港	yugh
渔火	yuho
渔网	yuwh
渔舟	yuvz
渔轮	yuly
渗入	ufru
渡海	duhd
渡过	dugo
渣都冇	vdmc
温厚	wfhz
温哥华	wghx
温室	wfui
温家宝	wjbc
温暾	wfty
温柔敦厚	wrdh
温润而泽	wrez
温良恭俭让	wlgr
港务局	gwju
游人	yzrf
游兴	yzxk
游击	yzji
游击战	yjvj
游击队	yjdv
游医	yzyi
游历	yzli
游园	yzyr
游园会	yyhv
游埠	yzbu
游子	yzzi
游干水	yguv
游弋	yzyi
游戏人间	yxrj
游泳池	yyii
游泳馆	yygr
游离	yzli
游绳	yzug
游艺	yzyi
游艺机	yyji
游记	yzji
渺嘴	mnzv
湉湉	tmtm
湑湑	xuxu
湖北省	hbug
湖区	huou
湖区	huqu
湖南省	hnug
湖州	huvz
湘赣	xlgj
湛蓝	vjlj
湝湝	jpjp
湮没	yjmo
湿地	uidi
湿度	uidu
湿柴	uiid
湿气	uiqi
湿水鸡	uuji
湿漉漉	ullu
湿碎	uisv
溃于蚁穴	kyyx
源流	yrlq
源源	yryr
溜冰场	lbih
溟蒙	mkmg
溢于言表	yyyb
溢利	yili
溯源	suyr
溶剂	rsji
溶化	rshx
滂沛	phpw
滃郁	wgyu
滇池	dmii
滋事	ziui
滋油	ziyz
滋油淡定	zydd
滋补品	zbpb
滑动	hxds
滑捋捋	hllo
滑捋捋	hllv
滑梯	hxti
滑潺潺	hiij
滑牙	hxya
滑稽戏	hjxi
滑翔	hxxl
滑雪	hxxt
滑雪板	hxbj
滕州	tgvz
滚水渌脚	gulj
滚热辣	grla
滚红滚绿	ghgl
滚轴溜冰	gvlb
滚雪球	gxqq
滞后	vihz
滞销	vixn
满员	mjyr
满城风雨	mify
满天	mjtm
满头	mjtz
满山红叶	muhx
满山红叶	muhy
满山遍野	muby
满怀信心	mhxx
满招损谦受益	mvsy
满文	mjwf
满族	mjzu
满洲	mjvz
满洲国	mvgo
满满	mjmj
满满当当	mmdd
满眼	mjyj
满肚密圈	mdmj
满肚密圈	mdmq
满腔热情	mqrq
满腹牢骚	mfls
滥觞	ljuh
滩地	tjdi
滩头	tjtz
滩涂	tjtu
滴水	diuv
滴水成冰	duib
滴溜	dilq
漂渺	pnmn
漂漂亮亮	ppll
漂移	pnyi
漏税	lzuv
漓江	lijl
演义	yjyi
演习	yjxi
演化	yjhx
演唱会	yihv
演奏员	yzyr
演奏家	yzjx
演播室	ybui
演示	yjui
演算	yjsr
演艺	yjyi
演进	yjjb
漠视	moui
漫天要价	mtyj
漫天飞雪	mtfx
漫漫	mjmj
漫漫长夜	mmiy
漫漫长夜	mmvy
漫漶	mjhr
漭漭	mhmh
漯河	lohe
漳州	vhvz
潆洄	ykhv
潇湘	xnxl
潋滟	lmyj
潜入	qmru
潜台词	qtci
潜意识	qyui
潜水员	quyr
潜水艇	qutk
潜质	qmvi
潜返	qmfj
潢洋	glyh
潢洋	hlyh
潦倒	lndc
潮头	ictz
潮汐	icxi
潮阳	icyh
潺湲	ijyr
激动人心	jdrx
激化	jihx
激奀	jien
激奀	jinf
激愤	jiff
激浊扬清	jvyq
激起	jiqi
激进	jijb
濑粉	ldff
濒于	bbyu
濮阳	puyh
灌区	grqu
灌注	grvu
灌浆	grjl
灌渠	grqu
火力	holi
火势	houi
火化	hohx
火器	hoqi
火树银花	huyh
火海	hohd
火滚	hogy
火灾	hozd
火炕	hokh
火电厂	hdih
火电站	hdvj
火箭弹	hjdj
火箭炮	hjpc
火箭筒	hjts
火花塞	hhsd
火药味	hyww
火起	hoqi
火路	holu
火车头	hitz
火辣辣	hlla
火遮眼	hvyj
火险	hoxm
火鸡	hoji
灭火喉	mhhz
灯市	dgui
灯柱	dgvu
灯油火腊	dyhl
灯油火腊	dyhx
灯胆	dgdj
灰土	hvtu
灰士	hvui
灰心	hvxb
灰白色	hbse
灰白色	hbud
灰蒙蒙	hmmg
灰质	hvvi
灵宝	lkbc
灵性	lkxk
灵敏度	lmdu
灶具	zcju
炉台	lutd
炉子	luzi
炉渣	luva
炉膛	luth
炊事	ivui
炊事员	iuyr
炊事班	iubj
炊烟四起	iysq
炎夏	yjxx
炎炎	yjyj
炎症	yjvg
炒买炒卖	imim
炒家	icjx
炒黄牛	ihnq
炖冬菇	ddgu
炖品	dypb
炮手	pcuz
炮灰	pchv
炸鱼	vayu
点子	dmzi
点心	dmxb
点拨	dmbo
点搞	dmgc
点明	dmmk
点止	dmvi
点红点绿	dhdl
点钟	dmvs
炼焦	lmjn
烂命	ljmk
烂头蟀	ltuk
烂摊子	ltzi
烂溶溶	lrrs
烂漫	ljmj
烂瘾	ljyb
烂瞓	ljff
烂瞓	ljxy
烂蓉蓉	lrrs
烂铜烂铁	ltlt
烂饭	ljfj
烈军属	ljuu
烈士	lpui
烈士墓	lumu
烈属	lpuu
烈日当头	lrdt
烘云托月	hyty
烚熟狗头	xugt
烟仔	yjzd
烟仔	yjzi
烟士	yjui
烟尘	yjif
烟帽队	ymdv
烟波	yjbo
烟波浩淼	ybhm
烟灰	yjhv
烟灰盅	yhvs
烟熏火燎	yxhl
烟盒	yjhe
烟筒	yjts
烟花	yjhx
烟草业	ycye
烟蒂	yjdi
烟雨	yjyu
烟雾	yjwu
烤烟	kcyj
烦燥	fjzc
烦琐	fjso
烧碱	ucjm
烧纸	ucvi
烧结	ucjp
热乎乎	rhhu
热心肠	rxih
热核	rehe
热气腾腾	rqtt
热水瓶	rupk
热河	rehe
热源	reyr
热火	reho
热电厂	rdih
热痱	refw
热轧	reva
热轧	reya
烽火台	fhtd
烽火连天	fhlt
焊缝	hjfg
焗亲	juqb
焗亲	juqk
焗漆	juqi
焗炉	julu
焗盅	juvs
焚化	ffhx
焚毁	ffhv
焦化	jnhx
焦土	jntu
焦油	jnyz
焦炉	jnlu
焦炭	jntj
焰火	yjho
然之后	rvhz
煎饼	jmbk
煜爚	yuyt
煞下煞下	uxux
煞住	uavu
煞掣	uaie
煤尘	mwif
煤层	mwcg
煤屎	mwui
煤气喉	mqhz
煤气罐	mqgr
煤油	mwyz
煤灰	mwhv
煤烟	mwyj
煤田	mwtm
煤窑	mwyc
照会	vchv
照发	vcfa
照壁	vcbi
照搬	vcbj
照杀	vcua
照板煮碗	vbvw
照肺	vcfw
煮饭仔	vfzd
煮饭仔	vfzi
煲仔菜	bzcd
煲仔饭	bzfj
煲冇米粥	bmmv
熄匙	xiii
熄匙	xiui
熊熊	xsxs
熔化	rshx
熔岩	rsyj
熔炼	rslm
熔解	rsjp
熔解	rsxp
熟性	uuxk
熟性	uzxk
熟知	uuvi
熟行	uuhh
熟行	uuxk
熟行	uzhh
熟行	uzxk
熟识	uuui
熟透	uutz
熟食	uuui
熟食档	usdh
熟食档	uudh
熟食档	uydh
熠熟狗头	yugt
熠熠	yiyi
熠爚	yiyt
燃起	rjqi
燎原之势	lyvu
燎泡	lnpc
燕京	yjjk
燕婉	yjwj
燕山	yjuj
燕梳	yjuu
燕燕	yjyj
燕语莺声	yyyu
燕雀安知	yqav
燕麦	yjmd
燥火	zcho
燮理阴阳	xlyy
爆发力	bfli
爆呔	bcdd
爆呔	bctd
爆圻	bcqi
爆圻	bcyb
爆大镬	bdho
爆满	bcmj
爆炒	bcic
爆炸性	bvxk
爆煲	bcbc
爆石	bcdj
爆石	bcui
爆竹	bcvu
爬格仔	pgzd
爬格仔	pgzi
爬罗剔抉	pltj
爬高	pagc
爱立信	alxb
爵士乐	juyt
父女	funv
父本	fubf
爹哋	dpdi
片剂	pmji
片子	pmzi
片断	pmdr
片片	pmpm
片糖	pmth
版式	bjui
牌位	pdww
牌号	pdhc
牌坊	pdfh
牌照	pdvc
牙医	yayi
牙擦	yaca
牙擦擦	ycca
牙斩斩	yvvj
牙烟	yayj
牙痛噉声	ytdu
牙罅	yaxx
牙铰	yajn
牙齿印	yiyb
牙齿当金使	yidu
牛噍牡丹	njmd
牛毛细雨	nmxy
牛油果	nygo
牛皮癣	npxr
牛皮纸	npvi
牛精	nqjk
牛羊肉	nyrz
牛脷	nqli
牛郎织女	nlvn
牛鼎烹鸡	ndpj
牝牡	pbmu
牟取暴利	mqbl
牢牢	lclc
牧人	murf
牧歌	muge
牧童	muts
牧羊	muyh
物主	wuvu
物似主人形	wuvx
物力	wuli
物欲	wuyu
物理	wuli
物理学	wlxt
物腐虫生	wfiu
物证	wuvg
物资局	wzju
牲畜	ugiu
牵制	qmvi
牵引力	qyli
牵线	qmxm
牵萝补屋	qlbw
特委	teww
特技	teji
特指	tevi
特效药	txyc
特洛伊	tlyi
特派员	tpyr
特种兵	tvbk
特赦	teue
牺牲品	xupb
犀厉	xili
犄角	jijn
犯众憎	fvzg
犯愁	fjiz
犰狳	qqyu
犹太人	ytrf
犹太教	ytjn
狂犬病	kqbk
狂草	klcc
狂风暴雨大雨淋漓	kfbl
狉狉	pipi
狍子	pczi
狐狸	huli
狐疑不决	hybj
狐群狗党	hqgd
狒狒	fwfw
狗乸	gzna
狗公	gzgs
狗咬狗骨	gygg
狗爪边	gvbm
狗牙	gzya
狙击	juji
狡黠	jnxx
独具匠心	djjx
独具特色	djts
独出心裁	dixc
独到之处	ddvi
独唱	duih
独善其身	duqu
独子	duzi
独木舟	dmvz
独沽一味	dgyw
独生女	dunv
独生子	duzi
独立团	dltr
独角戏	djxi
独资	duzi
狭长	xxih
狮城	uiig
狷介之士	jjvu
狸猫	limc
狻猊	srni
狼籍	lhji
狼胎	lhtd
猃狁	xmyy
猕猴桃	mhtc
猗傩	yino
猛兽	mguz
猛咁	mggj
猛将	mgjl
猛志常在	mviz
猛扑	mgpu
猛犸	mgma
猛跌	mgdp
猛醒	mgxk
猜呈寻	cixy
猞猁	ueli
猩猩	xkxk
猪乸	vuna
猪仔	vuzd
猪场	vuih
猪头炳	vtbk
猪头骨	vtgu
猪崽	vuzd
猪横脷	vhli
猪瘟	vuwf
猪突豨勇	vtxy
猪笼入水	vlru
猪脚姜	vjjl
猪舍	vuue
猫乸	mcna
猫扑	mcpu
猫王	mcwh
猫鼠同眠	mutm
献技	xmji
献礼	xmli
献艺	xmyi
献花	xmhx
献血	xmxt
献计	xmji
献词	xmci
献身	xmuf
献辞	xmci
獬豸	xpvi
玄学	xrxt
玄虚	xrxu
玄黄	xrhl
玉兰	yulj
玉器	yuqi
玉林	yulb
玉洁松贞	yjsv
玉溪	yuxi
玉石	yuui
玉米面	ymmm
玉雕	yudn
王位	whww
王公	whgs
王冠	whgr
王力	whli
王室	whui
王永民	wymb
王爷	whye
王羲之	wxvi
王铎	whdo
玎玲	dklk
玎珰	dkdh
玛丽	mali
玩意	wjyi
玩新人	wxrf
玩艺	wjyi
玫瑰色	mgse
环卫	hrww
环城	hrig
环形	hrxk
环抱	hrbc
环环相扣	hhxk
环行	hrxk
环首死刑	husx
现世	xmui
现今	xmjb
现代化	xdhx
现代史	xdui
现代戏	xdxi
现代派	xdpd
现代舞	xdwu
现任	xmrf
现出	xmiu
现场会	xihv
现实主义	xuvy
现实性	xuxk
现已	xmyi
现役	xmyi
现时	xmui
现汇	xmhv
现汉	xmhj
现眼	xmyj
现职	xmvi
现金	xmjb
现钱	xmqm
现阶段	xjdr
玳瑁	ddmc
玻利维亚	blwy
玻璃瓶	blpk
珊瑚礁	uhjn
珍本	vfbf
珍视	vfui
珐琅	falh
珑璁	lscs
珞巴族	lbzu
珠子	vuzi
班主任	bvrf
班加罗尔	bjle
班房	bjfh
班机	bjji
班马	bjma
球形	qqxk
球技	qqji
球状	qqvl
球艺	qqyi
琅玕	lhgj
理事	liui
理事会	luhv
理事长	luvh
理化	lihx
理发	lifa
理发师	lfui
理喻	liyu
理学	lixt
理工	ligs
理工科	lgke
理所当然	lsdr
理睬	licd
理科	like
理解力	ljli
理论家	lljx
琉璃	lqli
琉璃瓦	llwa
琥珀	hupo
琬圭	wjgv
琬琰	wjyj
琴声	qbug
琴师	qbui
琴心剑胆	qxjd
琴日	qbri
琴晚	qbwj
琼瑶	qsyc
瑞金	rvjb
瑞雪纷飞	rxff
瑰玮	gvww
璎珞	yklo
璞玉浑金	pyhj
瓜农	gxns
瓢泼大雨大雨倾盆	ppdp
瓦工	wags
瓦当	wadh
瓦煲	wabc
瓦通纸	wtvi
瓮声瓮气	wuwq
甘于	gjyu
甘油	gjyz
甘肃省	gsug
甘苦	gjku
甘蓝	gjlj
甚至于	uvyu
甜耶耶	tyye
甜菜	tmcd
甜酸苦辣	tskl
甜食	tmui
生于	ugyu
生产关系	uigx
生产力	uili
生产率	uilv
生产线	uixm
生产者	uive
生产队	uidv
生人	ugrf
生人唔生胆	urwd
生前	ugqm
生力军	uljy
生勾勾	uggz
生化	ughx
生埗	ugbu
生威	ugww
生安白造	uabz
生就	ugjq
生态学	utxt
生性	ugxk
生意人	uyrf
生意经	uyjk
生招牌	uvpd
生擒活捉	uqhv
生机	ugji
生机勃勃	ujbb
生果金	ugjb
生死与共	usyg
生殖	ugvi
生母	ugmu
生活费	uhfw
生源	ugyr
生父	ugfu
生物体	uwti
生物学	uwxt
生物钟	uwvs
生猪	ugvu
生理	ugli
生生	ugug
生生不已	uuby
生疑	ugyi
生肖	ugxn
生育	ugyu
生菜	ugcd
生萝卜	ulbo
生萝卜	ulbu
生计	ugji
生长期	uvqi
生长素	uvsu
生鸡	ugji
甡甡	ufuf
用之不竭	yvbj
用人	ysrf
用作	yszo
用尽	ysjb
用工	ysgs
用意	ysyi
用时	ysui
用材林	yclb
用武	yswu
用水	ysuv
用煤	ysmw
用语	ysyu
用费	ysfw
甩底	ukdi
甩拖	ukto
甩皮	ukpi
甩皮甩骨	upug
甩绳马骝	uuml
甩肺	ukfw
甩色	ukse
甩色	ukud
甩身	ukuf
甩须	ukxu
甫士咭	fuji
甫士咭	fuka
田园诗	tyui
田地	tmdi
田径赛	tjsd
田联	tmlm
由头	yztz
由此及彼	ycjb
由此可见	yckj
甲午	jxwu
甲午战争	jwvv
甲壳	jxqn
甲子	jxzi
甲寅	jxyb
甲戌	jxxu
甲板	jxbj
甲烷	jxwj
甲状腺	jvxm
甲申	jxuf
甲级	jxji
甲虫	jxis
甲辰	jxif
甲醇	jxiy
甲鱼	jxyu
申诉	ufsu
申请书	uquu
申请人	uqrf
申辩	ufbm
电令	dmlk
电信业	dxye
电信号	dxhc
电信局	dxju
电光石火	dguh
电劈石击	dpdj
电劈石击	dpuj
电压	dmya
电告	dmgc
电场	dmih
电声	dmug
电子学	dzxt
电子束	dzuu
电子琴	dzqb
电子管	dzgr
电子邮件	dzyj
电容器	drqi
电心	dmxb
电教	dmjn
电文	dmwf
电机	dmji
电极	dmji
电气	dmqi
电波	dmbo
电灯胆	dddj
电炉	dmlu
电瓶	dmpk
电盈	dmyk
电石	dmui
电码	dmma
电磁场	dcih
电磁波	dcbo
电离层	dlcg
电视剧	duju
电视台	dutd
电视塔	duta
电视机	duji
电视片	dupm
电话机	dhji
电贺	dmhe
电量	dmll
电钮	dmnq
电风扇	dfuj
电饭煲	dfbc
男中音	nvyb
男仔头	nztz
男低音	ndyb
男单	njdj
男声	njug
男女老少	nnlu
男妓	njji
男方	njfh
男权	njqr
男男女女	nnnn
男界	njjp
男童院	ntyr
男高音	ngyb
画像	hxxl
画公仔画出肠	hgzi
画坛	hxtj
画室	hxui
画师	hxui
画板	hxbj
画法	hxfa
画片	hxpm
画眉	hxmw
画虎类狗	hhlg
画院	hxyr
畀你	bini
畀心机	bxji
畅游	ihyz
畅达	ihda
界桩	jpvl
界河	jphe
界碑	jpbw
界线	jpxm
畏缩	wwso
畏罪	wwzv
畏首畏尾	wuww
留声机	luji
留学生	lxug
留宿	lqsu
留成	lqig
留有余地	lyyd
留案底	ladi
留美	lqmw
留言簿	lybu
留连	lqlm
留驻	lqvu
畜力	iuli
畜牧	xumu
畜牧业	xmye
略为	ltww
略语	ltyu
番书仔	fuzd
番书仔	fuzi
番书仔	puzd
番书仔	puzi
畸士	jiui
畿辅	jifu
疆域	jlyu
疆界	jljp
疏堂	uuth
疏松	uuss
疏财仗义	ucvy
疑义	yiyi
疑似	yisi
疑心	yixb
疑点	yidm
疗养院	lyyr
疫区	yiqu
疫病	yibk
疮痍	ilyi
疲乏	pifa
疾呼	jihu
疾步	jibu
疾风	jifg
疾驰	jiii
疾驶	jiui
痄腮	vasd
病倒	bkdc
病危	bkww
病历	bkli
病原	bkyr
病原体	byti
病友	bkyz
病史	bkui
病君	bkjy
病员	bkyr
病愈	bkyu
病灶	bkzc
病理	bkli
病程	bkig
病虫害	bihd
病魔缠身	bmiu
症结	vgjp
痘皮	dzpi
痛击	tsji
痛切	tsqp
痛哭	tsku
痛处	tsiu
痛心	tsxb
痛悼	tsdc
痛感	tsgj
痛打	tsda
痛斥	tsii
痢疾	liji
瘌痢	lali
瘛疭	iizs
瘟疫	wfyi
瘟瘟沌沌	wwdd
瘟神	wfuf
瘦小	uzxn
瘦蜢蜢	ummg
瘦骨仙	ugxm
瘭疽	bnju
瘰疬	loli
癫痫	dmxm
癫癫废废	ddff
癸丑	gviz
癸亥	gvhd
癸卯	gvmc
癸巳	gvsi
癸未	gvww
癸酉	gvyz
登基	dgji
登对	dgdv
登山队	dudv
登机	dgji
登陆艇	dltk
白云苍狗	bycg
白内障	bnvh
白区	bdqu
白发苍苍	bfcc
白咋	bdva
白咋	bdza
白咋	bdze
白垩纪	beji
白天鹅	btee
白山黑水	buhu
白布	bdbu
白开水	bkuv
白撞	bdvl
白晒晒	buud
白榄	bdlj
白灰	bdhv
白炽灯	bidg
白班	bdbj
白癜风	bdfg
白米	bdmi
白细胞	bxbc
白茫茫	bmmh
白薯	bduu
白蚀	bdui
白蚁	bdyi
白血球	bxqq
白血病	bxbk
白豆	bddz
白雪雪	bxxt
白饭鱼	bfyu
白鳍豚	bqty
白鸽眼	bgyj
白鸽笼	bgls
白鹤	bdhe
百代	bddd
百分之	bfvi
百分制	bfvi
百分比	bfbi
百分点	bfdm
百厌星	byxk
百口难辩	bknb
百叶窗	byil
百孔千疮	bkqi
百家争鸣	bjvm
百年不遇	bnby
百年大计	bndj
百废俱兴	bfjx
百慕大	bmda
百灵	bdlk
百老汇	blhv
百色	bdse
百色	bdud
百花园	bhyr
百花盛开	bhik
百花盛开	bhuk
百足咁多爪	bzgv
百鸟归林	bdgl
百鸟归林	bngl
百鸟鸣春	bdmi
百鸟鸣春	bnmi
的卡	deka
的卡	deqx
的卡	dika
的卡	diqx
的士	diui
的士高	dugc
的式	deui
的式	diui
的的确确	ddqq
的起心肝	dqxg
皇历	hlli
皇太子	htzi
皇权	hlqr
皇气	hlqi
皎皎	jnjn
皓首穷经	huqj
皖南	wjnj
皮子	pizi
皮影戏	pyxi
皮条	pitn
皮棉	pimm
皮特	pite
皮箧	piqp
皮肤病	pfbk
皮袋	pidd
皮货	piho
皮费	pifw
皱褶	vzve
盈余	ykyu
益友	yiyz
益发	yifa
益处	yiiu
益阳	yiyh
盐城	yjig
盐碱	yjjm
盐碱地	yjdi
盐蛇	yjue
监制	jmvi
监听	jmtk
监察	jmia
监护人	jhrf
监测	jmce
监理	jmli
监禁	jmjb
监粗嚟	jcli
监粗嚟	jclw
监视器	juqi
监趸	jmdy
盒子	hezi
盒带	hedd
盖世无双	guwu
盖世英雄	guyx
盖棺定论	ggdl
盗卖	dcmd
盗权	dcqr
盗窃犯	dqfj
盘桓	pjhr
盘货	pjho
盘陀	pjto
盘马弯弓	pmwg
盛世	ugui
盛事	ugui
盛产	ugij
盛名	ugmk
盛夏	ugxx
盛宴	ugyj
盛惠	ighv
盛惠	ughv
盛誉	ugyu
盟友	mgyz
盟员	mgyr
目不窥园	mbky
目不邪视	mbxu
目不邪视	mbyu
目光如豆	mgrd
目光短浅	mgdq
目击	muji
目击者	mjve
目力	muli
目视	muui
盲人瞎马	mrxm
盲佬	mhlc
盲公竹	mgvu
盲动	mhds
盲头乌蝇	mtwy
盲年	mhnm
盲摸摸	mmmo
盲眼	mhyj
直到	vidc
直升机	vuji
直属	viuu
直拍	vipd
直拨	vibo
直板	vibj
直流	vilq
直程	viig
直立	vili
直笔甩	vbuk
直肠	viih
直视	viui
直角	vijn
直译	viyi
直辖市	vxui
直选	vixr
相交	xljn
相仿	xlfh
相关性	xgxk
相宜	xlyi
相对论	xdly
相当之	xdvi
相形见绌	xxji
相思	xlsi
相持不下	xibx
相离	xlli
相继	xlji
相距	xlju
相较	xljn
相通	xlts
省会	ughv
省力	ugli
省去	ugqu
省城	ugig
省市	ugui
省府	ugfu
省悟	xkwu
省政府	uvfu
省界	ugjp
省直	ugvi
省籍	ugji
省籍	xkji
省级	ugji
省镜	ugjk
省镜	xkjk
省长	ugvh
眈天望地	dtwd
眉宇	mwyu
眉精眼企	mjyq
看做	kjzo
看头	kjtz
看守所	kuso
看官	kjgr
看轻	kjqk
看透	kjtz
看重	kjvs
真主	vfvu
真人	vfrf
真人真事	vrvu
真品	vfpb
真善美	vumw
真情实意	vquy
真意	vfyi
真是	vfui
真爱	vfai
真知	vfvi
真谛	vfdi
眯埋眼	mmyj
眼光光	yggl
眼冤	yjyr
眼凸凸	yttu
眼力	yjli
眼定定	yddk
眼崛崛	yjjt
眼巴巴	ybba
眼帘	yjlm
眼挹毛	yymc
眼核	yjhe
眼核	yjhu
眼湿湿	yuui
眼火爆	yhbc
眼热	yjre
眼甘甘	yggj
眼疾手快	yjuk
眼睁睁	yvvg
眼窝	yjwo
眼缘	yjyr
眼肚	yjdu
眼色	yjse
眼角高	yjgc
眼超超	yiic
眼镜	yjjk
眼镜蛇	yjue
着力点	vldm
着意	voyi
着数	vcuu
着眼点	vydm
睇化	dihx
睇医生	dyug
睇唔开	dwkd
睇场	diih
睇头睇尾	dtdw
睇定	didk
睇数	diuu
睇死	disi
睇水	diuv
睇白	dibd
睇真	divf
睇衰	diuk
睇送食饭	dssf
睇送食饭	dsuf
睇送食饭	dsyf
睇钱份上	dqfu
睇餸食饭	dssf
睇餸食饭	dsuf
睇餸食饭	dsyf
睚眦	yazi
睡意	uvyi
督波	dubo
瞓厉颈	flgg
瞓厉颈	fljk
瞓厉颈	xlgg
瞓厉颈	xljk
瞓身	ffuf
瞓身	xyuf
瞻顾	vjgu
矗立	iuli
矢志	uivi
矢志不移	uvby
知之为知之	vvwv
知了	viln
知事	viui
知名度	vmdu
知悉	vixi
知情人	vqrf
知情达理	vqdl
知晓	vixn
知法	vifa
知法犯法	vfff
知觉	vijt
知识化	vuhx
知识性	vuxk
知识界	vujp
知识面	vumm
知趣	viqu
知过必改	vgbg
知青	viqk
知音	viyb
矩形	juxk
矫形	jnxk
矫治	jnvi
短切切	dqqp
短平快	dpkk
短讯	drxy
矮凸凸	attu
矮瓜	aigx
矮细	aixi
石像	uixl
石刻	uike
石化	uihx
石匠	uijl
石器	uiqi
石墨	uimo
石子	uizi
石家庄	ujvl
石料	uiln
石棉	uimm
石榴	uilq
石沉大海	uidh
石油气	uyqi
石灰	uihv
石灰岩	uhyj
石灰石	uhui
石狮	uiui
石磨	uimo
石英	uiyk
石阶	uijp
矻矻	kuku
矿业	klye
矿务局	kwju
矿坑	klkg
砂浆	uajl
砂煲	uabc
砂煲兄弟	ubxd
砂石	uaui
砌生猪肉	quvr
砍伐	kjfa
砍刀	kjdc
研修生	yxug
研磨	yjmo
研究员	yjyr
研究室	yjui
研究所	yjso
研究生	yjug
研究者	yjve
研究院	yjyr
研讨会	ythv
砖墙	vrql
砗磲	iequ
砚台	yjtd
砥砺	dili
破伤风	pufg
破例	poli
破冰船	pbir
破口大骂	pkdm
破土	potu
破坏力	phli
破浪前进	plqj
硅酸盐	gsyj
硅钢片	ggpm
硕果	uogo
硙硙	wwww
硝烟	xnyj
硫化	lqhx
硬仗	ykvh
硬功	ykgs
硬化	ykhx
硬性	ykxk
硬指标	yvbn
硬是	ykui
硬晒軚	yutd
硬气	ykqi
硬汉	ykhj
硬汉子	yhzi
硬笔	ykbi
硬系	ykji
硬系	ykxi
硬颈	ykgg
硬颈	ykjk
硬骨头	ygtz
硭硝	mhxn
确确实实	qquu
碌架床	ljil
碌柚	luyz
碌碌无为	llww
碌碡	lqvz
碌葛	luge
碎湿湿	suui
碑刻	bwke
碔砆	wufu
碟头饭	dtfj
碟机	dpji
碧玉	biyu
碧空	biks
碧空万里	bkwl
碧空如洗	bkrx
碧绿	bilv
碰上	pguh
碰啱	pgnj
碰啱	pgyj
碰头会	pthv
碰杯	pgbw
碰碰车	ppie
碱性	jmxk
碾子	nmzi
磁力	cili
磁化	cihx
磁头	citz
磁性	cixk
磁石	ciui
磁针	civf
磅友	bhyz
磅友	phyz
磅水	bhuv
磅水	phuv
磐石之固	pdvg
磐石之固	puvg
磨刀	modc
磨拳擦掌	mqcv
磨杵成针	miiv
磨盘	mopj
磨穿铁砚	mity
磨练	molm
礁堡	jnbc
礁石	jnui
示众	uivs
示例	uili
示意	uiyi
礼仪	liyi
礼帽	limc
礼教	lijn
礼节	lijp
礼衣边	lybm
礼遇	liyu
礼金	lijb
社会化	uhhx
社会性	uhxk
社办	uebj
社火	ueho
社稷	ueji
社队	uedv
祁连山	qluj
祈望	qiwh
祈求	qiqq
祖坟	zuff
祖籍	zuji
祝寿	vuuz
祝词	vuci
祝辞	vuci
祝酒歌	vjge
祝酒词	vjci
祝酒辞	vjci
神主牌	uvpd
神乎其神	uhqu
神人	ufrf
神仙肚	uxdu
神力	ufli
神化	ufhx
神医	ufyi
神台猫屎神憎鬼厌	utmy
神妙	ufmn
神威	ufww
神志	ufvi
神情	ufqk
神明	ufmk
神枪手	uquz
神楼	uflz
神气	ufqi
神灵	uflk
神砂	ufua
神神化化	uuhh
神经元	ujyr
神经病	ujbk
神舟	ufvz
神色	ufse
神通	ufts
神采	ufcd
神高神大	ugud
票号	pnhc
票箱	pnxl
票证	pnvg
票额	pnee
祭品	jipb
祭奠	jidm
祭旗	jiqi
祭祖	jizu
禀报	bkbc
禁区	jbqu
禁忌	jbji
禁毒	jbdu
禁锢	jbgu
禁闭	jbbi
福克纳	fkna
福分	fuff
福州市	fvui
福建省	fjug
福星	fuxk
福星高照	fxgv
福气	fuqi
福清	fuqk
福禄	fulu
福音	fuyb
福鼎	fudk
离京	lijk
离合器	lhqi
离境	lijk
离奇	liqi
离子	lizi
离异	liyi
离心力	lxli
离职	livi
离间	lijm
禽日	qbri
秀丽	xqli
秀丽多姿	xldz
私了	siln
私事	siui
私交	sijn
私刑	sixk
私己	siji
私心	sixb
私房	sifh
私有制	syvi
私欲	siyu
私立	sili
私货	siho
秉性	bkxk
秉笔直书	bbvu
秋播	qqbo
秋收	qquz
秋粮	qqll
秋色宜人	qsyr
秋色宜人	quyr
秋色迷人	qsmr
秋色迷人	qumr
秋菊傲骨	qjag
秋菊怒放	qjnf
秋雨连绵	qylm
秋风送爽	qfsu
种姓	vsxk
种族主义	vzvy
种植	vsvi
种植业	vvye
种畜	vsiu
种类繁多	ilfd
种类繁多	vlfd
种花	vshx
科协	kexp
科员	keyr
科大	keda
科委	keww
科学性	kxxk
科学界	kxjp
科学院	kxyr
科室	keui
科工委	kgww
科教片	kjpm
科班	kebj
科盲	kemh
科研所	kyso
科索沃	kswo
科级	keji
科隆	kels
科龙	kels
秘书长	muvh
秘史	miui
秘捞	bilc
秘捞	milc
秘鲁	bilu
租户	zuhu
租界	zujp
秤砣	igto
秦始皇	quhl
秦镜高悬	qjgx
积习	jixi
积劳成疾	jlij
积存	jicy
积弊	jibi
积怨	jiyr
积木	jimu
积极分子	jjfz
积聚	jiju
积肥	jifw
积蓄	jixu
积蚊成雷	jwil
称为	igww
称之为	ivww
称作	igzo
称誉	igyu
称谓	igww
移居	yiju
移山倒海	yudh
移山填海	yuth
移栽	yizd
移植	yivi
移樽就教	yzjj
移除	yiiu
稀世	xiui
稀奇	xiqi
稀泥	xini
稀疏	xiuu
稀释	xiui
程式	igui
程门立雪	imlx
稍许	ucxu
税利	uvli
税制	uvvi
税源	uvyr
税目	uvmu
税种	uvvs
稚气	viqi
稳健	wfjm
稳定性	wdxk
稳当	wfdh
稳操左卷	wczj
稳稳	wfwf
稳稳当当	wwdd
稻子	dczi
稻穗	dcsv
稼穑	jxse
稿源	gcyr
稿纸	gcvi
穰穰	rhrh
穴位	xtww
穷根	qsgf
空中客车	kvki
空勤	ksqb
空域	ksyu
空子	kszi
空当	ksdh
空投	kstz
空架子	kjzi
空气清醒	kqqx
空白点	kbdm
空空荡荡	kkdd
空袭	ksxi
空车	ksie
空转	ksvr
空阔	ksko
空防	ksfh
空降兵	kjbk
穿山甲	iujx
穿崩	irbg
突击手	tjuz
突击队	tjdv
突破口	tpkz
突破性	tpxk
窄窄	vdvd
窑洞	ycds
窒头窒势	vtvu
窗棂	illk
窝窝头	wwtz
窝钉	wodk
窦口	dzkz
窸窣	xisu
窿窿罅罅	llxx
窿路	lslu
立宪	lixm
立式	liui
立志	livi
立意	liyi
立方米	lfmi
立时	liui
立杂	liza
立正	livg
立秋	liqq
立立乱	lllr
立论	lily
立足点	lzdm
立项	lixl
竖立	uuli
竖起	uuqi
站住脚	vvjn
竞争力	jvli
竞技	jkji
竞技场	jjih
竞投	jktz
竞相	jkxl
章草	vhcc
童声	tsug
童心	tsxb
童话	tshx
童趣	tsqu
童音	tsyb
竭尽	jpjb
端端正正	ddvv
竹丝鸡	vsji
竹升	vuug
竹升妹	vumw
竹战	vuvj
竹排	vupd
竹椅	vuyi
竹楼	vulz
竹竿	vugj
竹简	vujm
竿子	gjzi
笃爆	dubc
笃眼笃鼻	dydb
笃背脊	dbji
笊篱	vcli
笋嘢	syye
笑到碌地	xdld
笑口吟吟	xkyy
笑口噬噬	xkuu
笑口枣	xkzc
笑吟吟	xyyb
笑容满面	xrmm
笑意	xnyi
笑眯眯	xmmi
笑笑口	xxkz
笑语	xnyu
笑颜	xnyj
笑骑骑	xqqi
笔下	bixx
笔力	bili
笔势	biui
笔尖	bijm
笔录	bilu
笔杆子	bgzi
笔端	bidr
笔者	bive
笔触	biiu
笔记本	bjbf
笔译	biyi
笔试	biui
笔迹	biji
笔锋	bifg
笙簧	ughl
笛子	dizi
笠衫	liuj
笠记	liji
符弗	fufu
符箓	fulu
第一把手	dybu
第一线	dyxm
第二尐	dedi
第尾	diww
笸箩	polo
笸篮	polj
等次	dgci
等离子	dlzi
等离子体	dlzt
筑路	vulu
筒子楼	tzlz
答对	dadv
答疑	dayi
答词	daci
答话	dahx
答谢	daxp
答道	dadc
策源地	cydi
策骑	ceqi
筛子	udzi
筵席	yjxi
筹备会	ibhv
筹委会	iwhv
筼筜	yydh
签保	qmbc
签定	qmdk
签收	qmuz
简介	jmjp
简体字	jtzi
简便易行	jbyx
简写	jmxp
简化字	jhzi
简单易行	jdyx
简历	jmli
简史	jmui
简捷	jmjp
简政放权	jvfq
简易	jmyi
简章	jmvh
简练	jmlm
简编	jmbm
简装	jmvl
简言之	jyvi
简谱	jmpu
箍煲	gubc
箍颈	gugg
箍颈	gujk
箍颈党	ggdh
箍颈党	gjdh
箕踞	jiju
管区	grqu
管弦乐	gxyt
管材	grcd
管束	gruu
管理局	glju
管窥	grkv
管风琴	gfqb
箢箕	yrji
箩底橙	ldig
箭步	jmbu
篆书	vruu
篆刻	vrke
篓子	lzzi
篮板球	lbqq
篱士	liui
篷车	pgie
簏簌	lusu
簸箕	boji
米汤	mith
米粒	mili
米芾	mifu
米芾	mifw
米通	mits
米饭班主	mfbv
类人猿	lryr
籽棉	zimm
粉剂	ffji
粉擦	ffca
粉红色	fhse
粒声都唔出	ludi
粒子	lizi
粒状	livl
粗生	cuug
粗粗	cucu
粗线条	cxtn
粗衣淡饭	cydf
粗衣粝食	cyls
粗衣粝食	cylu
粗衣粝食	cyly
粘土	nmtu
粘性	nmxk
粘米	nmmi
粘米	vjmi
粘结	nmjp
粘膜	nmmo
粤剧	ytju
粤语残片	yycp
粪便	ffbm
粪肥	fffw
粮价	lljx
粮单	lldj
粮单	llij
粮单	lluj
粮商	lluh
粮库	llku
粮店	lldm
粮棉	llmm
粮田	lltm
粮站	llvj
粮食局	luju
粳米	jkmi
粼粼	lblb
精乖伶俐	jgll
精减	jkjm
精到	jkdc
精制	jkvi
精叻	jkle
精壮	jkvl
精子	jkzi
精干	jkgj
精当	jkdh
精液	jkye
精深	jkuf
精疲力尽	jplj
精疲力竭	jplj
精矿	jkkl
精确度	jqdu
精神抖擞	juds
精神文明	juwm
精神爽利	juul
精神病	jubk
精神百倍	jubb
精练	jklm
精细	jkxi
精英	jkyk
精装本	jvbf
精诚	jkig
精诚合作	jihz
精诚团结	jitj
精读	jkdu
精过冇尾蛇	jgmu
精金良玉	jjly
糊口	hukz
糖不甩	tbuk
糖尿病	tnbk
糖环	thhr
糖葫芦	thlu
糜烂	milj
糟质	zcvi
糟踏	zcta
糯米糍	nmci
系列剧	xlju
系列化	xlhx
系列片	xlpm
系咁先啦	jgxl
系咁先啦	xgxl
系威系势	jwju
系威系势	jwxu
系威系势	xwju
系威系势	xwxu
系统性	xtxk
索气	soqi
索水	souv
索油	soyz
索贿	sohv
紧巴巴	jbba
紧接	jbjp
紧身	jbuf
紧迫感	jpgj
紧追不舍	jvbu
紧邻	jblb
紫癜	zidm
紫禁城	zjig
紫红色	zhse
紫红色	zhud
絮语	xuyu
繁复	fjfu
繁星	fjxk
繁育	fjyu
繁花	fjhx
纠察队	jidv
纠集	jqji
红十字	huzi
红十字会	huzh
红土	hstu
红场	hsih
红宝石	hbui
红帽	hsmc
红当荡	hddh
红旗手	hquz
红星	hsxk
红白事	hbui
红白喜事	hbxu
红眼病	hybk
红簿仔	hbzd
红簿仔	hbzi
红粉绯绯	hfff
红红火火	hhhh
红肉	hsrz
红艳艳	hyyj
红豆沙	hdua
红领巾	hljb
纤夫	qmfu
纤维素	xwsu
约数	ytuu
约法	ytfa
约稿	ytgc
级差	jiia
纨绔	wjku
纪事	jiui
纪元	jiyr
纪委	jiww
纪实	jiui
纪年	jinm
纪录	jilu
纪念册	jnce
纪念堂	jnth
纪念塔	jnta
纪念封	jnfg
纪念日	jnri
纪念物	jnwu
纪念碑	jnbw
纪念章	jnvh
纪念馆	jngr
纪检	jijm
纪检委	jjww
纪行	jixk
纪要	jiyc
纬度	wwdu
纭纭	yyyy
纯收入	iuru
纯熟	iyuu
纱厂	uaih
纵使	zsui
纵横捭阖	zhbh
纵横驰骋	zhii
纵览	zslj
纵贯	zsgr
纵队	zsdv
纷呈	ffig
纷纭复杂	fyfz
纷纷扬扬	ffyy
纸屑	vixp
纸扎铺	vvpu
纸板	vibj
纸板人	vbrf
纸片	vipm
纸牌	vipd
纸皮石	vpdj
纸皮石	vpui
纸盒	vihe
纸箱	vixl
纸钱	viqm
纺织	fhvi
纺织业	fvye
纺织厂	fvih
纺织品	fvpb
纺锭	fhdk
纽门	nqmf
线上	xmuh
线头	xmtz
线性	xmxk
线材	xmcd
线步	xmbu
线眼	xmyj
线装书	xvuu
线辘	xmlu
组件	zujm
组委会	zwhv
组歌	zuge
组织性	zvxk
组织部	zvbu
组阁	zuge
细价	xijp
细价	xijx
细佬哥	xlge
细微	xiww
细胆	xidj
细胞核	xbhe
细胞膜	xbmo
细蚊仔	xwzd
细蚊仔	xwzi
细路仔	xlzd
细路仔	xlzi
细路女	xlnv
细部	xibu
细长	xiih
细雨	xiyu
织女	vinv
织布	vibu
织成	viig
织机	viji
织物	viwu
终南捷径	vnjj
终场	vsih
终审	vsuf
终将	vsjl
终年	vsnm
终极	vsji
终点	vsdm
终身制	vuvi
绊倒	bjdc
绊脚石	bjui
绍菜	uccd
经久	jkjq
经委	jkww
经学	jkxt
经常性	jixk
经手	jkuz
经济学	jjxt
经济林	jjlb
经济法	jjfa
经理	jkli
经管	jkgr
经纪	jkji
经纬	jkww
经线	jkxm
经营不善	jybu
经贸委	jmww
绒毛	rsmc
绒线	rsxm
结为	jpww
结伴	jpbj
结余	jpyu
结实	jpui
结成	jpig
结束语	juyu
结核	jphe
结核病	jhbk
结石	jpui
结结实实	jjuu
结识	jpui
绘制	hvvi
给与	gwyu
给与	jiyu
给养	jiyh
给水	jiuv
绚丽多姿	xldz
绚丽多彩	xldc
络绎	loyi
绝世超伦	juil
绝处逢生	jifu
绝对值	jdvi
绝对化	jdhx
绝无	jtmo
绝无	jtwu
绝桥	jtqn
绝甘分少	jgfu
绝笔	jtbi
绝经	jtjk
绝迹	jtji
绝食	jtui
绞刑	jnxk
统一	tsyi
统一体	tyti
统一性	tyxk
统制	tsvi
统帅	tsuk
统治	tsvi
统治阶级	tvjj
统计学	tjxt
统计局	tjju
统计表	tjbn
统配	tspw
统销	tsxn
绣品	xqpb
绣花袋仔人人啱	xhdn
绣花袋仔人人啱	xhdy
继之	jivi
继承人	jirf
继承权	jiqr
继父	jifu
绪言	xuyj
绮丽	qili
绳趋尺步	uqib
维亚康姆	wykm
维和	wwhe
维妙维肖	wmwx
维纳斯	wnsi
绵绵不绝	mmbj
绵羊	mmyh
绵蛮	mmmj
绶带	uzdd
综上所述	zusu
综合性	zhxk
综观	zsgr
综述	zsuu
绿水青山	luqu
绿油油	lyyz
绿肥	lvfw
绿茵茵	lyyb
绿草如茵	lcry
绿荫	lvyb
缉捕	jibu
缉毒	jidu
缉私	jisi
缓冲区	hiqu
缓刑	hrxk
缓期	hrqi
缓解	hrjp
缔交	dijn
缔约国	dygo
缕缕	lvlv
编委	bmww
编审	bmuf
编年体	bnti
编年史	bnui
编成	bmig
编目	bmmu
编织	bmvi
编辑部	bjbu
缘起	yrqi
缙绅	jbuf
缝纫机	frji
缧绁	lwxp
缩头龟	stgv
缩头龟	stjy
缩头龟	stqq
缩开	sokd
缩数	souu
缩沙	soua
缩骨	sogu
缩骨遮	sgve
缰绳	jlug
缴获	jnho
缺额	qtee
罐子	grzi
网景	whjk
网游	whyz
网状	whvl
网罗	whlo
网路	whlu
网际	whji
罔两	whll
罔愆	whqm
罗伯特	lbte
罗唣	lozc
罗布泊	lbpo
罗技	loji
罗拉	lola
罗柚	loyz
罗汉请观音	lhqy
罗织	lovi
罚球	faqq
罢啦	bala
罢啦	pila
罢官	bagr
罢市	baui
罨耷	yjda
置于	viyu
置于脑后	vynh
置办	vibj
置备	vibw
置评	vipk
置身	viuf
置顶	vidk
羁勒	jile
羁押	jiya
羁縻	jimi
羊入虎口	yrhk
羊城	yhig
羊毛衫	ymuj
羊肠小道	yixd
羊质虎皮	yvhp
美光	mwgl
美军	mwjy
美分	mwff
美容师	mrui
美报	mwbc
美术家	mujx
美术片	mupm
美术界	mujp
美术馆	mugr
美林	mwlb
美格	mwge
美泰	mwtd
美洲	mwvz
美玉	mwyu
美男	mwnj
美的	mwde
美的	mwdi
美眉	mwmw
美联社	mlue
美育	mwyu
美语	mwyu
美谈	mwtj
美貌	mwmc
美金	mwjb
美食	mwui
美餐	mwcj
羞家	xqjx
羞答答	xdda
羞羞答答	xxdd
羟基	qlji
群众性	qvxk
群像	qyxl
群威群胆	qwqd
群峰	qyfg
群情	qyqk
群芳	qyfh
群英会	qyhv
群落	qylo
群雄逐鹿	qxvl
羽坛	yutj
羽绒服	yrfu
羽翼	yuyi
翌年	yinm
翌日	yiri
翔实	xlui
翙翙	hvhv
翠色欲流	csyl
翠色欲流	cuyl
翩翩	pmpm
翯翯	hehe
翳气	yiqi
翳焗	yiju
翻云覆雨	fyfy
翻动	fjds
翻地	fjdi
翻翻	fjfj
翻越	fjyt
翻转	fjvr
翻风	fjfg
耀眼	ycyj
老一辈	lybw
老两口	llkz
老伴	lcbj
老农	lcns
老前辈	lqbw
老办法	lbfa
老友鬼鬼	lygg
老嘢	lcye
老坑	lckg
老大娘	ldnl
老大爷	ldye
老太太	lttd
老奶奶	lnnd
老好人	lhrf
老婆仔	lpzd
老婆仔	lpzi
老婆婆	lppo
老定	lcdk
老家	lcjx
老小	lcxn
老差骨	lcgu
老差骨	ligu
老帅	lcuk
老干部	lgbu
老年人	lnrf
老式	lcui
老懵懂	lmds
老搭档	lddh
老是	lcui
老朋友	lpyz
老框框	lkkl
老泥	lcni
老泪纵横	llzh
老爷爷	lyye
老猫烧须	lmux
老生	lcug
老番	lcfj
老番	lcpj
老积	lcji
老老少少	lluu
老而不	lebu
老臣子	lizi
老花镜	lhjk
老虎乸	lhna
老虎蟹	lhxp
老蚌生珠	lbuv
老行专	lhvr
老行专	lxvr
老衬	lcif
老西	lcxi
老规矩	lgju
老话	lchx
老调	lcdn
老路	lclu
老辣	lcla
老酒	lcjq
老骤伏枥	lvfl
老黄牛	lhnq
老鼠仔	luzd
老鼠仔	luzi
老鼠货	luho
考博	kcbo
考据	kcju
考查	kcia
考研	kcyj
考绩	kcji
耍手	uxuz
耐不耐	nbnd
耐劳	ndlc
耐唔中	nwvs
耐酸	ndsr
耕地	ggdi
耕牛	ggnq
耕种	ggvs
耗子	hczi
耗电	hcdm
耳仔软	ezrr
耳目众多	emvd
耵聍	dknk
耶路撒冷	ylsl
耷头耷脑	dtdn
耸入云天	sryt
耸立	ssli
聊城	lnig
聋哑人	lyrf
职业病	vybk
职代会	vdhv
职别	vibp
职场	viih
职守	viuz
职称	viig
职能	ving
职高	vigc
联会	lmhv
联办	lmbj
联合会	lhhv
联合国	lhgo
联大	lmda
联席	lmxi
联席会	lxhv
联席会	lxkk
联接	lmjp
联欢会	lhhv
联系	lmxi
联系人	lxrf
联结	lmjp
联谊	lmyi
联谊会	lyhv
联贯	lmgr
联针	lmvf
聘为	pbww
聚光灯	jgdg
聚变	jubm
聚合物	jhwu
聚宝盆	jbpf
聚居	juju
聚拢	juls
聚酯	juvi
聚首	juuz
肃反	sufj
肄业	yiye
肇事者	vuve
肉制品	rvpb
肉参	rzcj
肉参	rzuf
肉猪	rzvu
肉联厂	rlih
肉赤	rzii
肉鸡	rzji
肌体	jiti
肌理	jili
肖像画	xxhx
肖恩	xnen
肚屙	duee
肚耽	dudj
肝火	gjho
肝部	gjbu
肠梗阻	igzu
肠炎	ihyj
肠衣	ihyi
股利	guli
股市	guui
股金	gujb
股长	guvh
股骨	gugu
肢解	vijp
肥仔唛	fzma
肥仔唛	fzmd
肥力	fwli
肥头耷耳	ftde
肥尸大只	fudv
肥效	fwxn
肥水	fwuv
肥田	fwtm
肥肥白白	ffbb
肥腯腯	fttu
肩头	jmtz
肩章	jmvh
肯尼迪	kndi
育林	yulb
育种	yuvs
育苗	yumn
肺气肿	fqvs
肺结核	fjhe
胀卜卜	vbbo
胀卜卜	vbbu
胃溃疡	wkyh
胃炎	wwyj
胃肠	wwih
胃镜	wwjk
胆汁	djvi
胆生毛	dumc
胆识	djui
背书	bwuu
背地里	bdli
背弃	bwqi
背心袋	bxdd
背手影	buyk
背投	bwtz
背部	bwbu
胜仗	ugvh
胜似	ugsi
胜瓜	uggx
胞弟	bcdi
胡同	huts
胡椒	hujn
胡涂	hutu
胡琴	huqb
胡胡混混	hhhh
胡适	huui
胡锦涛	hjtc
胡须佬	hxlc
胡须簕特	hxlt
胭脂	yjvi
胰岛素	ydsu
胰腺	yixm
胳肋底	gldi
胳臂	gebw
胶印	jnyb
胶合板	jhbj
胶布	jnbu
胶带	jndd
胶擦	jnca
胶水	jnuv
胶皮	jnpi
胶鞋	jnxp
胼胝	pmvi
能为	ngww
能事	ngui
能见度	njdu
脂肪酸	vfsr
脊柱	jivu
脊梁	jill
脊椎动物	jvdw
脊背	jibw
脊骨	jigu
脏兮兮	zxxi
脏器	zhqi
脐带	qidd
脑力劳动	nlld
脑囟	ncxb
脑溢血	nyxt
脑神经	nujk
脑血栓	nxur
脚劲	jnjb
脚掌	jnvh
脚掣	jnie
脚板	jnbj
脚板底	jbdi
脚气	jnqi
脚甲	jnjx
脚眼	jnyj
脚趾	jnvi
脚趾公	jvgs
脚趾尾	jvww
脚踏	jnta
脚踭	jnvg
脚骨力	jgli
脱僵之马	tjvm
脱盲	tomh
脱粒	toli
脸颊	lmjx
腈纶	jkly
腊八粥	lbvz
腊梅	lamw
腌尖	aajm
腌尖	yjjm
腌臜	aaza
腌臜	yjza
腍善	rfuj
腍柿	rfui
腐化	fuhx
腐蚀	fuui
腔调	qldn
腥膻	xkuj
腰杆	ycgj
腹地	fudi
腹心	fuxb
腹水	fuuv
腹腔	fuql
腽肭	wana
膀子	bhzi
膊头	botz
膳食	ujui
臆断	yidr
自不待言	zbdy
自主权	zvqr
自习	zixi
自养	ziyh
自决	zijt
自制	zivi
自力	zili
自动化	zdhx
自助	zivu
自勉	zimm
自卑感	zbgj
自卫	ziww
自圆其说闲言碎语	zyqy
自备	zibw
自宫	zigs
自尽	zijb
自居	ziju
自己友	zjyz
自幼	ziyz
自序	zixu
自恃	ziui
自愧弗如	zkfr
自愿	ziyr
自慰	ziww
自成一体	ziyt
自成一家	ziyj
自我标榜	zwbb
自找麻烦	zvmf
自有	ziyz
自治	zivi
自治区	zvqu
自治县	zvxm
自治州	zvvz
自流	zilq
自然村	zrcy
自然界	zrjp
自燃	zirj
自由主义	zyvy
自由度	zydu
自由放任	zyfr
自由泳	zyys
自由港	zygh
自知	zivi
自立	zili
自细	zixi
自给	ziji
自给有余	zgyy
自给有余	zjyy
自绝	zijt
自荐	zijm
自让	zirh
自豪感	zhgj
自贡	zigs
自费	zifw
自费生	zfug
自转	zivr
自述	ziuu
自销	zixn
臭氧	izyh
臭烹烹	ippg
臭烹烹	xppg
至上	viuh
至亲	viqb
至关紧要	vgjy
至啱	vinj
至啱	viyj
至强	vijl
至强	viql
至死不变	vsbb
致以	viyi
致使	viui
致力	vili
致密	vimi
致富	vifu
致意	viyi
致敬	vijk
致死	visi
致电	vidm
致病	vibk
致词	vici
舅仔	jqzd
舅仔	jqzi
舅舅	jqjq
舆论界	yljp
舍命	uemk
舍死忘生	uswu
舒坦	uutj
舒心	uuxb
舒舒服服	uuff
舛错	irco
舞会	wuhv
舞剑	wujm
舞场	wuih
舞坛	wutj
舞姿	wuzi
舞小姐	wxjp
舞弊	wubi
舞曲	wuqu
舞池	wuii
舞狮	wuui
舞蹈家	wdjx
舢板	ujbj
舢舨	ujbj
航天器	htqi
航天局	htju
航天部	htbu
航次	hhci
航空兵	hkbk
航空器	hkqi
航空局	hkju
航空港	hkgh
航路	hhlu
航迹	hhji
舰只	jmvi
舰船	jmir
舰艇	jmtk
舰载	jmzd
舰长	jmvh
舱位	chww
舳舻	vulu
舴艋	zemg
舷梯	xmti
舷窗	xmil
船东	irds
船坞	irwu
船头	irtz
船工	irgs
船老大	ilda
船舶	irbo
船身	iruf
艅艎	yuhl
艇家	tkjx
艇屋	tkwu
艨艟	mgis
良友	llyz
良师	llui
良田	lltm
良种	llvs
良策	llce
良金美玉	ljmy
艰深	jmuf
艰苦卓绝	jkvj
艰苦朴素	jkps
色士风	sufg
色士风	uufg
色彩斑斓	scbl
色拉油	slyz
色水	seuv
色水	uduv
艳丽	yjli
艳情	yjqk
艳福	yjfu
艳阳天	yytm
艳阳高照	yygv
艺员	yiyr
艺坛	yitj
艺术品	yupb
艺术团	yutr
艺术家	yujx
艺术性	yuxk
艺术界	yujp
艺术馆	yugr
艺校	yixn
艺界	yijp
艺苑	yiyr
艾伦	aily
艾伦	yily
节余	jpyu
节俭	jpjm
节假日	jjri
节制	jpvi
节前	jpqm
节奏感	jzgj
节律	jplv
节支	jpvi
节水	jpuv
节油	jpyz
节电	jpdm
节目单	jmdj
节育	jpyu
节节胜利	jjul
芃芃	pgpg
芊绵	qmmm
芊芊	qmqm
芘芣	bifu
芘芣	pifu
芙蕖	fuqu
芜湖	wuhu
芣苜	fumu
芥蒂	jpdi
芦花飘扬	lhpy
芫荽	yjsv
芭蕉	bajn
花仔	hxzd
花仔	hxzi
花会	hxhv
花农	hxns
花哩碌	hllu
花哩花碌	hlhl
花坛	hxtj
花女	hxnv
花季	hxji
花岗岩	hgyj
花岗石	hgui
花市	hxui
花布	hxbu
花弗	hxfu
花旦	hxdj
花期	hxqi
花林	hxlb
花果山	hguj
花架子	hjzi
花樽	hxzy
花灯	hxdg
花生油	huyz
花生米	humi
花甲	hxjx
花粉	hxff
花红柳绿	hhll
花色迷人	hsmr
花色迷人	humr
花花绿绿	hhll
花菇	hxgu
花轿	hxjn
花靓仔	hjzd
花靓仔	hjzi
花靓仔	hlzd
花靓仔	hlzi
花面猫	hmmc
花飞蝶舞	hfdw
花香醉人	hxzr
花鸟画	hnhx
花鼓戏	hgxi
芳菲	fhfw
芳香	fhxl
苁蓉	csrs
苍翠挺拔	cctb
苍莽	chmh
苍髯如戟	crrj
苏东坡	sdpo
苏区	suqu
苏宁	sunk
苏联	sulm
苏轼	suui
苒苒	rjrj
苛求	keqq
苞米	bcmi
苞谷	bcgu
苣荬	jumd
苣荬	qumd
苤蓝	pplj
苦功	kugs
苦口苦面	kkkm
苦味	kuww
苦寒	kuhj
苦活	kuho
苦瓜咁嘅面	kggm
苦行	kuxk
英军	ykjy
英勇	ykys
英名	ykmk
英姿	ykzi
英姿焕发	yzhf
英报	ykbc
英杰	ykjp
英武	ykwu
英里	ykli
英飞凌	yflk
茁壮	vovl
茂里	mcli
范文	fjwf
茄喱啡	jlfw
茄喱啡	qlfw
茅台酒	mtjq
茅盾	mcdy
茉莉	moli
茏葱	lscs
茑萝	nnlo
茧丝	jmsi
茧子	jmzi
茯苓	fulk
茱萸	vuyu
茳芏	jldu
茶具	iaju
茶农	ians
茶场	iaih
茶座	iazo
茶炉	ialu
茶点	iadm
茶煲	iabc
茶缸	iagh
茶芥	iajp
茶话会	ihhv
茶餐厅	ictk
茹蕙	ruhv
茺蔚	isww
茼蒿	tshc
荆州	jkvz
荆条	jktn
荆棘	jkji
荆钗布裙	jibq
草场	ccih
草房	ccfh
草木知威	cmvw
草根阶层	cgjc
草皮	ccpi
草绿色	clse
草花头	chtz
草草	cccc
草袋	ccdd
草长莺飞	cvyf
荒地	hldi
荒山	hluj
荔枝	livi
荜菝	biba
荡失路	dulu
荡涤	dhdi
荣军	rsjy
荣誉奖	ryjl
荣誉感	rygj
荣誉章	ryvh
荣辱	rsru
荧光灯	ygdg
荫凉	ybll
药典	ycdm
药到病除	ydbi
药学	ycxt
药店	ycdm
药房	ycfh
药材铺	ycpu
药理	ycli
药用	ycys
药膳	ycuj
荸荠	biqi
荼蘼	tumi
莙荙	jyda
莨菪	lhdh
莨菪	lldh
莪术	eevu
莪蒿	eehc
莫扎特	mvte
莫明其妙	mmqm
莫桑比克	msbk
莫衷一是	mvyu
莱卡	ldka
莱卡	ldqx
莱菔	ldfu
莲叶满池	lxmi
莲叶满池	lymi
莲子	lmzi
莲子蓉面口	lzrk
莳萝	uilo
获释	houi
菁菁	jkjk
菌种	jyvs
菖蒲	ihpu
菜园	cdyr
菜园子	cyzi
菜市场	cuih
菜栏	cdlj
菜窖	cdjn
菜篮子	clzi
菜脯	cdfu
菜脯	cdpu
菜花	cdhx
菜蔬	cduu
菜薳	cdww
菜薳	cdyr
菝葜	baqx
菠萝盖	blgd
菡萏	hjdj
菥蓂	ximk
菩提树	ptuu
菩萨低眉	psdm
菲薄	fwbo
萆薢	bixp
萌动	mgds
萑苇	hrww
萤火虫	yhis
营业员	yyyr
营业所	yyso
营业税	yyuv
营业额	yyee
营养品	yypb
营养素	yysu
营利	ykli
营区	ykqu
营口	ykkz
营垒	yklw
营建	ykjm
营收	ykuz
营生	ykug
萧山	xnuj
萧萧	xnxn
萨拉热窝	slrw
萨法	safa
萨特	sate
萨达姆	sdmu
落口供	lkgs
落堂	lath
落堂	lcth
落堂	loth
落妆	lavl
落妆	lcvl
落妆	lovl
落客	lake
落客	lcke
落客	loke
落手落脚	lulj
落拓	loto
落晒形	luxk
落格	lage
落格	lcge
落格	loge
落泊	lobo
落画	lahx
落画	lchx
落画	lohx
落膈	lage
落膈	lcge
落膈	loge
落落难合	llng
落落难合	llnh
落货	laho
落货	lcho
落货	loho
落选	loxr
落雨收柴	lyui
落面	lamm
落面	lcmm
落面	lomm
落马	loma
著书	veuu
著书	vuuu
著作权	vzqr
著录	vulu
著文	vewf
著文	vuwf
著者	vuve
著述	vuuu
葛洲坝	gvba
葡萄干	ptgj
葡萄酒	ptjq
董事会	duhv
董事长	duvh
董仲舒	dvuu
葭莩	jxfu
葱头	cstz
葳蕤	wwrv
葶苈	tkli
蒋介石	jjdj
蒋介石	jjui
蒙住	mgvu
蒙古包	mgbc
蒙古族	mgzu
蒙头转向	mtvx
蒙查查	miia
蒙牛	mgnq
蒙蒙	mgmg
蒙蒙亮	mmll
蒙难	mgnj
蒜子	srzi
蒲公英	pgyk
蒲卢	pulu
蒲葵	pukv
蒲飞	pufw
蒸气	vgqi
蒸汽	vgqi
蒸汽机	vqji
蒸馏水	vluv
蒹葭	jmjx
蒺藜	jili
蓁艽	vfjn
蓁艽	vfqq
蓁蓁	vfvf
蓄水池	xuii
蓄电池	xdii
蓄积	xuji
蓇葖	gutu
蓉蓉烂烂	rrll
蓊郁	wgyu
蓑衣	soyi
蓓蕾	bwlw
蓖麻	bima
蓝宝石	lbui
蓝布	ljbu
蓝帽子	lmzi
蓝皮书	lpuu
蓝藻	ljzc
蓝调	ljdn
蓝调	ljtn
蓦地	modi
蓬蓬勃勃	ppbb
蔓菁	mjjk
蔗农	vens
蔚为壮观	wwvg
蔚为大观	wwdg
蔚成风气	wifq
蔚蓝色	wlse
蔫韧	nmrf
蕙心纨质	hxwv
蕞尔	zver
蕴涵	yyhj
蕴藉	yyjp
薄利	boli
薄地	bodi
薄幸	boxk
薄片	bcpm
薄薄	bcbc
薄雾	bcwu
薄雾	bowu
薏苡	yiyi
薜荔	bili
薪俸税	xfuv
薯头	uutz
薯类	uulw
薯蓣	uuyu
薿薿	nini
藏历	zhli
蘅芜	hgwu
蘑菇云	mgyy
蘼芜	miwu
虎口	hukz
虎威	huww
虎子	huzi
虎落平阳	hlpy
虚惊	xujk
虚高	xugc
虫害	ishd
虫灾	iszd
虱乸	uina
虱子	uizi
虺虺	hvhv
虾仁	xxrf
虾毛	xxmc
虾虾霸霸	xxbb
虾辘	xxlu
蚊到瞓啦	wdfl
蚊到瞓啦	wdxl
蚊子	wfzi
蚍蜉	pifu
蚕丝	cjsi
蚕茧	cjjm
蚰蜒	yzyj
蚴虬	yzqq
蛀米大虫	vmdi
蛇头	uetz
蛇蝎心肠	uxxi
蛇都死	udsi
蛋散	djsj
蛐蟮	quuj
蛙人	warf
蛛网	vuwh
蛤乸	gena
蛤乸	hana
蛤蜊	geli
蛴螬	qicc
蜂星	fgxk
蜂王浆	fwjl
蜂窝煤	fwmw
蜈蚣	wugs
蜉蝣	fuyz
蜎蜎	yryr
蜕化	tvhx
蜗螺	wolo
蜚声	fwug
蜚蠊	fwlm
蜞乸	qina
蜡梅	lamw
蜡青	laqk
蜥蜴	xiyi
蜾蠃	golo
蜿蜒	wjyj
蝇头微利	ytwl
蝉连	ijlm
蝎子	xpzi
蝗灾	hlzd
蝤蛑	qqmz
蝤蛴	qqqi
蝾螈	rsyr
螟蛉	mklk
螳臂挡车	tbdi
螳臂挡车	tbdj
螳螂捕蝉黄雀在后	tlbh
螵蛸	pnxn
螺丝批	lspi
螺丝钉	lsdk
螺旋桨	lxjl
螺栓	lour
螺蛳	losi
蟏蛸	xnxn
蟛蜞	pgqi
蟾宫折挂	igug
蟾宫折挂	igvg
蟾蜍	ijiu
蠛蠓	mpmg
蠢笨如猪	ibrv
蠼螋	qusz
血压计	xyji
血吸虫	xxis
血性	xtxk
血流成河	xlih
血淋淋	xllb
血红蛋白	xhdb
血缘	xtyr
血肉相连	xrxl
行不更名坐不改姓	hbgx
行不更名坐不改姓	xbgx
行不由径	hbyj
行不由径	xbyj
行事	xkui
行会	hhhv
行使	xkui
行咇	hhbi
行咇	xkbi
行埋	hhmd
行埋	hhmj
行埋	xkmd
行埋	xkmj
行山径	hujk
行山径	xujk
行差踏错	hctc
行差踏错	hitc
行差踏错	xctc
行差踏错	xitc
行径	xkjk
行必果	xbgo
行政区	xvqu
行政村	xvcy
行政院	hvyr
行政院	xvyr
行星	xkxk
行程	xkig
行署	xkuu
行行企企	hhqq
行行企企	hxqq
行行企企	xhqq
行行企企	xxqq
行装	xkvl
行路唔带眼	hlwy
行路唔带眼	xlwy
行雷	hhlw
行雷	xklw
行驶	xkui
衍生物	yuwu
街区	jpqu
街喉	jphz
街坊	jpfh
街头巷议	jthy
街头巷议	jtxy
街市	jpui
街症	jpvg
街线	jpxm
街道	jpdc
街面	jpmm
衡器	hgqi
衣兜	yidz
衣冠	yigr
衣料	yiln
衣架	yijx
衣物	yiwu
衣衫	yiuj
衣袋	yidd
衣裳	yiuh
衣襟	yijb
衣角	yijn
补习	buxi
补习班	bxbj
补发	bufa
补差	buia
补救	bujq
补给	buji
补缺	buqt
补药	buyc
补血	buxt
补课	buke
补足	buzu
表决权	bjqr
表哥	bnge
表弟	bndi
表征	bnvg
表演唱	byih
表肉	bnrz
表里不一	blby
表面化	bmhx
衫钮	ujnq
衬里	ifli
衰变	ukbm
衰咗	ukzo
衰女	uknv
衰衰地	uude
衰衰地	uudi
衷心	vsxb
衷情	vsqk
衷肠	vsih
袅袅瘦瘦	nnuu
袋袋平安	ddpa
袒露	tjlu
袖手傍观	xubg
被俘	bwfu
被压迫	bypd
被压迫	bypo
被压迫	pypd
被压迫	pypo
被告人	bgrf
被害	bwhd
被害人	bhrf
被害者	bhve
被捕	bwbu
被服	bwfu
被窦	bwdz
被窦	pidz
被选举权	bxjq
裁剪	cdjm
裁缝	cdfg
裂化	lphx
裂谷	lpgu
裂隙	lpxi
装假狗	vjgz
装弹弓	vdgs
装弹弓	vtgs
装机	vlji
装璜	vlhl
装甲	vljx
装甲兵	vjbk
装甲车	vjie
装船	vlir
装车	vlie
装配线	vpxm
装饰品	vupb
装香	vlxl
裙脚仔	qjzd
裙脚仔	qjzi
裙装	qyvl
裙褂	qygx
裣衽	lmrf
裤头带	ktdd
裸戏	loxi
裹蒸粽	gvzs
褒善贬恶	bube
褒善贬恶	bubw
褒扬	bcyh
褓姆车	bmie
褓姆车	bmju
褡裢	dalm
褥疮	ruil
褪軚	tvtd
褪軚	tytd
襁袍	qlpc
襁褓	qlbc
襄樊	xlfj
襄阳	xlyh
西化	xihx
西北风	xbfg
西半球	xbqq
西南风	xnfg
西城	xiig
西头	xitz
西学	xixt
西式	xiui
西文	xiwf
西方人	xfrf
西施	xiui
西服	xifu
西汉	xihj
西沙	xiua
西洋	xiyh
西洋参	xyuf
西洋菜	xycd
西端	xidr
西经	xijk
西装友	xvyz
西陆	xilq
西陆	xilu
西雅图	xytu
西非	xifw
要义	ycyi
要事	ycui
要件	ycjm
要冲	ycis
要务	ycwu
要员	ycyr
要旨	ycvi
要目	ycmu
要饭	ycfj
覆盖率	fglv
见习	jmxi
见利思义	jlsy
见危授命	jwum
见地	jmdi
见得	jmde
见怪不怪	jgbg
见报	jmbc
见效	jmxn
见步行步	jbhb
见步行步	jbxb
见牙唔见眼	jywy
见状	jmvl
见见	jmjm
见解	jmjp
见识	jmui
见长	jmih
见长	jmvh
见面礼	jmli
观众席	gvxi
观察力	gili
观察员	giyr
观察家	gijx
观战	grvj
观瞻	grvj
观礼	grli
观者如云	gvry
观音兵	gybk
规例	gvli
规律性	glxk
规程	gvig
规章制度	gvvd
规行矩步	gxjb
规规矩矩	ggjj
觅食	miui
视为	uiww
视入草芥	urcj
视力	uili
视图	uitu
视点	uidm
视线	uixm
视网膜	uwmo
视野	uiye
觉眼	jnyj
觉眼	jtyj
觉觉猪	jjvu
觊觎	jiyu
角落头	jltz
角钢	jngh
解体	jpti
解开	jpkd
解忧	jpyz
解放区	jfqu
解放后	jfhz
解放战争	jfvv
解数	xpuu
解构	jpgz
解毒	jpdu
解渴	jpke
解禁	jpjb
解衣推食	jytu
解说词	juci
解调	jptn
解除	jpiu
解难	jpnj
触动	iuds
触及	iuji
触发	iufa
触媒	iumw
触礁	iujn
觱篥	bili
觳觫	husu
言和	yjhe
言必信	ybxb
言必信行必果	ybxg
言必有据	ybyj
言教	yjjn
言词	yjci
誓师	uiui
誓死	uisi
誓言	uiyj
誓词	uici
警力	jkli
警卫员	jwyr
警句	jkju
警备区	jbqu
警察局	jiju
警戒	jkjp
警戒线	jjxm
警报器	jbqi
警服	jkfu
警种	jkvs
警笛	jkdi
警醒	jkxk
计仔	jizd
计仔	jizi
计分	jiff
计划性	jhxk
计划生育	jhuy
计委	jiww
计数	jiuu
计时	jiui
计酬	jiiz
计量	jill
订户	dkhu
讣告	fugc
认亲认戚	rqrq
认低威	rdww
认住	rfvu
认叻	rfle
认清	rfqk
认知	rfvi
认认真真	rrvv
认识论	ruly
讥笑	jixn
讨嫌	tcxm
讨饭	tcfj
训令	xylk
训练场	xlih
训练有素	xlys
训练班	xlbj
训诫	xyjp
议事	yiui
议价	yijx
议会制	yhvi
议员	yiyr
议和	yihe
议定	yidk
议定书	yduu
议席	yixi
议政	yivg
议长	yivh
议院	yiyr
议题	yiti
讯问	xywf
记事	jiui
记分	jiff
记功	jigs
记取	jiqu
记叙	jixu
记叙文	jxwf
记忆力	jyli
记性	jixk
记要	jiyc
记账	jivh
记述	jiuu
讲义	jlyi
讲信修睦	jxxm
讲堂	jlth
讲大话	jdhx
讲学	jlxt
讲师	jlui
讲开又讲	jkyj
讲打讲杀	jdju
讲理	jlli
讲耶稣	jysu
讲解员	jjyr
许可证	xkvg
许许多多	xxdd
论处	lyiu
论文集	lwji
论理	lyli
讻讻	xsxs
讽一劝百	fyqb
设伏	uefu
设计师	ujui
设计者	ujve
设计院	ujyr
证实	vgui
证明书	vmuu
证章	vgvh
证言	vgyj
评为	pkww
评介	pkjp
评剧	pkju
评功	pkgs
评头品足	ptpz
评头论足	ptlz
评委会	pwhv
评弹	pktj
评比	pkbi
评论员	plyr
评话	pkhx
识字	uizi
识捞	uilc
识捞	vilc
识饮识食	uyus
识饮识食	uyuu
识饮识食	uyuy
识饮识食	uyvs
识饮识食	uyvu
识饮识食	uyvy
识饮识食	vyus
识饮识食	vyuu
识饮识食	vyuy
识饮识食	vyvs
识饮识食	vyvu
识饮识食	vyvy
诈假意	vjyi
诈傻扮懵	vubm
诈嗲	vadx
诈型	vaxk
诈娇	vajn
诈糊	vahu
诈谛	vadi
诉状	suvl
诉讼法	ssfa
诉诸武力	svwl
诊室	vfui
诊治	vfvi
词人	cirf
词句	ciju
词曲	ciqu
词牌	cipd
译丛	yics
译作	yizo
译制	yivi
译文	yiwf
译本	yibf
译著	yivu
试制	uivi
试剂	uiji
试办	uibj
试听	uitk
试想	uixl
试映	uiyk
试用	uiys
试用期	uyqi
试看	uikj
试种	uivs
试管	uigr
试行	uixk
试试看	uukj
试金石	ujui
试销	uixn
试问	uiwf
试题	uiti
试飞	uifw
试验田	uytm
诖误	gxwu
诗体	uiti
诗作	uizo
诗圣	uiug
诗坛	uitj
诗意	uiyi
诗文	uiwf
诗经	uijk
诗话	uihx
诗集	uiji
诘诎	jiqu
诘诎	jpqu
诚信	igxb
诚实	igui
诚挚	igvi
诚聘	igpb
诚邀	igyc
诛杀	vuua
话之佢	hvko
话之佢	hvqu
话剧团	hjtr
话务员	hwyr
话匣子	hxzi
话口未完	hkww
话名	hxmk
话咁易	hgyi
话唔埋	hwmd
话唔埋	hwmj
话唔定	hwdk
话头	hxtz
话头醒尾	htxw
话斋	hxvd
话时话	huhx
话茬	hxia
话费	hxfw
诟詈	gzli
诠释	qrui
诤友	vgyz
诤言	vgyj
该煨	gdww
详实	xlui
详尽	xljb
详解	xljp
诧异	iayi
诬陷	wuxm
语义	yuyi
语境	yujk
语意	yuyi
语文课	ywke
语气	yuqi
语汇	yuhv
语系	yuxi
语词	yuci
误事	wuui
误导	wudc
误时	wuui
误点	wudm
误用	wuys
误食	wuui
诱使	yzui
诱因	yzyb
诱杀	yzua
说不上	ubuh
说到底	uddi
说和	uohe
说大话	udhx
说时迟	uuii
说是	uoui
说服力	ufli
说空话	ukhx
说说笑笑	uuxx
说说笑笑	uyxx
说说笑笑	yuxx
说说笑笑	yyxx
说长道短	uidd
请便	qkbm
请功	qkgs
请愿	qkyr
请战	qkvj
请鎗	qkql
请饮	qkyb
诸位	vuww
诸如	vuru
诸葛亮	vgll
读书人	durf
读后感	dhgj
课件	kejm
课余	keyu
课时	keui
课目	kemu
课间	kejm
谁不知	ubvi
谁料	uvln
谁料	uwln
谂头	uftz
谂缩数	usuu
调令	dnlk
调头	dntz
调幅	tnfu
调控	tnks
调节器	tjqi
调解	tnjp
调资	tnzi
调车	dnie
调车	dnju
调车	tnie
调车	tnju
调转	dnvr
调转头	dvtz
调转头	tvtz
调运	dnyy
谄谀	ijyu
谆谆	vyvy
谆谆告诫	vvgj
谆谆教导	vvjd
谈兴	tjxk
谈吐	tjtu
谈天说地	ttud
谈心	tjxb
谈笑	tjxn
谈虎色变	thsb
谈起	tjqi
谋取	mzqu
谐和	xphe
谐调	xptn
谗谀	ijyu
谚语	yjyu
谡谡	susu
谢意	xpyi
谦让末遑	qrmh
谨言慎行	jyux
谮气	zfqi
谰叻	ljle
谰正经	lvjk
谷地	gudi
谷气	guqi
谷物	guwu
谷雨	guyu
豁亮	holl
豁口	hokz
豁达大度	hddd
豆丁	dzdk
豆制品	dvpb
豆汁	dzvi
豆沙喉	duhz
豆油	dzyz
豆科	dzke
豆荚	dzjx
豆饼	dzbk
豉汁	iivi
象样	xlyh
象牙之塔	xyvt
豪气	hcqi
豪赌	hcdu
豫剧	yuju
豹子	bczi
豺狐之心	ihvx
豺狼成性	ilix
贝利	bwli
贝塔斯曼	btsm
贝多芬	bdff
负于	fuyu
负债累累	fvll
负数	fuuu
负有	fuyz
负气	fuqi
负荷	fuhe
负重	fuvs
财产权	ciqr
财季	cdji
财报	cdbc
财政厅	cvtk
财政部	cvbu
财权	cdqr
财源	cdyr
财物	cdwu
财神爷	cuye
责任制	zrvi
责任心	zrxb
责任田	zrtm
责编	zebm
贤人	xmrf
贤哲	xmve
贤慧	xmhv
贤达	xmda
败北	bdbw
败者	bdve
败血症	bxvg
败露	bdlu
货价	hojx
货场	hoih
货机	hoji
货畅其流	hiql
货车	hoie
货郎	holh
质保	vibc
质子	vizi
质朴无华	vpwh
质检	vijm
贪口爽	tkul
贪大求全	tdqq
贪大求洋	tdqy
贪得意	tdyi
贪污受贿	twuh
贪污犯	twfj
贫困户	pkhu
贫困线	pkxm
贫弱	pbro
贫民窟	pmku
贫贱不移	pjby
贬义	bmyi
贬值	bmvi
购买力	gmli
购价	gzjx
购机	gzji
贮备	vubw
贮运	vuyy
贯串	grir
贲门	bfmf
贴堂	tpth
贴心人	txrf
贴画	tphx
贴金	tpjb
贴钱买难受	tqmu
贴错门神	tcmu
贵国	gvgo
贵州省	gvug
贵金属	gjuu
贵阳市	gyui
贸促会	mchv
贸易额	myee
费事	fwui
费事理	fuli
费工	fwgs
贺信	hexb
贺函	hehj
贺年	henm
贺年片	hnpm
贺电	hedm
贺礼	heli
贺辞	heci
贻误	yiwu
贼佬	zwlc
贼佬试沙煲	zlub
资力	zili
资助	zivu
资历	zili
资本论	zbly
资财	zicd
赊数	ueuu
赌具	duju
赎买	uumd
赎罪	uuzv
赏识	uhui
赏赐	uhci
赑屃	bixi
赖死	ldsi
赖猫	ldmc
赘述	vvuu
赚头	vrtz
赛迪	sddi
赛门铁克	smtk
赞语	zjyu
赞谈不已	ztby
赠书	zguu
赠款	zgkr
赡养	ujyh
赢余	ykyu
赢利	ykli
赢取	ykqu
赢政	ykvg
赤卫队	iwdv
赤口	iikz
赤子	iizi
赤子之心	izvx
赤峰	iifg
赤心报国	ixbg
赤心相待	ixxd
赤日炎炎	iryy
赤诚	iiig
赤贫	iipb
赤道	iidc
赫哲族	hvzu
赫德	hede
赫赫	hehe
赫鲁晓夫	hlxf
走下坡路	zxpl
走埠	zzbu
走堂	zzth
走失	zzui
走夹唔唞	zgwd
走夹唔唞	zgwt
走夹唔唞	zjwd
走夹唔唞	zjwt
走宝	zzbc
走法律罅	zflx
走盏	zzvj
走私犯	zsfj
走精面	zjmm
走资派	zzpd
走趯	zzti
走趯	zzyt
走近	zzjb
走道	zzdc
走难	zznj
走露	zzlu
走露	zzlz
走马看花	zmkh
走鬼	zzgv
赴美	fumw
赵体	vcti
赵孟頫	vmfu
赶到	gjdc
赶唔切	gwqp
赶时髦	gumc
赶路	gjlu
赶集	gjji
赶鸭仔	gyzd
赶鸭仔	gyzi
起义	qiyi
起义军	qyjy
起事	qiui
起价	qijx
起伏	qifu
起先	qixm
起动	qids
起名	qimk
起始	qiui
起居	qiju
起底	qidi
起开	qikd
起早摸黑	qzmh
起火	qiho
起用	qiys
起程	qiig
起筷	qikk
起色	qise
起落架	qljx
起见	qijm
起跑	qipc
起跑线	qpxm
起运	qiyy
起重	qivs
起镬	qiho
起飞脚	qfjn
起鸡皮	qjpi
趁势	ifui
趁墟	ifxu
超产	icij
超低温	idwf
超低空	idks
超值	icvi
超声	icug
超声波	iubo
超导体	idti
超尘拔俗	iibs
超市	icui
超新星	ixxk
超期	icqi
超然物外	irww
超级大国	ijdg
超音速	iysu
超高	icgc
越剧	ytju
越境	ytjk
越是	ytui
越狱	ytyu
越界	ytjp
越级	ytji
趋于	quyu
趋向	quxl
趑趄	ziju
趣事	quui
足下	zuxx
足球队	zqdv
跃破	ytpo
跃跃欲试	yyyu
跃进	ytjb
跋山涉水	buuu
跌涨	dpvh
跏趺	jxfu
跑官	pcgr
跛脚佬	bjlc
跟头	gftz
跟尾狗	gwgz
跟手尾	guww
跟红顶白	ghdb
跨上	kxuh
跨国	kxgo
跨年度	kndu
跪倒	gvdc
路卡	luka
路卡	luqx
路基	luji
路见不平拔刀相助	ljbv
路透社	ltue
路风	lufg
跳楼货	tlho
跳皮	tnpi
跳糟	tnzc
跳马	tnma
跷妙	qnmn
跷蹊	qnqi
跼蹐	juji
踌躇	iziu
踎厕	bwce
踎厕	bwsi
踎街	bwjp
踟蹰	iiiu
踩低	cddi
踩单车	cdie
踩单车	cdju
踩单车	ciie
踩单车	ciju
踩单车	cuie
踩单车	cuju
踩场	cdih
踩死蚁	csyi
踩界	cdjp
踩蕉皮	cjpi
踩过界	cgjp
踩雪屐	cxji
踪迹	zsji
踯躅	vivu
踽踽	juju
蹀躞	dpxp
蹈节死义	djsy
蹊径	xijk
蹭蹬	cgdg
蹼泳	puys
身世	ufui
身亡	ufwh
身兴	ufxk
身分	ufff
身受	ufuz
身后	ufhz
身姿	ufzi
身孕	ufyy
身家	ufjx
身手	ufuz
身教	ufjn
身水身汗	uuuh
身纪	ufji
身长	ufih
躯干	qugj
躲躲闪闪	dduu
车体	ieti
车厘子	ilzi
车厘子	jlzi
车叶	iexp
车叶	ieye
车叶	juxp
车叶	juye
车头相	itxl
车头相	jtxl
车尾箱	iwxl
车尾箱	jwxl
车床	ieil
车房仔	ifzd
车房仔	ifzi
车房仔	jfzd
车房仔	jfzi
车皮	iepi
车组	iezu
车衫	ieuj
车衫	juuj
车軚	ietd
车軚	jutd
车辘	ielu
车辘	julu
车辙	ieve
轧制	yavi
轧辊	vagy
轩轾	xrvi
转下眼	vxyj
转业	vrye
转会	vrhv
转体	vrti
转卖	vrmd
转向	vrxl
转呔	vrdd
转呔	vrtd
转售	vruz
转嫁	vrjx
转干	vrgj
转性	vrxk
转战南北	vvnb
转投	vrtz
转机	vrji
转来转去	vlvq
转正	vrvg
转炉	vrlu
转用	vrys
转瞬间	vujm
转网	vrwh
转赠	vrzg
转车	vrie
转轪	vrdd
转运站	vyvj
转述	vruu
轮更	lygg
轮渡	lydu
轮训	lyxy
软弱无力	rrwl
软熟	rruu
软熟	rruz
软皮蛇	rpue
软着陆	rvlu
软荏荏	rrrf
软银	rryb
轰击	hsji
轰动一时	hdyu
轰响	hsxl
轰炸机	hvji
轻信	qkxb
轻取	qkqu
轻型	qkxk
轻如鸿毛	qrhm
轻工业	qgye
轻武器	qwqi
轻生	qkug
轻纺	qkfh
轻视	qkui
轻财好施	qchu
轻音乐	qyyt
轻风	qkfg
轻骑	qkqi
载人	zdrf
载货	zdho
载酒问字	zjwz
轿夫	jnfu
轿子	jnzi
较之	jnvi
较差	jnia
辅导员	fdyr
辈出	bwiu
辈分	bwff
辉映	hvyk
辑录	jilu
输卵管	ulgr
输家	uujx
输油管	uygr
输液	uuye
输电	uudm
输电线	udxm
输血	uuxt
输赌	uudu
辖区	xxqu
辘卡	luka
辘卡	luqx
辘轳	lulu
辛丑	xbiz
辛亥	xbhd
辛卯	xbmc
辛巳	xbsi
辛未	xbww
辛酉	xbyz
辞不达意	cbdy
辞书	ciuu
辞典	cidm
辞行	cixk
辟易	biyi
辟易	piyi
辨析	bmxi
辨证	bmvg
辨识	bmui
辩护人	bhrf
辩解	bmjp
辩证法	bvfa
边区	bmqu
边城	bmig
边寨	bmvd
边民	bmmb
边界	bmjp
边界线	bjxm
边线	bmxm
边角料	bjln
边远	bmyr
边际	bmji
辽宁省	lnug
辽远	lnyr
达卡	daka
达卡	daqx
达观	dagr
迁册	qmce
迁徙	qmxi
迂缓	yuhr
迅驰	xyii
过五关	gwgr
过人	gorf
过冬	gods
过冷河	glhe
过埠新娘	gbxn
过境	gojk
过大	goda
过失	goui
过底纸	gdvi
过往	gowh
过得硬	gdyk
过快	gokk
过敏	gomb
过时	goui
过时黄花	guhh
过来人	glrf
过激	goji
过火	goho
过眼烟云	gyyy
过硬	goyk
过秤	goig
过细	goxi
过街老鼠	gjlu
过路	golu
过路人	glrf
过道	godc
过钟	govs
过长	goih
过长	govh
过骨	gogu
过龙	gols
迈克	mdke
迈克尔	mker
迈拓	mdta
迈拓	mdto
迈进	mdjb
迍邅	vyvj
迎击	ykji
迎头赶上	ytgu
迎宾曲	ybqu
迎宾馆	ybgr
迎送	ykss
迎风招展	yfvv
运到	yydc
运力	yyli
运动员	ydyr
运动场	ydih
运动战	ydvj
运动衣	ydyi
运动量	ydll
运动队	yddv
运动鞋	ydxp
运城	yyig
运斤成风	yjif
运筹帷幄	yiww
运营商	yyuh
运输机	yuji
运输线	yuxm
运输费	yufw
运销	yyxn
近些年	jxnm
近代史	jdui
近住	jbvu
近在眉睫	jzmj
近处	jbiu
近年	jbnm
近日	jbri
近来	jbld
近海	jbhd
近程	jbig
近视眼	juyj
返乡	fjxl
返修	fjxq
返屋企	fwqi
返销	fjxn
返销粮	fxll
返青	fjqk
还乡	hdxl
还乡	hrxl
还应	hdyk
还应	hryk
还愿	hryr
还手	hruz
还清	hrqk
还神	hduf
还神	hruf
还须	hdxu
还须	hrxu
这一下	vyxx
这一来	vyld
这就是说	vjuu
进一步	jybu
进京	jbjk
进出口	jikz
进化论	jhly
进发	jbfa
进取	jbqu
进口税	jkuv
进口货	jkho
进城	jbig
进士	jbui
进犯	jbfj
进行曲	jxqu
进言	jbyj
进贡	jbgs
进逼	jbbi
进项	jbxl
进食	jbui
远亲近邻	yqjl
远古	yrgu
远望	yrwh
远洋	yryh
远涉重洋	yuiy
远游	yryz
远离	yrli
远行	yrxk
远见	yrjm
远远	yryr
远销	yrxn
违例	wwli
违宪	wwxm
违犯	wwfj
违禁品	wjpb
违纪	wwji
违者	wwve
连云港	lygh
连任	lmrf
连作	lmzo
连同	lmts
连埋	lmmd
连埋	lmmj
连环	lmhr
连环画	lhhx
连用	lmys
连续不断	lxbd
连绵	lmmm
连衣裙	lyqy
连轴转	lvvr
连连	lmlm
连通	lmts
连部	lmbu
连锁反应	lsfy
连队	lmdv
连阴雨	lyyu
迢递	tndi
迤逦	yili
迥然不同	jrbt
迪斯尼	dsni
迪斯科	dske
迫击炮	pjpc
迫纽	pdnq
迫纽	ponq
迭埋心水	dmxu
迭起	dpqi
述职	uuvi
述评	uupk
迷彩服	mcfu
迷漫	mimj
追击	vvji
追悼会	vdhv
追肥	vvfw
追记	vvji
追述	vvuu
退休金	txjb
退位	tvww
退守	tvuz
退居	tvju
退换	tvhr
送人情	srqk
适中	uivs
适于	uiyu
适宜	uiyi
适应性	uyxk
适应症	uyvg
适时	uiui
适用	uiys
适用性	uyxk
适配	uipw
适销	uixn
适龄	uilk
选举权	xjqr
选修课	xxke
选区	xrqu
选择题	xzti
选曲	xrqu
选本	xrbf
选段	xrdr
选矿	xrkl
选种	xrvs
选聘	xrpb
选育	xryu
选读	xrdu
选调	xrdn
选集	xrji
逊志时敏	xvum
透火	tzho
透镜	tzjk
逐一	vuyi
逐个	vuge
逐级	vuji
递补	dibu
途经	tujk
通例	tsli
通信员	txyr
通史	tsui
通商	tsuh
通明	tsmk
通晓	tsxn
通栏	tslj
通气	tsqi
通渠	tsqu
通用性	tyxk
通畅	tsih
通称	tsig
通统	tsts
通缉	tsji
通航	tshh
通衢	tsqu
通观	tsgr
通讯员	txyr
通讯网	txwh
通译	tsyi
通货	tsho
通路	tslu
通辽	tsln
通通	tsts
通邮	tsyz
通顶	tsdk
逝世	uiui
逞凶	igxs
速射	suue
速成	suig
速滑	suhx
速龙	suls
造反	zcfj
造就	zcjq
造影	zcyk
造物主	zwvu
造纸厂	zvih
造诣	zcyi
逡巡	qyxy
逢人说项	frux
逢人说项	fryx
逢年过节	fngj
逢系	fgji
逢系	fgxi
逶迤	wwyi
逶随	wwsv
逸事	yiui
逸闻	yiwf
逼人	birf
逼和	bihe
逼近	bijb
逾期	yuqi
逾越	yuyt
遁词	dyci
遇刺	yuci
遇险	yuxm
遍及	bmji
遍地	bmdi
遏力	eeli
遏止	eevi
道人	dcrf
道光	dcgl
道口	dckz
道士	dcui
道家	dcjx
道岔	dcia
道班	dcbj
道琼斯	dqsi
道道	dcdc
遗书	yiuu
遗传学	yixt
遗传性	yixk
遗体	yiti
遗作	yizo
遗像	yixl
遗址	yivi
遗失	yiui
遗孤	yigu
遗容	yirs
遗弃	yiqi
遗志	yivi
遗愿	yiyr
遗物	yiwu
遗训	yixy
遗迹	yiji
遗风	yifg
遥感	ycgj
遥遥	ycyc
遭遇战	zyvj
遮羞布	vxbu
遮阳	veyh
避孕药	byyc
避实击虚	bujx
避实就虚	bujx
避暑	biuu
避雷针	blvf
避风塘	bfth
避风港	bfgh
邀集	ycji
邅迴	vjhv
邓小平	dxpk
邓选	dgxr
邢台	xktd
那时快	nukk
那是	naui
邪气	xpqi
邪说	xpuo
邪路	xplu
邮展	yzvj
邮政局	yvju
邮电	yzdm
邮电局	ydju
邮筒	yzts
邮编	yzbm
邮袋	yzdd
邮资	yzzi
邮路	yzlu
邮车	yzie
邮递员	ydyr
邻县	lbxm
邻近	lbjb
邻里	lbli
郁渥	yuwo
郊游	jnyz
郑州市	vvui
部下	buxx
部优	buyz
部委	buww
部属	buuu
部族	buzu
部类	bulw
部级	buji
郭沫若	gmro
都城	duig
鄂西	eexi
鄂豫皖	eywj
鄙夷	biyi
鄙薄	bibo
鄙陋	bilz
鄢郢	yjyk
酋长国	qvgo
酌醴	voli
配制	pwvi
酒会	jqhv
酒米	jqmi
酒精	jqjk
酒菜	jqcd
酒饼	jqbk
酣睡	hjuv
酥油	suyz
酥油茶	syia
酥虾	suxx
酩酊	mkdk
酬金	izjb
酴醾	tumi
酸微微	swww
酸枝	srvi
醉酒佬	zjlc
醍醐	tihu
醒定	xkdk
醒目仔	xmzd
醒目仔	xmzi
醒胃	xkww
采伐	cdfa
采掘	cdjt
采石	cdui
采购员	cgyr
采风	cdfg
释义	uiyi
释文	uiwf
释疑	uiyi
里便	libm
里便	lipm
里勾外连	lgwl
里外	liwd
里手	liuz
里程	liig
里程碑	libw
里里外外	llww
里长	liih
里长	livh
重任	vsrf
重兵	vsbk
重利	vsli
重剑	vsjm
重印	isyb
重在	iszd
重在	vszd
重地	vsdi
重型	vsxk
重奖	vsjl
重工业	vgye
重心	vsxb
重案组	iazu
重案组	vazu
重武器	vwqi
重油	vsyz
重洋	isyh
重炮	vspc
重物	vswu
重秤	isig
重秤	vsig
重重叠叠	iidd
重金属	vjuu
野史	yeui
野战军	yvjy
野猪	yevu
野茫茫	ymmh
野鸡	yeji
量刑	llxk
量力	llli
量变	llbm
金不换	jbhr
金丝猴	jshz
金价	jbjp
金价	jbjx
金光灿烂	jgcl
金光闪闪	jguu
金刚石	jgui
金华	jbhx
金发	jbfa
金咭	jbji
金咭	jbka
金庸	jbys
金捞	jblc
金文	jbwf
金星	jbxk
金桂飘香	jgpx
金沙	jbua
金灿灿	jccj
金盘洗手	jpxu
金石	jbui
金矿	jbkl
金秋	jbqq
金笔	jbbi
金箔	jbbo
金花	jbhx
金蚕脱壳	jctk
金蚕脱壳	jctq
金质	jbvi
金门	jbmf
金陵	jblk
金鱼佬	jylc
金鸡	jbji
鉴定会	jdhv
鉴戒	jmjp
鉴赏力	juli
鎅刀	gddc
针冇两头利	vmll
针剂	vfji
针头	vftz
针头线脑	vtxn
针对性	vdxk
针眼	vfyj
针线	vfxm
针织	vfvi
针织品	vvpb
钉盖	dkgd
钟声	vsug
钟数	vsuu
钟点	vsdm
钟点女佣	vdny
钢丝绳	gsug
钢厂	ghih
钢材	ghcd
钢枪	ghql
钢渣	ghva
钢笔	ghbi
钢筋铁骨	gjtg
钢花	ghhx
钦差大臣	qidi
钱七	qmqi
钱学森	qxsf
钱币	qmbi
钱庄	qmvl
钱罂	qmyk
钳制	qmvi
钳子	qmzi
钳工	qmgs
钵仔糕	bzgc
钵酒	bojq
钻井队	zjdv
钻塔	zrta
钻机	zrji
钻石王老五	zdww
钻石王老五	zuww
钻空子	zkzi
铁丝网	tswh
铁中铮铮	tvvv
铁合金	thjb
铁心	tpxb
铁杵成针	tiiv
铁树开花	tukh
铁桥	tpqn
铁水	tpuv
铁流	tplq
铁矿石	tkdj
铁矿石	tkui
铁索桥	tsqn
铁路局	tlju
铁路桥	tlqn
铁通	tpts
铁道兵	tdbk
铁锨	tpxm
铁面御史	tmyu
铁骑	tpqi
铁骑士	tqui
铅印	qmyb
铅字	qmzi
铅球	qmqq
铎叔	douu
铓锣	mhlo
铜像	tsxl
铜器	tsqi
铜头铁额	ttte
铜板	tsbj
铜管乐	tgle
铜管乐	tgyt
铜陵	tslk
铠甲	kdjx
铭文	mkwf
铮铮	vgvg
铮铮铁骨	vvtg
铰剪	jnjm
铲泥车	inie
铲泥车	inju
铲车	ijie
铲除	ijiu
铴锣	thlo
银仔	ybzd
银仔	ybzi
银元	ybyr
银发	ybfa
银团	ybtr
银奖	ybjl
银币	ybbi
银河系	yhxi
银灰色	yhse
银芽	ybya
银行业	yhye
银行家	yhjx
银质奖	yvjl
铸件	vujm
铸成	vuig
铸成大错	vidc
铺路石	plui
铺轨	pugv
链冚	lmkj
链子	lmzi
链球菌	lqjy
销价	xnjx
销假	xnjx
销售一空	xuyk
销售额	xuee
销货	xnho
销路	xnlu
销铄	xnuo
锄大弟	iddi
锄头	iutz
锈蚀	xqui
锌盆	xbpf
锒铛	lhdh
错事	coui
错失	coui
锟铻	kywu
锡伯族	xbzu
锣鼓喧天	lgxt
锥处囊中	vinv
锥形	vvxk
锦州	jbvz
锦旗	jbqi
锦标赛	jbsd
锦绣	jbxq
锦绣前程	jxqi
锦绣山河荒山野地	jxud
锦西	jbxi
锭子	dkzi
键入	jmru
锯扒	juba
锯扒	jupa
锻压	drya
镆铘	moye
镇痛	vfts
镇纸	vfvi
镐头	gctz
镜像	jkxl
镜框	jkkl
镬气	hoqi
长一智	vyvi
长假	ihjx
长剑	ihjm
长势	vhui
长叹	ihtj
长官	vhgr
长年	ihnm
长成	vhig
长拉拉	illa
长拉拉	vlla
长方形	ifxk
长明灯	imdg
长春市	iiui
长春市	viui
长椅	ihyi
长沙市	iuui
长沙市	vuui
长河	ihhe
长法	ihfa
长焦	ihjn
长焦	vhjn
长白山	ibuj
长眠	ihmm
长矛	ihmc
长短周	idvz
长短周	vdvz
长笛	ihdi
长衫	ihuj
长袍	ihpc
长话	ihhx
长长	ihih
长长	ihvh
长长	vhih
长长	vhvh
閪狗	hwgz
门口狗	mkgz
门外汉	mwhj
门将	mfjl
门市部	mubu
门框	mfkl
门牌	mfpd
门联	mflm
门脸	mflm
门钟	mfvs
闪光灯	ugdg
闪动	ujds
闪失	ujui
闪存	ujcy
闪盘	ujpj
闪闪烁烁	uuuu
闭会	bihv
闭幕式	bmui
闭幕词	bmci
闭目塞听	bmst
闭翳	biyi
闭邪存诚	bxci
闭邪存诚	byci
闭门羹	bmgg
问及	wfji
问吊	wfdn
问好	wfhc
问讯	wfxy
问询	wfxy
问鼎	wfdk
闯劲	iljb
闲事	xmui
闲科	xmke
闲置	xmvi
闲话	xmhx
闲闲地	xxde
闲闲地	xxdi
间不容发	jbrf
间作	jmzo
间断	jmdr
间架	jmjx
间距	jmju
间隙	jmxi
闶阆	khlh
闷气	mfqi
闸住	vavu
闹交	ncjn
闹市	ncui
闹市区	nuqu
闻名	wfmk
阀阅	fayt
阁仔	gezd
阁仔	gezi
阅世	ytui
阅兵	ytbk
阅兵式	ybui
阅览室	ylui
阉割	yjge
阊阖	ihhe
阑尾炎	lwyj
阑干	ljgj
阒砾缂嘞	qlkl
阔佬懒理	klll
阔咧啡	klfw
阖府统请	hftq
阜新	fuxb
阜阳	fuyh
队旗	dvqi
队目	dvmu
队部	dvbu
队长	dvih
队长	dvvh
阢陧	wunp
阢陧	wwnp
防冻	fhds
防务	fhwu
防化	fhhx
防化兵	fhbk
防卫	fhww
防意如城	fyri
防护林	fhlb
防旱	fhhj
防汛	fhxy
防治	fhvi
防波堤	fbdi
防灾	fhzd
防盗	fhdc
防空洞	fkds
防腐	fhfu
防腐剂	ffji
防长	fhih
防长	fhvh
防震	fhvf
防风林	fflb
阳萎	yhww
阴云	ybyy
阴凉	ybll
阴声细气	yuxq
阴性	ybxk
阴道	ybdc
阴雨连绵	yylm
阵势	vfui
阵地战	vdvj
阶下囚	jxqq
阶梯	jpti
阶砖	jpvr
阶级性	jjxk
阶级斗争	jjdv
阻击	zuji
阻击战	zjvj
阻头阻势	ztzu
阻截	zujp
阻滞	zuvi
阿嫲	aama
阿嫲	eema
阿尔卑斯	aebs
阿尔卑斯	eebs
阿尔卡特	aekt
阿尔卡特	aeqt
阿尔卡特	eekt
阿尔卡特	eeqt
阿差	aaci
阿差	aaia
阿差	aaid
阿差	eeci
阿差	eeia
阿差	eeid
阿拉斯加	alsj
阿拉斯加	elsj
阿支阿左	avaz
阿支阿左	avez
阿支阿左	evaz
阿支阿左	evez
阿灿	aacj
阿灿	eecj
阿猪阿狗	avag
阿猪阿狗	aveg
阿猪阿狗	evag
阿猪阿狗	eveg
阿盟	aamg
阿茂	aamc
阿茂	eemc
阿茂整饼	amvb
阿茂整饼	emvb
阿里	aali
阿里	eeli
阿里巴巴	albb
阿里巴巴	elbb
陀螺	tolo
陂陀	poto
附中	fuvs
附件	fujm
附则	fuze
附加税	fjuv
附和	fuhe
附小	fuxn
附属物	fuwu
附庸	fuys
附录	fulu
附有	fuyz
附注	fuvu
附着物	fvwu
附言	fuyj
附设	fuue
际遇	jiyu
陆上	luuh
陆军装	ljvl
陆战队	lvdv
陆海空	lhks
陆游	lqyz
陆游	luyz
陆空	lqks
陆空	luks
陆荣廷睇相唔衰罗嚟衰	lrtu
陆陆续续	llxx
陈腐	iffu
陈迹	ifji
陋室	lzui
陌生人	murf
降水量	jull
降生	jlug
降职	jlvi
降落伞	jlsj
降龙伏虎	xlfh
限价	xmjx
限期	xmqi
限止	xmvi
限量版	xlbj
陕甘宁	ugnk
陕西省	uxug
院墙	yrql
院士	yrui
院子	yrzi
院方	yrfh
院校	yrxn
院系	yrji
院系	yrxi
除去	iuqu
除名	iumk
除咗	iuzo
除夕	iuxi
除息	iuxi
除此以外	icyw
除法	iufa
除笨有精	ibyj
除衫	iuuj
陨星	yyxk
险境	xmjk
险峰	xmfg
险恶	xmee
险滩	xmtj
险胜	xmug
险象	xmxl
险过剃头	xgtt
险阻	xmzu
陪审员	puyr
陵云之志	lyvv
陶器	tcqi
陶渊明	tymk
陷于	xmyu
随员	svyr
随得	svde
随得	svdw
随机性	sjxk
随风飘洒	sfps
隐匿	ybni
隐忧	ybyz
隐晦	ybhv
隐现	ybxm
隐约	ybyt
隐约可见	yykj
隐讳	ybhv
隶书	liuu
隶变	libm
难事	njui
难以忘怀	nywh
难友	njyz
难堪	njkj
雄关	xsgr
雄师	xsui
雄赳赳	xjjq
雄鸡	xsji
雄鸡报晓	xjbx
雅加达	yjda
集中制	jvvi
集中营	jvyk
集会	jihv
集体化	jthx
集体舞	jtwu
集团军	jtjy
集大成	jdig
集子	jizi
集市	jiui
集成度	jidu
集成电路	jidl
集散	jisj
集权	jiqr
集约	jiyt
集结	jijp
集聚	jiju
集装箱	jvxl
集训队	jxdv
集资	jizi
集邮	jiyz
集锦	jijb
集镇	jivf
雇佣	guys
雇佣军	gyjy
雇工	gugs
雨具	yuju
雨季	yuji
雨影	yuyk
雨果	yugo
雨溦	yuww
雨滴	yudi
雨花石	yhui
雨衣	yuyi
雨褛	yulv
雨露	yulu
雪原	xtyr
雪夜	xtye
雪屐	xtji
雪峰	xtfg
雪水	xtuv
雪泥鸿爪	xnhv
雪糕批	xgpi
雪糕筒	xgts
雪褛	xtlv
雪铁龙	xtls
零乱	lklr
零售商	luuh
零售店	ludm
零售额	luee
零头	lktz
零打碎敲	ldsq
零时	lkui
零星落索	lxls
零舍	lkue
零花钱	lhqm
零部件	lbjm
零配件	lpjm
雷击	lwji
雷声大	luda
雷曼	lwmj
雷电交加	ldjj
雷电大作	lddz
雷达站	ldvj
雷阵雨	lvyu
雾气	wuqi
需求量	xqll
震中	vfvs
震天	vftm
震天动地	vtdd
震情	vfqk
震级	vfji
霉变	mwbm
霉菌	mwjy
霉菜	mwcd
霎时	uaui
霎气	uaqi
霏凡	fwfj
霏霏	fwfw
霜期	ulqi
露天矿	ltkl
露械	luxp
露械	lzxp
霸位	baww
霸权主义	bqvy
霸王别姬	bwbj
青丝	qksi
青云	qkyy
青云直上	qyvu
青光眼	qgyj
青史	qkui
青壮年	qvnm
青天	qktm
青少年	qunm
青山绿水	qulu
青工	qkgs
青年人	qnrf
青年团	qntr
青年宫	qngs
青悲悲	qbbw
青春期	qiqi
青松	qkss
青海湖	qhhu
青海省	qhug
青灰	qkhv
青石	qkui
青稞	qkke
青翠	qkcv
青翠欲滴	qcyd
青联	qklm
青色	qkse
青苗	qkmn
青草	qkcc
青衣	qkyi
青霉素	qmsu
青青	qkqk
青靓白净	qjbj
青靓白净	qlbj
青面獠牙	qmly
靓爆镜	jbjk
靓爆镜	lbjk
静寂	jkji
静思默想	jsmx
静悄悄	jqqn
静止	jkvi
静物	jkwu
静电	jkdm
静穆	jkmu
静英英	jyyk
静静乐道	jjld
静静乐道	jjyd
静鸡鸡	jjji
非人	fwrf
非典	fwdm
非异人任	fyrr
非暴力	fbli
非正式	fvui
非法所得	ffsd
非金属	fjuu
靠山吃山	kuiu
靠水吃水	kuiu
靠背	kcbw
面世	mmui
面交	mmjn
面口	mmkz
面左左	mzzo
面懵心精	mmxj
面授	mmuz
面无人色	mwrs
面珠墩	mvdy
面皮厚	mphz
面目一新	mmyx
面筋	mmjb
面议	mmyi
面豉	mmii
面青口唇白	mqkb
面青青	mqqk
面面观	mmgr
面食	mmui
革命军	gmjy
革命化	gmhx
革命家	gmjx
革命者	gmve
革委会	gwhv
革委会	gwkk
革故鼎新	ggdx
革除	geiu
靶子	bazi
靶机	baji
鞋子	xpzi
鞋带	xpdd
鞋抽	xpiz
鞋踭	xpvg
鞠躬尽瘁死而后已	jgjy
鞠躬尽瘁死而后已一代风流	jgjl
鞭子	bmzi
鞭辟入里	bprl
鞲鞴	gzbw
韧性	rfxk
韩元	hjyr
韩语	hjyu
音乐会	yyhv
音乐厅	yytk
音乐家	yyjx
音乐界	yyjp
音乐课	ylke
音乐课	yyke
音像	ybxl
音响	ybxl
音域	ybyu
音容笑貌	yrxm
音箱	ybxl
音色	ybse
音质	ybvi
音速	ybsu
音阶	ybjp
音韵	ybyy
页码	yema
顶住	dkvu
顶你个肺	dngf
顶唔顺	dwuy
顶档	dkdh
顶点	dkdm
顶牛	dknq
顶硬上	dyuh
顶笼	dkls
顶肚	dkdu
顶趾	dkvi
顶颈	dkgg
顶颈	dkjk
顶风	dkfg
顷刻	qkke
顷刻之间	qkvj
项羽	xlyu
顺义	uyyi
顺口溜	uklq
顺延	uyyj
顺摊	uytj
顺治	uyvi
须眉茭白	xmjb
顽固派	wgpd
顽症	wjvg
顾住	guvu
顾全	guqr
顾及	guji
顾忌	guji
预付款	yfkr
预制	yuvi
预制板	yvbj
预备役	ybyi
预备队	ybdv
预委会	ywhv
预委会	ywkk
预审	yuuf
预展	yuvj
预应力	yyli
预支	yuvi
预演	yuyj
预热	yure
预示	yuui
预科	yuke
预置	yuvi
预见	yujm
预见性	yjxk
预言	yuyj
预订	yudk
预购	yugz
颅骨	lugu
领事	lkui
领事馆	lugr
领养	lkyh
领到	lkdc
领受	lkuz
领嘢	lkye
领太	lktd
领袖生	lxug
领路	lklu
颇为	poww
颈渴	ggke
颈渴	jkke
颈都长	gdih
颈都长	gdvh
颈都长	jdih
颈都长	jdvh
颈链	gglm
颈链	jklm
颉颃	xphh
颐和园	yhyr
频带	pbdd
频频扑扑	pppp
颓势	tvui
题写	tixp
题名	timk
题字	tizi
题诗	tiui
题跋	tiba
题辞	tici
颙颙	ysys
颜体	yjti
颜真卿	yvqk
额定	eedk
颞颥	npru
颟顸	mjhj
颠簸	dmbo
颠覆	dmfu
颤巍巍	iwww
风云	fgyy
风云人物	fyrw
风云变幻	fybh
风俗画	fshx
风凉水冷	flul
风势	fgui
风化	fghx
风口	fgkz
风吹日晒	firu
风声	fgug
风头火势	fthu
风头趸	ftdy
风姿	fgzi
风帆	fgfj
风扫落叶	fslx
风扫落叶	fsly
风景区	fjqu
风景如画	fjrh
风景画	fjhx
风机	fgji
风水佬	fulc
风沙	fgua
风油轪	fydd
风洞	fgds
风湿病	fubk
风箱	fgxl
风蚀	fgui
风行	fgxk
风速	fgsu
风雪交加	fxjj
风风火火	ffhh
风风雨雨	ffyy
风驰电掣	fidi
风骨峭峻	fgqj
飒爽英姿	suyz
飘浮	pnfu
飘渺	pnmn
飞发	fwfa
飞向	fwxl
飞士	fwui
飞擒大咬	fqdy
飞机场	fjih
飞机师	fjui
飞机恤	fjxu
飞机票	fjpn
飞来蜢	flmg
飞毛腿	fmtv
飞水	fwuv
飞站	fwvj
飞腾	fwtg
飞舞	fwwu
飞蛾扑火	feph
飞行器	fxqi
飞象过河	fxgh
飞越	fwyt
食不重味	sbiw
食不重味	sbvw
食不重味	ubiw
食不重味	ubvw
食不重味	ybiw
食不重味	ybvw
食价	sijp
食价	sijx
食价	uijp
食价	uijx
食价	yijp
食价	yijx
食品	uipb
食塞米	ssmi
食塞米	usmi
食塞米	ysmi
食客	uike
食宿	uisu
食得咸鱼抵得渴	sdxk
食得咸鱼抵得渴	udxk
食得咸鱼抵得渴	ydxk
食拖鞋饭	stxf
食拖鞋饭	utxf
食拖鞋饭	ytxf
食晏	siyj
食晏	uiyj
食晏	yiyj
食柠檬	snmg
食柠檬	unmg
食柠檬	ynmg
食死猫	ssmc
食死猫	usmc
食死猫	ysmc
食水深	suuf
食水深	uuuf
食水深	yuuf
食油	uiyz
食物链	uwlm
食猫面	smmm
食猫面	ummm
食猫面	ymmm
食生菜	sucd
食生菜	uucd
食生菜	yucd
食用	uiys
食白果	sbgo
食白果	ubgo
食白果	ybgo
食皇家饭	shjf
食皇家饭	uhjf
食皇家饭	yhjf
食盐	uiyj
食碗面反碗底	swmd
食碗面反碗底	uwmd
食碗面反碗底	ywmd
食管	uigr
食粮	uill
食糊	sihu
食糊	uihu
食糊	yihu
食糖	uith
食经	sijk
食经	uijk
食经	yijk
食螺蛳	slsi
食螺蛳	ulsi
食螺蛳	ylsi
食言	uiyj
食诈糊	svhu
食诈糊	uvhu
食诈糊	yvhu
食谷种	sgis
食谷种	sgvs
食谷种	ugis
食谷种	ugvs
食谷种	ygis
食谷种	ygvs
食道	uidc
食量	uill
餐馆	cjgr
饥民	jimb
饥馑	jijb
饭焦	fjjn
饭糗茹草	fqrc
饭钱	fjqm
饭铲头	fitz
饭锅	fjgo
饮冰茹檗	ybrb
饮品	ybpb
饮得杯落	ydbl
饮片	ybpm
饮用	ybys
饮用水	yyuv
饮胜	ybug
饮衫	ybuj
饰演	uiyj
饰物	uiwu
饱死	bcsi
饲养员	syyr
饲草	sicc
饸饹	hege
饸饹	hele
饼印	bkyb
饼咭	bkji
饼咭	bkka
饼家	bkjx
饽饽	bobo
饿过饥	egji
馆内	grnw
馉饳	gudo
首例	uzli
首倡	uzih
首家	uzjx
首富	uzfu
首尾	uzww
首府	uzfu
首张	uzvh
首日封	urfg
首款	uzkr
首演	uzyj
首长	uzvh
香口胶	xkjn
香喷喷	xppf
香椿	xliy
香槟酒	xbjq
香气	xlqi
香油	xlyz
香炉趸	xldy
香瓜	xlgx
香菜	xlcd
香蕉	xljn
香车宝马	xibm
香车宝马	xjbm
馨香	xbxl
马丁	madk
马克思	mksi
马刀	madc
马勒	male
马勒	malw
马匹	mapi
马可尼	mkni
马头琴	mtqb
马德里	mdli
马放南山	mfnu
马死落地行	mslh
马死落地行	mslx
马灯	madg
马王堆	mwdv
马赛	masd
马赛克	mske
马蹄粉	mtff
马里	mali
马铃薯	mluu
马革裹尸	mggu
驯养	xyyh
驯化	xyhx
驯品	xypb
驰驱	iiqu
驱使	quui
驱逐舰	qvjm
驱除	quiu
驳倒	bodc
驳嘴	bozv
驳骨	bogu
驶入	uiru
驻伊	vuyi
驻守	vuuz
驻沪	vuhu
驻防	vufh
驾驶员	juyr
驾驶室	juui
驾驶舱	juch
骁勇善战	xyuv
骁将	xnjl
骂名	mamk
骄阳	jnyh
骄阳似火	jysh
骅骝	hxlq
骈体	pmti
骋骛	igwu
验光	yjgl
验方	yjfh
验货	yjho
骎骎	qbqb
骐骝	qilq
骐骥	qiji
骑咧	qilp
骑士	qiui
骑手	qiuz
骑膊马	qbma
骑车	qiie
骑马	qima
骙骙	kvkv
骟鸡	ujji
骡马	loma
骤变	vzbm
骤起	vzqi
骨刺	guci
骨朵	gudo
骨架	gujx
骨灰盒	ghhe
骨痹	gubi
骨碌	gulu
骨科	guke
骨骼	guge
髑髅	dulz
高个	gcge
高个子	ggzi
高举	gcju
高义薄云	gyby
高争鞋	gvxp
高产田	gitm
高低杠	gdgh
高出	gciu
高分子	gfzi
高利	gcli
高利贷	gldd
高加索	gjso
高升	gcug
高危	gcww
高压	gcya
高压电	gydm
高压锅	gygo
高地	gcdi
高坡	gcpo
高墙	gcql
高寒	gchj
高寿	gcuz
高射炮	gupc
高小	gcxn
高山族	guzu
高山景行	gujh
高山景行	gujx
高山深涧悬崖峭壁	guub
高情远致	gqyv
高手如林	gurl
高技术	gjuu
高效益	gxyi
高教	gcjn
高新	gcxb
高材生	gcug
高校	gcxn
高楼大厦	gldu
高歌猛进	ggmj
高洁	gcjp
高清	gcqk
高炉	gclu
高热	gcre
高盛	gcig
高盛	gcug
高祖	gczu
高窦	gcdz
高等教育	gdjy
高管	gcgr
高纬度	gwdu
高耸入云崇山峻岭	gsrl
高见	gcjm
高超	gcic
高足	gczu
高踭鞋	gvxp
高达	gcda
高通	gcts
高速	gcsu
高高低低	ggdd
髢髢	didi
髽髻	vxji
鬼五马六	gwml
鬼咁	gvgj
鬼头仔	gtzd
鬼头仔	gtzi
鬼子	gvzi
鬼打鬼	gdgv
鬼杀咁嘈	gugc
鬼话	gvhx
鬼鬼鼠鼠	gguu
鬼鼠	gvuu
魍魉	whll
魏碑	wwbw
魑魅	iimw
魔兽	mouz
魔戒	mojp
鱼云	yuyy
鱼栏	yulj
鱼水情	yuqk
鱼池	yuii
鱼群	yuqy
鱼虾	yuxx
鱼跃鸟飞	yydf
鱼跃鸟飞	yynf
鱼雷	yulw
鱼露	yulu
鱼露	yulz
鱼鳞	yulb
鱿鱼	yzyu
鲍勃	bcbo
鲍勃	bcbw
鲍威尔	bwer
鲍肆	bcsi
鲜卑	xmbw
鲜嫩水灵	xnul
鲜果	xmgo
鲜菜	xmcd
鲜鱼	xmyu
鲜鲍	xmbc
鲤鱼	liyu
鲩鱼	hryu
鲫鱼	jiyu
鲯鳅	qiqq
鳝鱼	ujyu
鸟尽弓藏	njgc
鸟语蝉鸣	dyim
鸟语蝉鸣	nyim
鸟飞兔走	dftz
鸟飞兔走	nftz
鸡乸	jina
鸡仔	jizd
鸡仔	jizi
鸡仔媒人	jzmr
鸡啄唔断	jvwd
鸡手鸭脚	juyj
鸡毛扫	jmsc
鸡毛鸭血	jmyx
鸡泡鱼	jpyu
鸡犬不惊	jqbj
鸡皮纸	jpvi
鸡碎咁多	jsgd
鸡红	jihs
鸡肉	jirz
鸡肠	jiih
鸡脾	jipi
鸡脾锤	jpiv
鸡舍	jiue
鸡雏	jiiu
鸡项	jixl
鸡食放光草心知肚明	jsfm
鸡食放光草心知肚明	jufm
鸡食放光草心知肚明	jyfm
鸡鸣而起	jmeq
鸣金收兵	mjub
鸧鹒	chgg
鸭仔团	yztr
鸭梨	yali
鸱鸺	iixq
鸲鹆	quyu
鸸鹋	limn
鸺鹠	xqlq
鸽子	gezi
鸿海	hshd
鸿雁	hsyj
鸿鹄之志	hhvv
鹅卵石	elui
鹊局	qtju
鹊巢鸠占	qijv
鹍鹏	kypg
鹘突	gutu
鹘突	hutu
鹘鸼	guvz
鹘鸼	huvz
鹣鲽	jmdp
鹤发鸡皮	hfjp
鹤壁	hebi
鹤鸣之士	hmvu
鹦鹉学舌	ywxu
鹪鹩	jnln
麝香	uexl
麦收	mduz
麦浪	mdlh
麦田	mdtm
麦秸	mdjp
麦苗	mdmn
麻利	mali
麻布	mabu
麻甩佬	mulc
麻绳	maug
麻醉品	mzpb
麻雀脚	mqjn
麻雀虽小五脏俱全	mqsq
麻雀馆	mqgr
麻风	mafg
麻鹰	mayk
麻麻地	mmde
麻麻地	mmdi
黄土地	htdi
黄埔	hlpu
黄帝	hldi
黄庭坚	htjm
黄梅戏	hmxi
黄澄澄	hddg
黄灿灿	hccj
黄疸	hldj
黄石	hldj
黄石	hlui
黄禽禽	hqqb
黄绿医生	hlyu
黄肿脚	hvjn
黄脚鸡	hjji
黄花	hlhx
黄褐色	hhse
黄酒	hljq
黄金时代	hjud
黄面婆	hmpo
黄页	hlye
黄鳝	hluj
黎巴嫩	lbnf
黎族	lizu
黎民	limb
黐孖筋	imjb
黐孖筋	izjb
黐家	iijx
黐牙	iiya
黐线	iixm
黐脷筋	iljb
黐黐地	iide
黐黐地	iidi
黑乎乎	hhhu
黑匣子	hxzi
黑压压	hyya
黑口黑面	hkhm
黑古勒特	hglt
黑土	hwtu
黑孖孖	hmma
黑孖孖	hmzi
黑孖孖	hzma
黑孖孖	hzzi
黑山	hwuj
黑手党	hudh
黑斑	hwbj
黑板报	hbbc
黑洞洞	hdds
黑猩猩	hxxk
黑瞇擝	hmmg
黑社会	huhv
黑箱车	hxie
黑箱车	hxju
黑红	hwhs
黑色素	hssu
黑豆	hwdz
黑过墨斗	hgmd
黑霉	hwmw
黑麻麻	hmma
黑黝黝	hyyz
黑龙江省	hlju
黪黩	cjdu
鼎立	dkli
鼓动	guds
鼓劲	gujb
鼓手	guuz
鼓掌	guvh
鼓起	guqi
鼓鼓囊囊	ggnn
鼠害	uuhd
鼠摸	uumo
鼠窃狗盗	uqgd
鼻哥窿	bgls
鼾声	hjug
齐刷刷	quux
齐名	qimk
齐国	qigo
齐头数	qtuu
齐步走	qbzz
齐白石	qbui
齐缉缉	qjji
齐葺葺	qqqi
齐集	qiji
齐鲁	qilu
齐鸣	qimk
龂龂	kfkf
龂龂	kfyb
龂龂	ybkf
龂龂	ybyb
龃龆	jutn
龋齿	quii
龙井茶	ljia
龙卷风	ljfg
龙山	lsuj
龙文	lswf
龙江	lsjl
龙腾虎跃	lthy
龙芯	lsxb
龙跃凤鸣	lyfm
龙钟	lsvs
龙骧虎步	lxhb
