aa	oa
ag	oh
ah	oh
ai	od
an	oj
ao	oc
ba	ba
bb	bb
bc	bc
bd	bd
bf	bf
bg	bg
bh	bh
bi	bi
bj	bj
bk	bk
bm	bm
bn	bn
bo	bo
bp	bp
bu	bu
bw	bw
ca	ca
cc	cc
cd	cd
ce	ce
cf	cf
cg	cg
ch	ch
ci	ci
cj	cj
co	co
cr	cr
cs	cs
cu	cu
cv	cv
cy	cy
cz	cz
da	da
dc	dc
dd	dd
de	de
df	df
dg	dg
dh	dh
di	di
dj	dj
dk	dk
dm	dm
dn	dn
do	do
dp	dp
dq	dq
dr	dr
ds	ds
du	du
dv	dv
dw	dw
dx	dx
dy	dy
dz	dz
ee	oe
ei	ow
en	of
er	or
fa	fa
ff	ff
fg	fg
fh	fh
fj	fj
fo	fo
fu	fu
fw	fw
fz	fz
ga	ga
gc	gc
gd	gd
ge	ge
gf	gf
gg	gg
gh	gh
gj	gj
gk	gk
gl	gl
go	go
gr	gr
gs	gs
gu	gu
gv	gv
gw	gw
gx	gx
gy	gy
gz	gz
ha	ha
hc	hc
hd	hd
he	he
hf	hf
hg	hg
hh	hh
hj	hj
hk	hk
hl	hl
ho	ho
hr	hr
hs	hs
hu	hu
hv	hv
hw	hw
hx	hx
hy	hy
hz	hz
ia	qa
ic	qc
id	qd
ie	qe
if	qf
ig	qg
ih	qh
ii	oq
ij	qj
ik	qk
il	ql
io	qo
ir	qr
is	qs
iu	oi
iv	qv
ix	qx
iy	qy
iz	qz
jb	jb
ji	ji
jk	jk
jl	jl
jm	jm
jn	jn
jp	jp
jq	jq
jr	jr
js	js
jt	jt
ju	ju
jx	jx
jy	jy
ka	ka
kc	kc
kd	kd
ke	ke
kf	kf
kg	kg
kh	kh
kj	kj
kk	kk
kl	kl
ko	ko
kr	kr
ks	ks
ku	ku
kv	kv
kw	kw
kx	kx
ky	ky
kz	kz
la	la
lb	lb
lc	lc
ld	ld
le	le
lf	lf
lg	lg
lh	lh
li	li
lj	lj
lk	lk
ll	ll
lm	lm
ln	ln
lo	lo
lp	lp
lq	lq
lr	lr
ls	ls
lt	lt
lu	lu
lv	lv
lw	lw
lx	lx
ly	ly
lz	lz
ma	ma
mb	mb
mc	mc
md	md
me	me
mf	mf
mg	mg
mh	mh
mi	mi
mj	mj
mk	mk
mm	mm
mn	mn
mo	mo
mp	mp
mq	mq
mu	mu
mw	mw
mz	mz
na	na
nb	nb
nc	nc
nd	nd
ne	ne
nf	nf
ng	ng
nh	nh
ni	ni
nj	nj
nk	nk
nl	nl
nm	nm
nn	nn
no	no
np	np
nq	nq
nr	nr
ns	ns
nt	nt
nu	nu
nv	nv
nw	nw
nz	nz
og	og
om	om
oo	oo
ou	oz
pa	pa
pb	pb
pc	pc
pd	pd
pf	pf
pg	pg
ph	ph
pi	pi
pj	pj
pk	pk
pm	pm
pn	pn
po	po
pp	pp
pu	pu
pw	pw
pz	pz
qb	qb
qi	qi
qk	qk
ql	ql
qm	qm
qn	qn
qp	qp
qq	qq
qr	qr
qs	qs
qt	qt
qu	qu
qx	qx
qy	qy
rc	rc
re	re
rf	rf
rg	rg
rh	rh
ri	ri
rj	rj
ro	ro
rr	rr
rs	rs
ru	ru
rv	rv
ry	ry
rz	rz
sa	sa
sc	sc
sd	sd
se	se
sf	sf
sg	sg
sh	sh
si	si
sj	sj
so	so
sr	sr
ss	ss
su	su
sv	sv
sy	sy
sz	sz
ta	ta
tc	tc
td	td
te	te
tf	tf
tg	tg
th	th
ti	ti
tj	tj
tk	tk
tm	tm
tn	tn
to	to
tp	tp
tr	tr
ts	ts
tu	tu
tv	tv
ty	ty
tz	tz
ua	xa
uc	xc
ud	xd
ue	xe
uf	xf
ug	xg
uh	xh
ui	ox
uj	xj
uk	xk
ul	xl
uo	xo
ur	xr
uu	os
uv	xv
uw	xw
ux	xx
uy	xy
uz	xz
va	ja
vc	jc
vd	jd
ve	je
vf	jf
vg	jg
vh	jh
vi	ov
vj	jj
vk	jk
vl	jl
vm	jm
vo	jo
vr	jr
vs	js
vu	ot
vv	jv
vw	jw
vx	jx
vy	jy
vz	jz
wa	wa
wd	wd
wf	wf
wg	wg
wh	wh
wj	wj
wo	wo
wu	wu
ww	ww
xb	xb
xi	xi
xk	xk
xl	xl
xm	xm
xn	xn
xp	xp
xq	xq
xr	xr
xs	xs
xt	xt
xu	xu
xx	xx
xy	xy
ya	ya
yb	yb
yc	yc
ye	ye
yh	yh
yi	yi
yj	yj
yk	yk
yo	yo
yr	yr
ys	ys
yt	yt
yu	yu
yy	yy
yz	yz
za	za
zc	zc
zd	zd
ze	ze
zf	zf
zg	zg
zh	zh
zi	zi
zj	zj
zo	zo
zr	zr
zs	zs
zu	zu
zv	zv
zw	zw
zy	zy
zz	zz
