的	rqyy
一	ggll
了	bnh
是	jghu
不	gii
我	trnt
人	wwww
在	dhfd
这	ypi
他	wbn
有	def
来	goi
道	uthp
你	wqiy
个	whj
大	dddd
到	gcfj
上	hhgg
说	yukq
们	wun
着	udhf
出	bmk
中	khk
地	fbn
那	vfbh
就	yidn
也	bnhn
下	ghi
要	svf
么	tcu
子	bbbb
时	jfy
为	ylyi
然	qdou
可	skd
她	vbn
过	fpi
之	pppp
以	nywy
看	rhf
会	wfcu
得	tjgf
天	gdi
去	fcu
自	thd
好	vbg
心	nyny
和	tkg
没	imcy
能	cexx
对	cfy
后	rgkd
还	gipi
里	jfd
小	ihty
手	rtgh
而	dmjj
起	fhnv
只	kwu
身	tmdt
想	shnu
都	ftjb
头	udi
如	vkg
无	fqv
面	dmjd
多	qqu
已	nnnn
发	ntcy
事	gkvh
生	tgd
知	tdkg
家	peu
前	uejj
声	fnr
开	gak
方	yygn
经	xcag
现	gmqn
笑	ttdu
什	wfh
力	ltn
点	hkou
两	gmww
法	ifcy
国	lgyi
样	sudh
所	rnrh
成	dnnt
意	ujnu
见	mqb
但	wjgg
老	ftxb
用	etnh
又	cccc
情	ngeg
于	gfk
当	ivf
动	fcln
己	nngn
些	hxff
行	tfhh
此	hxn
眼	hvey
气	rnb
把	rcn
回	lkd
话	ytdg
将	uqfy
真	fhwu
长	tayi
三	dggg
间	ujd
进	fjpk
年	rhfk
神	pyjh
明	jeg
十	fgh
女	vvvv
向	tmkd
定	pghu
正	ghd
实	pudu
本	sgd
很	tvey
同	mgkd
从	wwy
高	ymkf
问	ukd
才	fte
全	wgf
被	puhc
主	ygd
再	gmfd
走	fhu
却	fcbh
儿	qtn
分	wvb
口	kkkk
其	adwu
作	wthf
种	tkhh
几	mtn
外	qhy
打	rsh
最	jbcu
门	uyhn
与	gngd
给	xwgk
光	iqb
白	rrrr
等	tffu
听	krh
因	ldi
重	tgjf
少	itr
风	mqi
相	shg
住	wygg
次	uqwy
何	wskg
让	yhg
色	qcb
二	fgg
公	wcu
日	jjjj
怎	thfn
名	qkf
死	gqxb
便	wgjq
位	wug
部	ukbh
果	jsi
应	yid
体	wsgg
感	dgkn
太	dyi
内	mwi
觉	ipmq
水	iiii
先	tfqb
难	cwyg
王	gggg
比	xxn
别	kljh
入	tyi
边	lpv
第	txht
直	fhf
机	smn
理	gjfg
快	nnwy
更	gjqi
做	wdty
处	thi
者	ftjf
并	uaj
接	ruvg
西	sghg
马	cnng
轻	lcag
四	lhng
关	udu
山	mmmm
月	eeee
放	yty
连	lpk
加	lkg
目	hhhh
脸	ewgi
飞	nui
使	wgkq
龙	dxv
强	xkjy
张	xtay
由	mhng
金	qqqq
立	uuuu
叫	knhh
安	pvf
师	jgmh
吧	kcn
剑	wgij
信	wyg
学	ipbf
军	plj
望	yneg
算	thaj
原	drii
美	ugdu
像	wqje
平	guhk
东	aii
场	fnrt
吗	kcg
战	hkat
特	trff
万	dnv
数	ovty
云	fcu
清	igeg
今	wynb
变	yocu
任	wtfg
空	pwaf
表	geu
完	pfqb
合	wgkf
带	gkph
常	ipkh
量	jgjf
海	itxu
受	epcu
解	qevh
文	yygy
命	wgkb
转	lfny
斯	adwr
通	cepk
冷	uwyc
思	lnu
黑	lfou
世	anv
该	yynw
双	ccy
利	tjh
至	gcff
非	djdd
林	ssy
呢	knxn
新	usrh
步	hir
候	whnd
五	gghg
李	sbf
度	yaci
虽	kju
路	khtk
惊	nyiy
微	tmgt
跟	khve
似	wnyw
物	trqr
许	ytfh
化	wxn
制	rmhj
火	oooo
性	ntgg
反	rci
武	gahd
总	uknu
指	rxjg
系	txiu
结	xfkg
花	awxb
亲	usu
教	ftbt
功	aln
刚	mqjh
提	rjgh
杀	qsu
竟	ujqb
士	fghg
远	fqpv
百	djf
红	xag
它	pxb
离	ybmc
满	iagw
找	rat
落	aitk
容	pwwk
必	nte
深	ipws
城	fdnt
拉	rug
奇	dskf
若	adkf
各	tkf
失	rwi
尔	qiu
言	yyyy
传	wfny
且	egd
形	gaet
青	gef
石	dgtg
干	fggh
半	ufk
近	rpk
认	ywy
怕	nrg
队	bwy
电	jnv
夫	fwi
往	tygg
突	pwdu
吃	ktnn
啊	kbsk
倒	wgcj
活	itdg
件	wrhh
随	bdep
绝	xqcn
刻	yntj
息	thnu
即	vcbh
工	aaaa
早	jhnh
极	seyy
乎	tuhk
界	lwjj
记	ynn
紧	jcxi
怪	ncfg
流	iycq
报	rbcy
车	lgnh
管	tpnn
音	ujf
衣	yeu
保	wksy
暗	jujg
弟	uxht
及	eyi
交	uqu
影	jyie
华	wxfj
爱	epdc
精	ogeg
伤	wtln
势	rvyl
民	nav
令	wycu
计	yfh
决	unwy
玉	gyi
服	ebcy
条	tsu
众	wwwu
领	wycm
哥	sksk
南	fmuf
般	temc
元	fqb
罗	lqu
收	nhty
未	fii
始	vckg
办	lwi
题	jghm
星	jtgf
克	dqb
根	svey
谁	ywyg
阵	blh
则	mjh
象	qjeu
男	llb
达	dpi
告	tfkf
展	naei
击	fmk
坐	wwff
灵	vou
血	tld
整	gkih
员	kmu
兵	rgwu
急	qvnu
千	tfk
切	avn
越	fhat
喜	fkuk
语	ygkg
站	uhkg
请	ygeg
德	tfln
帮	dtbh
敢	nbty
消	iieg
业	ogd
姐	vegg
周	mfkd
视	pymq
字	pbf
八	wty
每	txgu
苦	adf
房	ynyv
忙	nynn
雷	flf
团	lfte
片	thgn
哪	kvfb
尽	nyuu
书	nnhy
备	tlf
求	fiyi
司	ngkd
北	uxn
静	geqh
错	qajg
断	onrh
准	uwyg
江	iag
刀	vnt
建	vfhp
兄	kqb
终	xtuy
足	khu
兴	iwu
冲	ukhh
阳	bjg
代	way
或	akgd
楚	ssnh
底	yqay
夜	ywty
术	syi
格	stkg
识	ykwy
持	rffy
答	twgk
哈	kwgk
留	qyvl
确	dqeh
易	jqrr
七	agn
论	ywxn
父	wqu
拿	wgkr
程	tkgg
阿	bskg
害	pdhk
族	yttd
破	dhcy
孩	bynw
魔	yssc
官	pnhn
沉	ipmn
显	jogf
够	qkqq
宝	pgyu
取	bcy
单	ujfj
掌	ipkr
务	tlb
低	wqay
雪	fvf
响	ktmk
布	dmhj
市	ymhj
摇	rerm
依	wyey
久	qyi
级	xeyy
首	uthf
运	fcpi
朝	fjeg
待	tffy
娘	vyve
客	ptkf
统	xycq
忽	qrnu
速	gkip
复	tjtu
修	whte
欢	cqwy
异	naj
式	aad
护	rynt
爷	wqbj
况	ukqn
脚	efcb
招	rvkg
九	vtn
集	wysu
区	aqi
晚	jqkq
铁	qrwy
黄	amwu
友	dcu
亚	gogd
除	bwty
钱	qgt
送	udpi
兰	uff
联	budy
政	ghty
义	yqi
丝	xxgf
古	dghg
六	uygy
器	kkdk
甚	adwn
照	jvko
基	adwf
闪	uwi
院	bpfq
装	ufye
居	ndd
产	ute
呼	ktuh
杨	snrt
露	fkhk
句	qkd
乱	tdnn
举	iwfh
敌	tdty
斗	ufk
香	tjf
停	wyps
台	ckf
群	vtkd
嘴	khxe
希	qdmh
酒	isgg
巴	cnhn
怀	ngiy
议	yyqy
类	odu
支	fcu
慢	njlc
陈	baiy
仙	wmh
段	wdmc
调	ymfk
顿	gbnm
派	irey
英	amdu
喝	kjqn
期	adwe
威	dgvt
另	klb
府	ywfi
改	nty
旁	upyb
资	uqwm
续	xfnd
造	tfkp
乐	qii
攻	aty
左	daf
愿	drin
围	lfnh
疑	xtdh
念	wynn
引	xhh
热	rvyo
怒	vcnu
退	vepi
缓	xefc
线	xgt
注	iygg
细	xlg
图	ltui
背	uxef
需	fdmj
痛	ucek
观	cmqn
组	xegg
雨	fghy
曾	uljf
约	xqyy
包	qnv
木	ssss
技	rfcy
示	fiu
皇	rgf
据	rndg
差	udaf
设	ymcy
密	pntm
谢	ytmf
鬼	rqci
穿	pwat
脑	eybh
赶	fhfk
莫	ajdu
丽	gmyy
品	kkkf
叶	kfh
既	vcaq
存	dhbd
睛	hgeg
宫	pkkf
烈	gqjo
诉	yryy
追	wnnp
推	rwyg
您	wqin
右	dkf
商	umwk
争	qvhj
角	qej
淡	iooy
止	hhhg
谈	yooy
严	godr
恶	gogn
狂	qtgg
挥	rplh
亮	ypmb
卫	bgd
闻	ubd
忍	vynu
态	dynu
汉	icy
继	xonn
模	sajd
银	qvey
仍	wen
跑	khqn
否	gikf
君	vtkd
妹	vfiy
隐	bqvn
母	xgui
科	tufh
凌	ufwt
选	tfqp
梦	ssqu
刘	yjh
寒	pfju
局	nnkd
冰	uiy
禁	ssfi
境	fujq
掉	rhjh
究	pwvb
余	wtu
查	sjgf
激	iryt
号	kgnb
防	byn
费	xjmu
恐	amyn
楼	sovg
导	nfu
肯	hef
故	dty
游	iytb
球	gfiy
树	scfy
叹	kcy
救	fiyt
施	ytbn
帝	upmh
佛	wxjh
简	tujf
料	oufh
际	bfiy
顾	dbdm
齐	yjj
抓	rrhy
玩	gfqn
猛	qtbl
份	wwvn
米	oyty
仅	wcy
具	hwu
胜	etgg
治	ickg
章	ujj
巨	and
险	bwgi
守	pfu
散	aety
须	edmy
眉	nhd
抱	rqnn
权	scy
试	yaag
独	qtjy
震	fdfe
索	fpxi
证	yghg
礼	pynn
助	egln
圣	cff
股	emcy
跳	khiq
波	ihcy
负	qmu
虎	hamv
练	xanw
姑	vdg
唐	yvhk
室	pgcf
伙	woy
沙	iitt
妈	vcg
阴	beg
称	tqiy
投	rmcy
柔	cbts
扬	rnrt
规	fwmq
毫	yptn
温	ijlg
较	luqy
毒	gxgu
耳	bghg
座	ywwf
射	tmdf
厉	ddnv
层	nfci
副	gklj
担	rjgg
参	cder
置	lfhf
历	dlv
初	puvn
卡	hhu
承	bdii
质	rfmi
属	ntky
渐	ilrh
蓝	ajtl
船	temk
逃	iqpv
皮	hci
药	axqy
呀	kaht
靠	tfkd
充	ycqb
标	sfiy
坚	jcff
贵	khgm
共	awu
赵	fhqi
维	xwyg
陆	bfmh
块	fnwy
吸	keyy
刺	gmij
堂	ipkf
醒	sgjg
考	ftgn
松	swcy
排	rdjd
划	ajh
换	rqmd
河	iskg
环	ggiy
土	ffff
志	fnu
责	gmu
致	gcft
压	dfyi
素	gxiu
湖	ideg
睡	htgf
苏	alwu
京	yiu
效	uqty
朋	eeg
宇	pgfj
顺	kdmy
紫	hxxi
伸	wjhh
赛	pfjm
超	fhvk
忘	ynnu
幸	fufj
遇	jmhp
孙	biy
顶	sdmy
拍	rrg
警	aqky
按	rpvg
察	pwfi
广	yygt
藏	adnt
胡	deg
秘	tntt
凡	myi
型	gajf
尚	imkf
恩	ldnu
脱	eukq
营	apkk
增	fulj
价	wwjh
史	kqi
节	abj
秋	toy
翻	toln
迷	opi
州	ytyh
付	wfy
项	admy
萧	avij
状	udy
尼	nxv
雅	ahty
凤	mci
秦	dwtu
草	ajj
败	mty
著	aftj
咱	kthg
朱	rii
呆	ksu
封	fffy
普	uogj
景	jyiu
专	fnyi
味	kfiy
舞	rlgh
弄	gaj
虚	haog
毕	xxfj
讲	yfjh
福	pygl
纪	xnn
握	rngf
习	nud
社	pyfg
永	ynii
寻	vfu
默	lfod
洞	imgk
控	rpwa
骑	cdsk
钟	qkhh
徐	twty
辈	djdl
假	wnhc
病	ugmw
胸	eqqb
欲	wwkw
伯	wrg
峰	mtdh
肉	mwwi
岁	mqu
医	atdi
野	jfcb
值	wfhg
职	bkwy
尊	usgf
恨	nvey
狠	qtve
田	llll
魂	fcrc
毛	tfnv
免	qkqb
短	tdgu
秀	teb
麻	yssi
坏	fgiy
印	qgbh
良	yvei
迎	qbpk
枪	swbn
弹	xujf
骨	mef
探	rpws
啦	krug
研	dgah
妖	vtdy
劲	caln
临	jtyj
宁	psj
屋	ngcf
案	pvsu
杰	sou
欧	aqqw
饭	qnrc
村	sfy
升	tak
抬	rckg
蒙	apge
略	ltkg
丹	myd
源	idri
纷	xwvn
雄	dcwy
烟	oldy
危	qdbb
优	wdnn
写	pgng
床	ysi
罪	ldjd
网	mqqi
食	wyve
板	srcy
校	suqy
某	afsu
妙	vitt
休	wsy
珠	griy
列	gqjh
盘	telf
透	tepv
春	dwjf
委	tvf
移	tqqy
呵	kskg
偷	wwgj
奥	tmod
吴	kgdu
验	cwgi
牙	ahte
泪	ihg
宗	pfiu
摆	rlfc
善	uduk
浪	iyve
羽	nnyg
肩	yned
智	tdkj
拥	reh
弱	xuxu
柳	sqtb
硬	dgjq
纳	xmwy
洛	itkg
范	aibb
混	ijxx
玄	yxu
买	nudu
济	iyjh
徒	tfhy
烦	odmy
配	sgnn
适	tdpd
端	umdj
娜	vvfb
哭	kkdu
凝	uxth
镇	qfhw
率	yxif
避	nkup
拳	udrj
创	wbjh
采	esu
晓	jatq
托	rtan
森	sssu
哼	kybh
惜	najg
束	gkii
熟	ybvo
归	jvg
抗	rymn
邪	ahtb
庄	yfd
喊	kdgt
梅	stxu
韩	fjfh
罢	lfcu
仇	wvn
奔	dfaj
亡	ynv
富	pgkl
限	bvey
吓	kghy
养	udyj
厅	dsk
贝	mhny
娇	vtdj
省	ithf
占	hkf
横	samw
飘	sfiq
戏	cat
画	glbj
暴	jawi
灭	goi
域	fakg
瞧	hwyo
软	lqwy
摸	rajd
席	yamh
稳	tqvn
绿	xviy
伊	wvtt
讨	yfy
释	toch
获	aqtd
店	yhkd
敬	aqkt
谷	wwkf
仿	wyn
借	wajg
丈	dyi
姓	vtgg
挑	riqn
祖	pyeg
套	ddu
困	lsi
墙	ffuk
冒	jhf
夏	dhtu
叔	hicy
架	lksu
鱼	qgf
织	xkwy
尖	idu
丁	sgh
牛	rhk
旧	hjg
扑	rhy
彩	eset
降	btah
燕	auko
卷	udbb
臂	nkue
桌	hjsu
卖	fnud
嘿	klfo
骂	kkcf
鲜	qgud
幽	xxmk
训	ykh
演	ipgw
闭	ufte
巧	agnn
奋	dlf
杂	vsu
亦	you
预	cbdm
尤	dnv
偏	wyna
替	fwfj
箭	tuej
残	gqgt
拜	rdfh
腿	evep
婆	ihcv
唯	kwyg
迹	yopi
班	gytg
诸	yftj
吉	fkf
诺	yadk
狼	qtye
洋	iudh
虑	hani
杯	sgiy
袋	waye
策	tgmi
腰	esvg
殿	nawc
番	tolf
测	imjh
输	lwgj
杜	sfg
惨	ncde
盟	jelf
鲁	qgjf
豪	ypeu
积	tkwy
趣	fhbc
圆	lkmi
午	tfj
户	yne
执	rvyy
妇	vvg
沈	ipqn
登	wgku
懂	natf
含	wynk
犹	qtdn
互	gxgd
律	tvfh
锋	qtdh
抢	rwbn
厚	djbd
聚	bcti
尸	nngt
闹	uymh
纵	xwwy
凭	wtfm
迅	nfpk
财	mftt
搞	rymk
嘛	kyss
侧	wmjh
农	pei
稍	tieg
介	wjj
宣	pgjg
抽	rmg
颜	utem
躲	tmds
舒	wfkb
供	wawy
傲	wgqt
勇	celb
阶	bwjh
犯	qtbn
益	uwlf
尘	iff
甲	lhnh
皱	qvhc
街	tffh
孤	brcy
协	flwy
兽	ulgk
碰	duog
伟	wfnh
塔	fawk
批	rxxn
盖	uglf
监	jtyl
劳	aplb
碎	dywf
撞	rujf
阻	begg
操	rkks
概	svcq
曲	mad
胆	ejgg
轮	lwxn
婚	vqaj
迟	nypi
凶	qbk
党	ipkq
爸	wqcb
剧	ndjh
弃	ycaj
奈	dfiu
逐	epi
疯	umqi
距	khan
附	bwfy
谓	yleg
歌	sksw
哦	ktrt
构	sqcy
咬	kuqy
误	ykgd
塞	pfjf
慕	ajdn
笔	ttfn
孔	bnn
牌	thgf
陪	bukg
折	rrh
窗	pwtq
逼	gklp
材	sftt
挡	rivg
岛	qynm
择	rcfh
袭	dxye
挂	rffg
伦	wwxn
遍	ynmp
芒	aynb
征	tghg
触	qejy
瞪	hwgu
荡	ainr
抵	rqay
郎	yvcb
滚	iuce
怜	nwyc
乃	etn
幻	xnn
臣	ahnh
判	udjh
烧	oatq
翼	nlaw
腾	eudc
欣	rqwy
灯	osh
库	ylk
妻	gvhv
私	tcy
荣	apsu
夺	dfu
园	lfqv
壁	nkuf
贼	madt
颗	jsdm
累	lxiu
宋	psu
狗	qtqk
悄	nieg
颤	ylkm
吟	kwyn
伏	wdy
瞬	heph
舍	wfkf
补	puhy
扫	rvg
跃	khtd
艺	anb
挺	rtfp
岳	rgmj
悲	djdn
圈	ludb
旋	ytnh
瑞	gmdj
惑	akgn
竹	ttgh
蛋	nhju
艾	aqu
扎	rnn
莉	atjj
损	rkmy
迫	rpd
盛	dnnl
企	whf
缘	xxey
纯	xgbn
俊	wcwt
努	vclb
逸	qkqp
菲	adjd
抖	rufh
乌	qngd
油	img
炼	oanw
唇	dfek
幕	ajdh
康	yvii
吐	kfg
汗	ifh
馆	qnpn
昨	jthf
赞	tfqm
茶	awsu
苍	awbb
恢	ndoy
裂	gqje
育	ycef
央	mdi
闲	usi
吼	kbnn
爆	ojai
鼓	fkuc
乡	xte
陷	bqvg
曼	jlcu
泰	dwiu
踪	khpi
灰	dou
赤	fou
萨	abut
缺	rmnw
宽	pamq
岂	mnb
伴	wufh
猜	qtge
额	ptkm
遗	khgp
谋	yafs
浮	iebg
昏	qajf
融	gkmj
妮	vnxn
菜	aesu
例	wgqj
盯	hsh
涌	iceh
遭	gmap
洲	iyth
潜	ifwj
拼	ruah
勒	afln
博	fgef
蛇	jpxn
港	iawn
貌	eerq
绍	xvkg
拔	rdcy
洗	itfq
彻	tavn
针	qfh
纸	xqan
莱	agou
县	egcu
剩	tuxj
扶	rfwy
愤	nfam
镜	qujq
爵	elvf
晶	jjjf
佩	wmgh
讯	ynfh
忧	ndnn
鼻	thlj
御	trhb
均	fqug
枫	smqy
泽	icfh
凯	mnmn
浩	itfk
奶	ven
怨	qbnu
毁	vamc
壮	ufg
诚	ydnt
忠	khnu
洪	iawy
雾	ftlb
糊	odeg
固	ldd
轰	lccu
坦	fjgg
睁	hqvh
佳	wffg
爹	wqqq
蒂	auph
丢	tfcu
庆	ydi
亿	wnn
词	yngk
辛	uygh
丰	dhk
缩	xpwj
吹	kqwy
仰	wqbh
迪	mpd
晃	jiqb
庭	ytfp
莲	alpu
梁	ivws
仔	wbg
侠	wguw
阁	utkd
检	swgi
暂	lrjf
读	yfnd
郭	ybbh
绕	xatq
插	rtfv
凉	uyiy
净	uqvh
召	vkf
减	udgt
侍	wffy
慌	nayq
敏	txgt
伍	wgg
鹰	ywwg
朗	yvce
讶	yaht
诗	yffy
货	wxmu
掩	rdjn
码	dcg
浑	iplh
隔	bgkh
傅	wgef
疾	utdi
鸟	qyng
赏	ipkm
摩	yssr
池	ibn
氏	qav
振	rdfe
途	wtpi
闷	uni
童	ujff
朵	msu
傻	wtlt
粗	oegg
旦	jgf
悉	tonu
鸣	kqyg
径	tcag
旅	ytey
赫	fofo
穴	pwu
延	thpd
惯	nxfm
唤	kqmd
皆	xxrf
盗	uqwl
琴	ggwn
帐	mhty
戴	falw
忆	nnn
仁	wfg
宜	pegf
甘	afd
炸	othf
戒	aak
琳	gssy
浓	ipey
吻	kqrt
季	tbf
疼	utui
桑	cccs
侯	wntd
堡	wksf
珍	gwet
贴	mhkg
符	twfu
芳	ayb
嗯	kldn
羞	udnf
典	mawu
劫	fcln
骗	cyna
旗	ytaw
啸	kvij
堆	fwyg
霸	fafe
廷	tfpd
促	wkhy
惧	nhwy
耐	dmjf
庞	ydxv
荒	aynq
序	ycbk
躺	tmdk
粉	owvn
慧	dhdn
餐	hqce
喃	kfmf
踏	khij
吕	kkf
孟	blf
抚	rfqn
匆	qryi
漫	ijlc
乘	tuxv
启	ynkd
脉	eyni
仪	wyqy
络	xtkg
拒	rang
洁	ifkg
郑	udbh
奉	dwfh
漂	isfi
愈	wgen
倍	wukg
拖	rtbn
怔	nghg
映	jmdy
访	yyn
奴	vcy
乔	tdjj
颇	hcdm
愣	nlyn
献	fmud
编	xyna
健	wvfp
扭	rnfg
缠	xyjf
核	synw
评	yguh
享	ybf
尾	ntfn
碧	grdf
瓦	gnyn
尺	nyi
票	sfiu
玛	gcg
川	kthh
彼	thcy
焰	oqvg
醉	sgyf
述	sypi
痕	uvei
晨	jdfe
薄	aigf
胖	eufh
恭	awnu
辉	iqpl
绪	xftj
倾	wxdm
亏	fnv
躯	tmdq
磨	yssd
隆	btgg
岸	mdfj
括	rtdg
废	ynty
狐	qtry
吞	gdkf
丫	uhk
锁	qimy
忌	nnu
悟	ngkg
滑	imeg
椅	sdsk
赌	mftj
垂	tgaf
粮	oyve
厂	dgt
辰	dfei
曹	gmaj
霍	fwyf
遥	ermp
痴	utdk
款	ffiw
贫	wvmu
扩	ryt
督	hich
乖	tfux
欺	adww
聊	bqtb
悠	whtn
艳	dhqc
奖	uqdu
帅	jmhh
估	wdg
爬	rhyc
匹	aqv
录	viu
截	fawy
牢	prhj
锐	qukq
递	uxhp
唱	kjjg
唉	kctd
嘻	kfkk
董	atgf
刹	qsjh
钢	qmqy
惹	adkn
焦	wyou
穷	pwlb
援	refc
慰	nfin
措	rajg
悔	ntxu
革	afj
陵	bfwt
姿	uqwv
扯	rhg
泉	riu
予	cbj
筑	tamy
勾	qci
授	repc
罩	lhjj
埋	fjfg
熊	cexo
潮	ifje
漠	iajd
轩	lfh
殊	gqri
哀	yeu
鸡	cqyg
掠	ryiy
肚	efg
聪	bukn
斩	lrh
狱	qtyd
俩	wgmw
炮	oqnn
俱	whwy
挣	rqvh
邦	dtbh
袖	pumg
泛	itpy
沿	imkg
辞	tduh
卓	hjj
恼	nybh
航	teym
零	fwyc
盈	eclf
载	falk
扰	rdnn
末	gsi
恋	yonu
肃	vijk
鹏	eeqg
姆	vxgu
屈	nbmk
眸	hcrh
冥	pjuu
辆	lgmw
劝	cln
刃	vyi
炎	oou
姬	vahh
拦	rufg
堪	fadn
劈	nkuv
墨	lfof
培	fukg
霜	fshf
斜	wtuf
审	pjhj
甜	tdaf
撒	raet
驾	lkcf
耀	iqny
脆	eqdb
袍	puqn
驻	cygg
霞	fnhc
厌	ddi
尝	ipfc
弯	yoxb
宏	pdcu
滴	iumd
牧	trty
键	qvfp
耶	bbh
销	qieg
膀	eupy
寂	phic
媚	vnhg
枝	sfcy
牵	dprh
丧	fueu
祝	pykq
趁	fhwe
舌	tdd
课	yjsy
麦	gtu
抹	rgsy
玲	gwyc
喷	kfam
染	ivsu
跪	khqb
擦	rpwi
翔	udng
币	tmhk
埃	fctd
钻	qhkg
贯	xfmu
盾	rfhd
灾	pou
溜	iqyl
询	yqjg
腹	etjt
渡	iyac
燃	oqdo
眨	htpy
撤	ryct
敲	ymkc
侵	wvpc
喘	kmdj
柄	sgmw
悦	nukq
嫁	vpey
岩	mdf
赖	gkim
烂	oufg
嘉	fkuk
拾	rwgk
泥	inxn
夹	guwi
版	thgc
搜	rvhc
汇	ian
冬	tuu
俗	wwwk
僧	wulj
竞	ukqb
喂	klge
骇	cynw
搭	rawk
暖	jefc
茫	aiyn
返	rcpi
莎	aiit
挤	ryjh
宾	prgw
冠	pfqf
析	srh
郁	debh
允	cqb
疗	ubk
繁	txgi
桥	stdj
葛	ajqn
祥	pyud
瘦	uvhc
仲	wkhh
耸	wwbf
仗	wdyy
弓	xngn
违	fnhp
豫	cbqe
幅	mhgl
胁	elwy
瓶	uagn
愧	nrqc
晕	jplj
柱	sygg
饰	qnth
翠	nywf
勉	qkql
矮	tdtv
宿	pwdj
偶	wjmy
汤	inrt
刑	gajh
涛	idtf
黎	tqti
煞	qvto
贤	jcmu
姊	vtnt
衫	puet
锦	qrmh
抛	rvln
虫	jhny
昂	jqbj
恰	nwgk
咐	kwfy
铺	qgey
琪	gadw
衡	tqdh
饮	qnqw
捉	rkhy
纤	xtfh
袁	fkeu
猎	qtaj
赢	ynky
购	mqcy
卢	hne
础	dbmh
亭	ypsj
娃	vffg
慈	uxxn
晴	jgeg
咒	kkmb
羊	udj
签	twgi
猫	qtal
薇	atmt
覆	sttt
祸	pykw
罚	lyjj
舰	temq
魏	tvrc
耗	ditn
寸	fghy
跌	khrw
俄	wtrt
蝶	jans
详	yudh
撑	ripr
闯	ucd
箱	tshf
弗	xjk
扮	rwvn
诱	yten
障	bujh
怖	ndmh
屁	nxxv
弥	xqiy
歉	uvow
砍	dqwy
齿	hwbj
踢	khjr
寺	ffu
爪	rhyi
贸	qyvm
脏	eyfg
棋	sadw
贺	lkmu
迈	dnpv
捕	rgey
笼	tdxb
浅	igt
扣	rkg
拨	rnty
扇	ynnd
臭	thdu
篇	tyna
猪	qtfj
邓	cbh
泄	iann
辱	dfef
肤	efwy
懒	ngkm
裁	faye
仆	why
穆	trie
昆	jxxb
丑	nfd
愁	tonu
渊	itoh
勤	akgl
悬	egcn
铃	qwyc
韦	fnhk
崇	mpfi
井	fjk
帕	mhrg
昌	jjf
鞭	afwq
叛	udrc
僵	wglg
纹	xyy
鸿	iaqg
瑶	germ
雕	mfky
洒	isg
冯	ucg
蛮	yoju
爽	dqqq
跨	khdn
饶	qnaq
矛	cbtr
缝	xtdp
湾	iyox
税	tukq
涉	ihit
铜	qmgk
屠	nftj
麽	yssc
乾	fjtn
莹	apgy
涂	iwty
奸	vfh
梯	suxt
邀	rytp
誉	iwyf
诡	yqdb
慎	nfhw
夕	qtny
婉	vpqb
吩	kwvn
镖	qsfi
摔	ryxf
魄	rrqc
卧	ahnh
酷	sgtk
丛	wwgf
巡	vpv
祭	wfiu
崖	mdff
誓	rryf
描	ralg
奏	dwgd
肖	ief
碍	djgf
曰	jhng
霄	fief
糟	ogmj
麟	ynjh
枚	sty
肌	emn
欠	qwu
稀	tqdh
阔	uitd
液	iywy
笨	tsgf
勃	fpbl
毅	uemc
矿	dyt
湿	ijog
桃	siqn
疲	uhci
荷	awsk
汽	irnn
姜	ugvf
摄	rbcc
哎	kaqy
植	sfhg
艰	cvey
脖	efpb
催	wmwy
虹	jag
巫	awwi
屏	nuak
咽	kldy
驰	cbn
蓉	apwk
凑	udwd
愕	nkkn
肥	ecn
绩	xgmy
坛	ffcy
凄	ugvv
搬	rtec
扔	ren
瑟	ggnt
杖	sdyy
芙	afwu
畏	lgeu
频	hidm
润	iugg
酸	sgct
割	pdhj
绵	xrmh
披	rhcy
滋	iuxx
秒	titt
戈	agnt
贪	wynm
捷	rgvh
瞒	hagw
播	rtol
逆	ubtp
咳	kynw
申	jhk
卑	rtfj
搂	rovg
寇	pfqc
魅	rqci
惠	gjhn
宛	pqbb
喉	kwnd
幼	xln
卿	qtvb
龄	hwbc
赐	mjqr
驶	ckqy
瓜	rcyi
氛	rnwv
腕	epqb
污	ifnn
谅	yyiy
筹	tdtf
宠	pdxb
碗	dpqb
妃	vnn
筋	telb
甩	env
驱	caqy
寨	pfjs
蕾	aflf
兼	uvou
婷	vyps
捏	rjfg
妥	evf
拓	rdg
斥	ryi
吵	kitt
订	ysh
纠	xnhh
璃	gybc
届	nmd
饿	qntt
夸	dfnb
倩	wgeg
薛	awnu
窜	pwkh
崔	mwyf
尉	nfif
恒	ngjg
後	txty
宴	pjvf
晌	jtmk
艘	tevc
辣	ugki
哇	kffg
柜	sang
斤	rtth
储	wyfj
挨	rctd
豹	eeqy
雁	dwwy
吾	gkf
挖	rpwn
饱	qnqn
彭	fkue
役	tmcy
琼	gyiy
遮	yaop
舟	tei
佣	weh
狮	qtjh
寿	dtfu
陶	bqrm
患	kkhn
砸	damh
颊	guwm
励	ddnl
愚	jmhn
腐	ywfw
牲	trtg
哑	kgog
恍	niqn
裤	puyl
俏	wieg
鼠	vnun
岚	mmqu
狄	qtoy
妄	ynvf
丘	rgd
抑	rqbh
呈	kgf
蓦	ajdc
尹	vte
坡	fhcy
契	dhvd
嫌	vuvo
津	ivfh
售	wykf
棒	sdwh
郡	vtkb
撕	radr
骤	cbci
疆	xfgg
颈	cadm
贾	smu
咕	kdg
歇	jqww
漏	infy
脾	ertf
窝	pwkw
嫣	vgho
盼	hwvn
耻	bhg
蜜	pntj
姨	vgxw
厨	dgkf
珊	gmmg
链	qlpy
裹	yjse
汪	igg
靖	ugeg
殷	rvnc
拟	rnyw
淫	ietf
呜	kqng
韵	ujqu
柯	sskg
巾	mhk
庙	ymd
纱	xitt
娶	bcvf
矩	tdan
棍	sjxx
晋	gogj
伐	wat
绳	xkjn
涨	ixty
添	igdn
陛	bxxf
嘲	kfje
捧	rdwh
宅	ptab
鼎	hndn
谨	yakg
乏	tpi
黛	walo
仓	wbb
岗	mmqu
掏	rqrm
削	iejh
诧	ypta
灌	iaky
旨	xjf
刷	nmhj
页	dmu
泡	iqnn
辩	uyuh
俞	wgej
婴	mmvf
盒	wgkl
嚷	kyke
沾	ihkg
漆	iswi
蠢	dwjj
甫	gehy
膝	eswi
墓	ajdf
逢	tdhp
嫩	vgkt
坠	bwff
雀	iwyf
枯	sdg
偿	wipc
陌	bdjg
屑	nied
畅	jhnr
陡	bfhy
挽	rqkq
鹤	pwyg
涵	ibib
署	lftj
沃	itdy
叉	cyi
搏	rgef
逝	rrpk
趟	fhik
鞋	afff
赴	fhhi
谦	yuvo
砰	dguh
骄	ctdj
遂	uepi
泣	iug
档	sivg
摊	rcwy
慨	nvcq
籍	tdij
擒	rwyc
苗	alf
浴	iwwk
鉴	jtyq
尴	dnjl
迁	tfpk
疏	nhyq
尬	dnwj
赚	muvo
逗	gkup
豆	gkuf
孝	ftbf
芬	awvb
湘	ishg
诀	ynwy
晰	jsrh
廉	yuvo
馨	fnmj
辽	bpk
械	saah
吊	kmhj
炉	oynt
串	kkhk
裸	pujs
哲	rrkf
凛	uyli
渴	ijqn
柏	srg
芸	afcu
拱	rawy
妨	vyn
揉	rcbs
樱	smmv
寄	pdsk
宙	pmf
宰	puj
媒	vafs
眯	hoy
贡	amu
崩	meef
绑	xdtb
斧	wqrj
惶	nrgg
嘶	kadr
沟	iqcy
禅	pyuf
骚	ccyj
荆	agaj
歪	gigh
涯	idff
耍	dmjv
遵	usgp
伪	wyly
冤	pqky
悍	njfh
耿	boy
翅	fcnd
循	trfh
聂	bccu
猴	qtwd
拂	rxjh
裙	puvk
蓬	atdp
芝	apu
昭	jvkg
倏	whtd
舱	tewb
肆	dvfh
帽	mhjh
岭	mwyc
叮	ksh
拐	rkln
儒	wfdj
嫂	vvhc
瞥	umih
廊	yyvb
赔	mukg
辨	uytu
鄙	kflb
哩	kjfg
逊	bipi
愉	nwgj
摘	rumd
淋	issy
牺	trsg
俯	wywf
谭	ysjh
蒋	auqf
劣	itlb
玫	gty
吁	kgfh
肠	enrt
押	rlh
昔	ajf
攀	sqqr
乳	ebnn
鹿	ynjx
潘	itol
娅	vgog
藤	aeui
躬	tmdx
蔡	awfi
粒	oug
涩	ivyh
揭	rjqn
嗓	kccs
啪	krrg
翎	wycn
撼	rdgn
竖	jcuf
遣	khgp
囊	gkhe
眠	hnan
掀	rrqw
旺	jgg
弘	xcy
戚	dhit
烁	oqiy
逍	iepd
坤	fjhh
憾	ndgn
仑	wxb
租	tegg
咯	ktkg
卜	hhy
凰	mrgd
哄	kawy
匪	adjd
膛	eipf
淑	ihic
忖	nfy
堵	fftj
夷	gxwi
柴	hxsu
撇	rumt
歹	gqi
辜	duj
沐	isy
绽	xpgh
辅	lgey
萍	aigh
敖	gqty
拆	rryy
磊	dddf
罕	pwfj
冻	uaiy
赋	mgah
趋	fhqv
瞳	hujf
杆	sfh
灿	omh
葬	agqa
篮	tjtl
胞	eqnn
颠	fhwm
黯	lfoj
峡	mguw
顽	fqdm
朕	eudy
兆	iqv
擅	rylg
陀	bpxn
龟	qjnb
蜂	jtdh
贞	hmu
阎	uqvd
咦	kgxw
惟	nwyg
竭	ujqn
厢	dshd
惩	tghn
谎	yayq
腔	epwa
裴	djde
玻	ghcy
璇	gyth
溪	iexd
铭	qqkg
邻	wycb
朴	shy
衷	ykhe
帘	pwmh
拢	rdxn
魁	rqcf
哗	kwxf
侄	wgcf
茵	aldu
盆	wvlf
阅	uukq
弦	xyxy
兮	wgnb
翁	wcnf
贱	mgt
债	wgmy
斌	ygah
坑	fymn
逻	lqpi
踩	khes
瞎	hpdk
躁	khks
讽	ymqy
钉	qsh
蓄	ayxl
丸	vyi
丐	ghnv
矣	ctdu
册	mmgd
兔	qkqy
溃	ikhm
隙	biji
叠	cccg
瞄	halg
倚	wdsk
轿	ltdj
舅	vllb
钦	qqwy
祈	pyrh
烛	ojy
怡	nckg
兹	uxxu
肢	efcy
综	xpfi
禀	ylki
於	ywuy
壶	fpog
雯	fyu
栏	sufg
览	jtyq
斑	gygg
蹲	khuf
纽	xnfg
践	khgt
棠	ipks
汹	iqbh
胎	eckg
妾	uvf
篷	ttdp
腥	ejtg
厮	dadr
锅	qkmw
楞	slyn
澳	itmd
窃	pwav
霆	ftfp
桂	sffg
艇	tetp
轨	lvn
哨	kieg
寡	pdev
挪	rvfb
翰	fjwn
尧	atgq
咧	kgqj
怯	nfcy
瑰	grqc
沧	iwbn
寞	pajd
叙	wtcy
彷	tyn
佐	wdag
呐	kmwy
卒	ywwf
栽	fasi
焕	oqmd
塌	fjng
绣	xten
骆	ctkg
敛	wgit
携	rwye
蹄	khuh
颖	xtdm
棵	sjsy
廖	ynwe
呻	kjhh
痒	uudk
驳	cqqy
裳	ipke
睹	hftj
泼	inty
溢	iuwl
狡	qtuq
倘	wimk
胳	etkg
羡	uguw
婢	vrtf
枕	spqn
妒	vynt
绮	xdsk
噬	ktaw
呃	kdbn
喔	kngf
狸	qtjf
缕	xovg
译	ycfh
泊	irg
芷	ahf
咪	koy
刮	tdjh
咖	klkg
恕	vknu
煌	orgg
嘱	knty
蚩	bhgj
栋	saiy
锤	qtgf
逛	qtgp
暇	jnhc
栈	sgt
溅	imgt
巷	awnb
填	ffhw
膊	egef
诈	ythf
昧	jfiy
乞	tnb
叱	kxn
姚	viqn
渔	iqgg
摧	rmwy
遁	rfhp
焚	ssou
糕	ougo
衬	pufy
倦	wudb
辕	lfke
啡	kdjd
啥	kwfk
乙	nnll
彦	uter
郝	fobh
履	nttt
匕	xtn
潇	iavj
茜	asf
嘟	kftb
汝	ivg
耽	bpqn
旭	vjd
浸	ivpc
畜	yxlf
硕	ddmy
蕴	axjl
侦	whmy
佑	wdkg
灼	oqyy
嗤	kbhj
峻	mcwt
菊	aqou
彤	myet
焉	ghgo
敦	ybty
哟	kxqy
筒	tmgk
棉	srmh
霉	ftxu
衰	ykge
烤	oftn
麒	ynjw
钩	qqcy
犬	dgty
庸	yveh
滩	icwy
姥	vftx
桶	sceh
榜	supy
茅	acbt
狭	qtgw
剥	vijh
症	ughd
诞	ythp
乍	thfd
翩	ynmn
辑	lkbg
棺	spnn
潭	isjh
歆	ujqw
滞	igkh
抄	ritt
谱	yuoj
枉	sgg
趴	khwy
狞	qtps
隶	vii
嗔	kfhw
毙	xxgx
谊	ypeg
淮	iwyg
笛	tmf
缚	xgef
剪	uejv
囚	lwi
蔽	aumt
辟	nkuh
碌	dviy
塑	ubtf
刊	fjh
澜	iugi
捂	rgkg
秃	tmb
掷	rudb
桐	smgk
霎	fuvf
搁	rutk
帆	mhmy
矢	tdu
腻	eafm
函	bibk
址	fhg
弩	vcxb
邱	rgbh
孽	awnb
藉	adij
胀	etay
兀	gqv
嚣	kkdk
雍	yxty
巍	mtvc
匠	ark
冉	mfd
窥	pwfq
蛛	jriy
狈	qtmy
瑜	gwgj
妍	vgah
衍	tifh
邵	vkbh
朽	sgnn
噗	kogy
苟	aqkf
鲍	qgqn
胃	lef
壳	fpmb
暮	ajdj
萝	alqu
恳	venu
渠	ians
挟	rguw
琉	gycq
熙	ahko
噢	ktmd
雇	ynwy
碑	drtf
驼	cpxn
俺	wdjn
绘	xwfc
喀	kptk
捡	rwgi
斐	djdy
阮	bfqn
嘎	kdha
吱	kfcy
炽	okwy
钥	qeg
妆	uvg
杏	skf
桓	sgjg
昊	jgdu
擎	aqkr
贷	wamu
磁	duxx
宪	ptfq
沸	ixjh
衙	tgkh
匙	jghx
鞘	afie
剂	yjjh
搅	ripq
猿	qtfe
赠	mulj
徽	tmgt
裕	puwk
祷	pydf
株	sriy
蜀	lqju
桩	syfg
账	mtay
巢	vjsu
堕	bdef
梭	scwt
兜	qrnq
敞	imkt
肿	ekhh
骷	medg
髅	meov
娟	vkeg
茂	adnt
窄	pwtf
菱	afwt
吨	kgbn
絮	vkxi
坎	fqwy
琦	gdsk
芦	aynr
渗	icde
拘	rqkg
梵	ssmy
脊	iwef
澡	ikks
窟	pwnm
姻	vldy
捐	rkeg
盏	glf
孕	ebf
滔	ievg
挫	rwwf
伺	wngk
贩	mrcy
扁	ynma
墅	jfcf
寝	puvc
侮	wtxu
垃	fug
郊	uqbh
眶	hagg
莽	adaj
俘	webg
蝉	jujf
卦	ffhy
喧	kpgg
圾	feyy
诛	yriy
澄	iwgu
妞	vnfg
彪	hame
淳	iybg
唔	kgkg
揽	rjtq
厦	ddht
嗡	kwcn
勋	kmln
歧	hfcy
鸦	ahtg
聘	bmgn
珑	gdxn
哮	kftb
嗦	kfpi
虞	hakd
惭	nlrh
熬	gqto
迭	rwpi
盐	fhlf
啧	kgmy
捣	rqym
梳	sycq
浆	uqiu
烫	inro
虐	haag
钧	qqug
掘	rnbm
忿	wvnu
畔	lufh
樊	sqqd
倪	wvqn
亩	ylf
咙	kdxn
邮	mbh
襄	ykke
禽	wybc
鳞	qgoh
勿	qre
炀	onrt
嫉	vutd
杭	symn
嚎	kype
衔	tqfh
菁	agef
眩	hyxy
栗	ssu
蹦	khme
喻	kwgj
盲	ynhf
虏	halv
茹	avkf
觑	haoq
佘	wfiu
蔓	ajlc
陋	bgmn
苹	aguh
娱	vkgd
堤	fjgh
彬	sset
绷	xeeg
铸	qdtf
酬	sgyh
绞	xuqy
渺	ihit
淘	iqrm
卸	rhbh
蛟	juqy
朦	eape
帖	mhhk
菩	aukf
坊	fyn
旷	jyt
襟	pusi
汁	ifh
僻	wnku
翘	atgn
盔	dolf
嘘	khag
峨	mtrt
疚	uqyi
慑	nbcc
粹	oywf
醋	sgaj
饥	qnmn
秩	trwy
沫	igsy
肺	egmh
咆	kqnn
砖	dfny
嘀	kumd
弧	xrcy
锡	qjqr
顷	xdmy
迦	lkpd
拚	rcah
胧	edxn
妓	vfcy
捞	rapl
蹈	khev
坟	fyy
幢	mhuf
湛	iadn
亨	ybj
媳	vthn
荐	adhb
奕	yodu
吏	gkqi
磕	dfcl
皓	rtfk
婿	vnhe
跋	khdc
钰	qgyy
罡	lghf
扳	rrcy
屡	novd
犀	nirh
稿	tymk
蚁	jyqy
咚	ktuy
耕	difj
锻	qwdc
奢	dftj
诊	ywet
祺	pyaw
泳	iyni
拭	raag
蚀	qnjy
垒	cccf
冈	mqi
窍	pwan
龚	dxaw
戟	fjat
萱	apgg
绰	xhjh
脂	exjg
宵	pief
钓	qqyy
蔑	aldt
嵌	mafw
戮	nwea
叩	kbh
迸	uapk
淹	idjn
丞	bigf
喇	kgkj
哧	kfoy
叨	kvn
瓷	uqwn
炯	omkg
蝎	jjqn
揪	rtoy
沛	igmh
斋	ydmj
侣	wkkg
挠	ratq
蝠	jgkl
逞	kgpd
疫	umci
眷	udhf
姗	vmmg
懈	nqeh
瘫	ucwy
饼	qnua
嗅	kthd
豁	pdhk
棚	seeg
煤	oafs
框	sagg
绸	xmfk
殖	gqfh
券	udvb
蒸	abio
熄	othn
疤	ucv
蒲	aigy
稚	twyg
莺	apqg
冀	uxlw
稻	tevg
葡	aqgy
侃	wkqn
捆	rlsy
澈	iyct
毯	tfno
傍	wupy
旬	qjd
呕	kaqy
梧	sgkg
寓	pjmy
粘	ohkg
滨	iprw
薪	ausr
阱	bfjh
撩	rdui
舔	tdgn
辖	lpdk
舜	epqh
梨	tjsu
猾	qtme
抿	rnan
禹	tkmy
啼	kuph
炭	mdou
砚	dmqn
玑	gmn
掐	rqvg
夭	tdi
榻	sjng
哉	fakd
逮	vipi
旱	jfj
驴	cynt
甄	sfgn
煮	ftjo
憋	umin
缴	xryt
蕊	annn
稽	tdnj
绯	xdjd
喽	kovg
涡	ikmw
滥	ijtl
搓	ruda
颓	tmdm
瞅	htoy
铮	qqvh
纲	xmqy
揍	rdwd
鹅	trng
氓	ynna
瑾	gakg
肝	efh
踉	khye
讪	ymh
箫	tvij
腊	eajg
霓	fvqb
惫	tlnu
淌	iimk
霹	fnku
垫	rvyf
跄	khwb
茨	auqw
刁	ngd
禄	pyvi
膜	eajd
诅	yegg
擂	rflg
轴	lmg
厥	dubw
讥	ymn
厄	dbv
胶	euqy
扛	rag
惕	njqr
瞟	hsfi
凸	hgmg
肘	efy
媛	vefc
拧	rpsh
浙	irrh
奎	dfff
熏	tglo
沁	iny
骏	ccwt
笙	ttgf
岔	wvmj
沮	iegg
颅	hndm
酥	sgty
冶	uckg
嗽	kgkw
舵	tepx
燥	okks
拙	rbmh
蛊	jlf
瓣	urcu
吭	kymn
绫	xfwt
蝴	jdeg
罐	rmay
糖	oyvk
蹙	dhih
琢	geyy
漾	iugi
绅	xjhh
怠	cknu
嗷	kgqt
沦	iwxn
鸭	lqyg
涅	ijfg
驭	ccy
咏	kyni
窒	pwgf
槐	srqc
凳	wgkm
臀	nawe
伞	wuhj
懊	ntmd
雳	fdlb
逾	wgep
唬	kham
葫	adef
闺	uffd
咸	dgkt
镶	qyke
萄	aqrm
梢	sieg
嗜	kftj
戳	nwya
铲	qutt
缪	xnwe
猩	qtjg
跺	khms
蟒	jada
詹	qdwy
晒	jsg
浦	igey
邹	qvbh
黝	lfol
筷	tnnw
狰	qtqh
霖	fssu
炫	oyxy
凹	mmgd
伶	wwyc
揣	rmdj
窘	pwvk
悸	ntbg
垮	fdfn
噜	kqgj
颔	wynm
嚼	kelf
尿	nii
沼	ivkg
塘	fyvk
肋	eln
簇	tytd
哆	kqqy
兢	dqdq
琐	gimy
颁	wvdm
泻	ipgg
鞠	afqo
匿	aadk
膨	efke
酿	sgye
颂	wcdm
瘾	ubqn
栖	ssg
蔚	anff
楠	sfmf
帜	mhkw
剔	jqrj
靴	afwx
萌	ajef
棘	gmii
娥	vtrt
沌	igbn
谜	yopy
觅	emqb
砂	ditt
脯	egey
讳	yfnh
螺	jlxi
晖	jplh
韧	fnhy
瞻	hqdy
蜡	jajg
瀑	ijai
璧	nkuy
蚕	gdju
聋	dxbf
漓	iybc
踱	khyc
谣	yerm
敷	geht
偎	wlge
绢	xkeg
噩	gkkk
搔	rcyj
晏	jpvf
匣	alk
倔	wnbm
蹬	khwu
苑	aqbb
婶	vpjh
歼	gqtf
缉	xkbg
彰	ujet
拇	rxgu
寥	pnwe
昼	nyjg
弊	umia
坪	fguh
敝	umit
裘	fiye
呸	kgig
憎	nulj
镔	qprw
悯	nuyy
舆	wflw
诵	yceh
拎	rwyc
唾	ktgf
瑛	gamd
枢	saqy
叭	kwy
挚	rvyr
揖	rkbg
兑	ukqb
蜘	jtdk
秉	tgvi
荫	abef
衅	tluf
壤	fyke
匀	qud
驯	ckh
浊	ijy
惚	nqrn
牟	crhj
呛	kwbn
祁	pybh
娴	vusy
蜥	jsrh
炒	oitt
婕	vgvh
甸	qld
惮	nujf
碟	dans
谐	yxxr
叟	vhcu
猝	qtyf
侥	watq
斟	adwf
啤	krtf
髓	medp
寰	plge
峙	mffy
赦	foty
噪	kkks
枭	qyns
浇	iatq
腮	elny
遏	jqwp
哽	kgjq
芽	aaht
婪	ssvf
倭	wtvg
卵	qyty
暧	jepc
阙	uubw
诏	yvkg
炙	qou
祟	bmfi
拣	ranw
邸	qayb
骸	meyw
谬	ynwe
磋	duda
涕	iuxt
瀚	ifjn
邢	gabh
捶	rtgf
袱	puwd
洽	iwgk
峭	mieg
巩	amyy
檀	sylg
赎	mfnd
祀	pynn
滕	eudi
柬	glii
嵩	mymk
嬉	vfkk
僚	wdui
睬	hesy
葱	aqrn
嬷	vysc
缸	rmag
杉	set
虔	hayi
娲	vkmw
拽	rjxt
廓	yybb
玮	gfnh
蔷	afuk
恃	nffy
竿	tfj
恙	ugnu
绒	xadt
瑚	gdeg
漪	iqtk
鹃	keqg
睫	hgvh
鸽	wgkg
陕	bguw
钞	qitt
蝙	jyna
搀	rqku
袅	qyne
蝇	jkjn
佬	wftx
蚂	jcg
蚊	jyy
翡	djdn
朔	ubte
踹	khmj
嗖	kvhc
芊	atfj
崎	mdsk
啃	kheg
璋	gujh
慷	nyvi
咋	kthf
檐	sqdy
鞍	afpv
剿	vjsj
腑	eywf
悚	ngki
缎	xwdc
匈	qqbk
厕	dmjk
鹫	yidg
涟	ilpy
虾	jghy
漩	iyth
聆	bwyc
栅	smmg
搐	ryxl
鸾	yoqg
蓓	awuk
扒	rwy
穹	pwxb
瑕	gnhc
珀	grg
锥	qwyg
矫	tdtj
庐	yyne
暑	jftj
溶	ipwk
靡	yssd
晦	jtxu
喳	ksjg
咄	kbmh
巅	mfhm
墟	fhag
煎	uejo
芯	anu
亢	ymb
掳	rhal
屯	gbnv
叽	kmn
曦	jugt
獠	qtdi
厘	djfd
懦	nfdj
渣	isjg
桀	qahs
恬	ntdg
缀	xccc
褪	puvp
嵋	mnhg
筝	tqvh
秽	tmqy
庇	yxxv
绊	xufh
褚	pufj
拯	rbig
衲	pumw
眺	hiqn
悴	nywf
驹	cqkg
钝	qgbn
酋	usgf
珂	gskg
祢	pyqi
狙	qteg
汰	idyy
镯	qlqj
贿	mdeg
铠	qmnn
粥	xoxn
佟	wtuy
芮	amwu
奄	djnb
怅	ntay
剖	ukjh
伽	wlkg
忡	nkhh
萎	atvf
凿	ogub
鬟	dele
奠	usgd
熠	onrg
憔	nwyo
钮	qnfg
妩	vfqn
抡	rwxn
崆	mpwa
弛	xbn
褐	pujn
勘	adwl
妲	vjgg
唰	knmj
惺	njtg
膏	ypke
筠	tfqu
贬	mtpy
绚	xqjg
嗨	kitu
怦	nguh
晤	jgkg
俐	wtjh
窦	pwfd
驿	ccfh
棱	sfwt
竺	tff
烙	otkg
睿	hpgh
锣	qlqy
溺	ixuu
恺	nmnn
缔	xuph
牡	trfg
鬓	depw
藩	aitl
谕	ywgj
庵	ydjn
憨	nbtn
瘟	ujld
钗	qcyy
昕	jrh
徊	tlkg
偌	wadk
髯	demf
缰	xglg
庶	yaoi
札	snn
缭	xdui
徘	tdjd
曙	jlfj
阀	uwae
殆	gqck
巳	nngn
纬	xfnh
缄	xdgt
澎	ifke
掣	rmhr
惘	nmun
槽	sgmj
诣	yxjg
曳	jxe
娄	ovf
胤	txen
惋	npqb
虬	jnn
倡	wjjg
芭	acb
琛	gpws
肴	qdef
蹭	khuj
庚	yvwi
飙	dddq
仕	wfg
貂	eevk
嚓	kpwi
蜴	jjqr
募	ajdl
昱	juf
圳	fkh
氧	rnud
悻	nfuf
佯	wudh
锵	quqf
隋	bdae
笃	tcf
筱	twht
忑	ghnu
捅	rceh
捺	rdfi
茉	agsu
萤	apju
佗	wpxn
睨	hvqn
邃	pwup
谴	ykhp
霏	fdjd
屎	noi
乒	rgtr
谍	yans
缅	xdmd
忐	hnu
暄	jpgg
簌	tgkw
鲸	qgyi
涎	ithp
瞩	hnty
攒	rtfm
蟹	qevj
茄	alkf
漱	igkw
饲	qnnk
嗣	kmak
诫	yaah
阐	uujf
瑭	gyvk
熔	opwk
冽	ugqj
棕	spfi
酱	uqsg
辫	uxuh
辙	lyct
闵	uyi
殴	aqmc
蛙	jffg
滢	iapy
晁	jiqb
删	mmgj
裔	yemk
膳	eudk
殃	gqmd
蔼	ayjn
茱	ariu
苛	askf
跷	khaq
痊	uwgd
樵	swyo
烘	oawy
癫	ufhm
懿	fpgn
扼	rdbn
吆	kxy
鸠	vqyg
茧	aju
孜	bty
侨	wtdj
幡	mhtl
咎	thkf
蔬	anhq
酣	sgaf
亵	yrve
哝	kpey
隧	buep
禾	tttt
纺	xyn
黏	twik
湃	irdf
绛	xtah
崛	mnbm
嘈	kgmj
眈	hpqn
皙	srrf
礁	dwyo
琅	gyve
睦	hfwf
薰	atgo
璐	gkhk
蹿	khph
邑	kcb
躇	khaj
菌	altu
枣	gmiu
踌	khdf
迢	vkpd
赃	myfg
臻	gcft
苇	afnh
篝	tfjf
袜	pugs
崭	mlrj
屿	mgng
娆	vatq
靳	afrh
咨	uqwk
煜	ojug
聿	vfhk
陨	bkmy
鸳	qbqg
榴	sqyl
帷	mhwy
钵	qsgg
毋	xde
橙	swgu
雌	hxwy
丙	gmwi
琥	gham
匡	agd
狩	qtpf
芜	afqb
羿	naj
璀	gmwy
鲨	iitg
冕	jqkq
讷	ymwy
蠕	jfdj
砌	davn
戾	yndi
掺	rcde
拈	rhkg
酌	sgqy
殇	gqtr
忒	ani
铅	qmkg
戎	ade
蹑	khbc
唠	kapl
苔	ackf
栩	sng
烨	owxf
吝	ykf
啜	kccc
涣	iqmd
甬	cej
莞	apfq
恻	nmjh
雏	qvwy
窖	pwtk
傀	wrqc
蜷	judb
岱	wamj
疙	utnv
飒	umqy
衮	uceu
谑	yhag
乓	rgyu
棣	sviy
磅	dupy
焱	ooou
猖	qtjj
簿	tigf
譬	nkuy
羁	lafc
戬	goga
拗	rxln
煦	jqko
烬	onyu
伫	wpgg
葵	awgd
镰	qyuo
瘩	uawk
笠	tuf
趾	khhg
攸	whty
剌	gkij
唧	kvcb
睽	hwgd
坝	fmy
紊	yxiu
渍	igmy
迳	capd
靶	afcn
糙	otfp
宦	pahh
吮	kcqn
勺	qyi
祯	pyhm
邯	afbh
鄂	kkfb
窑	pwrm
圭	fff
侈	wqqy
粪	oawu
杠	sag
鸯	mdqg
炬	oang
浏	iyjh
橡	sqje
孰	ybvy
琶	ggcb
俨	wgod
泓	ixcy
涧	iujg
呗	kmy
麾	yssn
昵	jnxn
屹	mtnn
恤	ntlg
寐	pnhi
婧	vgeg
闸	ulk
韶	ujvk
菇	avdf
靓	gemq
椒	shic
荀	aqjf
癸	wgdu
饕	kgne
啐	kywf
疮	uwbv
岑	mwyn
辎	lvlg
攘	ryke
琵	ggxx
稷	tlwt
肮	eymn
矜	cbtn
楣	snhg
渎	ifnd
荧	apou
噎	kfpu
呱	krcy
崽	mlnu
饵	qnbg
拷	rftn
锭	qpgh
缥	xsfi
瘪	uthx
瞠	hipf
沪	iynt
奚	exdu
籁	tgkm
湮	isfg
萦	apxi
劭	vkln
铛	qivg
茗	aqkf
弑	qsaa
痹	ulgj
飕	mqvc
铿	qjcf
璨	ghqo
赘	gqtm
缨	xmmv
畴	ldtf
儡	wlll
冢	peyu
辐	lgkl
蜈	jkgd
珞	gtkg
鞑	afdp
咻	kwsy
笈	teyu
扈	ynkc
壑	hpgf
骰	memc
撰	rnnw
鲲	qgjx
噤	kssi
煽	oynn
玺	qigy
炳	ogmw
捻	rwyn
诶	yctd
嗒	kawk
锯	qndg
浣	ipfq
窿	pwbg
坞	fqng
鑫	qqqf
磷	doqh
蜒	jthp
噔	kwgu
绎	xcfh
咔	khhy
扉	yndd
阖	ufcl
穗	tgjn
叁	cddf
茸	abf
踞	khnd
皂	rab
璞	gogy
垢	frgk
枷	slkg
珏	ggyy
骋	cmgn
矗	fhfh
缇	xjgh
蹊	khed
粟	sou
呦	kxln
驸	cwfy
唆	kcwt
馒	qnjc
寅	pgmw
撮	rjbc
羹	ugod
楮	sftj
峦	yomj
灶	ofg
餮	gqwe
靥	dddl
嬴	ynky
遐	nhfp
胭	eldy
顼	gdmy
榕	spwk
胯	edfn
迂	gfpk
惦	nyhk
伎	wfcy
诬	yaww
癌	ukkm
桨	uqsu
黠	lfok
逵	fwfp
韬	fnhv
嫡	vumd
悼	nhjh
喏	kadk
帛	rmhj
俭	wwgi
啄	keyy
咣	kiqn
铐	qftn
咫	nykw
钳	qafg
骼	metk
舷	teyx
祠	pynk
箍	trah
橱	sdgf
鳄	qgkn
袂	punw
溟	ipju
锈	qten
篱	tybc
缈	xhit
淤	iywu
铎	qcfh
囔	kgke
蚣	jwcy
痞	ugik
吒	ktan
迄	tnpv
稼	tpey
汀	ish
槛	sjtl
漉	iynx
椎	swyg
辗	lnae
滤	ihan
洼	iffg
醇	sgyb
瘤	uqyl
桅	sqdb
喵	kalg
亥	yntw
渝	iwgj
惬	nagw
淼	iiiu
咛	kpsh
蛾	jtrt
筛	tjgh
髻	defk
幌	mhjq
笺	tgr
憧	nujf
梗	sgjq
颍	xidm
瓢	sfiy
馀	qnwt
殉	gqqj
翟	nwyf
盎	mdlf
濒	ihim
簧	tamw
馈	qnkm
孺	bfdj
伢	waht
闽	uji
楷	sxxr
亘	gjgf
惴	nmdj
瓒	gtfm
笋	tvtr
咀	kegg
幺	xnny
蒜	afii
掂	ryhk
杵	stfh
瞑	hpju
兖	ucqb
峒	mmgk
颐	ahkm
曜	jnwy
螂	jyvb
毗	lxxn
飓	mqhw
缆	xjtq
芥	awjj
缤	xprw
蜿	jpqb
翊	ung
卉	faj
屉	nanv
翱	rdfn
拴	rwgg
湄	inhg
稠	tmfk
桦	swxf
鹊	ajqg
咂	kamh
燎	odui
谏	ygli
贮	mpgg
猥	qtle
峥	mqvh
溯	iube
佼	wuqy
喋	kans
诩	yng
渥	ingf
曝	jjai
剃	uxhj
邺	ogbh
羔	ugou
匾	ayna
汲	ieyy
邬	qngb
赂	mtkg
炜	ofnh
锢	qldg
吠	kdy
锄	qegl
蛤	jwgk
藻	aiks
烹	ybou
蹋	khjn
垦	veff
迥	mkpd
岐	mfcy
耷	dbf
隘	buwl
淬	iywf
嚅	kfdj
慵	nyvh
烽	otdh
诲	ytxu
橘	scbk
翌	nuf
濮	iwoy
蟾	jqdy
垣	fgjg
锺	qtgf
抉	rnwy
茬	adhf
啷	kyvb
淇	iadw
硝	dieg
沥	idln
褥	pudf
踝	khjs
矶	dmn
骁	catq
酝	sgfc
梓	suh
唷	kyce
玎	gsh
憬	njyi
霭	fyjn
蕉	awyo
眦	hhxn
墩	fybt
毡	tfnk
蕃	atol
弼	xdjx
肇	ynth
阑	ugli
垄	dxff
晟	jdnt
呲	khxn
毓	txgq
痪	uqmd
陇	bdxn
鳌	gqtg
袒	pujg
谛	yuph
忏	ntfh
拌	rufh
臾	vwi
瀛	iyny
簪	taqj
懵	nalh
纶	xwxn
跤	khuq
胴	emgk
浚	icwt
唏	kqdh
筏	twar
甥	tgll
蝗	jrgg
癞	ugkm
瓮	wcgn
驮	cdy
涤	itsy
捍	rjfh
膺	ywwe
铳	qycq
芹	arj
嘭	kfke
骥	cuxw
炕	oymn
匐	qgkl
羌	udnb
娓	vntn
壕	fype
宓	pntr
隼	wyfj
泌	intt
嗫	kbcc
桔	sfkg
圃	lgey
抒	rcbh
稣	qgty
瓯	aqgn
鲤	qgjf
磐	temd
萃	aywf
魃	rqcc
侬	wpey
讼	ywcy
萼	akkn
皎	ruqy
簸	tadc
姒	vnyw
叼	kngg
茎	acaf
瞿	hhwy
剁	msjh
篆	txeu
羲	ugtt
骡	clxi
鹦	mmvg
蕙	agjn
隅	bjmy
瘸	ulkw
炊	oqwy
饷	qntk
辄	lbnn
嘤	kmmv
颌	wgkm
腆	emaw
嫖	vsfi
惆	nmfk
媲	vtlx
馁	qnev
娉	vmgn
褒	ywke
旖	ytdk
馋	qnqu
噘	kduw
呤	kwyc
缜	xfhw
荃	awgf
捋	refy
胥	nhef
潺	inbb
卯	qtbh
婵	vujf
撅	rduw
涔	imwn
舫	teyn
柿	symh
偕	wxxr
汩	ijg
榨	spwf
苞	aqnb
胄	mef
坍	fmyg
麓	ssyx
鸥	aqqg
掬	rqoy
礴	daif
轧	lnn
纣	xfy
淀	ipgh
糜	ysso
昙	jfcu
壹	fpgu
埔	fgey
诃	yskg
魇	ddrc
凋	umfk
蹂	khcs
荼	awtu
镑	qupy
鹉	gahg
臧	dndt
褂	pufh
筐	tagf
纨	xvyy
筵	tthp
轼	laag
蘑	aysd
潞	ikhk
榆	swgj
沣	idhh
黔	lfon
玟	gyy
婊	vgey
旌	yttg
痉	ucad
魑	rqcc
嫦	viph
卞	yhu
瘴	uujk
丕	gigf
贽	rvym
袄	putd
砾	dqiy
挛	yorj
麴	swwo
腋	eywy
隽	wyeb
躏	khay
撂	rltk
偃	wajv
馅	qnqv
醺	sgto
嗥	krdf
渭	ileg
阉	udjn
蟆	jajd
盅	khlf
沓	ijf
榭	stmf
睐	hgoy
婀	vbsk
哒	kdpy
啬	fulk
郢	kgbh
噼	knku
琬	gpqb
栓	swgg
冗	pmb
睚	hdff
硫	dycq
癖	unku
霈	figh
甭	giej
侏	wriy
皑	rmnn
拄	rygg
夙	mgqi
渲	ipgg
秤	tguh
攫	rhhc
岌	meyu
遽	haep
蛆	jegg
赧	fobc
踵	khtf
汴	iyhy
鸨	xfqg
剐	kmwj
窈	pwxl
潼	iujf
靼	afjg
睑	hwgi
霁	fyjj
沅	ifqn
卤	hlqi
掰	rwvr
攥	rthi
鹭	khtg
藕	adiy
颚	kkfm
蛰	rvyj
幔	mhjc
腼	edmd
篡	thdc
恣	uqwn
蟠	jtol
噌	kulj
嫔	vprw
裆	puiv
哺	kgey
跚	khmg
馥	tjtt
孚	ebf
僖	wfkk
窕	pwiq
盂	gflf
钊	qjh
囤	lgbn
喟	kleg
跛	khhc
刨	qnjh
槌	swnp
臊	ekks
苜	ahf
渤	ifpl
螳	jipf
肾	jcef
荤	aplj
捎	rieg
镭	qflg
糗	othd
薯	alfj
徨	trgg
蜕	jukq
瑙	gvtq
噫	kujn
鳖	umig
妤	vcbh
谪	yumd
贲	famu
隗	brqc
裟	iite
擞	rovt
濑	igkm
绔	xdfn
鳅	qgto
戍	dynt
摹	ajdr
堑	lrff
绾	xpnn
捱	rdff
旎	ytnx
谄	yqvg
谒	yjqn
谧	yntl
嚏	kfph
苋	amqb
恸	nfcl
粤	tlon
姣	vuqy
碳	dmdo
殒	gqkm
哂	ksg
龌	hwbf
啾	ktoy
蹒	khaw
蝼	jovg
龊	hwbh
娼	vjjg
揩	rxxr
沂	irh
舶	terg
泞	ipsh
啻	upmk
阜	wnnf
弋	agny
恪	ntkg
蜃	dfej
搪	ryvk
辘	lynx
挲	iitr
娑	iitv
嗝	kgkh
饺	qnuq
桉	spvg
岖	maqy
杳	sjf
碾	dnae
妪	vaqy
袈	lkye
赈	mdfe
摒	rnua
孵	qytb
菡	abib
哐	kagg
羚	udwc
撬	rtfn
颉	fkdm
晔	jwxf
罔	muyn
倜	wmfk
倌	wpnn
藐	aeeq
髦	detn
猊	qtvq
汐	iqy
颦	hidf
臌	efkc
獒	gqtd
粼	oqab
杞	snn
蚌	jdhh
郸	ujfb
揄	rwgj
竣	ucwt
嗲	kwqq
瞌	hfcl
胚	egig
愠	njlg
谙	yujg
恁	wtfn
龇	hwbx
啵	kihc
匍	qgey
脓	epey
撵	rfwl
痰	uooi
蛹	jceh
觎	wgeq
畿	xxal
殛	gqbg
泯	inan
讹	ywxn
潦	idui
犁	tjrh
苓	awyc
犷	qtyt
俟	wctd
邝	ybh
弈	yoaj
呓	kann
汛	infh
螓	jdwt
觊	mnmq
玷	ghkg
瞰	hnbt
槟	sprw
椰	sbbh
垠	fvey
邕	vkcb
臆	eujn
钛	qdyy
挎	rdfn
粱	ivwo
涸	ildg
糯	ofdj
霾	feef
禧	pyfk
俸	wdwh
箕	tadw
坷	fskg
祗	pyqy
熹	fkuo
俑	wceh
怂	wwnu
噙	kwyc
湍	imdj
赣	ujtm
芋	agfj
咝	kxxg
潋	iwgt
噶	kajn
巽	nnaw
汕	imh
仞	wvyy
釜	wqfu
鬃	depi
嗵	kcep
颀	rdmy
锚	qalg
螭	jybc
洵	iqjg
犸	qtcg
珈	glkg
魍	rqcn
摁	rldn
疵	uhxv
忤	ntfh
汾	iwvn
汜	inn
琰	gooy
褛	puov
惰	ndae
蚯	jrgg
斓	yugi
觐	akgq
梆	sdtb
漳	iujh
镣	qdui
贻	mckg
粲	hqco
恿	cenu
谲	ycbk
咿	kwvt
咤	kpta
篓	tovf
飚	mqoo
篑	tkhm
憩	tdtn
椭	sbde
睥	hrtf
沽	idg
犄	trdk
怏	nmdy
魉	rqcw
鼾	thlf
堰	fajv
齑	ydjj
帚	vpmh
亟	bkcg
镀	qyac
骠	csfi
苯	asgf
宸	pdfe
僮	wujf
阗	ufhw
榄	sjtq
辇	fwfl
豺	eeft
翦	uejn
纰	xxxn
阂	uynw
旃	ytmy
荦	aprh
蚓	jxhh
趄	fheg
猬	qtle
劾	yntl
趔	fhgj
蜻	jgeg
嵘	maps
铝	qkkg
滇	ifhw
呷	klh
暹	jwyp
蠡	xejj
淄	ivlg
囵	lwxv
掸	rujf
溉	ivcq
坳	fxln
轲	lskg
皋	rdfj
骜	gqtc
螃	jupy
帧	mhhm
蘅	atqh
剽	sfij
坂	frcy
涓	ikeg
魈	rqce
怆	nwbn
袤	ycbe
嗳	kepc
踊	khce
锏	qujg
濡	ifdj
昀	jqug
鹞	ermg
氲	rnjl
厩	dvcq
徙	thhy
瑁	gjhg
箩	tlqu
斡	fjwf
抠	raqy
褶	punr
痣	ufni
晾	jyiy
廿	aghg
揶	rbbh
炖	ogbn
氤	rnld
蹩	umih
芍	aqyu
愫	ngxi
玳	gway
嗬	kawk
臼	vthg
淅	isrh
嘣	kmee
桧	swfc
腺	eriy
壬	tfd
瘁	uywf
堇	akgf
侗	wmgk
赁	wtfm
匝	amhk
孱	nbbb
灸	qyou
褴	pujl
镂	qovg
畸	ldsk
碴	dsjg
羯	udjn
暨	vcag
谤	yupy
彝	xgoa
嘹	kdui
雹	fqnb
忱	npqn
蔫	agho
荔	alll
鲛	qguq
硅	dffg
刽	wfcj
悖	nfpb
脐	eyjh
骧	cyke
夥	jsqq
盹	hgbn
孪	yobf
谆	yybg
殡	gqpw
诌	yqvg
琊	gahb
敕	gkit
禺	jmhy
罂	mmrm
犊	trfd
滟	idhc
藜	atqi
蟑	jujh
郦	gmyb
绥	xevg
讧	yag
潢	iamw
夔	uhtt
橄	snbt
桢	shmy
酆	dhdb
淆	iqde
涮	inmj
蜗	jkmw
垛	fmsy
啕	kqrm
孬	givb
臃	eyxy
澹	iqdy
耘	difc
徵	tmgt
銮	yoqf
豚	eey
蓟	aqgj
汶	iyy
皿	lhng
遑	rgpd
倨	wndg
燧	ouep
佻	wiqn
诘	yfkg
碉	dmfk
摞	rlxi
镐	qymk
诽	ydjd
掖	rywy
峋	mqjg
戛	dhar
蒯	aeej
叵	akd
泗	ilg
鄢	ghgb
鏖	ynjq
邋	vlqp
舐	tdqa
獗	qtdw
酉	sgd
煊	opgg
嗟	kuda
忻	nrh
泱	imdy
蔻	apfl
蓁	adwt
琮	gpfi
遢	jnpd
庖	yqnv
帼	mhly
琏	glpy
诋	yqay
骊	cgmy
荻	aqto
遨	gqtp
俪	wgmy
秧	tmdy
怵	nsyy
瘠	uiwe
诠	ywgg
忪	nwcy
鹄	tfkg
卟	khy
腴	evwy
嶙	moqh
犒	tryk
挞	rdpy
焊	ojfh
碱	ddgt
傥	wipq
迩	qipi
馊	qnvc
摺	rnrg
珩	gtfh
葳	adgt
绉	xqvg
斫	drh
跆	khck
珉	gnan
泠	iwyc
忸	nnfg
闩	ugd
鸵	qynx
彗	dhdv
麝	ynjf
耙	dicn
岷	mnan
鸶	xxgg
粽	opfi
蝈	jlgy
闳	udci
骛	cbtc
佝	wqkg
蜓	jtfp
笆	tcb
怩	nnxn
奂	qmdu
掇	rccc
艮	vei
舀	evf
膘	esfi
踮	khyk
匮	akhm
濠	iype
狒	qtxj
宕	pdf
皖	rpfq
燮	oyoc
邙	ynbh
喙	kxey
莓	atxu
颛	mdmm
椿	sdwj
陲	btgf
恫	nmgk
钹	qdcy
檄	sryt
绡	xieg
鳍	qgfj
椁	sybg
偻	wovg
纾	xcbh
鹧	yaog
弭	xbg
漕	igmj
荑	agxw
贰	afmi
槿	sakg
牒	thgs
鸢	aqyg
砺	dddn
雉	tdwy
鸪	dqyg
绺	xthk
橇	stfn
跻	khyj
轶	lrwy
戊	dnyt
猷	usgd
锹	qtoy
衾	wyne
钺	qant
祚	pytf
闾	ukkd
涝	iapl
荥	apiu
逅	rgkp
肪	eyn
丶	yyll
囱	tlqi
洱	ibg
峪	mwwk
鄱	tolb
箬	tadk
嫒	vepc
繇	ermi
莆	agey
阪	brcy
镳	qyno
浃	iguw
佞	wfvg
麋	ynjo
搡	rccs
蘸	asgo
挝	rfpy
岈	maht
唳	kynd
娣	vuxt
忾	nrnn
戌	dgnt
幄	mhnf
氢	rnca
霰	faet
蔺	auwy
骅	cwxf
蚱	jthf
谀	yvwy
俦	wdtf
昶	ynij
撸	rqgj
狻	qtct
荏	awtf
磬	fnmd
昴	jqtb
杈	scyy
闰	ugd
缮	xudk
谚	yute
龛	wgkx
鸩	pqqg
谗	yqku
砥	dqay
俎	wweg
瘀	uywu
邂	qevp
沏	iavn
邈	eerp
埠	fwnf
坯	fgig
咭	kfkg
缙	xgoj
蹇	pfjh
俾	wrtf
蜚	djdj
箐	tgef
籽	obg
阚	unbt
嗄	kdht
钠	qmwy
泾	icag
腓	edjd
驽	vccf
辍	lccc
鞅	afmd
蹶	khdw
迤	tbpv
诮	yieg
哔	kxxf
赳	fhnh
刎	qrjh
聒	btdg
抨	rguh
腌	edjn
佥	wgif
炷	oygg
淙	ipfi
饯	qngt
垩	gogf
磺	damw
鳗	qgjc
钏	qkh
氅	imkn
胛	elh
遛	qyvp
涿	ieyy
酪	sgtk
糠	oyvi
翕	wgkn
姝	vriy
佶	wfkg
茴	alkf
呔	kdyy
檬	sape
衩	pucy
柩	saqy
恹	nddy
翳	atdn
纂	thdi
姹	vpta
浒	iytf
跖	khdg
琨	gjxx
铄	qqiy
镌	qwye
佃	wlg
钜	qang
莅	awuf
嗑	kfcl
沱	ipxn
膻	eylg
楔	sdhd
徇	tqjg
懑	iagn
豸	eer
儆	waqt
貉	eetk
潸	isse
仨	wdg
讫	ytnn
圜	llge
孀	vfsh
秣	tgsy
蜍	jwty
汨	ijg
柠	spsh
唁	kyg
舄	vqou
呶	kvcy
戗	wbat
璎	gmmv
莜	awht
泸	ihnt
谟	yajd
椋	syiy
扪	run
聃	bmfg
辔	xlxk
逖	qtop
猡	qtlq
剜	pqbj
佰	wdjg
掴	rlgy
绶	xepc
茁	abmj
罄	fnmm
町	lsh
龅	hwbn
蛀	jygg
诳	yqtg
颧	akkm
嵇	tdnm
谩	yjlc
砝	dfcy
殓	gqwi
胫	ecag
螟	jpju
玖	gqyy
蛭	jgcf
祛	pyfc
裨	purf
赝	dwwm
氐	qayi
湫	itoy
葆	awks
蒺	autd
睇	huxt
樽	susf
绦	xtsy
涪	iukg
啮	khwb
锲	qdhd
懔	nyli
囡	lvd
蹴	khyn
篙	tymk
葩	arcb
濯	inwy
矍	hhwc
溥	igef
藓	aqgd
铨	qwgg
盥	qgil
黜	lfom
覃	sjj
煅	owdc
谡	ylwt
坨	fpxn
淞	iswc
铤	qtfp
犟	xkjh
璜	gamw
铀	qmg
驷	clg
樟	sujh
猕	qtxi
菠	aihc
鱿	qgdn
瘌	ugkj
诰	ytfk
滂	iupy
葭	anhc
槁	symk
獐	qtuj
栾	yosu
饪	qntf
殄	gqwe
栉	sabh
酵	sgfb
噱	khae
醐	sgde
锉	qwwf
崧	mswc
砧	dhkg
蔗	ayao
牦	trtn
榷	spwy
泵	diu
嫱	vfuk
槊	ubts
醍	sgjh
逡	cwtp
赡	mqdy
鎏	iycq
鸷	rvyg
灞	ifae
荪	abiu
骓	cwyg
酗	sgqb
咩	kudh
箴	tdgt
哓	katq
蚤	cyju
罹	lnwy
馍	qnad
滓	ipuh
鹗	kkfg
釉	tomg
棂	svoy
赊	mwfi
熨	nfio
塾	ybvf
瑗	gefc
锟	qjxx
挹	rkcn
夯	dlb
囫	lqre
诙	ydoy
酡	sgpx
痍	ugxw
痿	utvd
绌	xbmh
莘	auj
殁	gqmc
兕	mmgq
刍	qvf
奘	nhdd
獬	qtqh
箸	tftj
锷	qkkn
崴	mdgt
纭	xfcy
骞	pfjc
锃	qkgg
蝮	jtjt
柑	safg
秆	tfh
圉	lfuf
馗	vuth
嶂	mujh
莒	akkf
膑	eprw
荟	awfc
豢	udeu
灏	ijym
脶	ekmw
衢	thhh
仄	dwi
鹘	meqg
痘	ugku
嚯	kfwy
碇	dpgh
晷	jthk
渚	iftj
碜	dcde
蛎	jddn
隍	brgg
砣	dpxn
谔	ykkn
泅	ilwy
骈	cuah
懋	scbn
仝	waf
稔	twyn
泫	iyxy
哞	kcrh
乜	nnv
诓	yagg
蓿	apwj
桠	sgog
耒	dii
糅	ocbs
烯	oqdh
镫	qwgu
貅	eews
猱	qtcs
犴	qtfh
纫	xvyy
褓	puws
蕲	aujr
偈	wjqn
溧	issy
訇	qyd
媾	vfjf
榛	sdwt
郏	guwb
葺	akbf
铩	qqsy
蚨	jfwy
掾	rxey
靛	geph
螯	gqtj
耦	dijy
萋	agvv
侩	wwfc
恽	nplh
徉	tudh
枰	sguh
鹜	cbtg
褫	purm
琚	gndg
蜮	jakg
抻	rjhh
襁	puxj
遴	oqap
蓑	ayke
皈	rrcy
娩	vqkq
虱	ntji
菟	aqky
阈	uakg
觞	qetr
呖	kdln
箝	traf
狎	qtlh
邳	gigb
轾	lgcf
幂	pjdh
阡	btfh
忝	gdnu
窳	pwry
貔	eetx
炅	jou
舢	temh
铢	qriy
糨	oxkj
髭	dehx
抟	rfny
沆	iymn
铣	qtfq
腩	efmf
烩	owfc
锴	qxxr
殚	gquf
秸	tfkg
砀	dnrt
氮	rnoo
孑	bnhg
愎	ntjt
睢	hwyg
逦	gmyp
薜	anku
嘞	kafl
狴	qtxf
悌	nuxt
猢	qtde
爻	qqu
牍	thgd
羸	ynky
囗	lhng
撺	rpwh
鹑	ybqg
缃	xshg
饽	qnfb
嶷	mxth
蒿	aymk
蝾	japs
稹	tfhw
雒	tkwy
仃	wsh
俅	wfiy
狍	qtqn
梏	stfk
橐	gkhs
韪	jghh
橹	sqgj
鳕	qgfv
轸	lwet
黢	lfot
徜	timk
桎	sgcf
鬣	devn
擢	rnwy
肓	ynef
泷	idxn
镏	qqyl
呙	kmwu
璺	wfmy
铡	qmjh
碘	dmaw
镁	qugd
伥	wtay
珐	gfcy
辂	ltkg
崂	mapl
炝	owbn
祉	pyhg
狲	qtbi
榔	syvb
钙	qghn
媪	vjlg
珲	gplh
肛	eag
濂	iyuo
芩	awyn
诿	ytvg
镞	qytd
鼬	vnum
臬	thsu
岫	mmg
氯	rnvi
阆	uyve
箔	tirf
貊	eedj
澧	imau
饨	qngn
蜇	rrju
馄	qnjx
蜢	jblg
镛	qyvh
寮	pdui
蛔	jlkg
诨	yplh
酊	sgsh
璁	gtln
骢	ctln
砒	dxxn
纛	gxgi
纛	gxf
楸	stoy
蟊	cbtj
煲	wkso
爿	nhde
谌	yadn
狷	qtke
聩	bkhm
媸	vbhj
掼	rxfm
蛐	jmag
莠	ateb
钨	qqng
镝	qumd
怼	cfnu
旮	vjf
酩	sgqk
韫	fnhl
诟	yrgk
硭	dayn
摈	rprw
蚋	jmwy
赭	fofj
絷	rvyi
歃	tfvw
黩	lfod
耆	ftxj
闱	ufnh
嘬	kjbc
飨	xtwe
茯	awdu
邴	gmwb
缛	xdff
驺	cqvg
訾	hxyf
轱	ldg
卅	gkk
祆	pygd
鲧	qgti
甯	pnej
蹉	khua
氨	rnpv
遒	usgp
僭	waqj
谯	ywyo
倥	wpwa
孢	bqnn
嵬	mrqc
誊	udyf
旯	jvb
妁	vqyy
岬	mlh
孛	fpbf
泖	iqtb
裾	pund
榈	sukk
荚	aguw
跎	khpx
囿	lded
悒	nkcn
檑	sflg
谥	yuwl
谶	ywwg
蚺	jmfg
痂	ulkd
虺	gqji
牯	trdg
镗	qipf
煨	olge
饴	qnck
獾	qtay
眇	hitt
闫	udd
伉	wymn
祧	pyiq
胪	ehnt
啖	kooy
钴	qdg
揆	rwgd
苻	awfu
錾	lrqf
鼹	vnuv
阒	uhdi
笞	tckf
豕	egty
耄	ftxn
撷	rfkm
椤	slqy
痔	uffi
菀	apqb
嫫	vajd
蟋	jton
拮	rfkg
暝	jpju
岿	mjvf
阕	uwgd
滁	ibwt
弁	caj
荇	atfh
逶	tvpd
蚪	jufh
喑	kujg
蟀	jyxf
嘁	kdht
糸	xiu
茕	apnf
埙	fkmy
獭	qtgm
觥	qeiq
晗	jwyk
蝌	jtuf
俚	wjfg
磔	dqas
墒	fumk
搽	raws
滦	iyos
姘	vuah
湎	idmd
螫	fotj
畹	lpqb
笮	tthf
饬	qntl
菅	apnn
肱	edcy
徕	tgoy
傈	wssy
汞	aiu
蓐	adff
徭	term
鳝	qguk
巯	cayq
鲽	qgas
铆	qqtb
剡	oojh
猁	qttj
柚	smg
逑	fiyp
捭	rrtf
脔	yomw
鬈	deub
哙	kwfc
铂	qrg
挈	dhvr
绻	xudb
跹	khtp
瑷	gepc
铖	qdnt
炻	odg
癣	uqgd
颢	jyim
裱	puge
蕤	aetg
悱	ndjd
猞	qtwk
赅	mynw
楹	secl
恚	ffnu
潍	ixwy
衽	putf
貘	eead
钎	qtfh
凼	ibk
蜉	jebg
粕	org
钿	qlg
涞	igoy
雩	ffnb
鲫	qgvb
傩	wcwy
莳	ajfu
斛	qeuf
珙	gawy
纥	xtnn
筅	ttfq
胰	egxw
荜	axxf
焘	dtfo
怄	naqy
栎	sqiy
讴	yaqy
洌	igqj
觜	hxqe
瘙	ucyj
唿	kqrn
缳	xlge
戕	nhda
锝	qjgf
埂	fgjq
拊	rwfy
讦	yfh
螈	jdri
锌	quh
郗	qdmb
仵	wtfh
烊	oudh
篁	trgf
搴	pfjr
獍	qtuq
杷	scn
脍	ewfc
醴	sgmu
鹂	gmyg
邰	ckbh
郜	tfkb
纩	xyt
堞	fans
鹬	cbtg
牝	trxn
湟	irgg
酃	fkkb
冼	utfq
氦	rnyw
锒	qyve
篾	tldt
缦	xjlc
杌	sgqn
硌	dtkg
骝	cqyl
碣	djqn
鏊	gqtq
虻	jynn
膂	ytee
咴	kdoy
缟	xymk
荞	atdj
偬	wqrn
暾	jybt
窨	pwuj
鼐	ehnn
帏	mhfh
洮	iiqn
胱	eiqn
铉	qyxy
鲟	qgvf
竦	ugki
虢	efhm
椽	sxey
韭	djdg
佤	wgnn
蕨	aduw
狯	qtwc
屐	ntfc
癯	uhhy
鳃	qgln
苌	atay
侔	wcrh
腚	epgh
腱	evfp
圻	frh
痨	uapl
眙	hckg
竽	tgfj
缢	xuwl
辚	loqh
尜	idiu
趺	khfw
茔	apff
蝰	jdff
囹	lwyc
洇	ildy
鼋	fqkn
芫	afqb
赍	fwwm
宥	pdef
樘	sipf
酶	sgtu
墉	fyvh
嘌	ksfi
恂	nqjg
罅	rmhh
镊	qbcc
椴	swdc
彀	fpgc
洹	igjg
盱	hgfh
噻	kpff
旄	yttn
犍	trvp
庹	yany
欹	dskw
珥	gbg
吡	kxxn
撄	rmmv
狃	qtnf
裢	pulp
镙	qlxi
圩	fgfh
铬	qtkg
馐	qnuf
峄	mcfh
馏	qnql
搠	rube
炔	onwy
踟	khtk
鼍	kkln
仟	wtfh
鹌	djng
戡	adwa
苫	ahkf
襦	pufj
擀	rfjf
娈	yovf
昃	jdwu
荛	aatq
龈	hwbe
焖	ouny
诤	yqvh
峤	mtdj
犰	qtvn
蟥	jamw
蹼	khoy
殳	mcu
妣	vxxn
楫	skbg
燹	eeou
缱	xkhp
厣	ddlk
傣	wdwi
狁	qtcq
帔	mhhc
锰	qblg
圄	lgkd
痢	utjk
嵯	muda
樨	snih
纡	xgfh
畲	wfil
瘐	uvwi
腭	ekkn
瓴	wycn
蠹	gkhj
裣	puwi
郓	plbh
柞	sthf
砦	hxdf
杼	scbh
闼	udpi
鞒	aftj
芨	aeyu
蛉	jwyc
骐	cadw
吖	kuhh
瘿	ummv
笳	tlkf
郧	kmbh
黟	lfoq
舛	qahh
钾	qlh
憷	nssh
稞	tjsy
颏	yntm
佚	wrwy
苡	anyw
勐	blln
淖	ihjh
澍	ifkf
勖	jhln
铰	quqy
褡	puak
诜	ytfq
薨	alpx
濉	ihwy
檫	spwi
郇	qjbh
骘	bhic
凫	qynm
垭	fgog
罨	ldjn
邗	fbh
钯	qcn
搦	rxuu
荠	ayjj
喁	kjmy
枋	syn
浔	ivfy
煸	oyna
矽	dqy
苕	avkf
謇	pfjy
垓	fynw
沔	ighn
粑	ocn
蝓	jwgj
躅	khlj
锨	qrqw
瀣	ihqg
迓	ahtp
杓	sqyy
喈	kxxr
烷	opfq
矾	dmyy
缁	xvlg
蜊	jtjh
陉	bcag
堠	fwnd
鄯	udub
幛	mhuj
愀	ntoy
瓤	ykky
蕈	asjj
踯	khub
鲵	qgvq
丨	hhll
刭	cajh
怫	nxjh
罴	lfco
坩	fafg
焙	oukg
氰	rnge
渑	ikjn
疥	uwjk
肜	eet
厶	cny
氟	rnxj
鲰	qgbc
疟	uagd
笫	ttnt
褰	pfje
痼	uldd
鲑	qgff
黍	twiu
沭	isyy
缗	xnaj
菸	aywu
悭	njcf
疱	uqnv
衿	puwn
艏	teuh
裎	pukg
孳	uxxb
庠	yudk
旒	ytyq
栳	sftx
茏	adxb
阄	uqjn
亳	ypta
艨	teae
邛	abh
麂	ynjm
尻	nvv
樯	sfuk
豌	gkub
踽	khty
鲈	qghn
艄	teie
鲶	qgwn
眭	hffg
陂	bhcy
榉	siwh
氖	rneb
笏	tqrr
廪	yyli
怛	njgg
蚍	jxxn
铙	qatq
殍	gqeb
泶	ipiu
淝	iecn
菘	aswc
蒹	auvo
忉	nvn
桁	stfh
疹	uwee
蝣	jytb
喱	kdjf
妊	vtfg
萑	awyf
擘	nkur
逋	gehp
埚	fkmw
苒	amff
锗	qftj
唢	kimy
谰	yugi
歙	wgkw
焯	ohjh
矬	tdwf
疽	uegd
艟	teuf
趸	dnkh
蹰	khdf
荩	anyu
縻	yssi
亍	fhk
佧	whhy
叻	kln
趿	khey
勰	llln
嘏	dnhc
桫	siit
侪	wyjh
疴	uskd
翥	ftjn
蚝	jtfn
鲠	qggq
雎	egwy
毂	fplc
茑	aqyg
觚	qery
阋	uvqv
洄	ilkg
焓	owyk
跗	khwf
猗	qtdk
胺	epvg
鹕	deqg
笤	tvkf
跸	khxf
钬	qoy
镪	qxkj
馕	qnge
疡	unre
篦	ttlx
鹈	uxhg
踅	rrkh
棼	sswv
睾	tlff
鹳	akkg
漭	iada
烃	ocag
瞽	fkuh
逄	tahp
锍	qycq
哚	kmsy
砬	dug
蝥	cbtj
钲	qghg
陟	bhit
耋	ftxf
酮	sgmk
塄	flyn
痫	uusi
蚧	jwjh
埘	fjfy
枸	sqkg
柢	sqay
潆	iapi
笄	tgaj
醮	sgwo
彖	xeu
稗	trtf
窠	pwjs
萘	adfi
郯	oobh
掮	ryne
尢	dnv
鲇	qghk
鼙	fkuf
畦	lffg
舸	tesk
帑	vcmh
睃	hcwt
蚜	jaht
溘	ifcl
蠃	ynky
岢	mskf
矸	dfh
鸱	qayg
狳	qtwt
祜	pydg
囟	tlqi
扦	rtfh
枥	sdln
庾	yvwi
菔	aebc
蟛	jfke
嗉	kgxi
擤	rthj
莪	atrt
觋	awwq
醪	sgne
倬	whjh
爰	eftc
蚰	jmg
轳	lhnt
锱	qvlg
鬻	xoxh
鳏	qgli
栲	sftn
渌	iviy
蛄	jdg
嬗	vylg
谘	yuqk
鋈	itdq
阍	uqaj
杲	jsu
柘	sdg
毖	xxnt
禳	pyye
馔	qnnw
鳐	qgem
鳟	qguf
耔	dibg
辊	ljxx
镍	qths
侑	wdeg
娠	vdfe
槎	suda
芾	agmh
豳	eemk
钤	qwyn
锕	qbsk
孥	vcbf
綦	adwi
锑	quxt
洙	iriy
榫	swyf
疣	udnv
砭	dtpy
筮	taww
酽	sggd
愆	tifn
栀	srgb
耪	diuy
薅	avdf
蜞	jadw
崤	mqde
椟	sfnd
糁	ocde
茇	adcu
啁	kmfk
氪	rndq
萁	aadw
龃	hwbg
墀	fnih
芪	aqab
莰	afqw
菏	aisk
嵊	mtux
蛩	amyj
鞯	afab
楂	ssjg
缒	xwnp
饣	qnb
乩	hknn
捌	rklj
毽	tfnp
愍	natn
瘢	utec
铋	qntt
铧	qwxf
髋	mepq
鹚	uxxg
儋	wqdy
奁	daqu
樾	sfht
滹	ihah
穑	tfuk
茌	awff
骶	meqy
刖	ejh
嫜	vujh
溏	iyvk
螽	tujj
囝	lbd
戽	ynuf
橛	sduw
舂	dwvf
遄	mdmp
坭	fnxn
澶	iylg
熵	oumk
镬	qawc
飧	qwye
枞	swwy
柙	slh
硎	dgaj
缯	xulj
蔌	agkw
鲂	qgyn
冱	ugxg
岙	tdmj
殂	gqeg
艉	tenn
蠼	jhhc
匏	dfnn
痈	uek
鹾	hlqa
尕	eiu
攮	rgke
樗	sffn
皲	plhc
髡	degq
坻	fqay
伧	wwbn
剀	mnjh
椐	sndg
瓠	dfny
讣	yhy
髁	mejs
龉	hwbk
彘	xgxx
棹	shjh
疠	udnv
薮	aovt
隈	blge
龋	hwby
朐	eqkg
橼	sxxe
芰	afcu
圹	fyt
敉	oty
暌	jwgd
饧	qnnr
泔	iafg
赜	ahkm
黧	tqto
筚	txxf
蓖	atlx
鸬	hnqg
蚬	jmqn
醯	sgyl
钪	qymn
餍	ddwe
鸹	tdqg
哏	kvey
甑	uljn
疋	nhi
膣	epwf
螅	jthn
锞	qjsy
髫	devk
宄	pvb
摭	ryao
檠	aqks
盍	fclf
绂	xdcy
骟	cynn
棰	stgf
缡	xybc
苷	aaff
蹁	khya
铗	qguw
鞣	afcs
圯	fnn
涑	igki
箜	tpwa
芎	axb
蔟	aytd
觯	qeuf
鍪	cbtq
镟	qyth
夤	qpgw
妫	vyly
熘	oqyl
硼	deeg
秫	tsyy
阏	uywu
飑	mqqn
啭	klfy
枳	skwy
礅	dybt
耨	didf
茭	auqu
钡	qmy
捩	rynd
柁	spxn
苴	aegf
铊	qpxn
寤	pnhk
牖	thgy
赀	hxmu
醚	sgop
柽	scfg
栌	shnt
肄	xtdh
脘	epfq
酎	sgfy
鲳	qgjj
柒	iasu
浠	iqdh
蛳	jjgh
壅	yxtf
枇	sxxn
楱	sdwd
焐	ogkg
秭	ttnt
笥	tngk
茈	ahxb
蒌	aovf
谵	yqdy
跏	khlk
镆	qajd
怙	ndg
枵	skgn
痱	udjd
膈	egkh
卮	rgbv
圊	lged
圮	fnn
堀	fnbm
忄	nyhy
氚	rnkj
皴	cwtc
绐	xckg
蟮	judk
邡	ybh
亻	wth
庑	yfqv
廨	yqeh
钭	qufh
觳	fpgc
闶	uymv
檗	nkus
漯	ilxi
瓿	ukgn
眚	tghf
芴	aqrr
诂	ydg
郴	ssbh
鳓	qgal
俣	wkgd
徼	tryt
桡	satq
楗	svfp
莨	ayve
酰	sgtq
雠	wyyy
喾	iptk
揿	rqqw
笊	trhy
苎	apgf
黥	lfoi
僳	wsoy
芏	aff
菖	ajjf
蓊	awcn
袢	puuf
馑	qnag
卺	bigb
垆	fhnt
旆	ytgh
曛	jtgo
汊	icyy
硒	dsg
穰	tyke
粳	ogjq
酾	sggy
鲷	qgmk
鹣	uvog
塬	fdri
曩	jyke
莴	akmw
蕞	ajbc
蘖	awns
怃	nfqn
欤	gngw
玢	gwvn
蕖	aias
镒	quwl
厝	dajd
坶	fxgu
屣	nthh
揎	rpgg
榧	sadd
芑	anb
蓥	apqf
钣	qrcy
鬲	gkmh
鳔	qgsi
鼗	iqfc
仂	wln
婺	cbtv
嫠	fitv
愦	nkhm
癍	ugyg
癔	uujn
碓	dwyg
箧	tagw
缶	rmk
蘧	ahap
妗	vwyn
幞	mhoy
沤	iaqy
痦	ugkd
蛑	jcrh
詈	lyf
钚	qgiy
铴	qinr
锆	qtfk
丌	gjk
岘	mmqn
枧	smqn
柰	sfiu
浜	irgw
蓼	anwe
蛞	jtdg
鄣	ujbh
偾	wfam
藿	afwy
酢	sgtf
铟	qldy
锛	qdfa
阊	ujjd
骖	ccde
鲆	qggh
檩	syli
燔	otol
猓	qtjs
蘼	aysd
趵	khqy
酲	sgkg
鹩	dujg
乇	tav
屙	nbsk
揸	rsjg
碛	dgmy
笸	takf
赓	yvwm
鄄	sfbh
铱	qyey
黻	oguc
伲	wnxn
缂	xafh
蜣	judn
蜩	jmfk
谝	yyna
铍	qhcy
伛	waqy
傧	wprw
揠	rajv
昝	thjf
溽	idff
胙	ethf
萏	aqvf
隹	wyg
麈	ynjg
妯	vmg
孓	byi
溱	idwt
碚	dukg
蕺	akbt
锊	qefy
镧	qugi
髀	merf
坫	fhkg
崃	mgoy
戢	kbnt
糌	othj
缬	xfkm
邶	uxbh
坼	fryy
梃	stfp
瞢	alph
缧	xlxi
菽	ahic
豉	gkuc
仳	wxxn
堙	fsfg
忭	nyhy
砷	djhh
筌	twgf
箪	tujf
艿	aeb
郅	gcfb
鲢	qglp
鳎	qgjn
厍	dlk
哕	kmqy
廑	yakg
敫	ryty
栊	sdxn
癜	unac
碹	dpgg
磙	duce
笾	tlpu
篪	trhm
缌	xlny
苣	aanf
荨	avfu
诹	ybcy
诼	yeyy
钒	qmyy
嗍	kube
槠	syfj
欷	qdmw
淦	iqg
甏	fkun
胝	eqay
蓍	aftj
蛱	jguw
裉	puve
辏	ldwd
颞	bccm
麸	gtfw
娌	vjfg
椹	sadn
缫	xvjs
翮	gkmn
诒	yckg
郾	ajvb
铯	qqcn
锂	qjfg
鞫	afqy
卣	hlnf
圬	ffnn
尥	dnqy
槲	sqef
氘	rnjj
瘘	uovd
耩	diff
轫	lvyy
迨	ckpd
馓	qnat
啉	kssy
圪	ftnn
廴	pny
泺	iqiy
熳	ojlc
璩	ghae
胗	ewet
苁	awwu
薹	afkf
锘	qadk
阌	uepc
鳊	qgya
唑	kwwf
溻	ijng
瘰	ulxi
砗	dlh
砩	dxjh
羝	udqy
茺	aycq
蓠	aybc
俳	wdjd
刳	dfnj
唣	kran
悝	njfg
慊	nuvo
瘳	unwe
茼	amgk
麇	ynjt
黾	kjnb
嗾	kytd
嵛	mwgj
杩	scg
狨	qtad
狺	qtyg
痧	uiit
砜	dmqy
缍	xtgf
芡	aqwu
蓣	acbm
顸	fdmy
槭	sdht
溲	ivhc
痤	uwwf
眄	hghn
糍	ouxx
葚	aadn
郐	wfcb
酹	sgef
镢	qduw
隳	bdan
鹋	alqg
唛	kgty
嬖	nkuv
怍	nthf
朊	efqn
涫	ipnn
绲	xjxx
胼	euah
腧	ewgj
葑	afff
蠓	jape
踬	khrm
鞲	afff
饫	qntd
刈	qjh
垲	fmnn
嵴	miwe
帻	mhgm
旰	jfh
畚	cdlf
荭	axaf
萸	avwu
蘩	atxi
颃	ymdm
颟	agmm
鸲	qkqg
龠	wgka
呒	kfqn
嗌	kuwl
疸	ujgd
硖	dguw
绁	xann
耧	diov
蚴	jxln
蛸	jieg
裰	pucc
謦	fnmy
跣	khtq
踺	khvp
逯	vipi
陔	bynw
凇	uswc
堋	feeg
屦	ntov
峁	mqtb
廛	yjff
栝	stdg
磴	dwgu
篌	twnd
芘	axxb
葸	alnu
薏	aujn
踔	khhj
鄞	akgb
醢	sgdl
铒	qbg
镲	qpwi
鲮	qgft
仉	wmn
侉	wdfn
桄	siqn
泮	iufh
燠	otmd
犭	qte
皤	rtol
粝	oddn
蹀	khas
颡	cccm
鲞	udqg
唪	kdwh
嗪	kdwt
掭	rgdn
畈	lrcy
簦	twgu
绨	xuxt
胍	ercy
胲	eynw
舻	tehn
铘	qahb
锩	qudb
鲋	qgwf
崮	mldf
庋	yfci
毳	tfnn
箅	tlgj
缣	xuvo
菹	aieg
虿	dnju
谇	yywf
贶	mkqn
陧	bjfg
隰	bjxo
僬	wwyo
匦	alvv
垧	ftmk
疔	usk
肭	emwy
蝤	jusg
谖	yefc
趑	fhuw
轭	ldbn
酐	sgfh
醅	sguk
醑	sgne
醛	sgag
锬	qooy
劂	dubj
垅	fdxn
悛	ncwt
戥	jtga
拶	rvqy
硷	dwgi
笕	tmqb
簟	tsjj
莼	axgn
蒴	aube
藁	ayms
诖	yffg
谠	yipq
谳	yfmd
邾	ribh
陴	brtf
鬏	deto
龀	hwbx
剞	dskj
劬	qkln
埸	fjqr
嬲	llvl
嵝	movg
搿	rwgr
柝	sryy
桴	sebg
洧	ideg
浯	igkg
疝	umk
笱	tqkf
肽	edyy
舯	tekh
艋	tebl
芤	abnb
葙	ashf
鲔	qgde
鸸	dmjg
佾	wweg
墁	fjlc
嫘	vlxi
榇	susy
煳	odeg
硪	dtrt
礞	dape
菰	abry
蚵	jskg
趱	fhtm
躜	khtm
钼	qhg
鲱	qgdd
匚	agn
呋	kfwy
媵	eudv
崦	mdjn
楝	sgli
潲	itie
獯	qtto
瘵	uwfi
绀	xafg
绋	xxjh
莩	aebf
觫	qegi
辋	lmun
镡	qsjh
髂	mepk
鬯	qobx
鹨	nweg
亓	fjj
劓	thlj
埕	fkgg
曷	jqwn
洚	itah
碲	duph
磲	dias
粜	bmou
绱	ximk
芄	avyu
酚	sgwv
铪	qwgk
髌	mepw
鲥	qgjf
俜	wmgn
刿	mqjh
吣	kny
垤	fgcf
枘	smwy
氽	wiu
溷	iley
甍	alpn
笪	tjgf
胬	vcmw
舨	terc
芟	amcu
蒽	aldn
銎	amyq
铵	qpvg
锶	qlny
骱	mewj
鹆	wwkg
岣	mqkg
岵	mdg
怿	ncfh
慝	aadn
挢	rtdj
掎	rdsk
毹	wgen
汆	tyiu
沲	itbn
湔	iuej
甙	aafd
罟	ldf
羼	nudd
菝	ardc
讵	yang
诎	ybmh
谮	yaqj
赉	gomu
郄	qdcb
鐾	nkuq
鲎	ipqg
啶	kpgh
塍	eudf
屺	mnn
庥	ywsi
掊	rukg
撙	rusf
柃	swyc
檎	swyc
毵	cden
渖	ipjh
砘	dgbn
窭	pwov
肟	efnn
蔸	aqrq
蚶	jafg
蛏	jcfg
躞	khoc
酯	sgxj
锾	qefc
饩	qnrn
劢	dnln
嘧	kpnm
嵫	muxx
擐	rlge
湓	iwvl
蝻	jfmf
蠖	jawc
觖	qenw
跬	khff
阝	bnh
鳜	qgdw
仡	wtnn
垌	fmgk
氆	tfnj
氇	tfnj
汔	itnn
篼	tqrq
缑	xwnd
舾	tesg
莸	aqtn
蛲	jatq
蠛	jalt
蠲	uwlj
褊	puya
醣	sgyk
骀	cckg
倮	wjsy
僦	wyin
凵	bnh
崾	msvg
渫	ians
瘗	uguf
箦	tgmu
肼	efjh
腽	ejlg
臁	eyuo
舳	temg
芈	gjgh
荽	aevf
蒉	akhm
蛴	jyjh
袼	putk
跫	amyh
遘	fjgp
儇	wlge
埽	fvph
庀	yxv
戆	ujtn
扃	ynmk
搛	ruvo
杪	sitt
浼	iqkq
滏	iwqu
瓞	rcyw
疃	lujf
砟	dthf
硗	datq
禊	pydd
篥	tssu
簋	tvel
綮	ynti
苤	agig
踣	khuk
躐	khvn
酴	sgwt
钽	qjgg
锸	qtfv
锼	qvhc
阃	ulsi
鞔	afqq
鲭	qgge
鹪	wyog
黪	lfoe
黼	oguy
榀	skkk
榘	tdas
氵	iyyg
浍	iwfc
炱	ckou
煺	ovep
犋	trhw
砻	dxdf
秕	txxn
籼	omh
耜	dinn
肀	vhk
肫	egbn
肷	eqwy
胂	ejhh
莛	atfp
裥	puuj
逭	pnhp
钋	qhy
钌	qbh
钸	qdmh
髑	melj
鳆	qgtt
鼯	vnuk
佴	wbg
吲	kxhh
帱	mhdf
搌	rnae
擗	rnku
桷	sqeh
氡	rntu
氩	rngg
溴	ithd
畋	lty
硐	dmgk
糇	ownd
腠	edwd
葶	ayps
袷	puwk
陬	bbcy
黉	ipaw
龆	hwbk
刂	jhh
哜	kyjh
埴	ffhg
岜	mcb
徂	tegg
惝	nimk
扌	rghg
烀	otuh
眢	qbhf
瞵	hoqh
筇	tabj
簏	tynx
芗	axtr
蝽	jdwj
蟪	jgjn
郫	rtfb
钕	qvg
钫	qyn
镉	qgkh
镘	qjlc
颥	fdmm
黹	ogui
坜	fdln
埤	frtf
廾	agth
彳	ttth
楦	spgg
氙	rnmj
澌	iadr
畛	lwet
疳	uafd
瘅	uujf
砉	dhdf
砹	daqy
碡	dgxu
穸	pwqu
缵	xtfm
羟	udca
膦	eoqh
菪	apdf
虼	jtnn
蛘	judh
螨	jagw
裼	pujr
讠	yyn
迕	tfpk
钅	qtgn
铈	qymh
锇	qtrt
锔	qnnk
锪	qqrn
镓	qpey
镦	qybt
镱	qujn
霪	fief
骒	cjsy
鹁	fpbg
冁	ujfe
冖	pyn
哿	lksk
噍	kwyo
埝	fwyn
弪	xcag
攉	rfwy
浞	ikhy
潴	iqtj
畀	lgjj
籴	tyou
罱	lfmf
羰	udmo
胨	eaiy
胩	ehhy
舴	tetf
苊	adbb
茆	aqtb
茛	aveu
蒇	admt
虮	jmn
蠊	jyuo
裒	yveu
襞	nkue
觇	hkmq
轺	lvkg
锿	qyey
髹	dews
鸫	aiqg
哌	krey
垸	fpfq
埏	fthp
墼	gjff
帙	mhrw
悃	nlsy
揲	rans
晡	jgey
榍	snie
榱	syke
殪	gqfu
淠	ilgj
漤	issv
疬	udlv
砑	daht
缲	xkks
罘	lgiu
苈	adlb
萆	artf
谂	ywyn
辶	pyny
鄹	bctb
酞	sgdy
钔	qun
铥	qtfc
镅	qnhg
髟	det
鲡	qggy
鲦	qgts
鳇	qgrg
鹇	usqg
鹱	qync
埒	fefy
岽	maiu
悫	fpmn
攵	ttgy
桊	udsu
桕	svg
槔	srdf
溆	iwtc
漶	ikkn
牾	trgk
畎	ldy
疖	ubk
矧	tdxh
稂	tyve
窀	pwgn
籀	trql
腈	egeg
苄	ayhu
薷	afdj
褙	puue
赙	mgef
跽	khnn
钐	qet
锖	qgeg
镎	qwgr
饔	yxte
骣	cnbb
鳙	qgyh
丿	ttll
坌	wvff
宀	pyyn
氍	hhwn
沩	iyly
洫	itlg
澉	inbt
瀹	iwga
爨	wfmo
珧	giqn
瘊	uwnd
瞍	hvhc
硇	dtlq
筘	trkf
粢	uqwo
聍	bpsh
舁	vaj
艚	tegj
荸	afpb
蜱	jrtf
钍	qfg
铞	qkmh
铫	qiqn
骺	merk
鲼	qgfm
冂	mhn
劐	awyj
哳	krrh
唼	kuvg
忮	nfcy
恝	dhvn
戋	gggt
椠	lrsu
瘕	unhc
瘛	udhn
瘼	uajd
祓	pydc
窆	pwtp
窬	pwwj
篚	tadd
粞	osg
羧	udct
脬	eebg
艽	avb
葜	adhd
蓰	athh
觌	fnuq
豇	gkua
轵	lkwy
醵	sghe
铌	qnxn
镄	qxjm
阼	bthf
鞴	afae
鲅	qgdc
鲒	qgfk
埯	fdjn
夂	ttny
恧	dmjn
憝	ybtn
搋	rrhm
氕	rntr
洳	ivkg
浈	ihmy
濞	ithj
礤	dawi
聱	gqtb
艹	aghh
蟓	jqje
襻	pusr
趼	khga
迮	thfp
钆	qnn
铷	qvkg
镨	quoj
驵	cegg
鲣	qgjf
鳘	txgg
鸺	wsqg
嚆	kayk
堍	fqky
嶝	mwgu
巛	vnnn
廒	ygqt
桤	smnn
橥	qtfs
爝	oelf
甾	vlf
痄	uthf
癀	uamw
筲	tief
箨	trch
罾	lulj
耵	bsh
舣	teyq
荬	anud
蕹	ayxy
诔	ydiy
赆	mnyu
蹯	khtl
钇	qnn
钶	qskg
铕	qdeg
镤	qogy
鲚	qgyj
鲻	qgvl
鳢	qgmu
鹛	nhqg
塥	fgkh
庳	yrtf
怊	nvkg
捃	rvtk
揞	rujg
洎	ithg
涠	ilfh
滠	ibcc
猸	qtnh
甓	nkun
瘃	ueyi
瞀	cbth
砼	dwag
礓	dglg
绠	xgjq
耱	diyd
脎	eqsy
脒	eoy
脞	ewwf
萜	amhk
蕻	adaw
薤	agqg
衤	pui
跞	khqi
轹	lqiy
锎	quga
锓	qvpc
馇	qnsg
鲐	qgck
鲩	qgpq
丬	uygh
亠	yyg
仫	wtcy
卩	bnh
垡	waff
垴	fybh
岍	mgah
崞	mybg
枨	stay
毪	tfnh
牮	warh
癃	ubtg
眍	haqy
眵	hqqy
稃	tebg
筢	trcb
腙	epfi
舭	texx
菥	asrj
蜾	jjsy
螬	jgmj
螵	jsfi
衄	tlnf
谫	yuev
躔	khyf
郛	ebbh
酤	sgdg
钷	qakg
锫	qukg
镩	qpwh
阢	bgqn
鼷	vnud
劁	wyoj
埭	fviy
墚	fivs
摅	rhan
撖	rnbt
泐	ibln
滗	ittn
牿	trtk
犏	trya
猹	qtsg
疰	uygd
痃	uyxi
痖	ugog
瘥	uuda
磉	dccs
礻	pyi
箢	tpqb
簖	tonr
缋	xkhm
缏	xwgq
耥	diik
脲	eniy
膪	eupk
苠	anab
茳	aiaf
莶	awgi
蒎	aire
蒡	aupy
虍	hav
螗	jyvk
贳	anmu
軎	gjfk
醌	sgjx
醭	sgoy
铹	qapl
铼	qgoy
镥	qqgj
阽	bhkg
馘	uthg
鲺	qgnj
鹎	rtfg
鼽	thlv
傺	wwfi
勹	qtn
喹	kdff
彡	ettt
戤	ecla
攴	hcu
瀵	iolw
灬	oyyy
〇	llll
丂	gnv
丄	hgd
丅	ghk
丆	dgt
丏	ghnn
丒	vygf
丗	gmk
丗	gkgd
丟	gcu
丠	uxgf
両	gmmk
丣	gajn
並	uogf
丩	nhk
丮	nfhk
丯	ehk
丱	njhg
丳	kkjk
丵	oguf
丷	uyt
丼	fjyi
乀	yyll
乁	yyll
乂	qty
乄	nyi
乆	nwi
乊	tur
乑	tii
乕	rfmh
乗	tgas
乚	nnll
乛	nnll
乢	mnn
乣	xnn
乤	ghnb
乥	tunb
乧	ufnb
乨	cknn
乪	nld
乫	lknb
乬	annb
乭	dnb
乮	qtbn
乯	tuhn
乲	uqwn
乴	rrnb
乵	unn
乶	gehn
乷	iitn
乸	bxgu
乹	fjnn
乺	rnrn
乻	ywun
乼	iygn
乽	ftjn
乿	exin
亀	qjjn
亁	fjfn
亂	ecmn
亃	oqan
亄	fpgn
亅	hhll
亇	qhj
亊	guvh
亐	fnv
亖	fff
亗	mff
亙	gqug
亙	ghng
亜	gkjg
亝	cccf
亞	ghgg
亞	gfgd
亣	yjj
亪	yoyu
亯	yjf
亰	yjiu
亱	ywjg
亴	ypfv
亶	ylkg
亷	utvo
亸	ybuf
亹	ywfg
亹	yvmg
亼	wgf
亽	wyu
亾	wnv
仈	wwy
仌	wwu
仏	wcy
仐	wfj
仒	wuu
仚	wmj
仛	wtan
仜	wag
仠	wfh
仢	wqyy
仦	wiy
仧	hwu
仩	whg
仭	wvyy
仮	wrcy
仯	witt
仱	wwyn
仴	weg
仸	wtdy
仹	wdhh
仺	wagf
仼	wgg
仾	wgxg
伀	wwcy
伂	wgmh
伃	wcbh
伄	wxhh
伅	wgbn
伆	wqrt
伇	wmcy
伈	wny
伋	weyy
伌	wdbn
伒	wrh
伓	wgiy
伔	wpmn
伕	wfwy
伖	wdcy
伜	wvfh
伝	wfcy
伡	wlh
伣	wmqn
伨	wqug
伩	wyy
伬	wnyy
伭	wyxy
伮	wvcy
伱	wwiy
伳	wann
伵	wlg
伷	wmg
伹	wegg
伻	wguh
伾	wgig
伿	wkwy
佀	whnn
佁	wckg
佂	wghg
佄	wafg
佅	wfiy
佇	wpsh
佈	wdmh
佉	wfcy
佊	whcy
佋	wvkg
佌	whxn
佒	wmdy
佔	whkg
佖	wntt
佡	wwmh
佢	wang
佦	wdg
佨	wqnn
佪	wlkg
佫	wtkg
佭	wtah
佮	wwgk
佱	wfhf
佲	wqkg
併	wuah
佷	wvey
佸	wtdg
佹	wqdb
佺	wwgg
佽	wuqw
侀	wgaj
侁	wtfq
侂	wyta
侅	wynw
來	swwi
侇	wgxw
侊	wiqn
侌	wync
侎	woy
侐	wtlg
侒	wpvg
侓	wvfh
侕	wdmj
侖	wgma
侘	wpta
侙	waag
侚	wqjg
侜	wtey
侞	wvkg
侟	wdhb
価	wsg
侢	wgmf
侤	wftn
侫	wynv
侭	wnyu
侰	wvtk
侱	wkgg
侲	wdfe
侳	wwwf
侴	wgnj
侶	wktk
侷	wnnk
侸	wgku
侹	wtfp
侺	wmwn
侻	wukq
侼	wfpb
侽	wlln
侾	wftb
俀	wevg
俁	wknd
係	wtxi
俆	wwty
俇	wqtg
俈	wtfk
俉	wgkg
俋	wkcn
俌	wgey
俍	wyve
俒	wpfq
俓	wgva
俔	whqn
俕	wpsy
俖	wgik
俙	wqdh
俛	wqkq
俠	wdww
俢	wtet
俤	wuxt
俥	wlh
俧	wfny
俫	wgoy
俬	wtcy
俰	wtkg
俲	wuql
俴	waat
俵	wgey
俶	whic
俷	wecn
俹	wghg
俹	wgfg
俻	wtlg
俼	wyce
俽	wrqw
俿	wham
倀	wdey
倁	wtdk
倂	wtff
倃	wthk
倄	wqde
倅	wywf
倆	wgmy
倇	wpqb
倈	wsww
倉	wyvk
倊	wwcn
個	wldg
倎	wmaw
倐	whto
們	wug
倓	wooy
倕	wtgf
倖	wfuf
倗	weeg
倛	wadw
倝	fjwy
倞	wyiy
倠	wwyg
倢	wgvh
倣	wyty
値	wfhn
倧	wpfi
倫	wwga
倯	wswc
倰	wfwt
倱	wjxx
倲	wgji
倳	wgkh
倴	wdfa
倵	wgah
倶	whgw
倷	wdfi
倸	wesy
倹	wwgw
倻	wbbh
倽	wwfk
倿	wuvg
偀	wamd
偁	wemf
偂	wuej
偄	wdmd
偅	wtgf
偆	wdwj
偉	wnhh
偊	wtky
偋	wnua
偍	wjgh
偐	wute
偑	wmtj
偒	wjgr
偓	wngf
偔	wkkn
偖	wftj
偗	with
偘	wkkk
偙	wuph
偛	wtfv
偝	wuxe
偞	wans
偟	wrgg
偠	wsvg
偡	wadn
偢	wtoy
偣	wujg
偤	wusg
偦	wnhe
偧	wdqq
偨	whxs
偩	wqmy
偪	wgkl
偫	wtff
偭	wdmd
偮	wkbg
偯	wyey
偰	wdhd
偱	wrfh
偲	wlny
偳	wmdj
側	wmjh
偵	whmy
偸	wwgb
偹	whtl
偺	wthj
偼	whvh
偽	wyto
傁	wvhc
傂	wrhm
傃	wgxi
傄	wduh
傆	wdri
傇	wabg
傉	wdff
傊	wkmy
傋	wfjf
傌	wcy
傎	wfhw
傏	wyvk
傐	wymk
傑	wqas
傒	wexd
傓	wynn
傔	wuvo
傕	wpwy
傖	wwyk
傗	wyxl
傘	wwwf
備	wate
傚	wuqt
傛	wpwk
傜	werm
傝	wjng
傞	wuda
傟	wwcn
傠	wyfy
傡	wuug
傢	wpey
傤	wfal
傦	wmeg
傪	wcce
傫	wlxi
傭	wyvh
傮	wgmj
傯	wtln
傰	wmee
傱	wtwh
傳	wgjf
傴	wakk
債	wgmy
傶	wdht
傷	wtjr
傸	wdqq
傹	wujq
傼	wakw
傽	wujh
傾	wxdm
傿	wgho
僀	waqh
僁	wton
僂	wlvg
僃	waqe
僄	wsfi
僅	wakg
僆	wlpy
僇	wnwe
僈	wjlc
僉	wgkw
僊	wsdn
僋	wwym
僌	wlty
働	wtgl
僎	wnnw
僐	wudk
僑	wtdk
僒	wpwk
僓	wkhm
僔	wusf
僕	wogy
僗	wool
僘	wimt
僙	wamw
僛	wadw
僜	wwgu
僝	wnbb
僞	weto
僟	wxxt
僠	wtol
僡	wgjn
僢	weph
僣	wfwj
僤	wkkf
僥	wffq
僨	wfam
僩	wueg
僪	wcbk
僫	wghn
僫	wgfn
僯	woqh
僰	gmiw
僱	wyny
僲	wsqh
僴	wujg
僶	wxg
僶	wmgv
僷	waas
僸	wssi
價	wsmy
僺	wkks
僼	wmau
僽	wton
僾	wept
僿	wpff
儀	wugt
儁	wwym
儂	wmae
儃	wylg
億	wujn
儅	wipl
儈	wwgj
儉	wwgw
儊	wssh
儌	wryt
儍	wqot
儍	wobt
儎	wfal
儏	whqo
儐	wpgm
儑	wjxo
儓	wfkf
儔	wfnf
儕	wyvf
儕	wyjg
儖	wahl
儗	wxth
儘	wvhl
儙	wkhp
儚	walq
儛	wrlh
儜	wpns
儝	woos
儞	wgwq
償	wipm
儠	wvln
儢	whan
儣	wyaw
儤	wjai
儥	wflm
儦	wyno
儧	wfwm
儨	wrrm
儩	wmjr
優	wdet
儫	wype
儬	wgeq
儭	wusq
儮	wdth
儯	wudc
儰	waeo
儱	wued
儲	wyfj
儳	wqky
儴	wyke
儵	whto
儶	wmwk
儷	wgmx
儸	wlxy
儹	wtfm
儺	waky
儻	wipo
儼	wkkt
儽	wlli
儾	wgke
兂	aqv
兇	qbqb
兊	wcqb
兌	wkqb
兎	tkqy
兏	dhqv
児	hjqb
兒	vqb
兓	aqaq
兗	ukqb
兘	fqck
兙	dqfk
兛	dqtf
兝	dqwv
兞	dqtn
兟	tfqq
兠	urxq
兡	dqdj
兣	dqdf
兤	iqyw
兦	tynv
內	mtyi
兩	gmhy
兪	wgeb
兯	ubj
兲	gwu
兺	wvkx
兾	ulaw
兿	urvc
冃	mfd
冄	mfd
円	mhgd
冇	dmb
冊	mak
冋	mkd
冎	mnmb
冏	mwkd
冐	jef
冑	mef
冓	fjgf
冔	jkgf
冘	pqv
冚	pmj
冝	pegf
冞	pou
冟	prxb
冡	pgeu
冡	pfeu
冣	pbcu
冦	pfqc
冧	pssu
冨	pgkl
冩	pvqo
冪	pajh
冫	uyg
冭	duu
冮	uag
冴	uaht
冸	uufh
冹	udcy
冺	unan
冾	uwgk
冿	uvfh
凁	ugki
凂	uqkq
凃	uwty
凅	uldg
凈	uevh
凊	ugeg
凍	ugji
凎	uqg
凐	usfg
凒	umgu
凓	ussy
凔	uwyk
凕	upju
凖	uwyf
凗	umwy
凘	uadr
凙	ulff
凚	ussi
凜	uylt
凞	utao
凟	uflm
凢	tmv
凣	hmv
凥	nmv
処	tmv
凧	mmhk
凨	mfci
凩	msi
凪	mhd
凬	mgjd
凮	mdjd
凱	mgkm
凲	muvo
凴	ucmb
凷	fbk
凾	bkcb
刄	vyi
刅	vwi
刉	tnjh
刋	tdjh
刌	fjh
刏	rnjh
刐	myjh
刓	fqjh
刔	nwjh
刕	vvvb
刜	xjjh
刞	egjh
刟	vkjh
刡	najh
刢	wycj
刣	ckjh
別	kqjh
刦	fcjh
刧	fcvn
刪	majh
刬	gjh
刯	gjgj
刱	fjvw
刲	ffjh
刴	esjh
刵	bjh
刼	fcvy
刾	guwj
剄	gvaj
剅	gkuj
剆	yvcj
則	mjh
剈	kejh
剉	wwfj
剋	dqjk
剎	qsyj
剏	uavy
剒	ajjh
剓	tqtv
剕	djdj
剗	aajh
剘	adwj
剙	uavw
剚	gkvj
剛	mumj
剝	xgij
剟	cccj
剠	yijh
剢	eyjh
剣	wgkj
剤	yjjh
剤	yjfj
剦	djnj
剨	dhdj
剫	yacj
剬	mdmj
剭	ngcj
剮	mnmj
剰	tgaj
剱	wgky
剳	awgj
剴	mgkj
創	wyvj
剶	xejh
剷	uttj
剸	gjhj
剹	nwej
剺	fitv
剻	meej
剼	cccj
剾	akkj
劀	cbtj
劃	vflj
劄	twgj
劅	lqjj
劆	yuvj
劇	haej
劉	qyvj
劊	wglj
劋	kkkj
劌	hdgj
劍	wgkj
劎	wgkv
劏	ipkj
劑	yvuj
劑	yjjh
劒	wgky
劔	wgky
劕	rrmj
劖	qkxj
劗	tfqj
劘	yssj
劙	xejj
劚	nilj
劜	lnn
劤	rln
劥	ymln
劦	lllb
劧	rln
劮	rwln
劯	dln
劰	rln
労	iplb
劵	udlb
劶	rgkl
劷	udln
劸	ffln
効	uqln
劺	crhl
劻	agln
劼	fkln
劽	gqjl
勀	dqln
勁	gval
勂	tfkl
勄	txgl
勅	gkil
勆	yvcl
勈	celn
勊	dqlv
勌	udbl
勍	yiln
勎	fwfl
勏	ukln
勑	swwl
勓	xxrl
勔	dmjl
動	tgjl
勗	jegl
務	cbtl
勚	anml
勛	kmln
勜	wcnl
勝	eudl
勞	oopl
勠	nwel
勡	sfil
勢	fwfl
勣	gmln
勥	xkjl
勦	vjsl
勧	rwyl
勨	qjel
勩	anml
勪	tdkl
勫	toll
勬	udxl
勭	ujfl
勮	hael
勯	ylkl
勱	ajml
勲	tgjo
勳	tgll
勴	hall
勵	dajl
勶	tycl
勷	ykkl
勸	akkl
勻	qfd
勼	qvv
勽	qwi
匁	qtyi
匁	qqi
匂	qxv
匃	qwnv
匄	qynv
匇	qqi
匉	qguh
匊	qoi
匋	qrmk
匌	qwgk
匎	qdjn
匑	qtmx
匒	qawk
匓	qvcc
匔	qtmk
匘	xvtq
匛	aqyi
匜	abv
匞	aad
匟	aymv
匢	aqre
匤	agyi
匥	acak
匧	adww
匨	anhf
匩	abhg
匫	aqrj
匬	awgj
匭	alvv
匯	aiwy
匰	akkf
匱	akhm
匲	adkk
匳	awgw
匴	atha
匵	aflm
匶	aawv
匷	ahhy
匸	agn
匼	awgk
匽	ajvd
區	akkk
卂	nfk
卄	aghh
卆	vfj
卋	faf
卌	glk
卌	fjfh
卍	nhgh
卍	hghn
卐	nghg
卐	ghgn
協	flll
単	ijfj
卙	adwf
卛	xyxf
卝	gjgd
卥	hlry
卨	hmnk
卪	byi
卬	qbh
卭	abh
卲	vkbh
卶	qqbh
卹	tlbh
卻	wwkb
卼	gqqb
卽	rxbh
卾	kkfb
厀	swib
厁	wtub
厃	qdr
厇	dtav
厈	dfk
厊	daht
厎	dqay
厏	dthf
厐	ddxv
厑	dkxv
厒	drmk
厓	dffd
厔	dgcf
厖	ddne
厗	duk
厙	dlk
厛	dkrk
厜	dtgf
厞	ddjd
厠	dmjk
厡	drii
厤	dtti
厧	dfhw
厪	dakg
厫	dgqt
厬	djtk
厭	djed
厯	dssn
厰	dimt
厱	dwgw
厲	dajy
厳	idnt
厴	djel
厵	drii
厷	dcu
厸	ccy
厹	vcu
厺	dcu
厼	ciu
厽	cccu
厾	nfci
叀	gjhc
參	ccce
叄	cccd
叅	cccn
叆	fcec
叇	fcvp
収	nhcy
叏	nhcu
叐	tdcu
叒	cccu
叓	gkhc
叕	cccc
叚	nhfc
叜	pocu
叝	fcbc
叞	nfic
叡	hpgc
叢	oguc
叧	kvb
叴	vkf
叺	ktyy
叾	bkf
叿	kag
吀	ktfh
吂	ynkf
吅	kkg
吇	kbg
吋	kfy
吔	kbn
吘	ktfh
吙	koy
吚	kvtt
吜	knfg
吢	nkf
吤	kwjh
吥	kgiy
吪	kwxn
吰	kdcy
吳	kndu
吶	kmty
吷	knwy
吺	kmcy
吽	krhh
吿	rhkf
呁	kqug
呂	ktkf
呄	edf
呅	kyy
呇	ikf
呉	kngw
呌	kufh
呍	kfcy
呎	knyy
呏	ktah
呑	tdkf
呚	kty
呝	kynn
呞	kngk
呟	kyxy
呠	ksgg
呡	knan
呣	kxgu
呥	kmfg
呧	kqay
呩	kfiy
呪	kkqn
呫	khkg
呬	klg
呭	kann
呮	kkwy
呯	kguh
呰	hxkf
呴	kqkg
呹	krwy
呺	kkgn
呾	kjgg
呿	kfcy
咁	kafg
咃	kwbn
咅	ukf
咇	kntt
咈	kxjh
咉	kmdy
咊	kty
咍	kckg
咑	krsh
咓	kgnn
咗	kdag
咘	kdmh
咜	kpxn
咞	kgah
咟	kdjg
咠	kbf
咡	kbg
咢	kkfn
咥	kgcf
咮	kriy
咰	kqjg
咲	kudy
咵	kdfn
咶	ktdg
咷	kiqn
咹	kpvg
咺	kgjg
咼	mnmk
咾	kftx
哃	kmgk
哅	kqqb
哊	kdeg
哋	kfbn
哖	krhf
哘	ktfh
哛	kxwv
哠	ktfk
員	kmu
哢	kgah
哣	kgku
哤	kdne
哫	kkhy
哬	kwsk
哯	khqn
哰	kprh
哱	kfpb
哴	kyve
哵	kklj
哶	kgjf
哷	kefy
哸	kevg
哹	kebg
哻	kjfh
哾	kukq
唀	kten
唂	kwwk
唃	kqeh
唄	kmy
唅	kwyk
唈	kkcn
唊	kdww
唋	kwty
唌	kthp
唍	kpfq
唎	ktjh
唒	ksgg
唓	klh
唕	krfh
唖	kgkg
唗	kfhy
唘	dckf
唙	kqto
唚	kvpc
唜	gskx
唝	kamy
唞	kruf
唟	fckx
唡	kgmw
唥	kuwc
唦	kiit
唨	kbeg
唩	ktvg
唫	kqg
唭	kadw
唲	kvqn
唴	kudn
唵	kdjn
唶	kajg
唸	kwyn
唹	kywu
唺	kmaw
唻	ksww
唽	ksrh
啀	kdff
啂	kebn
啅	khjh
啇	umdf
啈	kfuf
啋	kesy
啌	kpwa
啍	kybg
啎	tfgk
問	ukd
啑	kgvh
啒	knbm
啓	yntk
啔	ynak
啗	kqvg
啘	kpqb
啙	hxkk
啚	kflk
啛	kgvv
啝	ktkg
啞	kghg
啞	kgfg
啟	ynkt
啠	rrkf
啢	kgmy
啣	krhb
啨	kgeg
啩	kffh
啫	kftj
啯	klgy
啰	klqy
啱	kmdg
啲	krqy
啳	kudb
啴	kujf
啹	kndg
啺	kjgr
啽	kwga
啿	kadn
喅	kjug
喆	fkfk
喌	kkyh
喍	khxs
喎	kmnk
喐	kdeb
喒	kthj
喓	ksvg
喕	kdmd
喖	ksdg
喗	kplh
喚	kqmd
喛	kefc
喞	krxb
喠	ktgf
喡	knhh
喢	ktfv
喣	kqko
喤	krgg
喥	kyac
喦	kkkm
喨	kypm
喩	kwgb
喪	fkke
喫	kdhd
喬	tdkk
喭	kute
單	kkjf
喯	kdfa
喰	kwye
喲	kxqy
喴	kdgt
営	ipkk
喸	gehx
喺	kwti
喼	kqvn
喿	kkks
嗀	fpgc
嗁	krhm
嗂	kerm
嗃	kymk
嗆	kwyk
嗇	fwwk
嗈	kvkc
嗊	kamy
嗋	klle
嗎	kcy
嗏	kaws
嗐	kpdk
嗕	kdff
嗗	kmeg
嗘	kexd
嗙	kupy
嗚	kwno
嗛	kuvo
嗞	kuxx
嗠	ebtk
嗢	kjlg
嗧	lkwa
嗩	kimy
嗭	fhkx
嗮	kjsg
嗰	kwld
嗱	kwgr
嗴	kudc
嗶	kjaf
嗸	gqtk
嗹	klpy
嗺	kmwy
嗻	kyao
嗼	kajd
嗿	kwym
嘂	kknk
嘃	kyvh
嘄	kwvs
嘅	kvcq
嘆	kakw
嘇	kcce
嘊	kmdf
嘋	kftt
嘍	klvg
嘍	kkgv
嘐	knwe
嘑	khah
嘒	kdhv
嘓	klag
嘔	kakk
嘕	kgho
嘖	kgmy
嘗	ipkj
嘙	kihv
嘚	ktjf
嘜	kswt
嘝	kqef
嘠	kdea
嘡	kipf
嘢	kjfb
嘥	kthh
嘦	kwsv
嘨	kvoj
嘩	kagf
嘪	klmy
嘫	kqdo
嘮	kool
嘯	kvhh
嘯	kvfj
嘰	kxxt
嘳	kkhm
嘵	kffq
嘷	kthf
嘸	krlo
嘺	ktdk
嘼	kklk
嘽	kkkf
嘾	ksjh
噀	knnw
噁	kghn
噁	kgfn
噂	kusf
噃	ktol
噄	kdhi
噅	keto
噆	kaqj
噇	kujf
噈	kyin
噉	knbt
噊	kcbk
噋	kybt
噏	kwgn
噐	kkak
噑	krif
噒	koqh
噓	khag
噕	etnk
噖	kggn
噚	kvaf
噛	khob
噝	kxxi
噞	kwgw
噟	ywwk
噠	kfup
噡	kqdy
噣	klqj
噥	kmae
噦	khdt
噧	kajy
噭	kryt
噮	klge
噯	kept
噰	kyxy
噲	kwgj
噳	khad
噴	kfam
噵	uthk
噷	kujw
噸	kgbm
噹	kipl
噺	kusr
噽	fkug
噾	kpwj
噿	knyf
嚀	kpns
嚁	knwy
嚂	kahl
嚃	klip
嚄	kawc
嚇	kfoo
嚈	kdjd
嚉	kogf
嚊	kthj
嚋	kfnf
嚌	kyvf
嚌	kyjg
嚍	kvhl
嚐	kipj
嚑	ktgo
嚒	kysx
嚔	kfph
嚕	kqoj
嚖	kdhn
嚗	kjai
嚘	kdet
嚙	khwb
嚙	khbh
嚚	kkak
嚛	kxrs
嚜	klff
嚝	kyaw
嚞	fkfk
嚟	ktqi
嚠	kqyj
嚡	kaff
嚢	gkhe
嚤	kysr
嚥	kauo
嚦	kdth
嚧	khal
嚨	kued
嚩	kxgf
嚪	kuqv
嚫	kusq
嚬	khim
嚭	fkuk
嚮	xtyk
嚰	kysd
嚱	khaa
嚲	ybkf
嚳	wfqk
嚳	vqqk
嚴	kkdt
嚵	kqky
嚶	kmmv
嚸	klfk
嚹	krmh
嚺	klup
嚻	kkdk
嚽	kgqm
嚾	kaky
嚿	kawv
囀	klgf
囁	kbbb
囂	kkdk
囃	kywy
囄	kyby
囅	kkje
囆	kajj
囇	kgmx
囈	kafc
囉	klxy
囋	ktfm
囌	kaqt
囍	fkuk
囎	kmuj
囏	akfk
囐	khad
囑	knij
囒	kaui
囓	kdhb
囕	kahq
囖	ktly
囘	mnv
囙	lnd
囜	lci
団	lfi
囥	lymv
囦	lii
囧	lwmv
囨	lgii
囩	lfci
囪	tlry
囬	mjdd
囬	ljfd
囮	lwxv
囯	lgd
囲	lfjk
図	luqi
囶	lwfd
囷	lti
囸	lghd
囻	lnav
囼	lckd
圀	lwyv
圁	lyd
圂	lei
圅	cluf
圇	lwga
國	lakg
圌	lmdj
圍	lnhh
圎	lcmi
圏	ludn
圐	llyv
圑	lgef
園	lfky
園	lfke
圓	lkmi
圔	lfcl
圕	lvfj
圖	lkfk
圗	lcfd
團	lgjf
圙	lwdd
圚	lkhm
圛	llff
圝	lxyx
圞	lxys
圠	fnn
圡	fyi
圢	fsh
圤	fhy
圥	fqb
圦	ftyy
圧	dfd
圫	ftan
圱	tdfg
圲	ftfh
圴	fqyy
圵	fhg
圶	dff
圷	fghy
圸	fmh
圼	jff
圽	fqrt
圿	fwjh
坁	fqan
坃	ffqn
坄	fmcy
坅	fwyn
坆	fty
坈	fpmn
坉	fgbn
坋	fwvn
坒	xxff
坓	fjff
坔	iff
坕	rhyf
坖	fqff
坘	fgxg
坙	gvff
坢	fufh
坣	ipff
坥	fegg
坧	fdg
坬	frcy
坮	fckg
坰	fmkg
坱	fmdy
坲	fxjh
坴	fwff
坵	frgg
坸	fqkg
坹	fpwy
坺	fdcy
坽	fwyc
坾	fpsh
坿	fwfy
垀	ftuh
垁	ftdy
垇	fmmg
垈	waff
垉	fqnn
垊	fnan
垍	fthg
垎	ftkg
垏	fvfh
垐	uqwf
垑	fqqy
垔	sff
垕	rgkf
垖	fwnn
垗	fiqn
垘	fwdy
垙	fiqn
垚	ffff
垜	fesy
垝	fqdb
垞	fpta
垟	fudh
垥	fwgk
垨	fpfy
垪	fuah
垬	fawy
垯	fdpy
垰	fhgh
垱	fivg
垳	ftfh
垵	fpvg
垶	fuh
垷	fhqn
垹	fdtb
垺	febg
垻	fmy
垼	tmcf
垽	irff
垾	fjfh
垿	fycb
埀	tguf
埀	tfuf
埁	fmwn
埄	ftdh
埅	byff
埆	fqeh
埇	fceh
埈	fcwt
埉	fdww
埊	miff
埌	fyve
埍	fkeg
埐	fvpc
埑	rrff
埓	fefy
埖	fawx
埗	fhit
埛	fmwk
埜	ssff
埞	fpgh
埡	fghg
埡	fgfg
埢	fudb
埣	fywf
埥	fgeg
埦	fpqb
埧	fhwy
埨	fwga
埩	fqvh
埪	fpwa
埫	fimk
埬	fgji
埮	fooy
埰	fesy
埱	fhic
埲	fdwh
埳	fqvg
埵	ftgf
埶	fwfy
執	fufy
埻	fybg
埼	fdsk
埾	bcff
埿	inxf
堁	fjsy
堃	yyff
堄	fvqn
堅	ahnf
堈	fmum
堉	fyce
堊	ghgf
堊	gfgf
堌	fldg
堎	ffwt
堏	syff
堐	fdff
堒	fjxx
堓	fmdf
堔	fpws
堖	fvtq
堗	fpwd
堘	fudf
堚	fplh
堛	fgkl
堜	fgli
堝	fmnk
堟	fxey
堢	fwks
堣	fjmy
堥	cbtf
堦	fxxr
堧	fdmd
堨	fjqn
堩	fngg
堫	fqbt
堬	fwgj
堭	frgg
堮	fkkn
堯	fffq
報	fufc
堲	vcbf
堳	fnhg
場	fjgr
堶	fdae
堷	fujg
堸	fmtj
堹	ftgf
堺	flwj
堻	ivff
堼	ffff
堽	flgh
堾	fdwj
堿	fdgt
塀	fnua
塁	liff
塂	fawn
塃	fayq
塅	fwdc
塆	fyox
塇	fpgg
塈	vcaf
塉	fiwe
塊	frqc
塋	oopf
塎	fpwk
塏	fmgu
塐	fgxi
塒	fjff
塓	fpju
塕	fwcn
塖	ftux
塗	iwtf
塙	fymk
塚	fpey
塛	fssy
塜	fpge
塜	fpfe
塝	fupy
塟	agqf
塠	fwnp
塡	fxhw
塢	fwno
塣	ikgf
塤	fkmy
塦	blff
塧	fuwl
塨	fawn
塩	ftkl
塪	fevg
塭	fjlg
塮	ftmf
塯	fqyl
塰	itxf
塱	yvcf
塲	ftjr
塳	ftdp
塴	fmee
塵	ynjf
塶	fynx
塷	fhlo
塸	fakk
塹	lrff
塺	yssf
塻	fajd
塼	fgjf
塽	fdqq
塿	flvg
塿	fkgv
墂	fsfi
墄	fdht
墆	faqh
墇	fujh
墈	fadl
墊	fuff
墋	fcce
墌	fyao
墍	rxaf
墎	fybb
墏	nhdf
墐	fakg
墑	fumd
墔	fmwy
墕	fgho
墖	fwgl
増	fulj
墘	ffjn
墛	fnff
墜	buef
墝	fffq
墠	fkkf
墡	fudk
墢	fwxc
墣	fogy
墤	fkhm
墥	fujf
墦	ftol
墧	ftdk
墪	ybtf
墫	fusf
墬	bxef
墭	fdnl
墮	bdaf
墯	ndaf
墰	fsjh
墱	fwgu
墲	frlo
墳	ffam
墴	famw
墵	fffc
墶	ffup
墷	fagf
墸	fafj
墹	fujg
墺	ftmd
墻	ffwk
墽	fryt
墾	eevf
墿	flff
壀	fnku
壂	nawf
壃	fglg
壄	scbf
壆	wfqf
壆	vqqf
壇	fylg
壈	fylt
壉	fhae
壊	ffle
壋	fipl
壌	fufe
壍	ilrf
壎	ftgo
壏	fahl
壐	gwmf
壒	fafl
壓	djef
壔	ffnf
壖	ffdj
壗	fvhl
壘	lllf
壙	fyaw
壚	fhal
壛	fuqv
壜	fjfc
壝	fkhp
壞	fyle
壟	uegf
壠	fued
壡	hpgf
壢	fdth
壣	fbxg
壥	fdlf
壦	faky
壧	fkkt
壨	lllf
壩	ffae
壪	fxyx
壭	fbj
壯	nhdf
壱	fpxb
売	fpqb
壴	fkuf
壵	ffff
壷	fpkg
壸	fpgg
壺	fphg
壺	fpfg
壻	fnhe
壼	fpgg
壽	fnaf
壾	fkun
壿	fusf
夀	fnkf
夁	flld
夃	eci
夅	tahj
夆	tdhj
夈	tou
変	yotu
夊	qyi
夋	cwtu
夌	fwtu
夎	wwft
夐	qmwt
夑	oyot
夒	dhht
夓	vdht
夗	qbn
夘	qbh
夛	vqu
夝	qtgg
夞	qhkx
夠	qqqk
夡	qqfk
夢	alpq
夣	yclq
夦	adwq
夨	gnyi
夬	nwi
夰	djj
夲	dfj
夳	dff
夵	diu
夶	ddy
夻	dkf
夼	dkj
夽	dfcu
夾	dwwi
夿	dcb
奀	gidu
奃	dqay
奅	dqtb
奆	danf
奊	ffgy
奌	hkdu
奍	udjj
奐	qmwd
奒	dynw
奓	dqqu
奙	cdjn
奛	djef
奜	djdd
奝	dmfk
奞	dwyf
奟	deef
奡	dhdj
奣	gdje
奤	ddmd
奦	cbtd
奧	tmtd
奨	uefd
奩	dakk
奪	dwyf
奫	dith
奫	dijg
奬	nhdd
奭	ddjj
奮	dwyl
奯	dhdt
奰	llld
奱	xyxd
奲	dftf
奵	vsh
奷	vtfh
奺	vqyy
奻	vvg
奼	vtan
奾	vmh
奿	vyvd
妀	nvg
妅	vag
妉	vpqn
妋	vfwy
妌	vfjh
妎	vwjh
妏	vyy
妐	vwcy
妑	vcn
妔	vymn
妕	vkhh
妘	vfcy
妚	vgiy
妛	bhgv
妜	vnwy
妝	nhdv
妟	jvf
妠	vmwy
妡	vrh
妢	vwvn
妦	vdhh
妧	vfqn
妬	vdg
妭	vdcy
妰	vthf
妱	vvkg
妳	vqiy
妴	qbvf
妵	vygg
妶	vyxy
妷	vrwy
妸	vskg
妺	vgsy
妼	vntt
妽	vjhh
妿	lkvf
姀	vty
姁	vqkg
姂	vtpy
姃	vghg
姄	vnan
姅	vufh
姇	wfvf
姈	vwyc
姉	vgmh
姌	vmfg
姍	vmah
姎	vmdy
姏	vafg
姕	hxvf
姖	vang
姙	vwtf
姛	vmgk
姞	vfkg
姟	vynw
姠	vtmk
姡	vtdg
姢	vceg
姤	vrgk
姦	vvvf
姧	vvfh
姩	vrhf
姪	vgcf
姫	vahh
姭	lllv
姮	vgjg
姯	viqn
姰	vqjg
姱	vdfn
姲	vpvg
姳	vqkg
姴	gqjv
姵	vmgh
姶	vwgk
姷	vdeg
姸	vftf
姺	vtfq
姼	vqqy
姽	vqdb
姾	vwgg
娀	vadt
娂	vawy
娊	vhqn
娋	vieg
娍	vdnt
娎	rrvf
娏	vdne
娐	vebg
娒	vtxu
娔	vdqn
娕	vgki
娖	vkhy
娗	vtfp
娙	vgva
娚	vlln
娛	vknd
娝	vgik
娞	vevg
娡	vfny
娢	vwyk
娤	nhdv
娦	vrgw
娧	vukq
娨	vjfh
娪	vgkg
娫	vthp
娬	vgah
娭	vctd
娮	vyg
娯	vknw
娰	vwnw
娳	vtjh
娵	vbcy
娷	vtgf
娸	vadw
娹	vxyx
娺	vccc
娻	vgji
娽	vviy
娾	vdff
娿	bskv
婁	lvf
婁	kgkv
婂	vrmh
婃	vpfi
婄	vukg
婅	vqoy
婇	vesy
婈	vfwt
婋	vham
婌	vhic
婍	vdsk
婎	vwyg
婏	vqky
婐	vjsy
婑	vtvg
婒	vooy
婓	djdv
婔	vdjd
婖	vgdn
婗	vvqn
婘	vudb
婙	vqvh
婛	vyiy
婜	ahnv
婝	vpgh
婞	vfuf
婟	vldg
婠	vpnn
婡	vsww
婣	vthh
婣	vjgg
婤	vmfk
婥	vhjh
婦	vvph
婨	vwga
婩	vmdf
婫	vjxx
婬	vetf
婭	vghg
婭	vgfg
婮	vndg
婯	gmyv
婰	vmaw
婱	xyxv
婲	vawx
婳	vglb
婸	vjgr
婹	vsvg
婻	vfmf
婼	vadk
婽	vnhc
婾	vwgb
媀	vjmy
媁	vnhh
媂	vuph
媃	vcbs
媄	vugd
媅	vadn
媆	vdmd
媇	vusy
媈	vplh
媉	vngf
媊	vuej
媋	vdwj
媌	valg
媍	vqmy
媎	vftj
媏	vmdj
媐	ahkv
媑	vtgf
媓	vrgg
媔	vdmd
媕	vwga
媖	vamd
媗	vpgg
媘	vxxr
媙	vdgt
媜	vhmy
媝	tovf
媞	vjgh
媟	vans
媠	vdae
媡	vgli
媢	vjhg
媣	vivs
媤	vlny
媥	vyna
媦	vleg
媧	vmnk
媨	vusg
媩	vdeg
媫	vhvh
媬	vwks
媭	edmv
媮	vwgj
媯	vyto
媰	vqbt
媱	verm
媴	vfke
媶	vabg
媷	vdff
媹	vqyl
媺	vmgt
媻	temv
媼	vlwl
媽	vcy
媿	vrqc
嫀	vdwt
嫃	vfhw
嫄	vdri
嫅	vuda
嫆	vpwk
嫇	vpju
嫈	oopv
嫊	vgxi
嫋	vxuu
嫍	vevg
嫎	vupy
嫏	vyvb
嫐	vllv
嫑	gisv
嫓	vqmx
嫕	vatn
嫗	vakk
嫙	vyth
嫚	vjlc
嫛	atdv
嫝	vyvi
嫞	vyvh
嫟	vaak
嫢	fwhv
嫤	vakg
嫥	vgjf
嫧	vgmy
嫨	vakw
嫪	vnwe
嫬	vyao
嫭	vhah
嫮	vffn
嫯	gqtv
嫰	vgkw
嫲	vyss
嫳	umiv
嫴	vduh
嫵	vrlo
嫶	vwyo
嫷	vbde
嫸	vudk
嫹	vamw
嫺	vueg
嫻	vusy
嫼	vlfo
嫽	vdui
嫾	voqh
嫿	vvfg
嬀	veto
嬁	vwgu
嬂	vuaj
嬃	edmv
嬄	vfpu
嬅	vagf
嬆	vwgn
嬇	vkhm
嬈	vffq
嬊	aukv
嬋	vkkf
嬌	vtdk
嬍	vmgt
嬎	vqkg
嬏	vtol
嬐	vwgw
嬑	vujn
嬒	vwgj
嬓	vryt
嬔	vqkg
嬕	vlff
嬘	vuep
嬙	vfwk
嬚	vyuo
嬛	vlge
嬜	ujqv
嬝	vwve
嬞	vatf
嬟	vugt
嬠	vkks
嬡	vept
嬢	vufe
嬣	vpns
嬤	vysx
嬥	vnwy
嬦	vfnf
嬧	vvhl
嬨	vuxn
嬩	vwfw
嬩	vvgw
嬪	vpgm
嬫	voos
嬬	vfdj
嬭	vgwq
嬮	djev
嬯	vfkf
嬰	mmvf
嬱	ilrv
嬳	vawc
嬵	vxrh
嬶	vthj
嬸	vptl
嬹	vwfw
嬹	vvmw
嬺	vaan
嬻	vflm
嬼	vqyj
嬽	vlhd
嬾	vgkm
嬿	vauo
孁	fkkv
孂	vtvl
孃	vyke
孄	vugi
孅	vwwg
孆	vmmv
孇	vwyc
孈	vmwk
孉	vaky
孊	vysd
孋	vgmx
孌	xyxv
孍	vkkt
孎	vnij
孏	vaui
孒	bgd
孖	bbg
孞	bnu
孠	ngkb
孡	bckg
孧	xlbf
孨	bbbf
孫	btxi
孭	bmy
孮	bpfi
孯	ahnb
孲	bghg
孲	bgfg
孴	bbbj
孶	yxyb
孷	fitb
學	wfqb
學	vqqb
孹	nkub
孻	bvhl
孼	btwb
孾	bmmv
孿	xyxb
宂	pmb
宆	pxb
宊	pdu
宍	puu
宎	ptdu
宐	pqyg
宐	phng
宑	pfjj
宒	ptfn
宔	pygf
宖	pxcu
実	pdwu
宧	pahh
宨	piqb
宩	pou
宬	pdnt
宭	pvtk
宮	pktk
宯	pftb
宱	pwtf
宲	pksu
宷	ptou
宺	pkgq
宻	pcum
宼	pfqv
寀	pesu
寁	pgvh
寃	pqky
寈	pgef
寉	pwyf
寊	phmu
寋	pfjb
寍	pnlf
寎	pnhw
寏	pqmd
寑	pwvc
寔	pjgh
寕	pdls
寖	pivc
寗	pntf
寘	pfhw
寙	prcy
寚	pgrm
寛	pahq
寜	pnlh
寠	plvf
寠	pkgv
寢	pnhc
寣	pnhy
實	pxfm
寧	pnls
審	ptol
寪	peto
寫	pvqo
寬	pahy
寭	pgjn
寯	pwym
寱	pnhs
寲	pxth
寳	pgqm
寴	pusq
寵	pued
寶	pgrm
寷	pdhu
寽	efu
対	yfy
尀	akfy
専	gmfu
尃	gehf
尅	dqfi
將	nhdf
專	gjhf
尋	vakf
尌	fkuf
對	oguf
導	uthf
尐	iyu
尒	wiu
尓	tiu
尗	hiu
尙	imkf
尛	iiiu
尞	duji
尟	jght
尠	adwt
尡	iqjx
尣	wqb
尦	wqqy
尨	dnee
尩	wqgd
尪	dngd
尫	gqgd
尭	faqb
尮	dnes
尯	dnqb
尰	dntf
尲	dnuo
尳	dnme
尵	dnkm
尶	gqal
尷	dnal
屃	nmi
屄	npwi
屆	nfbk
屇	nld
屌	nkmh
屍	ngqx
屒	ndfe
屓	nmi
屔	rgnx
屖	nuk
屗	ntff
屘	ntfb
屚	nfi
屛	ntff
屜	ntan
屝	ndjd
屟	nans
屢	pkgv
屢	nlvd
屢	nkgv
層	nulj
屧	ntas
屨	ntlv
屨	ntkv
屩	nttk
屪	npdi
屫	nnhk
屬	nilj
屭	nmmm
屮	bhk
屰	ubtr
屲	tmj
屳	tymj
屴	mlb
屵	mdr
屶	mvb
屷	men
屸	mag
屻	mvyy
屼	mgqn
屽	mfh
屾	mmh
岀	mmj
岃	mvyu
岄	meg
岅	mrcy
岆	mtdy
岇	mqbj
岉	mqrt
岊	cmj
岋	meyy
岎	mwvn
岏	mfqn
岒	mwyn
岓	mrh
岕	mwjj
岝	mthf
岞	mthf
岟	mmdy
岠	mang
岡	mumk
岤	mpwy
岥	mhcy
岦	muf
岧	mvkf
岨	megg
岪	mxjj
岮	mpxn
岯	mgig
岰	mxln
岲	mkqn
岴	mrgg
岶	mrg
岹	mvkg
岺	mwyc
岻	mqay
岼	mguh
岾	mhkg
峀	mmf
峂	mtuy
峃	ipmj
峅	mcah
峆	mwgk
峇	mwgk
峈	mtkg
峉	mtkf
峊	wnnm
峌	mgcf
峍	mvfh
峎	mveu
峏	mdmj
峐	mynw
峑	mwgf
峓	mgxw
峔	mftx
峕	myjf
峖	mpvg
峗	mqdb
峘	mgjg
峚	mdff
峛	mgqj
峜	mwhf
峝	mmgk
峞	mqdb
峟	mdef
峠	mhgh
峢	mgqj
峣	matq
峧	muqy
峩	mtrt
峫	mahb
峬	mgey
峮	mvtk
峯	mtdh
峱	qtnm
峲	mtjj
峳	mwht
峴	mhqn
峵	mpdc
島	wvgm
峷	muj
峸	mdnt
峹	wtmj
峺	mgjq
峼	mtfk
峽	mdww
峾	irmj
峿	mgkg
崀	myve
崁	mfqw
崄	mwgi
崅	mqeh
崈	pfim
崉	mijg
崊	mssy
崋	mgaf
崌	mndg
崍	msww
崏	mqaj
崐	mjxx
崑	mjxx
崒	mywf
崓	mldg
崕	mdff
崗	mmum
崘	mwga
崙	mwga
崚	mfwt
崜	mtgf
崝	mgeg
崟	mqf
崠	mgji
崡	mbib
崢	mevh
崣	mtvf
崥	mrtf
崨	mgvh
崪	mywf
崫	mnbm
崬	mgji
崯	mqg
崰	mvlg
崱	mmjj
崲	mrgg
崳	mwgj
崵	mjgr
崶	mfff
崷	musg
崸	mdmy
崹	muph
崺	mytb
崻	mtff
崼	mjgh
崿	mkkn
嵀	msyg
嵁	madn
嵂	mtvh
嵃	mute
嵄	mugd
嵅	mdgt
嵆	tdnm
嵈	mefc
嵉	myps
嵍	cbtm
嵎	mjmy
嵏	mqbt
嵐	mmtj
嵑	mjqn
嵒	kkkm
嵓	mkkk
嵔	mlge
嵕	mqbt
嵖	msjg
嵗	mdgt
嵙	mtuf
嵚	mqqw
嵜	musk
嵜	mukh
嵞	wtmm
嵟	mdwy
嵠	mexd
嵡	mwcn
嵢	mwyk
嵣	myvk
嵤	oopm
嵥	mqas
嵦	mmgu
嵧	mqyl
嵨	mwno
嵪	mymk
嵭	mupy
嵮	mfhw
嵰	muvo
嵱	mpwk
嵲	mths
嵳	muda
嵵	mjff
嵶	mxuu
嵷	mtwh
嵸	mtwh
嵹	mxkj
嵺	mnwe
嵻	myvi
嵼	mutg
嵽	maqh
嵾	mcce
嵿	msdm
嶀	mffn
嶁	mlvg
嶁	mkgv
嶃	mlrh
嶄	mlrj
嶅	gqtm
嶆	mgmj
嶇	makk
嶈	mnhf
嶉	mkwy
嶊	mrwy
嶋	mwvo
嶌	mwvo
嶍	mnrg
嶎	mnff
嶏	mdsn
嶐	mbtg
嶑	mqje
嶒	mulj
嶓	mtol
嶔	mqqw
嶕	mwyo
嶖	mwgn
嶗	mool
嶘	msaa
嶚	mdui
嶛	mdui
嶜	maqj
嶞	bdam
嶟	musf
嶠	mtdk
嶡	mduw
嶢	mffq
嶣	mwyo
嶤	mffq
嶥	mduw
嶦	mqdy
嶧	mlff
嶨	wfqm
嶨	vqqm
嶩	mmae
嶪	mogw
嶫	mogw
嶬	mugt
嶭	mwnu
嶮	mwgw
嶯	mkbt
嶰	mqeh
嶱	majn
嶲	mwym
嶳	meff
嶴	tmom
嶵	mldd
嶶	mtmt
嶸	moos
嶹	mfnf
嶺	mwym
嶻	mfay
嶼	mwfw
嶼	mvgw
嶽	mqtd
嶾	mean
嶿	mfdj
巀	miwa
巁	mday
巂	mwyk
巃	mued
巄	mued
巆	mook
巇	mhaa
巈	mafo
巉	mqky
巊	mmmv
巋	mwnh
巌	midt
巎	mdht
巏	maky
巐	myma
巑	mtfm
巒	xyxm
巓	mxhm
巔	mfhm
巕	muwv
巖	mkkt
巗	mkkt
巘	mhad
巙	muht
巚	mhad
巜	bnn
巟	ynqb
巠	gvaf
巣	ijsu
巤	vlqn
巪	annb
巬	amfw
巭	alfw
巰	gvaq
巵	rgcv
巶	vknn
巸	ahkn
巹	bign
巺	nngw
巻	udnb
巼	ckxb
巿	gmhk
帀	gmhk
帄	mhsh
帇	vmhk
帉	mhwv
帊	mhcn
帋	qamh
帍	ynmh
帎	mhpq
帒	wamh
帓	mhgs
帗	mhdc
帞	mhdj
帟	yomh
帠	vmhj
帡	mhua
帢	mhwk
帣	udmh
帤	vkmh
帥	wnnh
帨	mhuq
帩	mhie
帪	mhde
師	wnnh
帬	vtkh
帯	gmph
帯	gkgh
帰	ytvh
帲	mhtf
帳	mhde
帴	mhaa
帵	mhpb
帶	aqph
帹	mhuv
帺	mhaw
帾	mhfj
帿	mhwd
幀	mhhm
幁	mhdm
幃	mhnh
幆	mhjn
幇	fffh
幈	mhna
幉	mhas
幊	mham
幋	temh
幍	mhev
幎	mhpu
幏	mhpe
幐	eudh
幑	tmtt
幒	mhtn
幓	mhce
幖	mhsi
幗	mhlg
幘	mhgm
幙	mhad
幚	dtbh
幜	mhji
幝	mhkf
幟	mhuj
幠	mhro
幣	umih
幤	imkh
幥	mhir
幦	nkuh
幧	mhks
幨	mhqy
幩	mhfm
幪	mhae
幫	fffh
幬	mhff
幭	mhat
幮	mhyf
幯	mhtb
幰	mhpn
幱	mhui
幵	ftfh
幷	tftf
幹	fjwf
幾	xxdt
庁	ysk
庂	ywi
広	yci
庅	ytci
庈	ywyn
庉	ygbn
庌	yaht
庍	yrk
庎	ywjk
庒	yfyi
庘	ylk
庛	yhxv
庝	ytui
庡	yyei
庢	ygcf
庣	yiqv
庤	yffi
庨	yftb
庩	ywti
庪	yrfc
庫	ylk
庬	ydne
庮	ysgd
庯	ygey
庰	yuak
庱	yfwt
庲	ysww
庴	yajd
庺	ywcs
庻	yaww
庼	yxdm
庽	yjmy
庿	yald
廀	ypoc
廁	ymjk
廂	yshd
廃	ywfq
廄	yvcc
廅	yfcl
廆	yrqc
廇	yqyl
廈	ydht
廋	yvhc
廌	ynjo
廍	yukb
廎	yxdm
廏	yrxc
廐	yrxq
廔	ylvd
廔	ykgv
廕	ybwc
廗	yaqh
廘	yynx
廙	ylaw
廚	yfkf
廜	ynfj
廝	yadr
廞	yqqw
廟	yfje
廠	yimt
廡	yrlo
廢	ywxc
廣	yamw
廤	ylkx
廥	ywgj
廦	ynku
廧	yfwk
廩	yylt
廫	yene
廬	yhal
廭	ytgm
廮	ymmv
廯	yqod
廰	ybfn
廱	yvky
廲	ygmx
廳	ybgn
廵	vpv
廸	mpd
廹	rpd
廻	lkpd
廼	spd
廽	mjdp
弅	wvaj
弆	fcaj
弇	wgka
弉	nhda
弌	agd
弍	afd
弎	add
弐	gafd
弒	qsya
弔	xhk
弖	xgf
弙	xgfh
弚	uxhj
弜	xxn
弝	xcn
弞	xqwy
弡	xang
弢	xbhc
弣	xwfy
弤	xqay
弨	xvkg
弫	xahh
弬	xahh
弮	udxb
弰	xieg
弲	xkeg
弳	xgva
弴	xybg
張	xdey
弶	xyiy
強	xcjy
弸	xeeg
弻	xglx
弽	xans
弾	xijf
弿	pfjx
彁	xskk
彂	ogxd
彃	xjaf
彄	xakk
彅	xuev
彆	umix
彇	xvhh
彇	xvfj
彈	xkkf
彉	xamw
彊	xglg
彋	xlge
彌	xgwq
彍	xyaw
彎	xyxx
彏	xhhc
彐	vngg
彑	xgd
彔	xgiu
彙	xgps
彚	vpjs
彛	vowa
彜	xgoa
彞	voxa
彟	vfac
彠	vakc
彣	yee
彥	yder
彧	gkgy
彧	akge
彨	gmye
彫	mfke
彮	pwwe
彯	sfie
彲	gmye
彴	tqyy
彵	tbn
彶	teyy
彸	twcy
彺	tgg
彽	tqay
彾	twyc
彿	txjh
徃	ttgg
徆	tsg
徍	tffg
徎	tkgg
徏	thit
徑	tgva
従	tuhy
徔	tapy
徖	tpfi
徚	tgli
徛	tdsk
徝	tfhg
從	twwh
徟	tmfk
徠	tsww
徢	tgvh
徣	tajg
徤	tvfp
徥	tjgh
徦	tnhc
徧	tyna
復	ttjt
徫	tnhh
徬	tupy
徯	texd
徰	tghh
徱	tsfi
徲	tnih
徳	tfln
徴	tmgt
徶	tumt
徸	tujf
徹	tyct
徺	tffq
徻	twgj
徾	tmyt
徿	tued
忀	tyke
忁	tjbi
忂	thhy
忇	nln
忈	fnu
忊	nsh
忋	nnn
忎	tfnu
忓	nfh
忔	ntnn
忕	ndy
忚	nbn
忛	nmyy
応	yni
忞	ynu
忟	nyy
忢	gnu
忣	neyy
忥	rnnu
忦	nwjh
忨	nfqn
忩	wcnu
忬	ncbh
忯	nqan
忰	nvfh
忲	ndyy
忳	ngbn
忴	nwyn
忶	nfcy
忷	nqbh
忹	ngg
忺	nqwy
忼	nymn
怇	nang
怈	nann
怉	nqnn
怋	nnan
怌	ngig
怐	nqkg
怑	nufh
怓	nvcy
怗	nhkg
怘	dnu
怚	negg
怞	nmg
怟	nqay
怢	nrwy
怣	rwnu
怤	wfnu
怬	nlg
怭	nntt
怮	nxln
怰	nyxy
怱	qryn
怲	ngmw
怳	nkqn
怴	nant
怶	nhcy
怷	fqyn
怸	synu
怹	wbnu
怺	nyni
怽	nfiy
怾	nkwy
恀	nqqy
恄	nfkg
恅	nftx
恆	ngqg
恆	nghg
恇	nagg
恈	ncrh
恉	nxjg
恊	nlll
恌	niqn
恎	ngcf
恏	vbnu
恑	nqdb
恓	nsg
恔	nuqy
恖	tlqn
恗	ndfn
恘	nwsy
恛	nlkg
恜	naag
恞	ngxw
恟	nqqb
恠	ndhf
恡	nqdc
恥	bny
恦	ntmk
恮	nwgg
恱	nwcq
恲	nuah
恴	yjnu
恵	gmnu
恷	wsnu
恾	nayn
悀	nceh
悁	nkeg
悂	nxxf
悅	nwkq
悆	wtnu
悇	nwty
悈	naah
悊	rrnu
悋	nykg
悎	ntfk
悏	ndww
悐	qton
悑	ngey
悓	nhqn
悕	nqdh
悗	nqkq
悘	atdn
悙	nybh
悜	nkgg
悞	nknd
悡	tjnu
悢	nyve
悤	tlqn
悥	ynu
悧	ntjh
悩	niqb
悪	gkjn
悮	nkgd
悰	npfi
悳	fhnn
悵	ndey
悶	uni
悷	nynd
悹	pnhn
悺	npnn
悽	ngvv
悾	npwa
悿	ngdn
惀	nwga
惁	srnu
惂	nqvg
惃	njxx
惄	hicn
惇	nybg
惈	njsy
惉	ihkn
惌	pqbn
惍	nqg
惎	adwn
惏	nssy
惐	nakg
惒	tknu
惓	nudb
惔	nooy
惖	jqrn
惗	nwyn
惙	nccc
惛	nqaj
惞	nrqw
惡	ghgn
惡	gfgn
惢	nnnu
惣	trqn
惤	nxyx
惥	vwnu
惪	fhnu
惱	nvtq
惲	nplh
惵	nans
惷	dwjn
惸	nqjb
惻	nmjh
惼	nyna
惽	nnaj
惾	nqbt
惿	njgh
愂	fpbn
愃	npgg
愄	nlge
愅	nafh
愇	nnhh
愊	ngkl
愋	nefc
愌	nqmd
愐	ndmd
愑	ncel
愒	njqn
愓	njgr
愔	nujg
愖	nadn
愗	cbtn
愘	nptk
愙	ptkn
愛	epnt
愜	nadw
愝	najv
愞	ndmd
愡	nqrn
愢	nlny
愥	namd
愨	fpgn
愩	namy
愪	nkmy
愬	ubtn
愭	nftj
愮	nerm
愯	nwyc
愰	njiq
愱	nutd
愲	nmeg
愳	hhnu
愴	nwyk
愵	nxuu
愶	nlle
愷	nmgu
愸	swwn
愹	npwk
愺	najh
愻	btxn
愼	nxhw
愽	ngef
愾	nrno
慀	nexd
慁	lenu
慂	icen
慃	nwcn
慄	nssy
慅	ncyj
慆	nevg
慇	rvnn
慉	nyxl
態	cexn
慍	nlwl
慏	npju
慐	amnu
慒	ngmj
慓	nsfi
慔	najd
慖	nlag
慗	gkin
慘	ncce
慙	lrnu
慚	nlrh
慛	nmwy
慜	txgn
慞	nujh
慟	ntgl
慠	ngqt
慡	ndqq
慣	nxfm
慤	fpmn
慥	ntfp
慦	fiyn
慩	nlpy
慪	nakk
慫	twwn
慬	nakg
慭	godn
慮	haln
慯	ntjr
慱	ngjf
慲	namy
慳	nahf
慴	nnrg
慶	ynjt
慸	aqpn
慹	fufn
慺	nlvg
慺	nkgv
慻	nudh
慼	dhin
慽	ndht
慾	wwkn
慿	ughn
憀	nnwe
憁	ntln
憂	dept
憃	dwvn
憄	tfhn
憅	tgjn
憆	nipf
憇	tdan
憈	nhag
憉	nfke
憊	watn
憌	qqun
憍	ntdk
憏	nwfi
憐	noqh
憑	ucnu
憒	nkhm
憓	ngjn
憕	nwgu
憖	swwn
憗	swwn
憘	nfkk
憙	fkun
憚	nkkf
憛	nsjh
憜	nbde
憞	nybt
憟	nsoy
憠	dubn
憡	ntgi
憢	nffq
憣	ntol
憤	nfam
憥	oopn
憦	nool
憪	nueg
憫	nuyy
憭	ndui
憮	nrlo
憯	naqj
憰	ncbk
憱	nyin
憲	pgln
憳	nvaf
憴	nxg
憴	nmgv
憵	nkun
憶	nujn
憸	nwgw
憹	nmae
憺	nqdy
憻	nylg
憼	aqkn
憽	naqn
憿	nryt
懀	nwgj
懁	nlge
懃	akgn
懄	nakl
懅	nhae
懆	nkks
懇	eevn
應	ywwn
懌	nlff
懍	nylt
懎	nfwk
懏	nwym
懐	nyle
懓	nept
懕	djen
懖	qtdn
懗	nfoo
懘	iaqn
懙	nwfw
懙	nvgw
懚	nean
懛	nfkf
懜	nalq
懝	nxth
懞	nape
懟	ogun
懠	nyvf
懠	nyjg
懡	nysc
懢	nahl
懣	iamn
懤	nfnf
懥	nfph
懧	npns
懨	ndjd
懩	nude
懪	njai
懫	nrrm
懬	yamn
懭	nyaw
懮	ndet
懯	gehn
懰	nqyj
懱	nalt
懲	tmgn
懳	ndhn
懴	nfag
懶	ngkm
懷	nyle
懸	hitn
懹	nyke
懺	nwwg
懻	nuxw
懼	nhhy
懽	naky
懾	nbbb
戀	xyxn
戁	akfn
戂	nysd
戃	nipo
戄	nhhc
戅	ujan
戇	ujtn
戉	anyt
戉	anty
戓	akd
戔	aar
戙	mgka
戜	akgd
戝	mat
戞	depa
戠	uajd
戣	wgda
戦	ijfa
戧	wyva
戨	sksa
戩	gcca
戫	deag
戭	pgma
戯	haoa
戰	kkja
戱	hana
戲	haga
戵	hhwa
戶	rnd
戸	gnr
戹	ynnv
戺	ynnn
戻	yndi
戼	angn
扂	ynhk
扄	yntk
扅	ynqq
扆	ynye
扊	ynoo
扏	rvn
扐	rln
払	rcy
扖	rtyy
扗	rfg
扙	rdyy
扚	rqyy
扜	rgfh
扝	rfnn
扞	rfh
扟	rnfh
扠	rcyy
扡	rbn
扢	rtnn
扤	rgqn
扥	rtan
扨	rvyy
扱	reyy
扲	rwyn
扴	rwjh
扵	rwuy
扷	rtdy
扸	rthn
扺	rqan
扻	rqwy
扽	rgbn
抁	rcqn
抂	rgg
抃	ryhy
抅	rqcy
抆	ryy
抇	rjg
抈	reg
抋	rny
抌	rpqn
抍	rtah
抎	rfcy
抏	rfqn
抐	rmwy
抔	rgiy
抙	rrh
抜	rdcy
抝	rxnn
択	rnyy
抣	rqug
抦	rgmw
抧	rkwy
抩	rmfg
抪	rdmh
抭	rpmn
抮	rwet
抯	regg
抰	rmdy
抲	rskg
抳	rnxn
抴	rann
抶	rrwy
抷	rgig
抸	rtpy
抺	rfiy
抾	rfcy
拀	rkqn
拁	rlkg
拃	rthf
拋	rdnl
拏	vcrj
拑	rafg
拕	rpxn
拝	rdfh
拞	rrgg
拠	rtmn
拡	rycy
拤	rhhy
拪	rsg
拫	rvey
拰	rwtf
拲	awrj
拵	rdhb
拸	rqqy
拹	rlll
拺	rgmi
拻	rdoy
挀	rrey
挃	rgcf
挄	riqn
挅	resy
挆	rmsy
挊	rhgh
挋	rahh
挌	rtkg
挍	ruqy
挏	rmgk
挐	vkrj
挒	rgqj
挓	rpta
挔	ryey
挕	rbg
挗	rgxw
挘	ritl
挙	iwrj
挜	rgog
挦	rvfy
挧	rng
挩	rwkq
挬	rfpb
挭	rgjq
挮	ruxt
挰	rkgg
挱	riit
挳	rgva
挴	rtxu
挵	rgah
挶	rnnk
挷	rdtb
挸	rhqn
挻	rthp
挼	revg
挾	rdww
挿	rtgh
挿	rtfj
捀	rtdh
捁	rtfk
捄	rfiy
捇	rfoy
捈	rwty
捊	rebg
捑	rjgy
捒	rgki
捓	rahb
捔	rqeh
捖	rpfq
捗	rhit
捘	rcwt
捙	rlh
捚	rjfg
捛	rkkg
捜	rjhc
捝	rukq
捠	rrgw
捤	rntn
捥	rpqb
捦	rqg
捨	rwfk
捪	rqaj
捫	rug
捬	rywf
捯	rgcj
捰	rjsy
捲	rudb
捳	rrgm
捴	rwcn
捵	rmaw
捸	rviy
捹	rdfa
捼	rtvg
捽	rywf
捾	rpnn
捿	rgvv
掁	rdey
掃	rvph
掄	rwga
掅	rgeg
掆	rmum
掋	ryqy
掍	rjxx
掑	radw
掓	rhic
掔	ahnr
掕	rfwt
掗	rghg
掗	rgfg
掙	revh
掚	rgmy
掛	rffh
掜	rvqn
掝	rakg
掞	rooy
掟	rpgh
採	resy
掤	reeg
掦	rjqr
掫	rbcy
掯	rheg
掱	rrrj
掲	rjqx
掵	rwgb
掶	ryvw
掹	rblg
掻	rcjy
掽	ruog
掿	radk
揀	rgli
揁	rhmy
揂	rusg
揃	ruej
揅	dgar
揇	rfmf
揈	rqyg
揊	rgkl
揋	rlge
揌	rlny
揑	rvag
揓	rytb
揔	rqrn
揕	radn
揗	rrfh
揘	rrgg
揙	ryna
揚	rjgr
換	rqmd
揜	rwga
揝	rthj
揟	rnhe
揢	rptk
揤	rvcb
揥	ruph
揦	rgkj
揧	gkir
揨	ryps
揫	torj
揬	rpwd
揮	rplh
揯	rngg
揰	rtgf
揱	iejr
揳	rdhd
揵	rvfp
揷	rtgh
揷	rtfv
揹	ruxe
揺	refb
揻	rdgt
揼	rdiy
揾	rjlg
搃	rukn
搄	rngg
搆	rfjf
搇	rwye
搈	rpwk
搉	rpwy
搊	rqbt
損	rkmy
搎	rbti
搑	rabg
搒	rupy
搕	rfcl
搖	rqrm
搗	rwvm
搘	rftj
搙	rdff
搚	rlle
搝	rthd
搟	rlfh
搢	rgoj
搣	rdgt
搤	ruwl
搥	rwnp
搧	rynn
搨	rjng
搩	rqas
搫	temr
搮	rssy
搯	revg
搰	rmeg
搱	rnuh
搲	rpwy
搳	rpdk
搵	rlwl
搶	rwyk
搷	rfhw
搸	rdwt
搹	rgkh
搻	wgkr
搼	rudr
搾	rpwf
摀	rwno
摂	rbiy
摃	ramy
摉	rpwq
摋	rqsc
摌	rutg
摍	rpwj
摎	rnwe
摏	rdwv
摐	rtwh
摑	rlag
摓	rtdp
摕	raqh
摖	rwfi
摗	rgkw
摙	rlpy
摚	ripf
摛	rybc
摜	rxfm
摝	rynx
摟	rlvg
摟	rkgv
摠	rtln
摡	rvcq
摢	rhah
摣	rhag
摤	rdqq
摥	rtjr
摦	rdfy
摨	rnih
摪	rnhf
摫	rfwq
摬	rujq
摮	gqtr
摯	fufr
摰	fwfr
摱	rjlc
摲	rlrh
摳	rakk
摴	rffn
摵	rdht
摶	rgjf
摷	rvjs
摻	rcce
摼	rahf
摽	rsfi
摾	rxkj
摿	rwuj
撀	fnmr
撁	ryxh
撃	lmcr
撆	umir
撈	rool
撉	ybtr
撊	rueg
撋	rugg
撌	rkhm
撍	raqj
撎	rfpu
撏	rvaf
撐	ript
撓	rffq
撔	rjyi
撗	ramw
撘	rtwk
撚	rqdo
撛	roqh
撜	rwgu
撝	reto
撟	rtdk
撠	rfja
撡	rccn
撢	rsjh
撣	rkkf
撥	rwxc
撦	rdfj
撧	rxqc
撨	rwyo
撪	rcdl
撫	rrlo
撯	rudh
撱	rbde
撲	rogy
撳	rqqw
撴	rybt
撶	ragf
撹	ripq
撻	rfup
撽	rryt
撾	rmnp
撿	rwgw
擁	ryxy
擃	rmae
擄	rhal
擆	rafj
擇	rlff
擈	rogw
擉	rlqj
擊	lbmr
擋	ripl
擌	rtdw
擏	raqt
擑	rkbt
擓	raiy
擔	rqdy
擕	rwym
擖	rajn
擙	rtmd
據	rhae
擛	raas
擜	rfmd
擝	rjel
擟	rgwq
擠	ryvf
擠	ryjg
擡	rfkf
擣	rfnf
擥	ahnr
擧	wfgr
擧	vgnr
擨	rrhw
擩	rfdj
擪	djer
擫	rdjd
擬	rxth
擭	rawc
擮	rfay
擯	rpgm
擰	rpns
擱	rutk
擲	rusb
擳	rtvb
擴	ryaw
擵	rysr
擶	rtuj
擷	rfkm
擸	rvln
擹	rakw
擺	rlcx
擻	rlvt
擻	rkgt
擼	rqoj
擽	rxrs
擾	rdet
擿	rump
攁	rude
攂	rlll
攃	rawi
攄	rhan
攅	rfwm
攆	rfwl
攇	rpdn
攈	rynt
攊	rdth
攋	rgkm
攌	rlle
攍	ryny
攎	rhal
攏	rued
攐	rpfe
攑	rwfh
攑	rvgh
攓	rpfh
攔	rugi
攕	rwwg
攖	rmmv
攗	ryno
攙	rqky
攚	rook
攛	rpwn
攜	rmwk
攝	rbbb
攞	rlxy
攟	rynt
攠	rysd
攡	ryby
攢	rtfm
攣	xyxr
攤	raky
攦	rgmx
攧	rfhm
攨	rpwy
攩	ripo
攪	rwfq
攪	rvqq
攬	rahq
攭	rxej
攰	fclv
攱	ufcy
攲	dskc
攳	fcvf
攷	gnty
攺	nty
攼	fty
攽	wvty
敀	rty
敁	hkhc
敂	qkty
敃	naty
敄	cbtt
敆	wgkc
敇	gmit
敊	hihc
敋	tkty
敍	wthc
敎	qdbt
敐	dfet
敒	wjht
敓	wkqt
敔	gkty
敗	mty
敘	wtty
敚	ukqt
敜	wynt
敟	mawt
敠	cccc
敡	jqrc
敤	jshc
敥	oohc
敧	dskc
敨	ukty
敩	ipbt
敪	ccct
敭	jgqt
敮	tfvc
敯	najc
敱	mgkc
敳	mgkt
敵	umdt
敶	bgjt
數	lvty
數	kgkt
敹	hptt
敺	akkc
敻	qmwt
敼	fkuc
敽	tdkc
敾	udut
敿	tdkt
斀	lqjc
斁	lfut
斂	wgkt
斃	umix
斄	fitw
斅	wfqc
斅	vqqc
斆	wfqt
斆	vqqt
斈	ybf
斉	yjff
斊	ybf
斍	yhqb
斎	yjiu
斎	yjfi
斏	yyve
斒	yyna
斔	yjvw
斕	yugi
斖	ywfg
斖	yvmg
斘	qufh
斚	ccpf
斝	kkpf
斞	vwuf
斠	fjgf
斢	amwf
斣	lqjf
斦	rrh
斨	nhdr
斪	qkrh
斬	lrh
斮	ajrh
斱	ftjr
斲	nngr
斲	anjr
斳	akgr
斴	oqar
斵	qyvr
斶	rlqj
斷	xxgr
斸	nilr
斺	ywjh
斻	ytmn
斾	ytmh
斿	ytbg
旀	yciy
旂	ytrh
旇	ythc
旈	yycq
旉	gehy
旊	ytgn
旍	ytwc
旐	ytiq
旑	ydsk
旓	ytie
旔	yvfp
旕	ywux
旘	yuaj
旙	ytol
旚	ytsi
旛	yttl
旜	ytyg
旝	ytwj
旞	ytup
旟	ytww
旟	ytvw
旡	aqv
旣	rxaq
旤	mnmq
旪	jfh
旫	jvn
旲	jdu
旳	jqyy
旴	jgfh
旵	jmj
旸	jnrt
旹	bhgj
旻	jyu
旼	jyy
旽	jgbn
旾	gbnj
旿	jtfh
昁	jgmh
昄	jrcy
昅	jeyy
昇	jtaj
昈	jynt
昉	jyn
昋	tdjf
昍	jjg
昐	jwvn
昑	jwyn
昒	jqrt
昖	jwcy
昗	juu
昘	jyb
昚	dujf
昛	jang
昜	jgqr
昞	jgmw
昡	jyxy
昢	jbmh
昣	jwet
昤	jwyc
昦	jdjj
昩	jgsy
昪	jcaj
昫	jqkg
昬	najf
昮	jalb
昰	jghf
昲	jxjh
昳	jrwy
昷	jlf
昸	jtuy
昹	jyni
昺	jgmw
昻	jabj
昽	jdxn
昿	jycy
晀	jiqn
時	jffy
晄	jiqn
晅	jgjg
晆	jffg
晇	jdfn
晈	juqy
晉	gccj
晊	jgcf
晍	jmgk
晎	jawy
晐	jynw
晑	jtmk
晘	jjfh
晙	jcwt
晛	jhqn
晜	juxt
晝	vfjg
晞	jqdh
晠	jdnt
晢	rrjf
晣	jrrh
晥	jpfq
晧	jtfk
晩	jqjq
晪	jmaw
晫	jhjh
晬	jywf
晭	jmfk
晱	jooy
晲	jvqn
晳	srjf
晵	yntj
晸	jght
晹	jjqr
晻	jdjn
晼	jpqb
晽	jssy
晿	jjjg
暀	jtyg
暁	jfaq
暃	jdjd
暅	jngg
暆	jytb
暈	jplj
暉	jplh
暊	jdmy
暋	natj
暍	jjqn
暎	jamd
暏	jftj
暐	jnhh
暒	jjtg
暓	cbtj
暔	jfmf
暕	jgli
暘	jjgr
暙	jdwj
暚	jerm
暛	juda
暜	uujf
暞	jths
暟	jmgu
暠	jymk
暡	jwcn
暢	jhjr
暣	jrno
暤	jrdf
暥	jjpv
暦	dssj
暩	jwfi
暪	jamy
暫	lrjf
暬	fwfj
暭	jrif
暯	jajd
暰	jtwh
暱	jaak
暲	jujh
暳	jdhv
暵	jakw
暶	jyth
暷	jgjf
暸	jdui
暺	jkkf
暻	jjyi
暼	umij
暽	joqh
暿	jfkk
曀	jfpu
曁	rxag
曂	jamw
曃	jvip
曄	jagf
曅	jagh
曅	jagf
曆	dttj
曇	jffc
曈	jujf
曉	jffq
曊	jxjm
曋	jsjh
曌	jepa
曍	jthf
曎	jlff
曏	jxtb
曐	jjjg
曑	jjje
曒	jryt
曓	jbmf
曔	jaqt
曕	jqdy
曖	jept
曗	jogw
曘	jfdj
曚	jape
曞	jday
曟	jjje
曠	jyaw
曡	jjjg
曢	jpdi
曣	jauo
曤	jfwy
曥	jhal
曧	jgkj
曨	jued
曪	jlxy
曫	xyxj
曬	jgmx
曭	jipo
曮	jkkt
曯	jnij
曱	jhk
曵	jxyi
曶	qrjf
書	vfjf
曺	gmjf
曺	gjhj
曻	jqah
曽	uljf
朁	aqaj
朂	jblb
會	wglj
朄	jhgi
朅	fcjn
朆	uljr
朇	wglf
朌	ewvn
朎	ewyc
朏	ebmh
朑	muan
朑	eann
朒	emww
朓	eiqn
朖	eyve
朘	ecwt
朙	lwme
朚	ynje
朜	eybg
朞	adwe
朠	eamd
朡	eqbt
朢	ahng
朣	eujf
朤	eeee
朥	muol
朥	eool
朧	eued
朩	sghy
朮	fqyi
朰	snb
朲	swy
朳	swy
朶	esu
朷	svn
朸	sln
朹	svn
朻	snhh
朼	sxn
朾	ssh
朿	gmii
杁	styy
杄	stfh
杅	sgfh
杇	sfnn
杊	skh
杋	smyy
杍	sbg
杒	svyy
杔	stan
杕	sdy
杗	ynsu
杘	nsi
杙	say
杚	stnn
杛	sxn
杝	sbn
杢	saf
杣	smh
杤	sdnn
杦	sqyy
杧	synn
杫	shg
杬	sfqn
杮	sgmh
東	gjii
杴	sqwy
杶	sgbn
杸	smcy
杹	swxn
杺	sny
杻	snfg
杽	srh
枀	wcsu
枂	seg
枃	squg
枅	sgah
枆	stfn
枈	xxsu
枊	sqbh
枌	swvn
枍	swgn
枎	sfwy
枏	smfg
枑	sgxg
枒	saht
枓	sufh
枔	swyn
枖	stdy
枙	sdbn
枛	srhy
枟	sfcy
枠	svfh
枡	stah
枤	sdy
枦	synt
枩	swcu
枬	smyg
枮	shkg
枱	sckg
枲	cksu
枴	skvn
枹	sqnn
枺	sgsy
枻	sann
枼	ansu
枽	fasu
枾	sfjg
枿	sfah
柀	shcy
柂	stbn
柅	snxn
柆	sug
柇	sty
柈	sufh
柉	stpy
柊	stuy
柋	wasu
柌	sngk
柍	smdy
柎	swfy
柕	scbt
柖	svkg
柗	swkg
柛	sjhh
柟	smfg
柡	sfiy
柣	srwy
柤	segg
柦	sjgg
柧	srcy
柨	sdmh
柪	sxln
柫	sxjh
柭	sdcy
柮	sbmh
柲	sntt
柵	smah
柶	slg
柷	skqn
柸	sgig
柹	stnt
柺	skln
査	segf
柼	spwy
柾	sghg
栁	sqbh
栂	sxgu
栃	srdn
栄	ipsu
栆	gkwu
栆	gkhu
栍	stgg
栐	syni
栒	sqjg
栔	dhvs
栕	sahh
栘	sqqy
栙	stah
栚	sudy
栛	slll
栜	sgmi
栞	gdfs
栟	suah
栠	wtfs
栢	sdjg
栣	swtf
栤	suiy
栥	uqws
栦	syth
栧	sjxt
栨	suqw
栫	sdhb
栬	sqcn
栭	sdmj
栮	sbg
栯	sdeg
栰	swat
栱	sawy
栴	stmy
栵	sgqj
栶	sldy
栺	sxjg
栻	saag
栿	swdy
桇	vksu
桋	sgxw
桍	sdfn
桏	sabh
桒	fasu
桖	stlg
桗	sesy
桘	swnn
桙	scrh
桚	svqy
桛	shgh
桜	sivg
桝	sqah
桞	sqbh
桟	sdxy
桟	sdny
桪	svfy
桬	iits
桭	sdfe
桮	sgik
桯	skgg
桰	sqak
桱	sgva
桲	sfpb
桳	scdf
桵	sevg
桸	sqdh
桹	syve
桺	sgan
桻	stdh
桼	swiu
桽	swwf
桾	svtk
桿	sjfh
梀	sgki
梂	sfiy
梄	ssgg
梇	sgah
梈	sybh
梉	snhf
梊	rrsu
梋	skeg
梌	swty
梍	sran
梎	srxn
梐	sxxf
梑	sqto
梒	swyk
梔	srgc
梕	svyn
梖	smy
梘	shqn
梙	skkh
梚	sqkq
梛	svfb
梜	sdww
條	whts
梞	snny
梟	wvgs
梠	skkg
梡	spfq
梣	smwn
梤	smwv
梥	pwcs
梩	sjfg
梪	sgku
梫	svpc
梬	smgn
梮	snnk
梱	slsy
梲	swkq
梴	sthp
梶	sntn
梷	hkcs
梸	stjh
梹	srgw
梺	ssgh
梻	swxj
梼	sdtf
梽	sfny
梾	sgoy
梿	slpy
棁	sukq
棃	tqts
棄	ycgs
棄	ycas
棅	stgi
棆	swga
棇	swcn
棈	sgeg
棊	adws
棌	sesy
棎	spws
棏	sjgf
棐	djds
棑	sdjd
棓	sukg
棔	sqaj
棖	sdey
棗	gmii
棙	synd
棛	syce
棜	sywu
棝	sldg
棞	slty
棟	sgji
棡	smum
棢	smun
棤	sajg
棥	sqqs
棦	sqvh
棧	saat
棨	ynts
棩	sthh
棩	sjgg
棪	sooy
棫	sakg
棬	sudb
棭	sywy
棯	swyn
棲	sgvv
棳	sccc
棴	sebc
棶	ssww
棷	sbcy
棸	bcsu
棻	awvs
棽	sswn
棾	sspm
棿	svqn
椀	spqb
椂	sviy
椃	sham
椄	suvg
椆	smfk
椇	shwy
椈	sqoy
椉	yqas
椊	sywf
椌	spwa
椏	sghg
椏	sgfg
椑	srtf
椓	seyy
椔	svlg
椕	swvs
椖	syny
椗	spgh
椘	sspu
椙	sjjg
椚	sug
椛	sawx
検	swgw
椝	fwms
椞	srsu
椡	sgcj
椢	slgy
椣	smaw
椥	stdk
椦	sudl
椧	swgb
椨	sywf
椩	syvw
椪	suog
椫	sujf
椬	speg
椮	scde
椯	smdj
椱	stjt
椲	snhh
椳	slge
椵	snhc
椶	sqbt
椷	sdgt
椸	sytb
椺	swks
椻	sajv
椼	stih
椾	suej
楀	stky
楁	sptk
楃	sngf
楄	syna
楅	sgkl
楆	ssvg
楇	smnk
楈	snhe
楉	sadk
楊	sjgr
楋	sgkj
楌	sute
楍	skkk
楎	splh
楏	sdff
楐	slwj
楑	swgd
楒	slny
楓	smtj
楕	sdae
楖	svcb
楘	cbts
楙	scbs
楛	sadg
楜	sdeg
楟	syps
楡	swgb
楢	susg
楤	sqrn
楥	sefc
楧	samd
楨	shmy
楩	swgq
楪	sans
楬	sjqn
業	oguw
楯	srfh
楰	svwy
楲	sdgt
楳	safs
楴	suph
極	sbkg
楶	uqws
楺	scbs
楻	srgg
楽	risu
楾	sriy
楿	stjg
榁	spgf
榃	sslf
榅	sjlg
榊	spyh
榋	svvv
榌	snuj
榌	snuh
榎	sdht
榏	suwl
榐	snae
榑	sgef
榒	sxuu
榓	sntl
榖	fptc
榗	sgoj
榙	sawk
榚	sugo
榝	sqsc
榞	sdri
榟	spuh
榠	spju
榡	sgxi
榢	spey
榣	serm
榤	sqas
榥	sjiq
榦	fjws
榩	shay
榪	scy
榬	sfke
榮	oops
榯	sjff
榰	sftj
榲	slwl
榳	sytp
榵	sabg
榶	syvk
榸	sfjf
榹	srhm
榺	euds
榼	sfcl
榽	sexd
榾	smeg
榿	smgu
槀	ymks
槂	sbti
槃	tems
槄	sevg
槅	sgkh
槆	saqj
槇	sxhw
槈	sdff
槉	sutd
構	sfjf
槍	swyk
槏	suvo
槑	ksks
槒	syxl
槓	samy
槕	shjs
槖	fpds
槗	sdkk
様	sugi
槙	sfhw
槚	ssmy
槜	swye
槝	swvm
槞	sujn
槡	sccs
槢	snrg
槣	spdk
槤	slpy
槥	sdhv
槦	syvh
槧	lrsu
槨	sybb
槩	rxas
槪	srxq
槫	sgjf
槬	sdfy
槮	scce
槯	smwy
槰	stdp
槱	ssgo
槳	nhds
槴	sync
槵	skkn
槶	slag
槷	fwfs
槸	sfwy
槹	srif
槺	syvi
槻	sfwq
槼	fwhs
槾	sjlc
樀	sumd
樁	sdwv
樂	xrxs
樃	syve
樄	sbgi
樅	stwh
樆	sybc
樇	swhe
樈	sujq
樉	sdqq
樋	scep
樌	sxfm
樍	sgmy
樎	spwj
樏	slxi
樐	shlo
樑	sivs
樒	spnm
樓	slvg
樓	skgv
樔	svjs
樕	sgkw
樖	wgkk
標	ssfi
樚	synx
樛	snwe
樜	syao
樝	shag
樞	sakk
樠	samy
樢	swvo
樣	sugi
樤	swhs
樥	sath
樦	styg
樧	sqsc
権	srwy
樫	sahf
樬	stln
樭	sadf
樮	ssoy
樮	sgjo
樰	sfvg
樲	safm
樳	svaf
樴	suaj
樶	sjbc
樷	ssbc
樸	sogy
樹	sfkf
樺	sagf
樻	skhm
樼	snbb
樿	skkf
橀	sycl
橁	stqj
橂	susd
橃	swxc
橅	srlo
橆	rlgs
橈	sffq
橉	soqh
橊	sgal
橋	stdk
橌	sueg
橍	sugg
橎	stol
橏	sudk
橑	sdui
橒	sffc
橓	seph
橔	sybt
橕	sipt
橖	sips
橗	saje
橚	svhh
橚	svfj
橜	dubs
橝	ssjh
橞	sgjn
機	sxxt
橠	syqe
橢	sbde
橣	spne
橤	nnns
橦	sujf
橧	sulj
橨	sfam
橩	soof
橪	sqdo
橫	sagw
橬	saqj
橭	sduh
橮	sqym
橯	sool
橰	sthf
橲	sfkk
橳	seul
橴	shxi
橵	saet
橶	sfja
橷	surq
橸	sjjj
橺	sujg
橻	snff
橽	sfup
橾	skks
橿	sglg
檁	sylt
檂	smae
檃	beas
檅	shdt
檆	sook
檇	swyn
檈	slge
檉	sbkg
檊	sfjf
檋	sawl
檌	sldd
檍	sujn
檏	sogw
檒	ssmj
檓	svac
檔	sipl
檕	lbms
檖	suep
檘	snku
檙	shnn
檚	sssh
檛	smnp
檜	swgj
檝	skbt
檞	sqeh
檟	ssmy
檡	slff
檢	swgw
檣	sfwk
檤	sutp
檥	sugt
檦	ssfj
檧	saqn
檨	sugw
檪	sris
檭	sqve
檮	sfnf
檯	sfkf
檰	sxrh
檱	staw
檲	slgf
檳	spgm
檴	sawc
檵	sxxn
檶	sdak
檷	sgwq
檸	spns
檹	sytk
檺	sype
檻	sahl
檼	sean
檽	sfdj
檾	oops
檿	djes
櫀	sadi
櫁	spnj
櫂	snwy
櫃	sakm
櫄	stgo
櫅	syvf
櫅	syjg
櫆	srqf
櫇	shcm
櫈	swgm
櫉	sdff
櫊	sutk
櫋	sthy
櫌	sdet
櫍	srrm
櫎	syaw
櫏	ssdp
櫐	llls
櫑	slll
櫒	sawi
櫓	sqoj
櫔	sday
櫕	sfwm
櫖	shan
櫗	salt
櫘	sdhn
櫙	saak
櫚	sukk
櫛	stvb
櫜	gkhs
櫝	sflm
櫞	sxxe
櫟	sxrs
櫠	sywc
櫡	stfj
櫢	slvt
櫢	skgt
櫣	salp
櫤	stuj
櫥	syff
櫦	synt
櫧	syfj
櫨	shal
櫩	suqv
櫪	sdth
櫫	efts
櫬	susq
櫭	svcg
櫮	sgkk
櫯	sqot
櫰	syle
櫱	btws
櫲	scbe
櫳	sued
櫴	sgkm
櫵	sawo
櫶	spdn
櫷	stxg
櫷	stmg
櫸	swfh
櫸	svgh
櫹	savj
櫹	savh
櫺	sfkk
櫻	smmv
櫼	swwg
櫽	beas
櫾	seri
櫿	sook
欀	syke
欁	smas
欂	saif
欃	sqky
欄	sugi
欅	swfr
欅	svgr
欆	swyc
欇	sbbb
欈	smwk
欉	sogc
權	saky
欋	shhy
欌	sadt
欍	sawv
欎	sqqf
欏	slxy
欐	sgmx
欑	stfm
欒	xyxs
欓	sipo
欔	shhc
欕	skkt
欖	sahq
欗	saui
欘	snij
欙	slli
欚	sxej
欛	sfae
欜	sgke
欝	sqqf
欞	sfkw
欟	sakq
欥	jqwy
欦	wynw
欨	qkqw
欩	vkqw
欪	bmqw
欫	rhqw
欬	yntw
欭	ldqw
欮	ubtw
欯	fkqw
欰	tlqw
欱	wgkw
欳	hmaw
欴	yvcw
欵	xtdw
欶	gkiw
欸	ctdw
欻	ooqw
欼	cccw
欽	qqwy
欿	qvqw
歀	sfiw
歁	adww
歂	mdmw
歄	mnmw
歅	sfqw
歈	wgew
歊	ymkw
歋	rhaw
歍	wngw
歎	akfw
歏	akgw
歐	akkw
歑	hatw
歒	umdw
歓	rwyw
歔	haow
歕	famw
歖	fkuw
歗	vhtw
歗	vfjw
歘	ooow
歚	uduw
歛	wgkw
歜	lqjw
歝	lfuw
歞	jxxw
歟	wfgw
歟	vgnw
歠	cccw
歡	akkw
歨	hhu
歩	hitr
歫	hang
歬	hteu
歭	hffy
歮	hhhf
歯	hobj
歰	vyvh
歱	htgf
歲	hdgt
歳	hdgt
歴	dssh
歵	hgmy
歶	hxjy
歷	dtth
歸	wnnh
歺	hqu
歽	gqrh
歾	gqqr
歿	gqqc
殀	gqtd
殅	gqtg
殈	gqtl
殌	gqga
殎	gqdw
殏	gqfy
殐	gqgi
殑	gqdq
殔	gqvi
殕	gquk
殗	gqdn
殘	gqaa
殙	gqqj
殜	gqas
殝	gqdt
殞	gqkm
殟	gqjl
殠	gqtd
殢	gqah
殣	gqag
殤	gqtr
殥	gqpw
殦	gqwo
殧	gqyn
殨	gqkm
殩	gqho
殫	gqkf
殬	gqlf
殭	gqgg
殮	gqww
殯	gqpm
殰	gqfm
殱	gqfg
殲	gqwg
殶	ygmc
殸	fnmc
殹	atdc
殺	qsmc
殻	fpmc
殼	fpgc
殽	qdec
殾	ftjc
毀	vfmc
毃	ymkc
毄	lkmc
毆	akkc
毇	vomc
毈	qytc
毉	atdw
毊	fnmk
毌	xfk
毎	txfj
毐	fxdr
毑	xgub
毘	lxxb
毚	qkxy
毜	tfni
毝	tfne
毞	xxtn
毟	ittn
毠	lktn
毢	tfns
毣	ntfn
毤	wcqn
毥	tfnj
毦	btfn
毧	tfnd
毨	tfnq
毩	tfno
毬	tfny
毭	gkun
毮	ritn
毰	tfnk
毱	tfno
毲	cccn
毴	tfnd
毶	tfne
毷	jhtn
毸	tfnn
毺	tfnj
毻	daen
毼	jqwn
毾	jntn
毿	cccn
氀	lvtn
氀	kgkn
氁	tfnd
氂	fitn
氃	ujfn
氄	cbtn
氈	ylkn
氉	kkkn
氊	tfng
氋	apgn
氋	apfn
氌	tfnj
氎	llln
氒	qafj
気	rnqu
氜	rnjf
氝	rnmw
氞	rngw
氠	rnjh
氣	rnou
氥	rnsf
氫	rnga
氬	rngg
氭	rngi
氱	rnjr
氳	rnll
氶	bii
氷	yii
氹	nii
氺	ihyy
氻	iln
氼	iwu
氾	ibn
氿	ivn
汃	iwy
汄	iwy
汅	ignn
汈	ingg
汋	iqyy
汌	ikh
汍	ivyy
汎	imyy
汏	idy
汑	itan
汒	iynn
汓	ibg
汖	miu
汘	itfh
汙	igfh
汚	ifnn
汢	ifg
汣	iqyy
汥	ifcy
汦	iqan
汧	igah
汫	ifjh
汬	fjiu
汭	imwy
汮	iqug
汯	idcy
汱	idy
汳	ircy
汵	iwyn
汷	ity
汸	iyn
決	inwy
汻	itfh
汼	irhh
汿	icbh
沀	icbh
沄	ifcy
沇	icqn
沊	pqii
沋	idnn
沍	igxg
沎	iwxn
沑	infg
沒	iqcy
沕	iqrt
沖	ikhh
沗	gdiu
沘	ixxn
沚	ihg
沜	ithn
沝	iiy
沞	igmh
沠	irhy
沢	inyy
沨	imqy
沬	ifiy
沯	idf
沰	idg
沴	iwet
沵	iqiy
沶	ifiy
沷	idcy
沺	ilg
泀	ingk
況	ikqn
泂	imkg
泃	iqkg
泆	irwy
泇	ilkg
泈	ituy
泋	ifah
泍	isgg
泎	ithf
泏	ibmh
泑	ixln
泒	ircy
泘	ituh
泙	iguh
泚	ihxn
泜	iqay
泝	iryy
泟	ighg
泤	inyw
泦	invn
泧	iant
泩	itgg
泬	ipwy
泭	iwfy
泲	itnt
泴	ilf
泹	ijgg
泿	ivey
洀	itey
洂	iyoy
洃	idoy
洅	igmf
洆	ibig
洈	iqdb
洉	irgk
洊	idhb
洍	iahh
洏	idmj
洐	itfh
洑	iwdy
洓	igmi
洔	iffy
洕	iweg
洖	ikgd
洘	iftn
洜	tkiu
洝	ipvg
洟	igxw
洠	icrh
洡	idiy
洢	iwvt
洣	ioy
洤	iwgg
洦	idjg
洨	iuqy
洩	ijxt
洬	imgq
洭	iagg
洯	dhvi
洰	iang
洴	iuah
洶	iqqb
洷	igcf
洸	iiqn
洺	iqkg
洿	idfn
浀	imag
浂	iudy
浄	iqvh
浉	ijgh
浌	iwat
浐	iutt
浕	inyu
浖	iefy
浗	ifiy
浘	intn
浛	iwyk
浝	idne
浟	iwht
浡	ifpb
浢	igku
浤	ipdc
浥	ikcn
浧	ikgg
浨	ipsy
浫	ipwf
浬	ijfg
浭	igjq
浰	itjh
浱	idfe
浲	itdh
浳	iaeg
浵	imye
浶	iprh
浹	idww
浺	inkh
浻	imwk
浽	ievg
浾	ifoy
浿	imy
涀	ihqn
涁	iset
涃	ilsy
涄	imgn
涆	ijfh
涇	igva
涊	ivyn
涋	ipdy
涍	iftb
涏	itfp
涐	itrt
涒	ivtk
涖	iwug
涗	iwkq
涘	ictd
涙	iynd
涚	iukq
涜	ifpq
涢	ikmy
涥	iybh
涬	ifuf
涭	iepc
涰	iccc
涱	idey
涳	ipwa
涴	ipqb
涶	itgf
涷	igji
涹	itvg
涺	indg
涻	iwfk
涼	iyiy
涽	iqaj
涾	iijg
淁	iuvg
淂	ijgf
淃	iudb
淈	inbm
淉	ijsy
淊	iqvg
淍	imfk
淎	idwh
淏	ijgd
淐	ijjg
淒	igvv
淓	iayn
淔	ifhg
淕	ifwf
淗	iqoy
淚	iynd
淛	irmj
淜	ieeg
淟	imaw
淢	iakg
淣	ivqn
淥	ixgi
淧	ipnt
淨	ievh
淩	ifwt
淪	iwga
淭	iyns
淯	iyce
淰	iwyn
淲	iham
淴	iqrn
淵	ithh
淵	ijgg
淶	isww
淸	igmg
淺	iaat
淽	iahg
淾	qiu
淿	irmh
渀	idfa
渁	iiiy
渂	ijyy
渃	iadk
渄	idjd
渆	iuaj
渇	ijqx
済	iyjg
済	iyjf
渉	ihit
渋	ihiy
渏	idsk
渒	irtf
渓	iefw
渕	iudj
渘	icbs
渙	iqmd
減	idgt
渜	idmd
渞	iuth
渟	iyps
渢	imtj
渦	imnk
渧	iuph
渨	ilge
渪	itky
測	imjh
渮	iask
渰	iwga
渱	ijag
渳	ixbg
渵	ialg
渶	iamd
渷	iukq
渹	iqyg
渻	iith
渼	iugd
渽	ifak
渾	iplh
渿	isfi
湀	iwgd
湁	irwk
湂	ikkn
湅	igli
湆	iujg
湇	iueg
湈	iafs
湉	intd
湊	idwd
湋	inhh
湌	iwye
湏	idmy
湐	isrg
湑	inhe
湒	ikbg
湕	ivfp
湗	ifff
湙	iyod
湚	itxn
湜	ijgh
湝	ixxr
湞	ihmy
湠	imdo
湡	ijmy
湢	igkl
湣	inaj
湤	iytb
湥	ipwd
湦	ijtg
湧	icel
湨	ihdy
湩	itgf
湪	ixey
湬	toiu
湭	iusg
湯	ijgr
湰	itgg
湱	idhd
湲	iefc
湳	ifmf
湴	iuog
湵	iugy
湶	iriy
湷	idwj
湸	iypm
湹	idjf
湺	iwks
湻	iyjg
湼	ivag
湽	igvl
満	iamm
溁	iaps
溂	igkj
溄	imth
溇	iovg
溈	iyto
溊	inhc
溋	iecl
溌	iwfq
溍	igoj
溎	isff
溑	iimy
溒	ifke
溓	iuvo
溔	iugo
溕	ipge
準	iwyf
溗	itux
溙	idwi
溚	iawk
溛	ipwy
溝	ifjf
溞	icyj
溠	iuda
溡	ijff
溣	iwwa
溤	icy
溦	imgt
溨	ifas
溩	iwno
溫	ilwl
溬	iudc
溭	ilwt
溮	iwnh
溰	imgu
溳	ikmy
溵	irvc
溸	igxi
溹	ifpi
溼	igxf
溾	irqc
溿	iluf
滀	iyxl
滃	iwcn
滄	iwyk
滅	idgt
滆	igkh
滈	iymk
滉	ijiq
滊	irno
滌	iwhs
滍	ibhj
滎	oopi
滐	iqas
滒	iskk
滖	iyke
滘	ipwk
滙	iawy
滛	ierm
滜	irdf
滝	iujn
滣	idfk
滧	iuqt
滪	icbm
滫	iwhe
滬	iync
滭	ijaf
滮	ihae
滯	iaqh
滰	iujq
滱	ipfc
滲	icce
滳	iumk
滵	ipnm
滶	igqt
滷	ihlo
滸	iytf
滺	iwhn
滻	iutg
滼	issy
滽	iyvh
滾	iuke
滿	iamy
漀	fnmi
漁	iqoy
漃	iphc
漄	imdf
漅	ivjs
漇	ithh
漈	iwfi
漊	ilvg
漊	ikgv
漋	ibtg
漌	iakg
漍	ilag
漎	itwh
漐	fufi
漑	irxq
漒	ixkj
漖	iftt
漗	itln
漘	idfe
漙	igjf
漚	iakk
漛	iudi
漜	issf
漝	inrg
漞	iehq
漟	iipf
漡	itjr
漢	iakw
漣	ilpy
漥	ipwf
漦	fiti
漧	ifjn
漨	itdp
漬	igmy
漮	iyvi
漰	imee
漲	ixde
漴	impi
漵	iwtt
漷	iybb
漸	ilrh
漹	igho
漺	idqq
漻	inwe
漼	imwy
漽	inih
漿	nhdi
潀	ilwy
潀	ilww
潀	ilwu
潁	xidm
潂	imug
潃	itte
潄	igkt
潅	irwy
潈	itle
潉	imjx
潊	iwtc
潌	ipwf
潎	iumt
潏	icbk
潐	iwyo
潑	iwxc
潒	iqje
潓	igjn
潔	idhi
潕	irlo
潖	iggc
潗	iwys
潙	ieto
潚	ivhh
潚	ivfj
潛	iaqj
潝	iwgn
潟	ivqo
潠	innw
潡	iybt
潣	iuyy
潤	iugg
潥	isoy
潧	iulj
潨	itli
潩	ilaw
潪	itdj
潫	iudi
潬	ikkf
潯	ivaf
潰	ikhm
潱	ifpu
潳	infj
潵	iaet
潶	ilfo
潷	itvh
潹	isss
潻	itwi
潽	iuoj
潾	ioqh
潿	ilnh
澀	ivyh
澁	ihhh
澂	imgt
澃	edmi
澅	ivfg
澆	iffq
澇	iool
澊	iusf
澋	ijyi
澏	ikkm
澐	iffc
澑	igal
澒	iadm
澓	ittt
澔	irtk
澕	iagf
澖	iusy
澗	iujg
澘	issj
澙	ivgo
澚	itmn
澛	iqgj
澝	ipne
澞	ihad
澟	iylt
澠	ixg
澠	imgv
澢	iipl
澣	ifjf
澤	ilff
澥	iqeh
澦	icbm
澨	itaw
澩	wfqi
澩	vqqi
澪	ifwc
澫	iajy
澬	iuqm
澭	iyxy
澮	iwgj
澯	ihqo
澰	iwgw
澱	inac
澲	iogw
澴	ilge
澵	iusr
澷	ijly
澸	idgn
澺	iujn
澻	iuep
澼	inku
澽	ihae
澾	ifup
澿	issi
濁	ilqj
濃	imae
濄	imnp
濅	ipvc
濆	ifam
濇	ifwk
濈	ikbt
濊	ihdt
濋	issh
濌	tgjj
濍	iaqn
濎	ihnn
濏	iggt
濐	ijfj
濓	iuto
濔	igwq
濕	ijxo
濖	ilfj
濗	iajh
濘	ipns
濙	iooo
濚	ioos
濛	iape
濜	ivhl
濝	iadi
濟	iyvf
濟	iyjg
濢	inyf
濣	ifjf
濤	ifnf
濥	iqpw
濦	iean
濧	iogf
濨	iuxn
濩	iawc
濪	igec
濫	iahl
濬	ihph
濭	iafl
濰	ixwy
濱	ipgm
濲	ifpc
濳	itfj
濴	iooi
濵	ipnm
濶	iutd
濷	iiay
濸	iawk
濹	ijff
濺	imaa
濻	ibkm
濼	ixrs
濽	ifwm
濾	ihan
濿	iday
瀀	idet
瀁	iude
瀂	iqoj
瀃	imjr
瀄	itvb
瀅	iooy
瀆	iflm
瀇	iyaw
瀈	inpl
瀉	ipvo
瀊	itel
瀋	iptl
瀌	iyno
瀍	iyjf
瀎	ialt
瀏	iqyj
瀐	ifag
瀒	iswk
瀓	itmt
瀔	ifpc
瀕	ihim
瀖	ifwy
瀗	ipdn
瀘	ihal
瀙	iusq
瀜	igkj
瀝	idth
瀞	igeh
瀟	iavj
瀟	iavh
瀠	iooi
瀡	ibdp
瀢	ikhp
瀤	iyle
瀥	inyk
瀦	iefj
瀧	iued
瀨	igkm
瀩	itmm
瀪	txgi
瀫	ifpc
瀬	igkm
瀭	ilwj
瀮	ifss
瀯	iook
瀰	ixgq
瀱	ildj
瀲	iwgt
瀳	iayo
瀴	immv
瀶	iahk
瀷	inlw
瀸	iwwg
瀺	iqky
瀻	ifaw
瀼	iyke
瀽	ipfh
瀾	iugi
瀿	itxi
灀	ifsh
灁	iuri
灂	ielf
灃	idhu
灄	ibbb
灅	illf
灆	iaal
灇	iogc
灈	ihhy
灉	ivky
灊	iaqh
灋	iync
灍	iuuw
灎	imal
灐	iooq
灑	igmx
灒	itfm
灓	xyxi
灔	imac
灕	iyby
灖	iysd
灗	ijyg
灘	iaky
灙	iipo
灚	iwfq
灚	ivqq
灛	iukf
灜	iyny
灝	ijym
灟	inij
灠	iahq
灡	iaui
灢	igke
灣	ixyx
灤	ixys
灥	riri
灦	ijxm
灧	idhc
灨	iujm
灩	idhl
灪	isre
灮	oqb
灱	ovn
灲	ojh
灳	qoi
灴	oag
灷	oaj
灹	otan
灺	obn
灻	fou
災	vou
炁	aqou
炂	owcy
炃	wvou
炄	onfg
炆	oyy
炇	oty
炈	omcy
炋	ogiy
炌	owjh
炍	orcy
炏	ooy
炐	odhh
炑	osy
炓	oufh
炗	aou
炘	orh
炚	joy
炛	owxb
炞	oyhy
炟	ojgg
炠	olh
炡	oghg
炢	osyy
炣	oskg
炤	ovkg
炥	oxjh
炦	odcy
炧	otbn
炨	opxn
炩	owyc
炪	obmh
炰	qnou
炲	ockg
炴	omdy
炵	otuy
炶	ohkg
為	ytno
炾	okqn
炿	otmy
烄	ouqy
烅	otlg
烆	otfh
烇	owgg
烉	qmwo
烋	wsou
烌	owsy
烍	otfq
烎	gaou
烏	wngo
烐	otey
烑	oiqn
烒	oaag
烓	offg
烔	omgk
烕	dgot
烖	faoi
烗	oynw
烚	owgk
烜	ogjg
烝	bigo
烞	oshy
烠	odeg
烡	oawu
烢	opta
烣	odoy
烥	oahh
烪	oudy
烮	gqjo
烰	oebg
烱	omwk
烲	rrou
烳	ogey
烴	ogva
烵	oaqy
烶	otfp
烸	otxu
烺	oyve
烻	othp
烼	oey
烾	ooff
烿	omye
焀	owwk
焁	kqwo
焂	whto
焃	ofoy
焄	vtko
焅	otfk
焆	okeg
焇	oieg
焈	ynno
焋	nhdo
焌	ocwt
焍	ouxt
焎	rrou
焏	bkco
焑	olsy
焒	okkg
焔	oqhj
焗	onnk
焛	uoi
焜	ojxx
焝	oqaj
焞	oybg
焟	oajg
焠	oywf
無	rlgo
焢	opwa
焣	bcou
焤	ywfo
焥	opqb
焧	owcn
焨	ojeg
焩	oeeg
焪	opwx
焫	oamw
焬	ojqr
焭	oopm
焮	orqw
焲	oywy
焳	owyg
焴	oyce
焵	omum
焷	ortf
焸	jjou
焹	omun
焺	ojta
焻	ojjg
焼	ofaq
焽	jeou
焾	owyn
焿	oyvw
煀	onbm
煁	oadn
煂	oafh
煃	odff
煄	otgf
煆	onhc
煇	oplh
煈	omtj
煉	ogli
煋	ojtg
煍	otoy
煏	ogkl
煐	oamd
煑	ftjo
煒	onhh
煓	omdj
煔	oohk
煕	ahho
煖	oefc
煗	odmd
煘	odgt
煙	osfg
煚	jano
煛	hhou
煝	onhg
煟	oleg
煠	oans
煡	ovfp
煢	oopf
煣	ocbs
煥	oqmd
煩	odmy
煪	ousg
煫	ouey
煬	ojgr
煭	vgqo
煯	oxxr
煰	okkk
煱	omnk
煴	ojlg
煵	ofmf
煶	ojgh
煷	oypm
煹	ofjf
煻	oyvk
煼	oqbt
煾	oldn
煿	ogef
熀	ojiq
熁	olle
熂	orno
熃	cbto
熅	olwl
熆	ofcl
熇	oymk
熈	taho
熉	okmy
熋	cexo
熌	ouwy
熍	opkk
熎	oerm
熐	opju
熑	ouvo
熒	oopo
熓	owno
熕	oamy
熖	oevg
熗	owyk
熚	ojaf
熛	osfi
熜	otln
熝	oynx
熞	oahf
熡	olvg
熡	okgv
熢	otdp
熣	omwy
熤	onug
熥	ocep
熦	oiwy
熧	twwo
熩	oync
熪	otqq
熫	oyao
熭	dhdo
熮	onwe
熯	oakw
熰	oakk
熱	fwfo
熲	xodm
熴	omjx
熶	ojbc
熷	oulj
熸	oaqj
熺	ofkk
熻	owgn
熼	olaw
熽	ovhh
熽	ovfj
熾	ouaj
熿	oamw
燀	okkf
燁	oagf
燂	osjh
燄	qvoo
燅	fwfo
燆	otdk
燇	ousf
燈	owgu
燉	oybt
燊	ooos
燋	owyo
燌	ofam
燍	oadr
燏	ocbk
燐	ooqh
燑	oujf
燒	offq
燓	sqqo
燖	ovaf
燗	oueg
燘	ouyy
燙	ijgo
燚	oooo
燛	nhao
燜	ouny
燝	ojyi
燞	wyqo
營	oopk
燡	olff
燢	wfqo
燢	vqqo
燣	oylt
燤	oajy
燦	ohqo
燨	ougt
燩	oryt
燪	oaqn
燫	oyuo
燬	ovac
燭	olqj
燯	ofwc
燰	oept
燱	oujn
燲	ollm
燳	ojvo
燴	owgj
燵	ofup
燶	omae
燷	oyli
燸	ofdj
燺	oyms
燻	otgo
燼	ovhl
燽	ofnf
燾	fnao
燿	onwy
爀	ofoo
爁	oahl
爂	wfmo
爂	vmgo
爃	ooos
爄	oday
爅	olff
爇	afwo
爈	ohan
爉	ovln
爊	oyno
爋	otgo
爌	oyaw
爍	oxrs
爎	opdi
爏	odth
爐	ohal
爑	oawo
爒	qodi
爓	ouqv
爔	ougt
爕	oyoo
爖	oued
爗	ojaf
爘	ohqe
爙	oyke
爚	owga
爛	ougi
爜	oogc
爞	ojjj
爟	oaky
爠	ohhy
爡	oajj
爢	ysso
爣	oipo
爤	oaui
爥	onij
爦	oahq
爧	ofkw
爩	osre
爫	etyt
爭	evhj
爮	rhyn
爯	emff
爲	etno
爳	etnb
爴	laky
爺	wqbb
爼	qqeg
爾	gwmq
牀	nhds
牁	nhdk
牂	nhdd
牃	nhds
牄	nhdk
牅	nhdh
牆	nhdk
牉	thgf
牊	thgk
牋	thga
牎	thgn
牏	thgj
牐	thgv
牑	thga
牓	thgy
牔	thgf
牕	thgn
牗	thgh
牘	thgm
牚	ipkt
牜	trd
牞	trln
牠	trbn
牣	trvy
牤	tryn
牥	tryn
牨	trym
牪	trrh
牫	trat
牬	trtt
牭	trlg
牰	trmg
牱	trsk
牳	trxu
牴	trqy
牶	udrh
牷	trwg
牸	trpb
牻	trde
牼	trga
牽	yxph
犂	tqth
犃	truk
犅	trmm
犆	trfh
犇	rhth
犈	trub
犉	tryb
犌	trnc
犎	fffh
犐	trtf
犑	trhd
犓	trqt
犔	trro
犕	trae
犖	ooph
犗	trpk
犘	yssh
犙	trce
犚	nfih
犛	fith
犜	tryt
犝	truf
犞	trtk
犠	trut
犡	trdy
犢	trfm
犣	trvn
犤	trlx
犥	tryo
犦	trji
犧	trut
犨	wywh
犩	tvrh
犪	trut
犫	wyyh
犮	dcu
犱	qtvy
犲	qtft
犳	qtqy
犵	qttn
犺	qtym
犻	qtgh
犼	qtbn
犽	qtat
犾	qtdy
犿	qtyh
狀	nhdd
狅	qttf
狆	qtkh
狇	qtsy
狉	qtgg
狊	hdu
狋	qtfi
狌	qttg
狏	qttb
狑	qtwc
狓	qthc
狔	qtnx
狕	qtxl
狖	qtpw
狘	qtat
狚	qtjg
狛	qtrg
狜	qtdg
狝	qtqi
狟	qtgg
狢	qttk
狣	qtiq
狤	qtfk
狥	qtqj
狦	qtmj
狧	qttd
狪	qtmk
狫	qtfx
狵	qtde
狶	qtqh
狹	qtdw
狽	qtmy
狾	qtrr
狿	qttp
猀	qtit
猂	qtjf
猃	qtwi
猄	qtyi
猅	qtdd
猆	djdd
猇	qthm
猈	qtrf
猉	qtaw
猋	dddu
猌	swwd
猍	qtsw
猏	qtye
猐	qtun
猑	qtjx
猒	jedy
猔	qtpi
猘	qtrj
猙	qteh
猚	qtwy
猟	qtih
猠	qtmw
猣	qtqt
猤	qtwd
猦	qtmj
猧	qtmk
猨	qtec
猭	qtxe
猯	qtmj
猰	qtdd
猲	qtjn
猳	qtnc
猵	qtya
猶	qtug
猺	qtem
猻	qtbi
猼	qtgf
猽	qtpu
獀	qtvc
獁	qtcy
獂	qtdi
獃	mgkd
獄	qtyd
獅	qtwh
獆	qtrf
獇	qtuc
獈	qtul
獉	qtdt
獊	qtwk
獋	qttf
獌	qtjc
獎	nhdd
獏	qtad
獑	qtlr
獓	qtgt
獔	qtrf
獕	qtmy
獖	qtfm
獘	umid
獙	qtut
獚	qtaw
獛	qtoy
獜	qtoh
獝	qtck
獞	qtuf
獟	qtfq
獡	qtvo
獢	qttk
獣	ilgd
獤	qtyt
獥	qtrt
獦	qtan
獧	qtle
獨	qtlj
獩	qtht
獪	qtwj
獫	qtww
獮	qtgq
獰	qtps
獱	qtpm
獲	qtac
獳	qtfj
獴	qtae
獵	qtvn
獶	qtdt
獷	qtyw
獸	kkld
獹	qthl
獺	qtgm
獻	hagd
獼	qtxq
獽	qtye
獿	qtdt
玀	qtly
玁	qtkt
玂	qtar
玃	qthc
玅	yxit
玆	yxyx
玈	yxte
玊	gyi
玌	gnn
玍	tff
玏	gln
玐	gwy
玒	gag
玓	gqyy
玔	gkh
玕	gfh
玗	ggfh
玘	gnn
玙	ggng
玚	gnrt
玜	gwcy
玝	gtfh
玞	gfwy
玠	gwjh
玡	gaht
玣	gyhy
玤	gdhh
玥	geg
玦	gnwy
玧	gcqn
玨	ggg
玪	gwyn
玬	gmyg
玭	gxxn
玱	gwbn
玴	gann
玵	gafg
玶	gguh
玸	gqnn
玹	gyxy
玼	ghxn
玽	gqkg
玾	glh
玿	gvkg
珁	ggnn
珃	gmfg
珄	gtgg
珅	gjhh
珆	gckg
珇	gegg
珋	gqtb
珌	gntt
珎	gqiy
珒	gvfh
珓	guqy
珔	gdhb
珕	glll
珖	giqn
珗	gtfq
珘	gtey
珚	gldy
珛	gdeg
珜	gudh
珝	gng
珟	gmgq
珡	ggwu
珢	gvey
珣	gqjg
珤	grmh
珦	gtmk
珨	gwgk
珪	gffg
珫	gycq
珬	gdgt
珮	gmgh
珯	gftx
珰	givg
珱	givg
珳	gyet
珴	gtrt
珵	gkgg
珶	guxt
珷	ggah
珸	ggkg
珹	gdnt
珺	gvtk
珻	gtxu
珼	gmy
珽	gtfp
現	ghqn
珿	gkhy
琀	gwyk
琁	gtnh
琂	gyg
琄	gkeg
琇	gten
琈	gebg
琋	gqdh
琌	gmwn
琍	gtjh
琎	gfjp
琑	gieg
琒	gtdh
琓	gpfq
琔	gpgh
琕	grtf
琖	gaat
琗	gywf
琘	gqaj
琙	gakg
琜	gsww
琝	gjyy
琞	jegy
琟	gwyg
琠	gmaw
琡	ghic
琣	gukg
琤	gqvh
琧	ghgy
琧	gfgy
琩	gjjg
琫	gdwh
琭	gviy
琯	gpnn
琱	gmfk
琲	gdjd
琷	gudn
琸	ghjh
琹	ggsu
琺	gifc
琻	gqg
琽	gftj
琾	glwj
琿	gplh
瑀	gtky
瑂	gnhg
瑃	gdwj
瑄	gpgg
瑅	gjgh
瑆	gjtg
瑇	ggxu
瑈	gcbs
瑉	gnaj
瑊	gdgt
瑋	gnhh
瑌	gdmd
瑍	gqmd
瑎	gxxr
瑏	gpwt
瑐	guej
瑑	gxey
瑒	gjgr
瑓	ggli
瑔	griy
瑖	gwdc
瑘	gbbh
瑝	grgg
瑠	gqyl
瑡	gwnh
瑢	gpwk
瑣	gimy
瑤	gqrm
瑥	gjlg
瑦	gwno
瑧	gdwt
瑨	ggoj
瑩	oopy
瑪	gcy
瑫	gevg
瑬	iycy
瑮	gssy
瑯	gyvb
瑱	gfhw
瑲	gwyk
瑳	guda
瑴	fpgc
瑵	gcyj
瑸	gprw
瑹	gawt
瑺	giph
瑻	gxfm
瑼	ggjf
瑽	gtwh
瑿	atdy
璂	gadf
璄	gujq
璅	gvjs
璆	gnwe
璈	ggqt
璉	glpy
璊	gamy
璌	gpgw
璍	gagf
璏	gxgx
璑	grlo
璒	gwgu
璓	gate
璔	gulj
璕	gvaf
璖	gias
璗	ijgy
璘	goqh
璙	gdui
璚	gcbk
璛	gvhh
璛	gvfj
璝	gkhm
璟	gjyi
璠	gtol
璡	gwyp
璢	ggal
璣	gxxt
璤	ggjn
璥	gaqt
璦	gept
璪	gkks
璫	gipl
璬	gryt
璭	gplp
璮	gylg
璯	gwgj
環	glge
璱	gggt
璲	guep
璳	grim
璴	gssh
璵	gwfw
璵	gvgw
璶	gvhl
璷	gget
璸	gpgm
璹	gfnf
璻	gnyf
璼	gahl
璽	gwmy
璾	gyvf
璾	gyjg
璿	ghph
瓀	gfdj
瓁	gawc
瓂	gafl
瓃	glll
瓄	gflm
瓅	gxrs
瓆	grrm
瓇	gdet
瓈	gtqi
瓉	gfwm
瓊	gqmt
瓋	gump
瓌	gyle
瓍	gbdp
瓎	ggkm
瓏	gued
瓐	ghal
瓑	gdth
瓓	gugi
瓔	gmmv
瓕	xgwy
瓖	gyke
瓗	gmwk
瓘	gaky
瓙	gfno
瓚	gtfm
瓛	ghad
瓝	rcyy
瓟	rcyn
瓡	fufy
瓥	rcyj
瓧	gnyf
瓨	agnn
瓩	gnyf
瓪	gnyc
瓫	wvgn
瓬	ygnn
瓭	pqgn
瓰	gnyv
瓱	gnyn
瓲	gnyn
瓳	dgnn
瓵	ckgn
瓸	gnyj
瓹	kegn
瓺	dgnn
瓻	qdmn
瓼	gnyf
瓽	ipkn
瓾	tvgn
甀	tgan
甁	tftn
甂	ynmn
甃	togn
甅	gnyf
甆	uxxn
甇	oopn
甈	thsn
甉	uvon
甊	lvgn
甊	kgkn
甋	umdn
甌	akkn
甎	gjhn
甐	oqan
甒	rlgn
甔	qdwn
甕	yxtn
甖	mmgn
甗	hagn
甛	aftd
甝	hamf
甞	ipkf
甠	jtgg
甡	tgtg
產	ydtg
産	uttg
甤	etgd
甦	gjqg
甧	tgte
甪	tek
甮	qrej
甴	jhk
甶	tld
甹	mgnb
甼	lsj
甽	lkh
甿	lynn
畁	mgjj
畂	lqyy
畃	jhqy
畄	ilf
畆	ylcy
畇	lqug
畉	lfwy
畊	lfjh
畍	lwjh
畐	gklf
畑	olg
畒	ylwy
畓	ilf
畕	llf
畖	lrcy
畗	ylf
畘	lmfg
畝	ylqy
畞	flqy
畟	lwtu
畠	rlf
畡	lynw
畢	jafk
畣	wgkl
畤	lffy
畧	ltkf
畨	olf
畩	lyey
畫	vflg
畬	wtlf
畭	lwty
畮	ltxu
畯	lcwt
異	lawu
畱	gajl
畳	lpeg
畵	vflb
當	ipkl
畷	lccc
畺	glgg
畻	ludf
畼	ljgr
畽	ltgf
畾	lllf
疀	vlgh
疁	lnwe
疂	lipg
疄	loqh
疅	lglg
疇	lfnf
疈	gkll
疉	lllg
疊	lllg
疌	gvhi
疍	nhjg
疎	nhgi
疐	fplh
疒	uygg
疓	uev
疕	uxv
疘	uad
疛	ufi
疜	ughi
疞	ufnv
疢	uoi
疦	unwi
疧	uqav
疨	uaht
疩	uvfk
疪	uxxv
疭	uwwi
疶	uanv
疷	uqay
疺	utpi
疻	ukwi
疿	uxjk
痀	uqkd
痁	uhkd
痆	unxv
痋	uji
痌	umgk
痎	uynw
痏	uded
痐	ulkd
痑	uqqi
痓	ugcf
痗	utxu
痙	ugva
痚	uftb
痜	utmv
痝	udne
痟	uied
痠	ucwt
痡	ugey
痥	uukq
痩	ujhc
痬	ujqr
痭	ueed
痮	udei
痯	upnn
痲	usfq
痳	ussi
痵	utbd
痶	umaw
痷	udjn
痸	urmj
痺	urtf
痻	uqaj
痽	uwyd
痾	ubsk
瘂	ughg
瘂	ugfg
瘄	uajd
瘆	ucde
瘇	utgf
瘈	udhd
瘉	uwgj
瘋	umtj
瘍	ujgr
瘎	uadn
瘏	uftj
瘑	umnk
瘒	uplk
瘓	uqmd
瘔	uadd
瘖	uujd
瘚	uubw
瘜	uthn
瘝	ulii
瘞	udwf
瘡	uwyk
瘣	urqc
瘧	uhag
瘨	ufhw
瘬	uxde
瘭	usfi
瘮	ucce
瘯	uytd
瘱	udwn
瘲	utwh
瘶	ugkw
瘷	ugkt
瘹	uqqy
瘺	unfi
瘻	ulvd
瘻	ukgv
瘽	uakg
癁	uttt
療	udui
癄	uwyo
癅	ugal
癆	uool
癇	uued
癈	uwxc
癉	ukkf
癊	ubwc
癋	ughn
癋	ugfn
癎	uujd
癏	ulge
癐	uwgj
癑	umae
癒	uwgn
癓	utmt
癕	uyxy
癗	ufld
癘	uajy
癙	uvnn
癚	uqdy
癛	uylt
癝	uyli
癟	utha
癠	uyvf
癠	uyjd
癡	uxth
癢	uude
癤	utvb
癥	utmt
癦	ulff
癧	udth
癨	ufwy
癩	ugkm
癪	utgm
癬	uqod
癭	ummv
癮	uben
癰	uvky
癱	uaky
癲	ufhm
癳	ulli
癴	uxyr
癵	uxyw
癶	wnyt
癷	wfj
癹	wmcu
発	wfqb
發	wxmc
癿	rnn
皀	rxb
皁	rfj
皃	rqb
皅	rcn
皉	rhxn
皊	rwyc
皌	rgsy
皍	rxbj
皏	ruah
皐	rifj
皒	rtrt
皔	rjfh
皕	djdj
皗	rmfk
皘	rgeg
皚	rmgu
皛	rrrf
皜	rymk
皝	rgiq
皞	rrdf
皟	rgmy
皠	rmwy
皡	rrif
皢	rffq
皣	ragf
皥	rthf
皦	rryt
皧	rept
皨	rrrf
皩	rgjq
皪	rxrs
皫	ryno
皬	rfwy
皭	relf
皯	hcfh
皰	hcqn
皳	fiyc
皵	ajhc
皶	sjgc
皷	fkuc
皸	plhc
皹	hcpl
皺	qbtc
皻	haec
皼	fpgc
皽	ylkc
皾	flmc
盀	hlf
盁	elf
盃	gilf
盄	xhlf
盇	dylf
盉	tlf
盋	dclf
盌	qblf
盓	igfl
盕	imyl
盙	gehl
盚	fiyl
盜	iqwl
盝	vilf
盞	aalf
盠	xelf
盡	vhgl
盢	ldlf
監	ahnl
盤	teml
盦	wynl
盧	hall
盨	edml
盩	fufl
盪	ijgl
盫	wgkl
盬	ahnl
盭	xful
盰	hfh
盳	hynn
盵	htnn
盶	hfqn
盷	hqug
盺	hrh
盻	hwgn
盽	hdhh
盿	hyy
眀	heg
眂	hqan
眃	hfcy
眅	hrcy
眆	hyn
眊	htfn
県	hniu
眎	hfiy
眏	hmdy
眐	hghg
眑	hxln
眒	hjhh
眓	hant
眔	liu
眕	hwet
眖	hkqn
眗	hqkg
眘	duhf
眛	hfiy
眜	hgsy
眝	hpsh
眞	xhnw
眡	hqay
眣	hrwy
眤	hnxn
眥	hxhf
眧	hvkg
眪	hgmw
眫	hufh
眬	hdxn
眮	hmgk
眰	hgcf
眱	hgxw
眲	hbg
眳	hqkg
眴	hqjg
眹	hudy
眻	hudh
眽	hrey
眾	lwwy
眾	lwww
眾	lwwu
眿	hyni
睂	wwhh
睄	hieg
睅	hjfh
睆	hpfq
睈	hkgg
睉	hwwf
睊	hkeg
睋	htrt
睌	hqkq
睍	hhqn
睎	hqdh
睏	hlsy
睒	hooy
睓	hmaw
睔	hwga
睕	hpqb
睖	hfwt
睗	hjqr
睘	lgke
睙	hynd
睜	hevh
睝	tqth
睞	hsww
睟	hywf
睠	hudb
睤	hlgj
睧	hqaj
睩	hviy
睪	lfuf
睭	hmfk
睮	hwgj
睯	nath
睰	hadk
睱	hnhc
睲	hjtg
睳	hdff
睴	hplh
睵	hfak
睶	hdwj
睷	hvfp
睸	hnhg
睺	hwnd
睻	hpgg
睼	hjgh
瞁	hhdy
瞂	rfhc
瞃	hrfh
瞆	hkhm
瞇	hopy
瞈	hwcn
瞉	fpgc
瞊	hyvk
瞋	hfhw
瞏	lfke
瞐	hhhf
瞓	hykh
瞔	hgmy
瞕	hujh
瞖	atdh
瞗	htvo
瞘	hakk
瞙	hajd
瞚	hpgw
瞛	htwh
瞜	hlvg
瞜	hkgv
瞝	hybc
瞞	hamy
瞡	hfwq
瞣	hkkn
瞤	hugg
瞦	hfkk
瞨	hogy
瞫	hsjh
瞭	hdui
瞮	hyct
瞯	hueg
瞱	hagf
瞲	hcbk
瞴	hrlo
瞶	hkhm
瞷	hujg
瞸	haas
瞹	hept
瞺	hwgj
瞼	hwgw
瞾	hhpa
矀	htmt
矁	hton
矂	hkks
矃	hpns
矄	htgo
矅	hnwy
矆	hawc
矇	hape
矈	hrpy
矉	hpgm
矊	hxrh
矋	hday
矌	hyaw
矎	hqmt
矏	hthy
矐	hfwy
矑	hhal
矒	halh
矓	hued
矔	haky
矕	xyxh
矖	hgmx
矘	hipo
矙	hunt
矚	hnij
矝	cbtc
矞	cbtk
矟	cbte
矠	cbtj
矡	cbtc
矤	xtdy
矦	qdtd
矨	tdtd
矪	tdte
矯	tdtk
矰	tduj
矱	tdac
矲	tdlx
矴	dsh
矵	djh
矷	dbg
矹	dgqn
矺	dtan
矻	dtnn
矼	dag
砃	dmyg
砄	dnwy
砅	diy
砆	dfwy
砇	dyy
砈	ddbn
砊	dymn
砋	dhg
砎	dwjh
砏	dwvn
砐	deyy
砓	dmcy
砕	dvfh
砙	dgnn
砛	dwyn
砞	dgsy
砠	degg
砡	dgyy
砢	dskg
砤	dtbn
砨	dynn
砪	dxgu
砫	dygg
砮	vcdf
砯	dyiy
砱	dwyc
砲	dqnn
砳	ddg
砵	dsgg
砶	drg
砽	deh
砿	dycy
硁	dcag
硂	dwgg
硃	driy
硄	diqn
硆	dwgk
硈	dfkg
硉	dvfh
硊	dqdb
硋	dynw
硍	dvey
硏	dftf
硑	duah
硓	dftx
硔	dawy
硘	dlkg
硙	dmnn
硚	dtdj
硛	dyoy
硜	dgva
硞	dtfk
硟	dthp
硠	dyve
硡	dpdc
硢	dwty
硣	dftb
硤	ddww
硥	ddne
硦	dgah
硧	dceh
硨	dlh
硩	rrdf
硯	dhqn
硰	iitd
硱	dlsy
硲	dwwk
硳	dfoy
硴	dawx
硵	dhlq
硶	dmwn
硸	dmdf
硹	dswc
硺	deyy
硻	ahnd
硽	ddjn
硾	dtgf
硿	dpwa
碀	dqvh
碁	adwd
碂	dpfi
碃	dgeg
碄	dssy
碅	dlty
碆	ihcd
碈	dqaj
碊	daat
碋	dmsk
碏	dajg
碐	dfwt
碒	dqg
碔	dgah
碕	ddsk
碖	dwga
碙	dmum
碝	ddmd
碞	kkkd
碠	dyps
碢	dmnk
碤	damd
碥	dyna
碦	dptk
碨	dlge
碩	ddmy
碪	dadn
碫	dwdc
碬	dnhc
碭	djgr
碮	djgh
碯	dvtq
碵	dhmy
碶	ddhd
碷	drfh
碸	dmtj
確	dpwy
碻	dymk
碼	dcy
碽	damy
碿	dnie
磀	dubp
磂	dqyl
磃	drhm
磄	dyvk
磆	dmeg
磇	dtlx
磈	drqc
磌	dfhw
磍	dpdk
磎	dexd
磏	duvo
磑	dmgu
磒	dkmy
磓	dwnp
磖	dnrg
磗	dgef
磘	derm
磚	dgjf
磛	lrdf
磜	dwfi
磝	dgqt
磞	dmee
磟	dnwe
磠	dhlo
磡	dadl
磢	ddqq
磣	dcce
磤	drvc
磥	dlxi
磦	dsfi
磧	dgmy
磩	ddht
磪	dmwy
磫	dtwh
磭	ddfe
磮	dmwa
磯	dxxt
磰	dudk
磱	dool
磳	dulj
磵	dujg
磶	dvqo
磸	dusd
磹	dsjh
磻	dtol
磼	dwys
磽	dffq
磾	dkkf
磿	dttd
礀	dueg
礂	dfkk
礃	dipr
礄	dtdk
礆	dwgw
礇	dtmd
礈	duep
礉	dryt
礊	lbmd
礋	dlff
礌	dflg
礍	dajn
礎	dssh
礏	dogw
礐	wfqd
礐	vqqd
礑	dipl
礒	dugt
礔	dnku
礕	nkud
礖	dwfw
礖	dvgw
礗	dpgm
礘	djxo
礙	dxth
礚	dafl
礛	dahl
礜	wfgd
礜	vgnd
礝	dfdj
礟	dcqq
礠	duxn
礡	dagf
礢	dude
礣	dalt
礥	dahm
礦	dyaw
礧	dlll
礨	llld
礩	drrm
礪	dday
礫	dxrs
礬	sqqd
礭	dfwy
礮	dcuq
礯	dooi
礰	ddth
礱	uegd
礲	dued
礳	dysd
礵	dfsh
礶	daky
礷	daal
礸	dtfm
礹	dkkt
礽	pyen
礿	pyqy
祂	pybn
祃	pycg
祄	pywj
祅	pytd
祇	pyqa
祊	pyyn
祋	pymc
祌	pykh
祍	pytf
祎	pyfh
祏	pydg
祐	pydk
祑	pyrw
祒	pyvk
祔	pywf
祕	pynt
祘	fifi
祙	pyfi
祡	hxfi
祣	pyte
祤	pyng
祦	pykd
祩	pyri
祪	pyqb
祫	pywk
祬	pygf
祮	pyfk
祰	pytk
祱	pyuq
祲	pyvc
祳	pyde
祴	pyaa
祵	pyls
祶	pyut
祹	pyqm
祻	pyld
祼	pyjs
祽	pyyf
祾	pyft
祿	pyxi
禂	pymk
禃	pyfh
禆	pyrf
禇	pyfj
禈	pypl
禉	pyug
禋	pysf
禌	pyux
禍	pymk
禎	pyhm
禐	pyec
禑	pyjy
禒	pyxe
禓	pyjr
禔	pyjh
禕	pynh
禖	pyas
禗	pyln
禘	pyuh
禙	pyue
禚	pyuo
禛	pyfw
禜	oopi
禝	pylt
禞	pyyk
禟	pyyk
禠	pyrm
禡	pycy
禢	pyjn
禣	pygf
禤	pyln
禥	pyaf
禦	trhi
禨	pyxt
禩	pylw
禪	pykf
禫	pysj
禬	pywj
禭	pyup
禮	pymu
禯	pyme
禰	pygq
禱	pyff
禲	pydy
禴	pywa
禵	pyjm
禶	pytm
禷	pyom
禸	mci
禼	hlqc
禿	tqb
秂	twu
秄	tbg
秅	ttan
秇	tvyy
秈	tmh
秊	ttfj
秌	oty
秎	twvn
秏	ttfn
秐	tfcy
秓	tfcy
秔	tymn
秖	tqan
秗	ttdy
秙	tdg
秚	tufh
秛	thcy
秜	tnxn
秝	tty
秞	tmg
秠	tgig
秡	tdcy
秢	twyc
秥	thkg
秨	tthf
秪	tqay
秬	tang
秮	tckg
秱	tmgk
秲	tffy
秳	ttdg
秴	twgk
秵	tldy
秶	uqwt
秷	tgcf
秹	twtf
秺	tpta
秼	triy
秾	tpey
秿	tgey
稁	yptu
稄	tcwt
稅	twkq
稆	tkkg
稇	tlsy
稈	tjfh
稉	tgjq
稊	tuxt
稌	twty
稏	tghg
稏	tgfg
稐	twga
稑	tfwf
稒	tldg
稓	tajg
稕	tybg
稖	tukg
稘	tadw
稙	tfhg
稛	tlty
稜	tfwt
稝	teeg
稟	ylkt
稡	tywf
稢	takg
稤	tyiy
稥	tojf
稦	tnhh
稧	tdhd
稨	tyna
稩	tleg
稪	ttjt
稫	tgkl
稬	tdmd
稭	txxr
種	ttgf
稯	tqbt
稰	tnhe
稱	temf
稲	tehj
稴	tuvo
稵	tuxx
稶	tgky
稶	take
稸	tyxl
稺	tnuh
稾	ymkt
穀	fpgc
穁	tabg
穂	tgmn
穂	tgjn
穃	tpwk
穄	twfi
穅	tyvi
穇	tcce
穈	ysst
穉	tnih
穊	tvcq
穋	tnwe
穌	qoty
積	tgmy
穎	xtdm
穏	tevn
穐	tqjn
穒	twvo
穓	tlaw
穔	tamw
穕	twys
穖	txxt
穘	tffq
穙	togy
穚	ttdk
穛	twyo
穜	tujf
穝	tjbc
穞	tqgj
穟	tuep
穠	tmae
穡	tfwk
穢	thdt
穣	tufe
穤	tfdj
穥	twfw
穥	tvgw
穦	tpgm
穧	tyvf
穧	tyjg
穨	tmkm
穩	tean
穪	tgwq
穫	tawc
穬	tyaw
穭	tqoj
穮	tyno
穯	tfkk
穱	telf
穲	tgmx
穳	ttfm
穵	pwnb
穻	pwgf
穼	pwsu
穽	pwfj
穾	pwtd
窂	pwrh
窅	pwhf
窇	pwqn
窉	pwgw
窊	pwry
窋	pwbm
窌	pwqb
窎	pwqg
窏	pwif
窐	pwff
窓	pwcn
窔	pwuq
窙	pwfb
窚	pwdt
窛	pwfv
窞	pwqv
窡	pwcc
窢	pwag
窣	pwyf
窤	pwjx
窧	pwhj
窩	pwmk
窪	pwif
窫	pwdd
窮	pwtx
窯	pwuo
窰	pwem
窱	pwws
窲	pwof
窴	pwfw
窵	pwwo
窶	pwlv
窶	pwkv
窷	pwbb
窸	pwtn
窹	pwnk
窺	pwfq
窻	pwtn
窼	pwvs
窽	pwxw
窾	pwfw
竀	pwgq
竁	pwtn
竂	pwdi
竃	pwfn
竄	pwvn
竅	pwrt
竆	pwtk
竇	pwfm
竈	pwfx
竈	pwfv
竉	pwud
竊	pwtc
竌	umn
竍	ufh
竎	uaj
竏	utfh
竐	umcy
竑	udcy
竒	uskf
竒	ukhj
竓	utfn
竔	utah
竕	uwvn
竗	uitt
竘	uqkg
竚	upsh
竛	uwyc
竜	ujnb
竝	uug
竡	udjg
竢	uctd
竤	updc
竧	utmt
竨	uhjh
竩	upeg
竪	ahnu
竫	uqvh
竬	utky
竮	unua
竰	udjf
竱	ugjf
竲	uulj
竳	uwgu
竴	uusf
竵	ugkh
競	ukqq
竷	ujtt
竸	ujqq
竻	tlb
竼	tmyu
竾	tbb
笀	tynb
笁	taf
笂	tvyu
笅	tqqu
笇	tyhu
笉	tquf
笌	taht
笍	tmwu
笎	tfqb
笐	tymb
笒	twyn
笓	txxb
笖	tnyw
笗	ttuu
笘	thkf
笚	tlj
笜	tbmj
笝	tlcu
笟	trcy
笡	tegf
笢	tnab
笣	tqnb
笧	tmmg
笩	twau
笭	twyc
笯	tvcu
笰	txjj
笲	tcaj
笴	tskf
笵	tibb
笶	ttdu
笷	tqtb
笹	tanb
笻	tabj
笽	tlf
笿	ttkf
筀	tfff
筁	tmaf
筂	tibb
筃	tldu
筄	tiqb
筆	tvfh
筈	ttdf
筊	tuqu
筍	tqjf
筎	tvkf
筓	tftf
筕	ttfh
筗	twkh
筙	tdiu
筜	tivf
筞	tpsu
筟	tebf
筡	twtu
筣	ttjj
筤	tyve
筥	tkkf
筦	tpfq
筧	thqb
筨	twyk
筩	tcej
筪	talj
筫	tmu
筬	tdnt
筭	tgaj
筯	tegl
筰	twtf
筳	ttfp
筴	tdww
筶	ttfk
筸	tjfj
筺	tagy
筻	tgjq
筼	tkmu
筽	tkgd
筿	ttsu
箁	tukf
箂	tsww
箃	tbcu
箄	trtf
箆	tmwx
箇	tldf
箈	tick
箉	trkl
箊	tywu
箋	taar
箌	tgcj
箎	tham
箏	tevh
箑	tgvh
箒	tvph
箓	tviu
箖	tssu
箘	tltu
箙	tebc
箚	twgj
箛	tbry
箞	tudb
箟	tjxx
箠	ttgf
箣	tgmj
箤	tywf
箥	tihc
箮	tpgg
箯	twgq
箰	tqjb
箲	titq
箳	tnua
箵	tith
箶	tdef
箷	tytb
箹	txqy
箺	tdwj
箻	ttvh
箼	tngf
箽	ttgf
箾	tiej
箿	tkbf
節	tvcb
篂	tjtg
篃	tnhf
範	tlbb
篅	tmdj
篈	tfff
築	tams
篊	tiaw
篋	tadw
篍	ttou
篎	thit
篏	tafw
篐	tsah
篒	twye
篔	tkmu
篕	tfcl
篖	tyvk
篗	twyc
篘	tqbt
篛	txuu
篜	tbio
篞	tijf
篟	twge
篠	twhs
篢	tamu
篣	tupy
篤	tcu
篧	tpwy
篨	tbwt
篩	twnh
篫	tamr
篬	twyk
篭	tujn
篯	tqgr
篰	tukb
篲	tdhv
篳	tjaf
篴	tepu
篵	ttwh
篶	tgho
篸	tcce
篹	thdb
篺	trrf
篻	tsfi
篽	ttrb
篿	tgjf
簀	tgmu
簁	tthh
簂	tlag
簃	ttqq
簄	tync
簅	tutg
簆	tpfc
簈	tntf
簉	ttfp
簊	tadf
簍	tlvf
簍	tkgv
簎	traj
簐	tlqw
簑	tyke
簒	thdc
簓	tmfe
簔	tyge
簕	tafl
簗	tivs
簘	tvoj
簙	tfgf
簚	tlah
簛	tadr
簜	tijr
簝	tdui
簞	tkkf
簠	tgel
簡	tujf
簢	tuyu
簣	tkhm
簤	tlmu
簥	ttdk
簨	tnnw
簩	tool
簫	tvhh
簫	tvfj
簬	tkhk
簭	tawk
簮	tfwj
簯	tsaw
簰	tthf
簱	tyaw
簲	terf
簳	tfjf
簴	thaw
簵	tltk
簶	tpyi
簷	tqdy
簹	tipl
簺	tpff
簻	tmnp
簼	trff
簽	twgw
簾	tyuo
籂	twyh
籂	twph
籃	tahl
籄	takm
籅	twfw
籅	tvgw
籆	tawc
籇	type
籈	tsfn
籉	tfkf
籊	tnwy
籋	tgwq
籌	tfnf
籎	txth
籏	tytw
籐	teui
籑	thde
籒	trgl
籓	titl
籔	tlvt
籔	tkgt
籕	tsql
籖	tfag
籗	tfwy
籘	teui
籙	tqvi
籚	thal
籛	tqaa
籜	trlf
籝	tyny
籞	ttri
籟	tgkm
籠	tued
籡	trww
籢	twgt
籣	tugi
籤	twwg
籥	twga
籦	tqtf
籧	thap
籨	twgw
籩	tthp
籪	txxr
籫	ttfm
籬	tyby
籭	tgmx
籮	tlxy
籯	tyny
籰	thhc
籱	tfwy
籲	twgm
籵	ofh
籶	omn
籷	otan
籸	onfh
籹	ovg
籺	otnn
籾	ovyy
籿	ofy
粀	odyy
粁	otfh
粂	qyou
粃	oxxn
粄	orcy
粅	oqrt
粆	oitt
粇	oymn
粈	onfg
粊	xxou
粋	ovfh
粌	oxhh
粍	otfn
粎	onyy
粏	odyy
粐	oynt
粓	oafg
粔	oang
粖	ogsy
粙	omg
粚	otbn
粛	vojk
粠	oawy
粡	omgk
粣	ommg
粦	oqah
粧	oyfg
粨	odjg
粩	oftx
粫	odmj
粬	omag
粭	owgk
粯	ohqn
粰	oebg
粴	ojfg
粵	tmtn
粶	oviy
粷	oqoy
粸	oadw
粺	ortf
粻	odey
粿	ojsy
糀	oawx
糂	oadn
糃	ojgr
糄	oyna
糆	odmd
糈	onhe
糉	oqbt
糋	ouej
糎	odjf
糏	onie
糐	ogef
糑	oxuu
糒	oate
糓	fpgc
糔	ocyj
糘	opey
糚	oanf
糛	oipf
糝	occe
糞	olaw
糡	oujq
糢	oajd
糣	oaqj
糤	oaet
糥	odmj
糦	ofkk
糧	ojgf
糩	owgj
糪	nkuo
糫	olge
糬	olfj
糭	oqot
糭	oobt
糮	oahl
糰	olgf
糱	btwo
糲	oday
糳	oguo
糴	tyoy
糵	awno
糶	bmoy
糷	oaui
糹	xnny
糺	xnn
糼	xln
糽	xsh
糾	xnhh
糿	xvn
紀	xnn
紁	xcyy
紂	xfy
紃	xkh
約	xqyy
紅	xag
紆	xgfh
紇	xtnn
紈	xvyy
紉	xvyy
紋	xyy
紌	xdnn
納	xmwy
紎	xdy
紏	xufh
紐	xnfg
紑	xgiy
紒	xwjh
紓	xcbh
純	xgbn
紕	xxxn
紖	xxhh
紗	xitt
紘	xdcy
紙	xqan
級	xeyy
紛	xwvn
紜	xfcy
紝	xtfg
紞	xpqn
紟	xwyn
紡	xyn
紣	xvfh
紤	xrh
紥	rnxi
紦	xcn
紨	xwfy
紩	xrwy
紪	xhxn
紬	xmg
紭	xxcy
紮	snxi
細	xlg
紱	xdcy
紲	xann
紳	xjhh
紴	xhcy
紵	xpsh
紶	xfcy
紷	xwyc
紸	xygg
紹	xvkg
紺	xafg
紻	xmdy
紼	xxjh
紽	xpxn
紾	xwet
紿	xckg
絀	xbmh
絁	xtbn
終	xtuy
絃	xyxy
組	xegg
絅	xmkg
絆	xufh
絇	xqkg
絈	xrg
絉	xsyy
絊	xsgg
絋	xycy
経	xcfg
絍	xwtf
絎	xtfh
絏	xjxt
絏	xjnt
結	xfkg
絑	xriy
絒	xyth
絓	xffg
絔	xdjg
絕	xvcn
絖	xiqn
絗	xlkg
絘	xuqw
絙	xgjg
絚	xgqg
絚	xghg
絛	whti
絜	dhvi
絝	xdfn
絞	xuqy
絟	xwgg
絠	xdeg
絡	xtkg
絢	xqjg
絣	xuah
絤	xsg
絥	xwdy
給	xwgk
絧	xmgk
絨	xadt
絩	xiqn
絪	xldy
絫	ccci
絬	xtdg
絭	udxi
絯	xynw
絰	xgcf
統	xycq
絲	xxiy
絳	xtah
絴	xudh
絵	xwfc
絶	xqcn
絸	xhqn
絹	xkeg
絺	xqdh
絻	xqkq
絼	xeet
絽	xkkg
絾	xdnt
絿	xfiy
綀	xgki
綁	xdtb
綂	xyqn
綃	xieg
綄	xpfq
綅	xvpc
綆	xgjq
綇	xsgg
綈	xuxt
綉	xten
綊	xdww
綋	xpdc
綌	xwwk
綍	xfpb
綎	xtfp
綏	xevg
綐	xukq
綑	xlsy
綒	xebg
經	xgva
綔	dfni
綕	xfny
綖	xthp
綗	xmwk
綘	xtdh
継	xonn
続	xfpq
綛	xvyn
綜	xpfi
綝	xssy
綞	xtgf
綟	xynd
綠	xxgi
綡	xyiy
綢	xmfk
綣	xudb
綤	vkbi
綥	xlgj
綧	xybg
綨	xadw
綩	xpqb
綪	xgeg
綫	xaat
綬	xepc
維	xwyg
綯	xqrm
綰	xpnn
綱	xmum
網	xmun
綳	xeeg
綴	xccc
綵	xesy
綶	xjsy
綷	xywf
綸	xwga
綹	xthk
綺	xdsk
綻	xpgh
綼	xrtf
綽	xhjh
綾	xfwt
綿	xrmh
緀	xgvv
緁	xgvh
緂	xooy
緃	xwwh
緄	xjxx
緅	xbcy
緆	xjqr
緇	xvlg
緈	xfuf
緉	xgmy
緊	ahni
緋	xdjd
緌	xtvg
緍	xqaj
緎	xakg
総	xwcn
緐	txgi
緑	xviy
緒	xftj
緓	xamd
緔	ximk
緕	xyjg
緕	xyjf
緖	xftj
緗	xshg
緘	xdgt
緙	xafh
線	xriy
緛	xdmd
緜	rmhi
緝	xkbg
緞	xwdc
緟	xtgf
締	xuph
緡	xnaj
緢	xalg
緣	xxey
緤	xans
緥	xwks
緦	xlny
緧	xusg
編	xyna
緩	xefc
緪	xngg
緫	xqrn
緬	xdmd
緭	xleg
緮	xtjt
緯	xnhh
緰	xwgj
緱	xwnd
緲	xhit
緳	ydhi
練	xgli
緵	xqbt
緶	xwgq
緷	xplh
緸	xsfg
緹	xjgh
緺	xmnk
緻	xgct
緼	xjlg
緽	xhmy
緾	xdjf
緿	xckn
縀	xnhc
縁	xvey
縂	xukn
縃	xnhe
縄	xjjn
縅	xdgt
縆	xngg
縇	xpgg
縈	oopi
縉	xgoj
縊	xuwl
縋	xwnp
縌	xubp
縍	xupy
縎	xmeg
縏	temi
縐	xqbt
縑	xuvo
縒	xuda
縓	xdri
縔	xccs
縕	xlwl
縖	xpdk
縗	xyke
縘	xexd
縙	xabg
縚	xevg
縛	xgef
縜	xkmy
縝	xfhw
縞	xymk
縟	xdff
縠	fpgc
縡	xpuh
縢	eudi
縣	hiti
縤	xgxi
縥	xdwt
縦	xtuh
縧	xwhs
縨	xjiq
縩	xwfi
縪	xjaf
縫	xtdp
縬	xdht
縭	xybc
縮	xpwj
縯	xpgw
縰	xthh
縱	xtwh
縲	xlxi
縳	xgjf
縴	xyxh
縵	xjlc
縶	fufi
縷	xlvg
縷	xkgv
縸	xajd
縹	xsfi
縺	xlpy
縼	xyth
總	xtln
績	xgmy
縿	xcce
繀	xmwy
繂	xyxf
繃	xmee
繄	atdi
繅	xvjs
繆	xnwe
繈	xxcj
繉	xhiq
繊	xfag
繋	lmci
繌	xtlt
繍	xvoj
繎	xqdo
繏	xnnw
繐	xgjn
繑	xtdk
繒	xulj
繓	xjbc
織	xuaj
繕	xudk
繖	xaet
繗	xoqh
繘	xcbk
繙	xtol
繚	xdui
繛	gxij
繜	xusf
繝	xueg
繞	xffq
繟	xkkf
繠	nnni
繡	xvhh
繡	xvfj
繢	xkhm
繣	xvfg
繤	ahdi
繥	xfkk
繦	xxkj
繧	xffc
繨	xfup
繩	xxg
繩	xmgv
繪	xwgj
繫	lbmi
繬	xfwk
繭	amhj
繮	xglg
繯	xlge
繰	xkks
繱	xaqn
繲	xqeh
繳	xryt
繴	nkui
繵	xylg
繶	xujn
繷	xmae
繸	xuep
繹	xlff
繺	xqvo
繻	xfdj
繼	xxxn
繽	xpgm
繾	xkhp
繿	xahl
纀	xwoy
纁	xtgo
纃	xyvf
纃	xyjg
纄	xatp
纅	xxrs
纆	xlff
纇	oxim
纈	xfkm
纉	xfwm
纊	xyaw
纋	xdet
續	xflm
纍	llli
纎	xfag
纏	xyjf
纐	xuqm
纑	xhal
纒	xyjf
纓	xmmv
纔	xqky
纕	xyke
纖	xwwg
纗	xmwk
纘	xtfm
纙	xlxy
纚	xgmx
纜	xahq
纝	xlli
纞	xxyn
纟	xxxx
纮	xdcy
纴	xtfg
纻	xpgg
纼	xxhh
绖	xgcf
绗	xtfh
绤	xwwk
绬	xamd
绹	xqrm
缊	xjlg
缐	xriy
缞	xyke
缷	rmbh
缹	rmou
缻	rmgn
缼	rmqw
缽	rmsg
缾	rmua
缿	rmrk
罀	rmiq
罁	rmmm
罃	oopm
罆	rmxm
罇	rmuf
罈	rmsj
罉	rmir
罊	lbmm
罋	yxtm
罌	mmrm
罍	lllm
罎	rmjc
罏	rmhl
罒	lhng
罓	mqi
罖	lwyu
罙	pwsu
罛	lrcy
罜	lygf
罝	legf
罞	lcbt
罠	lnab
罣	lfff
罤	luxt
罥	lkef
罦	lebf
罧	lssu
罫	lffh
罬	lccc
罭	lakg
罯	lujf
罰	lyjj
罳	llnu
罵	lcu
罶	lqyl
罷	lcex
罸	lyfu
罺	lvjs
罻	lnff
罼	ljaf
罽	ldoj
罿	lujf
羀	mqql
羂	lxke
羃	lajh
羄	lxhj
羅	lxwy
羆	lceo
羇	lafk
羈	lafc
羉	lxyi
羋	gkgh
羍	dudj
羏	udet
羐	gjgy
羑	ugqy
羒	udwv
羓	udcn
羕	ugyi
羖	udmc
羗	udnc
羘	eudh
羙	ugou
羛	ugxj
羜	udps
羠	udgw
羢	udad
羣	vtkd
羥	udga
羦	udpq
羨	ugiw
義	ugtt
羪	udye
羫	udpa
羬	uddt
羭	udwj
羮	ugoy
羱	uddi
羳	udtl
羴	udud
羵	udfm
羶	udyg
羷	udww
羺	udfj
羻	udyt
羾	nag
翀	nkhh
翂	nwvn
翃	dcng
翄	nfcy
翆	nvfj
翇	ndcu
翈	lng
翉	sgng
翋	nug
翍	nhcy
翏	nwer
翐	nrwy
翑	nqkg
習	nrf
翓	fkng
翖	wgkn
翗	qqng
翙	mqng
翚	nplj
翛	whtn
翜	ndww
翝	pdcn
翞	nyiy
翢	mfkn
翣	nuvf
翤	kman
翧	pgjn
翨	njgh
翪	nqbt
翫	nrfq
翬	nplj
翭	nwnd
翯	nymk
翲	sfin
翴	nlpy
翵	nwvo
翶	rifn
翷	oqan
翸	famn
翹	fffn
翺	thin
翽	hdgn
翾	lgkn
翿	fnan
耂	fte
耇	ftqk
耈	ftxk
耉	fttk
耊	ftgf
耎	dmjd
耏	dmje
耑	mdmj
耓	dish
耖	diit
耚	dihc
耛	dick
耝	dieg
耞	dilk
耟	dian
耠	diwk
耡	diel
耢	dial
耣	diwa
耤	diaj
耫	digm
耬	dilv
耬	dikv
耭	dixt
耮	diol
耯	diac
耰	didt
耲	diye
耴	bnn
耹	bwyn
耺	bfcy
耼	bmfg
耾	bdcy
聀	bat
聁	bwvn
聄	bwet
聅	btdy
聇	bghg
聈	bxln
聉	bbmh
聎	biqn
聏	bdmj
聐	bfkg
聑	bbg
聓	amyb
聕	btfk
聖	bkgf
聗	bdww
聙	bgeg
聛	brtf
聜	bpwa
聝	bakg
聞	ubd
聟	tdkb
聠	buah
聡	bwcn
聢	bpgh
聣	bvqn
聤	byps
聥	btky
聦	bqrn
聧	bwgd
聨	bxxa
聫	bxxd
聬	bwcn
聭	brqc
聮	bxxo
聯	bxxg
聰	btln
聲	fnmb
聳	twwb
聴	bfln
聵	bkhm
聶	bbbf
職	buaj
聸	bqdy
聹	bpns
聺	bpwi
聻	ilrb
聼	nbfn
聽	bgfn
聾	uegb
肁	ynvh
肂	gqvh
肅	vhth
肅	vfjk
肈	ynah
肊	enn
肍	evn
肎	pef
肏	tymw
肐	etnn
肑	eqyy
肒	evyy
肔	ebn
肕	evyy
肗	evg
肙	kef
肞	ecyy
肣	ewyn
肦	muwv
肦	ewvn
肧	egiy
肨	edhh
肬	ednn
肰	edy
肳	eqrt
肵	erh
肶	exxn
肸	ewfh
肹	ewgn
肻	hpef
胅	erwy
胇	exjh
胈	edcy
胉	erg
胊	muqk
胊	eqkg
胋	ehkg
胏	etnt
胐	mubm
胐	ebmh
胑	ekwy
胒	enxn
胓	eguh
胔	hxmw
胕	ewfy
胘	eyxy
胟	exgu
胠	efcy
胢	eskg
胣	etbn
胦	emdy
胮	etah
胵	egcf
胷	qqbe
胹	edmj
胻	etfh
胾	famw
胿	effg
脀	bige
脁	muiq
脁	eiqn
脃	eqcn
脄	edoy
脅	llle
脇	elll
脈	erey
脋	vvve
脌	erhf
脕	eqkq
脗	eqrk
脙	efiy
脛	egva
脜	edhg
脝	eybh
脟	eefy
脠	ethp
脡	etfp
脢	etxu
脣	dfee
脤	edfe
脥	edww
脦	eany
脧	muct
脧	ecwt
脨	egki
脩	whte
脪	eqdh
脫	ewkq
脭	ekgg
脮	eevg
脰	egku
脳	eiqb
脴	egik
脵	ekgd
脷	etjh
脹	edey
脺	eywf
脻	egvh
脼	egmy
脽	ewyg
脿	egey
腀	ewga
腁	etff
腂	ejsy
腃	eudb
腄	etgf
腅	eooy
腇	etvg
腉	evqn
腍	ewyn
腎	ahne
腏	eccc
腒	endg
腖	egji
腗	emgj
腘	elgy
腛	engf
腜	eafs
腝	edmd
腞	exey
腟	epgf
腡	emnk
腢	ejmy
腣	euph
腤	eujg
腦	evtq
腨	emdj
腪	eplh
腫	etgf
腬	ecbs
腯	erfh
腲	elge
腳	ewwb
腵	enhc
腶	ewdc
腷	egkl
腸	ejgr
膁	euvo
膃	elwl
膄	evhc
膅	eyvk
膆	egxi
膇	ewnp
膉	euwl
膋	oope
膌	eiwe
膍	etlx
膎	eexd
膐	ytew
膒	eakk
膓	etjr
膔	eynx
膕	elag
膖	etdp
膗	emwy
膙	exkj
膚	hale
膞	egjf
膟	eyxf
膠	enwe
膡	eudh
膢	elvg
膢	ekgv
膤	efvg
膥	gsdw
膧	muuf
膧	eujf
膩	eafm
膫	edui
膬	etfn
膭	ekhm
膮	effq
膯	ewgu
膰	etol
膱	euaj
膲	ewyo
膴	erlo
膵	eayf
膶	eugg
膷	extb
膸	edap
膹	efam
膼	emnp
膽	eqdy
膾	ewgj
膿	emae
臄	ehae
臅	elqj
臇	ewym
臈	eajn
臉	ewgw
臋	naww
臍	eyvf
臍	eyjg
臎	enyf
臏	epgm
臐	etgo
臑	efdj
臒	eawc
臓	eadt
臔	eahm
臕	eyno
臖	wfme
臖	vmge
臗	epay
臘	evln
臙	eauo
臚	ehal
臛	efwy
臜	etfm
臝	ynky
臞	ehhy
臟	eadt
臠	xyxw
臡	akfw
臢	etfm
臤	ahnc
臥	ahnw
臦	nhah
臨	ahnk
臩	nhaj
臫	thnn
臮	thwy
臮	thww
臮	thwu
臯	thif
臰	thgx
臱	thpy
臲	thsb
臵	gcfk
臶	gcfb
臷	fagf
臸	gcff
臹	gcft
臺	fkpf
臽	qvf
臿	tfvd
舃	vgno
與	wfgw
與	vgnw
興	wfmw
興	vmgw
舉	wfgh
舉	vgnh
舊	awyv
舋	wfmg
舋	vmgg
舎	wfkf
舏	tdnh
舑	tdmf
舓	tdjr
舕	tdoo
舖	wfky
舗	wfky
舘	wfkn
舙	tdtd
舚	tdqy
舝	nhvh
舠	tevn
舡	teag
舤	temy
舥	tecn
舦	tedy
舧	tety
舩	tewc
舮	teyn
舲	tewc
舺	telh
舼	teaw
舽	teth
舿	tedn
艀	teeb
艁	tetk
艂	teth
艃	tejf
艅	tewt
艆	teye
艈	teyq
艊	terh
艌	tewn
艍	tend
艎	terg
艐	teqt
艑	teya
艒	tejh
艓	teas
艔	teyc
艕	teuy
艖	teua
艗	teul
艙	tewk
艛	telv
艛	tekv
艜	teah
艝	tefv
艞	tetq
艠	tewu
艡	teil
艢	tefk
艣	tehl
艤	teut
艥	tekt
艦	teal
艧	teac
艩	teyj
艩	teyf
艪	teqj
艫	tehl
艬	teqy
艭	tewc
艱	akfe
艴	xjqc
艵	uaqc
艶	magc
艷	dhdc
艸	btbh
艻	alb
艼	asj
芀	avb
芁	amb
芃	amyu
芅	aau
芆	acyu
芇	amhj
芉	afj
芌	afnb
芐	aghu
芓	abf
芔	bhbh
芕	aqu
芖	adu
芚	agbn
芛	avtr
芞	arnb
芠	ayu
芢	awff
芣	agiu
芧	acbj
芲	awxb
芵	anwu
芶	aqcu
芺	atdu
芻	qbtt
芼	atfn
芿	aweb
苀	aymb
苂	aou
苃	adcu
苅	aqjj
苆	aavb
苉	aaqb
苐	axht
苖	amf
苘	amkf
苙	auf
苚	aej
苝	auxb
苢	anhn
苧	apsj
苨	anxb
苩	arf
苪	agmw
苬	alwu
苭	axlb
苮	awmj
苰	axcu
苲	athf
苳	atuu
苵	arwu
苶	awiu
苸	atuh
苺	axgu
苼	atgf
苽	arcy
苾	antr
苿	afiu
茀	axjj
茊	argf
茋	aqay
茍	gjgk
茐	aqry
茒	aqbj
茓	apwu
茖	atkf
茘	avvv
茙	aadr
茚	aqgb
茝	aahh
茞	aahh
茟	avfh
茠	awsu
茡	apbf
茢	agqj
茣	akgd
茤	aqqu
茥	afff
茦	agmi
茩	argk
茪	aiqb
茮	ahiu
茰	ajqu
茲	axxu
茷	awar
茻	btbh
茽	awkh
茾	agaj
茿	aamy
荁	agjg
荂	adfn
荄	aynw
荅	awgk
荈	aqah
荊	agaj
荋	admj
荌	apvf
荍	anht
荎	agcf
荓	auaj
荕	aelb
荖	aftx
荗	adyt
荘	auff
荙	adpu
荝	amjj
荢	apgf
荮	axfu
荰	asff
荱	antn
荲	ajff
荳	agku
荴	arfw
荵	avyn
荶	akwn
荹	ahir
荺	afqu
荾	acwt
荿	adnt
莀	adfe
莁	aaww
莂	aklj
莃	aqdh
莄	agjq
莇	aegl
莈	aimc
莊	anhf
莋	awtf
莌	aukq
莍	afiy
莏	arit
莐	aipq
莑	atdh
莔	alwm
莕	askf
莖	agva
莗	alj
莙	avtk
莚	athp
莝	awwf
莟	awyk
莡	akhu
莢	adww
莣	aynn
莤	asgf
莥	aqtf
莦	aief
莧	ahqb
莬	aqkq
莭	avcb
莮	allb
莯	aisu
莵	atky
莻	aekx
莾	adfa
莿	agmj
菂	arqy
菃	aian
菄	agji
菆	abcu
菈	aruf
菉	aviu
菋	akfi
菍	awyn
菎	ajxx
菐	oguy
菑	avlf
菒	ajsu
菓	ajsu
菕	awga
菗	armf
菙	atgf
菚	aaar
菛	auf
菞	atqt
菢	arqn
菣	aahc
菤	audb
菦	arpu
菧	ayqy
菨	auvf
菫	agkg
菬	aivk
菭	aick
菮	ayvw
華	agaf
菳	aqf
菴	adjn
菵	amun
菶	adwh
菷	avph
菺	ayne
菻	assu
菼	aoou
菾	agdn
菿	agcj
萀	aham
萂	atkf
萅	agbj
萇	adeu
萈	ahqy
萉	aecb
萊	asww
萐	agvh
萒	aucq
萓	apeg
萔	arvk
萕	ayjf
萖	avqb
萗	apfi
萙	aspq
萚	arch
萛	ahaj
萞	amwx
萟	atvy
萠	aeef
萡	airf
萢	aiqn
萣	apgh
萩	atou
萪	atuf
萫	atjf
萬	ajmy
萭	atky
萮	awgj
萯	aqmu
萰	agli
萲	aefc
萳	afmf
萴	amjj
萵	amnk
萶	adwj
萷	aiej
萹	ayna
萺	ajhf
萻	aujf
萾	aecl
萿	aitd
葀	artd
葁	augv
葂	aqkl
葃	ajtf
葄	aetf
葅	awwg
葇	acbs
葈	acks
葉	aans
葊	awga
葋	aeqk
葌	avvv
葍	agkl
葎	atvh
葏	aivh
葐	awvl
葒	axaf
葓	aiaw
葔	awnd
葕	atih
葖	apwd
葘	agvl
葝	agvl
葞	axbf
葟	argf
葠	awvc
葢	adyl
葤	axfu
葥	auej
葦	anhh
葧	afpl
葨	alge
葪	aqej
葮	awdc
葯	axqy
葰	awct
葲	ariu
葴	adgt
葷	aplj
葹	aytb
葻	amtj
葼	aqbt
葽	asvf
葾	aqbn
葿	anhf
蒀	ajlf
蒁	asyp
蒃	axeu
蒄	apff
蒅	aivs
蒆	aamv
蒈	axxr
蒊	awxx
蒍	ayto
蒏	apsg
蒐	arqc
蒑	arvc
蒒	awnh
蒓	axgn
蒔	ajff
蒕	alwl
蒖	afhw
蒗	aiye
蒘	avkr
蒚	agkh
蒛	armw
蒝	adri
蒞	aiwu
蒟	auqk
蒠	athn
蒢	abwt
蒣	atwt
蒤	aiwt
蒥	aqyl
蒦	awyc
蒧	adht
蒨	awge
蒩	ateg
蒪	agef
蒫	auda
蒬	apqy
蒭	aqbt
蒮	apwy
蒰	atec
蒱	argy
蒳	axmw
蒵	aexd
蒶	axwv
蒷	akmu
蒻	axuu
蒼	awyk
蒾	aopu
蓀	abti
蓂	apju
蓃	avhc
蓅	aiyq
蓆	ayah
蓇	amef
蓈	ayvb
蓋	afcl
蓌	awwt
蓎	ayvk
蓏	arcy
蓒	alfj
蓔	augo
蓕	asff
蓗	atfh
蓘	auce
蓙	aywf
蓚	awhe
蓛	agmt
蓜	asgn
蓞	aevf
蓡	aivc
蓢	ayve
蓤	auft
蓧	awhs
蓨	awhe
蓩	acbl
蓪	acep
蓫	aepu
蓭	aydn
蓮	alpu
蓯	atwh
蓱	aiua
蓲	aakk
蓳	aakg
蓴	agjf
蓵	argh
蓶	akwy
蓷	arwy
蓸	agmj
蓹	atrb
蓺	afwy
蓻	afuy
蓽	ajaf
蓾	ahlo
蔀	aukb
蔁	aujj
蔂	alxi
蔃	axkj
蔄	aukf
蔅	auvf
蔆	aift
蔇	avcq
蔈	asfi
蔉	auke
蔊	aojf
蔋	aihc
蔍	aynx
蔎	aymc
蔏	aumk
蔐	aumd
蔒	avto
蔔	aqgl
蔕	aaqh
蔖	ahag
蔘	acce
蔙	ayth
蔛	aqef
蔜	agqt
蔝	ahou
蔞	alvf
蔞	akgv
蔠	axtu
蔢	aihv
蔣	anhf
蔤	apnm
蔥	atln
蔦	awvo
蔧	adhv
蔨	alub
蔩	apgw
蔪	alrj
蔭	abwc
蔮	alag
蔯	abgi
蔰	aync
蔱	aqsc
蔲	apft
蔳	aige
蔴	ayss
蔵	adat
蔶	agmu
蔹	awgt
蔾	atqs
蔿	aeto
蕀	agmi
蕁	avaf
蕂	aeul
蕄	aunu
蕅	aijy
蕆	admt
蕇	akkf
蕋	ahhh
蕌	ajjj
蕍	aiwj
蕎	atdk
蕏	aqtj
蕐	agwh
蕑	auef
蕒	almu
蕓	affc
蕔	afuc
蕕	aqtg
蕗	akhk
蕘	affq
蕚	akkn
蕛	atut
蕜	adjn
蕝	axqc
蕟	awxc
蕠	avki
蕡	afam
蕢	akhm
蕣	aeph
蕥	aahy
蕦	aedm
蕧	attt
蕩	aijr
蕪	arlo
蕫	aujf
蕬	axxi
蕭	avhh
蕭	avfj
蕮	avqo
蕯	abtg
蕰	aijl
蕱	atie
蕳	aujf
蕵	aqwe
蕶	afwc
蕷	acbm
蕸	anhp
蕼	advh
蕽	amae
蕿	aoec
薀	aill
薁	atmd
薂	aryt
薃	aiyk
薆	aept
薈	awgj
薉	ahdt
薊	aqoj
薋	auqm
薌	axtb
薍	aecn
薎	alpa
薐	atft
薑	aglg
薒	ahqo
薓	aivc
薔	afwk
薕	ayuo
薖	amnp
薗	alfy
薗	alfe
薘	afup
薙	atdy
薚	agqr
薝	aqdy
薞	agqe
薟	awgw
薠	aodm
薡	ahnn
薢	aqeh
薣	afkc
薥	alqj
薦	ayno
薧	aypx
薩	abug
薫	atgo
薬	aris
薭	atrf
薱	aogf
薲	apgm
薳	afkp
薴	apns
薵	afnf
薶	aeef
薸	aisi
薺	ayvf
薺	ayjf
薻	aivs
薼	aynf
薽	asfn
薾	agwq
薿	axth
藀	aooo
藂	abci
藃	aymw
藄	aadi
藅	alyj
藆	apfr
藇	awfw
藇	avgw
藈	ahwd
藊	atya
藋	anwy
藌	apnj
藍	aahl
藎	avhl
藑	aqmt
藒	atjn
藔	apdi
藖	aahm
藗	agkp
藘	ahan
藙	auec
藚	aflm
藛	apvo
藝	afwc
藞	addd
藟	alll
藠	arrr
藡	aump
藢	atmt
藣	alcx
藥	axrs
藦	aysr
藧	axec
藨	ayno
藪	alvt
藪	akgt
藫	aisj
藬	abkm
藭	apwx
藮	aswo
藯	anfn
藰	aqyj
藱	aurc
藲	asak
藳	aymt
藴	axjl
藵	awke
藶	adth
藷	ayfj
藸	aefj
藹	ayjn
藺	auwy
藼	apgn
藽	ausq
藾	agkm
蘀	arlf
蘁	agkk
蘂	anns
蘃	ahhs
蘄	akkr
蘆	ahal
蘇	aqot
蘈	atmm
蘉	alpc
蘊	axll
蘋	ahim
蘌	atri
蘍	atgl
蘎	afec
蘏	axfm
蘐	ayec
蘒	atqn
蘓	atqo
蘔	axtm
蘕	axtp
蘗	anks
蘘	ayke
蘙	aatn
蘚	aqod
蘛	aade
蘜	aafo
蘝	awgw
蘞	awgt
蘟	aben
蘠	anhk
蘡	ammv
蘢	aued
蘣	aamg
蘤	areo
蘥	awga
蘦	afkk
蘨	aeri
蘪	ayno
蘫	aial
蘬	awnh
蘭	augi
蘮	aldj
蘯	aijl
蘰	axjc
蘱	aodm
蘲	allf
蘳	aamf
蘴	adhu
蘵	abuj
蘶	atvc
蘷	gjgt
蘹	anye
蘺	ayby
蘻	albi
蘽	alls
蘾	afye
蘿	alxy
虀	ayvg
虀	aydg
虁	gjgt
虁	auht
虂	afkk
虃	aiwg
虄	ajtg
虅	aeuc
虆	alli
虇	axay
虈	akkk
虉	agko
虊	axys
虋	awfv
虋	avmv
虌	aumx
虌	aumv
虒	rham
虓	vham
處	hatm
虖	hath
虗	harg
虘	haeg
虙	hant
虛	hang
虜	hall
虝	hamr
號	kgnm
虠	uqhm
虡	haow
虣	gahm
虤	hamm
虥	hama
虦	aahm
虧	hawn
虨	hase
虩	ijim
虪	hamo
虭	jvn
虯	jnhh
虰	jsh
虲	jhy
虳	jqyy
虴	jtan
虵	jbn
虶	jgfh
虷	jfh
虸	jbg
蚃	xtju
蚄	jyn
蚅	jdbn
蚆	jcn
蚇	jnyy
蚈	jgah
蚉	yju
蚎	jjg
蚏	jeg
蚐	jqug
蚑	jfcy
蚒	jmyg
蚔	jqan
蚖	jfqn
蚗	jnwy
蚘	jdnn
蚙	jwyn
蚚	jrh
蚛	jkhh
蚞	jsy
蚟	jgg
蚠	wvju
蚡	jwvn
蚢	jymn
蚥	jwqy
蚦	jmfg
蚫	jqnn
蚭	jnxn
蚮	jway
蚲	jguh
蚳	jqay
蚷	jang
蚸	jryy
蚹	jwfy
蚻	snju
蚼	jqkg
蚽	jgig
蚾	jhcy
蚿	jyxy
蛁	jvkg
蛂	jdcy
蛃	jgmw
蛅	jhkg
蛈	jrwy
蛌	jrcy
蛍	ipju
蛒	jtkg
蛓	faji
蛕	jdeg
蛖	jdne
蛗	wnnj
蛚	jgqj
蛜	jwvt
蛝	jvey
蛠	jlll
蛡	jng
蛢	juah
蛣	jfkg
蛥	jqqy
蛦	jgxw
蛧	jmqq
蛨	jdjg
蛪	dhvj
蛫	jqdb
蛬	awju
蛯	jftx
蛵	jgva
蛶	jefy
蛷	jfiy
蛺	jdww
蛻	jwkq
蛼	jlh
蛽	jmy
蛿	jwyk
蜁	jtnh
蜄	jdfe
蜅	jgey
蜆	jhqn
蜋	jyve
蜌	jxxf
蜎	jkeg
蜏	jten
蜐	jfcl
蜑	thpj
蜔	jqlg
蜖	jmjd
蜙	jswc
蜛	jndg
蜝	adwj
蜟	jyce
蜠	jlty
蜤	srju
蜦	jwga
蜧	jynd
蜨	jgvh
蜪	jqrm
蜫	jjxx
蜬	jbib
蜭	jqvg
蜯	jdwh
蜰	ecju
蜲	jtvg
蜳	jybg
蜵	jthh
蜵	jjgg
蜶	jywf
蜸	ahnj
蜹	jamw
蜺	jvqn
蜼	jwyg
蜽	jgmy
蝀	jgji
蝁	ghgj
蝁	gfgj
蝂	jthc
蝃	jccc
蝄	jmun
蝅	gdgj
蝆	jgkf
蝊	jpgh
蝋	jimh
蝍	jvcb
蝏	jyps
蝐	jjhg
蝑	jnhe
蝒	jdmd
蝔	jxxr
蝕	wyvj
蝕	wpjy
蝖	jpgg
蝘	jajv
蝚	jcbs
蝛	jdgt
蝜	jqmy
蝝	jxey
蝞	jnhg
蝟	jleg
蝡	jdmd
蝢	jdmy
蝦	jnhc
蝧	jamd
蝨	nfjj
蝩	jtgf
蝪	jjgr
蝫	jftj
蝬	jqbt
蝭	jjgh
蝯	jefc
蝱	ynjj
蝲	jgkj
蝳	jgxu
蝵	toju
蝷	jyut
蝸	jmnk
蝹	jjlg
蝺	jtky
蝿	jjjn
螀	uqfj
螁	jvep
螄	jwnh
螆	juxx
螇	jexd
螉	jwcn
螊	juvo
螋	jvhc
螌	temj
螎	jgkh
螏	jutd
螐	jwno
螑	jthd
螒	fjwj
螔	jrhm
螕	jtlx
螖	jmeg
螘	jmgu
螙	sjju
螚	cexj
螛	jpdk
螜	fpgj
螝	jrqc
螞	jcy
螠	juwl
螡	yjju
螢	oopj
螣	eudj
螤	yjjw
螥	jwyk
螦	jgxi
螧	jftj
螩	jwhs
螪	jumk
螮	jaqh
螰	jynx
螱	nfij
螲	jpwf
螴	bgjj
螶	anjj
螷	yrtj
螸	wwkj
螹	jlrh
螻	jlvg
螻	jkgv
螼	jakg
螾	jpgw
螿	nhdj
蟁	najj
蟂	jwvs
蟃	jjlc
蟄	fufj
蟅	jyao
蟇	ajdj
蟈	jlag
蟉	jnwe
蟌	jtln
蟍	jtjs
蟎	jamy
蟏	javj
蟐	jiph
蟔	jlfo
蟕	jhxe
蟖	jadr
蟗	gkhj
蟘	jwam
蟙	juaj
蟚	fkuj
蟜	jtdk
蟝	jias
蟞	umij
蟟	jdui
蟡	jeto
蟢	jfkk
蟣	jxxt
蟤	jnnw
蟦	jfam
蟧	jool
蟨	dubj
蟩	jduw
蟫	jsjh
蟬	jkkf
蟭	jwyo
蟯	jffq
蟰	jvhh
蟰	jvfj
蟱	jrlo
蟲	jjju
蟳	jvaf
蟴	adwj
蟵	jdgf
蟶	jbkg
蟷	jipl
蟸	ejju
蟺	jylg
蟻	jugt
蟼	aqkj
蟽	jfup
蟿	lbmj
蠀	juqm
蠁	xtyj
蠂	jaas
蠄	jwyc
蠅	jxg
蠅	jmgv
蠆	ajmj
蠇	jajy
蠈	madj
蠉	jlge
蠋	jlqj
蠌	jlff
蠍	jjqw
蠎	jada
蠏	jqeh
蠐	jyvf
蠐	jyjg
蠑	joos
蠒	gwmj
蠔	jype
蠗	jnwy
蠘	jfay
蠙	jpgm
蠚	adkj
蠜	sqqj
蠝	jlll
蠞	tvcj
蠟	jvln
蠠	dmjj
蠣	jday
蠤	usgj
蠥	btwj
蠦	jhal
蠧	fpdj
蠨	javj
蠨	javh
蠩	jyfj
蠪	uegj
蠫	eejj
蠬	jued
蠭	tdhj
蠮	jatn
蠯	yrtj
蠰	jyke
蠱	jjjl
蠳	jmmv
蠴	jalj
蠵	jmwk
蠶	aqaj
蠷	jhhy
蠸	jaky
蠺	gdgj
蠻	xyxj
蠽	iwyj
蠾	jnij
蠿	vxxj
衁	yntl
衂	tlvy
衃	tlgi
衆	tlti
衇	tlre
衈	tlbg
衉	tltk
衊	tlat
衋	vfhl
衎	tffh
衏	tfqh
衐	tanh
衑	twyh
衒	tyxh
術	tsyh
衕	tmgh
衖	tawh
衘	trhh
衚	tdeh
衛	tnhh
衜	tuth
衝	ttgh
衞	tnhh
衟	tvdh
衠	tfhh
衦	pufh
衧	pugf
衪	pubn
衭	pufw
衯	puwv
衱	puey
衳	puwc
衴	pupq
衵	pujg
衶	pukh
衸	puwj
衹	puqa
衺	yahe
衻	pumf
衼	pufc
袀	puqu
袃	avye
袆	pufh
袇	pumy
袉	pupx
袊	puwc
袌	yqne
袎	puxl
袏	puda
袐	punt
袑	puvk
袓	pueg
袔	pusk
袕	pupw
袗	puwe
袘	putb
袙	purg
袚	pudc
袛	puqy
袝	puwf
袞	ukeu
袟	purw
袠	yrwe
袡	pumf
袣	puan
袥	pudg
袦	pubm
袧	puqk
袨	puyx
袩	puhk
袪	pufc
袬	ycke
袮	puti
袯	puny
袰	xgue
袲	yqqe
袳	puqq
袴	pudn
袵	puwf
袶	puth
袸	pudb
袹	pudj
袺	pufk
袻	pudj
袽	puvk
袾	puri
袿	puff
裀	puld
裃	puhh
裄	puth
裇	putl
裈	pupl
裊	wvge
裋	pugu
裌	pudw
裍	puls
裏	yjfe
裐	puke
裑	putt
裓	puaa
裖	pude
裗	puyq
裚	rrye
裛	yceu
補	pugy
裝	nhde
裞	puuq
裠	vtke
裡	pujf
裦	yqge
裧	puoo
裩	pujx
裪	puqm
裫	puth
裫	pujg
裬	puft
裭	puhm
裮	pujj
裯	pumk
裲	pugy
裵	ydje
裶	pudd
裷	puub
裺	pudn
裻	hice
製	rmhe
裿	pudk
褀	puaw
褁	jseu
褃	puhe
褄	pugv
褅	puuh
褆	pujh
複	putt
褈	putf
褉	pudd
褋	puas
褌	pupl
褍	pumj
褎	yqge
褏	yqge
褑	puec
褔	pugl
褕	puwj
褖	puxe
褗	puav
褘	punh
褜	eqne
褝	puif
褞	pujl
褟	pujn
褠	puff
褢	yrqe
褣	pupk
褤	pufe
褦	pucx
褧	boye
褨	puua
褩	teme
褬	pucs
褭	yceu
褮	oope
褯	puyh
褱	ylie
褲	puyl
褳	pulp
褵	puyc
褷	puth
褸	pulv
褸	pukv
褹	pufy
褺	fufe
褻	yfwe
褼	pusn
褽	nfie
褾	pusi
褿	pugj
襀	pugm
襂	puce
襃	yqge
襅	pujf
襆	puoy
襇	puuj
襈	punw
襉	puue
襊	pujc
襋	pugi
襌	pukf
襍	puws
襎	putl
襏	puwc
襐	puqe
襑	puvf
襒	puut
襓	pufq
襔	puay
襕	puui
襖	putd
襗	pulf
襘	puwj
襙	puks
襚	puup
襛	pume
襜	puqy
襝	puww
襠	puil
襡	pulj
襢	puyg
襣	putj
襤	pual
襥	puwy
襧	pugq
襨	puof
襩	pufm
襪	puat
襫	pudj
襬	pulx
襭	pufm
襮	puji
襯	puuq
襰	pugm
襱	puud
襲	uege
襳	puwg
襴	puui
襵	pubb
襶	pufw
襷	puwr
襷	puvr
襸	putm
襹	pugx
襺	puaj
襼	puac
襽	puai
襾	gmjg
覀	sghg
覂	stpu
覄	swdu
覅	svqr
覇	safe
覈	sryt
覉	safk
覊	safc
見	hqb
覌	chqn
覍	ihqb
覎	hqbd
規	fwhq
覐	hqqq
覑	thgq
覒	tfnq
覓	ehqb
覔	gihq
覕	nthq
視	pyhq
覗	ngkq
覘	hkhq
覙	qihq
覚	iphq
覛	rehq
覜	iqhq
覝	fohq
覞	hqhq
覟	fnhq
覠	vtkq
覡	awwq
覢	oohq
覣	tvhq
覤	hamq
覥	mawq
覦	wgeq
覧	ahnq
覨	kkfq
覩	ftjq
親	ushq
覫	upyq
覬	mgkq
覭	pjuq
覮	oopq
覯	fjgq
覰	haeq
覱	lrhq
覲	akgq
観	rwyq
覴	wgkq
覵	uehq
覶	ecmq
覷	haoq
覸	ujhq
覹	hqtt
覺	wfqq
覺	vqqq
覻	hagq
覼	gwmq
覽	ahnq
覾	ptoq
覿	flmq
觀	akkq
觃	mqbd
觍	mawq
觏	fjgq
觓	qenh
觔	qeln
觕	trqe
觗	qeqa
觘	qeit
觙	qeey
觛	qejg
觝	qeqy
觟	qeff
觠	udqe
觡	qetk
觢	dhve
觤	qeqb
觧	qeud
觨	qeai
觩	qefy
觪	qeuh
觬	qevq
觭	qedk
觮	qevi
觰	qmfj
觱	dgke
觲	qeuh
觴	qmfr
觵	qeaw
觶	qekf
觷	wfqe
觷	vqqe
觸	qelj
觹	qewm
觺	xtde
觻	qexs
觼	qeqt
觽	qemm
觾	qeao
觿	qemk
訁	yygg
訂	ysh
訃	yhy
訄	vyd
訅	yvn
訆	ynhh
計	yfh
訉	ymyy
訊	ynfh
訋	yqyy
訌	yag
訍	ycyy
討	yfy
訏	ygfh
訐	yfh
訑	ybn
訒	yvyy
訓	ykh
訔	myf
訕	ymh
訖	ytnn
託	ytan
記	ynn
訙	yvyy
訚	uyd
訛	ywxn
訜	ywvn
訝	yaht
訞	ytdy
訟	ywcy
訠	yxhh
訡	ywyn
訢	yrh
訣	ynwy
訤	yqqy
訥	ymwy
訦	ypqn
訧	ydnn
訨	yhg
訩	yqbh
訪	yyn
訫	yny
訬	yitt
設	ymcy
訮	ygah
訯	yeyy
訰	ygbn
許	ytfh
訲	ykhh
訳	ynyy
訴	yryy
訵	ylg
訶	yskg
訷	yjhh
訸	yty
訹	ysyy
診	ywet
註	yygg
証	yghg
訽	yqkg
訿	yhxn
詀	yhkg
詁	ydg
詂	ywfy
詃	yyxy
詄	yrwy
詅	ywyc
詆	yqay
詇	ymdy
詉	yvcy
詊	yufh
詋	ykqn
詌	yafg
詍	yann
詎	yang
詏	yxln
詐	ythf
詑	ypxn
詒	yckg
詓	yfcy
詔	yvkg
評	yguh
詖	yhcy
詗	ymkg
詘	ybmh
詙	ydcy
詚	yjgg
詛	yegg
詜	ybhc
詝	ypsh
詞	yngk
詟	dxyf
詠	yyni
詡	yng
詢	yqjg
詣	yxjg
詤	ywnq
詥	ywgk
試	yaag
詧	wyf
詨	yuqy
詩	yffy
詪	yvey
詫	ypta
詬	yrgk
詭	yqdb
詮	ywgg
詯	ythg
詰	yfkg
話	ytdg
該	yynw
詳	yudh
詴	ydeg
詵	ytfq
詶	yyth
詷	ymgk
詸	yoy
詺	yqkg
詻	ytkg
詼	ydoy
詽	yftf
詾	yqqb
詿	yffg
誀	ybg
誁	yuah
誂	yiqn
誃	yqqy
誄	ydiy
誅	yriy
誆	yagg
誇	ydfn
誈	ygcf
誋	ynny
誌	yfny
認	yvyn
誎	ygki
誏	yyve
誐	ytrt
誑	yqtg
誒	yctd
誔	ytfp
誕	ythp
誖	yfpb
誗	ytjh
誘	yten
誙	ygva
誚	yieg
誛	yvpc
誜	ycwt
誝	ywyk
語	ygkg
誟	yftb
誠	ydnt
誡	yaah
誢	yhqn
誣	yaww
誤	ykgd
誥	ytfk
誦	yceh
誧	ygey
誨	ytxu
誩	yyg
說	ywkq
誫	ydfe
説	yukq
読	yfpq
誮	yawx
誯	yjjg
誰	ywyg
誱	ygvh
課	yjsy
誳	ynbm
誴	ypfi
誵	yqde
誶	yywf
誷	ymun
誸	yxyx
誹	ydjd
誺	ysww
誻	yijg
誼	ypeg
誽	yvqn
誾	uyd
調	ymfk
諀	yrtf
諁	yccc
諂	yqvg
諃	yssy
諄	yybg
諅	adwy
諆	yadw
談	yooy
諈	ytgf
諉	ytvg
諊	yqoy
請	ygeg
諌	ygji
諍	yqvh
諎	yajg
諏	ybcy
諐	wkqy
諑	yeyy
諒	yyiy
諓	yaat
諔	yhic
諕	yham
論	ywga
諗	ywyn
諘	ygey
諙	yqaj
諚	ypgh
諛	yvwy
諜	yans
諝	ynhe
諞	yyna
諟	yjgh
諠	ypgg
諡	ywgl
諢	yplh
諣	ymnk
諤	ykkn
諥	ytgf
諦	yuph
諧	yxxr
諨	ygkl
諩	yuog
諪	yyps
諫	ygli
諬	tdny
諭	ywgj
諮	yuqk
諯	ymdj
諰	ylny
諱	ynhh
諲	ysfg
諳	yujg
諴	ydgt
諵	yfmf
諶	yadn
諷	ymtj
諸	yftj
諹	yjgr
諺	yute
諻	yrgg
諼	yefc
諽	yafh
諾	yadk
諿	ykbg
謀	yafs
謁	yjqn
謂	yleg
謃	yjtg
謄	eudy
謅	yqbt
謆	yynn
謈	jawy
謉	yrqc
謊	yayq
謋	yqas
謌	yskk
謍	oopy
謎	yopy
謏	yvhc
謐	yntl
謑	yexd
謒	ywyk
謓	yfhw
謔	yhag
謕	yrhm
謖	ylwt
謗	yupy
謘	ynuh
謙	yuvo
謚	yuwl
講	yfjf
謜	ydri
謝	ytmf
謞	yymk
謟	yevg
謠	yqrm
謡	yerm
謢	ywyc
謣	yffn
謤	ysfi
謥	ytln
謧	yybc
謨	yajd
謩	ajdy
謪	yumk
謫	yumd
謬	ynwe
謭	yuev
謮	ygmy
謯	yhag
謰	ylpy
謱	ylvg
謱	ykgv
謲	ycce
謳	yakk
謴	yxfm
謵	ynrg
謶	yyao
謷	gqty
謸	ygqt
謹	yakg
謺	fufy
謻	ytqq
謼	yhah
謽	xkjy
謾	yjlc
謿	yfje
譀	ynbt
譁	yagf
譂	ykkf
譃	yhag
譄	yulj
譅	yvyh
譆	yfkk
譇	ydfj
譈	yybt
證	ywgu
譊	yffq
譋	yueg
譌	yeto
譍	ywwy
譎	ycbk
譏	yxxt
譐	yusf
譑	ytdk
譒	ytol
譓	ygjn
譔	ynnw
譕	yrlo
譖	yaqj
譗	ytwk
識	yuaj
譙	ywyo
譚	ysjh
譛	yfwj
譜	yuoj
譝	yxg
譝	ymgv
譞	ylge
譟	ykks
譠	yylg
譡	yipl
譢	yuep
譣	ywgw
譤	yryt
譥	ryty
譧	yyuo
譨	ymae
譩	yujn
譪	yajn
譫	yqdy
譭	yvac
譮	ywgj
譯	ylff
議	yugt
譱	udyy
譲	yufe
譳	yfdj
譴	ykhp
譵	yogf
譶	yyyf
護	yawc
譸	yfnf
譹	yype
譺	yxth
譻	mmyf
譼	ahny
譽	wfgy
譽	vgny
譾	yuen
譿	ydhn
讀	yflm
讁	yump
讂	yqmt
讃	yfwm
讄	ylll
讅	yptl
讆	tnhy
讇	yuqv
讈	ydth
讉	ykhp
變	xyxt
讋	uegy
讌	yauo
讍	ygkk
讎	wyyy
讏	tnhy
讐	wywy
讑	ywga
讒	yqky
讓	yyke
讔	yben
讕	yugi
讖	ywwg
讗	ymwk
讘	ybbb
讙	yaky
讚	ytfm
讛	yafc
讜	yipo
讝	ykkt
讞	yhad
讟	yfly
讬	ytan
讱	yvyy
讻	yqbh
诇	ymkg
诐	yhcy
诪	ydtf
谉	ypjh
谞	ynhe
谸	tdwk
谹	wwkc
谺	wwkt
谻	wwkt
谼	wwkw
谽	wwkk
谾	wwka
谿	exdk
豀	wwkd
豂	wwke
豃	wwkt
豄	wwkm
豅	wwkd
豈	mgku
豊	magu
豋	wgku
豍	gkuf
豎	ahnu
豏	gkuo
豐	dhdu
豑	magt
豒	dhdt
豓	dhdl
豔	dhdl
豖	eyi
豗	gqei
豘	egbn
豙	ueu
豛	emcy
豜	egah
豝	ecn
豞	eqkg
豟	eynn
豠	eegg
豣	eftf
豤	evey
豥	eynw
豦	haei
豧	egey
豨	eqdh
豩	eey
豬	eftj
豭	enhc
豮	efam
豯	eexd
豰	fpgc
豱	ejlg
豲	edri
豴	eumd
豵	etwh
豶	efam
豷	efpu
豻	eefh
豼	eexx
豽	eemw
豾	eegg
豿	eeqk
貀	eebm
貁	eepw
貃	eerg
貄	eevh
貆	eegg
貇	eeve
貈	eete
貋	eejf
貍	eejf
貎	eevq
貏	eerf
貐	eewj
貑	eenc
貒	eemj
貓	eeal
貕	eeed
貖	eeul
貗	eelv
貗	eekv
貙	eeak
貚	eekf
貛	eeay
貜	eehc
貝	mhny
貞	hmu
貟	cmu
負	qmu
財	mftt
貢	amu
貣	amu
貤	mbn
貥	mymn
貦	mfqn
貧	wvmu
貨	wxmu
販	mrcy
貪	wynm
貫	xfmu
責	gmu
貭	rfmi
貮	gami
貯	mpsh
貰	anmu
貱	mhcy
貲	hxmu
貳	afmi
貴	khgm
貵	cdmu
貶	mtpy
買	lmu
貸	wamu
貹	mtgg
貺	mkqn
費	xjmu
貼	mhkg
貽	mckg
貾	mqay
貿	qyvm
賀	lkmu
賁	famu
賂	mtkg
賃	wtfm
賄	mdeg
賅	mynw
賆	muah
資	uqwm
賈	smu
賉	mtlg
賊	madt
賋	muqy
賌	yntm
賍	myfg
賎	mdxy
賏	mmy
賐	mcwt
賑	mdfe
賒	mwfi
賓	pgim
賔	pnmu
賕	mfiy
賖	mwty
賗	mkkh
賘	myfy
賙	mmfk
賚	swwm
賛	fwfm
賜	mjqr
賝	mpws
賞	ipkm
賟	mmaw
賠	mukg
賡	yvwm
賢	ahnm
賣	flmu
賤	maat
賥	mywf
賦	mgah
賧	mooy
賨	pfim
賩	mpfi
質	rrmu
賫	fwwm
賬	mdey
賭	mftj
賮	vhgm
賯	mqjb
賰	mdwj
賱	mplh
賲	wksm
賳	mfak
賴	gkim
賵	mjhg
賶	mwyk
賷	fkkm
賸	eudm
賹	muwl
賺	muvo
賻	mgef
購	mfjf
賽	pfjm
賾	ahkm
賿	mnwe
贀	atdm
贁	mmty
贂	mcce
贃	mkkn
贄	fufm
贅	gqtm
贆	mddd
贇	ygam
贈	mulj
贉	msjh
贊	tfqm
贋	dwwm
贌	mogy
贍	mqdy
贎	majy
贏	ynky
贐	mvhl
贑	ujam
贒	ahnm
贓	mdnt
贔	mmmu
贕	qytm
贖	mflm
贗	dwwm
贘	mipm
贙	hamm
贚	mued
贛	ujtm
贜	madt
贠	cmu
赇	mfiy
赑	mmmu
赒	mmfk
赕	mooy
赗	mjhg
赟	ygam
赥	foqw
赨	fojy
赩	foqc
赪	fohm
赬	fohm
赮	fonc
赯	foyk
赱	fuyu
赲	fhlv
赸	fhmk
赹	fhqu
赺	fhwn
赻	fhit
赼	fhqw
赽	fhnw
赾	fhrk
赿	fhqa
趀	fhtt
趂	fhqi
趃	fhrw
趆	fhqy
趇	fhud
趈	fhhk
趉	fhbm
趌	fhfk
趍	fhqq
趎	fhri
趏	fhtd
趐	fhnd
趒	fhiq
趓	fhms
趕	fhjf
趖	fhwf
趗	fhkh
趘	fhnn
趙	fhie
趚	fhgi
趛	fhqd
趜	fhqo
趝	fhwn
趞	fhaj
趠	fhhj
趡	fhwy
趢	fhvi
趤	fhpd
趥	fhug
趦	fhuk
趧	fhjh
趨	fhqt
趩	fhlw
趪	fhaw
趫	fhtk
趬	fhfq
趭	fhwo
趮	fhks
趯	fhny
趰	fhgq
趲	fhtm
趶	khgf
趷	khtn
趹	khnw
趻	khwn
趽	khyn
跀	kheg
跁	khcn
跂	khfc
跅	khry
跇	khan
跈	khwe
跉	khwc
跊	khfi
跍	khdg
跐	khhx
跒	khsk
跓	khyg
跔	khqk
跕	khhk
跘	khuf
跙	kheg
跜	khnx
跠	khgw
跡	khyo
跢	khqq
跥	khes
跦	khri
跧	khwg
跩	khjx
跭	khth
跮	khgf
跰	khua
跱	khff
跲	khwk
跴	khsg
跶	khdp
跼	khnk
跾	whth
跿	khfh
踀	khkh
踁	khga
踂	khbn
踃	khie
踄	khhi
踆	khct
踇	khtu
踈	khgi
踋	khfb
踍	khfb
踎	khgk
踐	khaa
踑	khaw
踒	khtv
踓	khwy
踕	khgh
踖	khaj
踗	khwn
踘	khqo
踙	khbc
踚	khwa
踛	khff
踜	khft
踠	khpb
踡	khub
踤	khyf
踥	khuv
踦	khdk
踧	khhc
踨	khwh
踫	khug
踭	khqh
踰	khwj
踲	khrh
踳	khdj
踴	khcl
踶	khjh
踷	khfj
踸	khan
踻	khmk
踼	khjr
踾	khgl
踿	khto
蹃	khak
蹅	khsg
蹆	khvp
蹌	khwk
蹍	khne
蹎	khfw
蹏	khrm
蹐	khie
蹓	khql
蹔	lrkh
蹕	khjf
蹖	khdv
蹗	khyx
蹘	khne
蹚	khif
蹛	khah
蹜	khpj
蹝	khth
蹞	khxm
蹟	khgm
蹠	khyo
蹡	khnf
蹢	khud
蹣	khay
蹤	khth
蹥	khlp
蹧	khgj
蹨	khqo
蹪	khkm
蹫	khck
蹮	khsn
蹱	khuf
蹳	khwc
蹵	yidh
蹷	dubh
蹸	khoh
蹹	khwn
蹺	khfq
蹻	khtk
蹽	khdi
蹾	khyt
躀	khxm
躂	khfp
躃	khnu
躄	nkuh
躆	khhe
躈	khrt
躉	ajmh
躊	khff
躋	khyj
躋	khyf
躌	khrh
躍	khny
躎	khgq
躑	khub
躒	khxs
躓	khrm
躕	khyf
躖	khxh
躖	khxg
躗	tnhh
躘	khud
躙	khuy
躚	khsp
躛	tnhh
躝	khui
躟	khye
躠	awnh
躡	khbb
躢	khun
躣	khhy
躤	khaj
躥	khpn
躦	khtm
躧	khgx
躨	khut
躩	khhc
躪	khay
躭	tmdq
躮	tmdv
躰	tmdg
躱	tmds
躳	tmdk
躴	tmde
躵	tmdn
躶	tmds
躷	tmdv
躸	tmdk
躹	tmdo
躻	tmda
躼	tmde
躽	tmdv
躾	tmdd
躿	tmdi
軀	tmdk
軁	tmdv
軂	tmdl
軃	tmdf
軄	tmdj
軅	tmdy
軆	tmdu
軇	tmdf
軈	tmdn
軉	tmdm
車	lghh
軋	lnn
軌	lvn
軍	plj
軏	lgqn
軐	lnfh
軑	ldy
軒	lfh
軓	lmyy
軔	lvyy
軕	lmh
軖	lgg
軗	lmcy
軘	lgbn
軙	lhcy
軚	ldyy
軛	ldbn
軜	lmwy
軝	lqan
軞	ltfn
軟	lqwy
軠	ltfg
軡	lwyn
転	lfcy
軣	liu
軤	ltuh
軥	lqkg
軦	lkqn
軧	lqay
軨	lwyc
軩	lckg
軪	lxln
軫	lwet
軬	cdlj
軭	lagg
軮	lmdy
軯	lguh
軰	uxlj
軱	lrcy
軲	ldg
軳	lqnn
軴	lygg
軵	lwfy
軶	lynn
軷	ldcy
軸	lmg
軹	lkwy
軺	lvkg
軻	lskg
軼	lrwy
軽	lcfg
軾	laag
軿	luah
輀	ldmj
輁	lawy
輂	awlj
較	luqy
輄	liqn
輅	ltkg
輆	lynw
輇	lwgg
輈	ltey
載	falk
輊	lgcf
輋	mdlj
輌	lgmm
輍	lwwk
輎	lieg
輏	lsgg
輐	lpfq
輑	lvtk
輒	lbnn
輓	lqkq
輔	lgey
輕	lgva
輖	lmfk
輗	lvqn
輘	lfwt
輙	lbcy
輚	laat
輛	lgmy
輜	lvlg
輝	iqpl
輞	lmun
輟	lccc
輠	ljsy
輡	lqvg
輢	ldsk
輣	leeg
輤	lgeg
輥	ljxx
輦	fwfl
輧	ltff
輨	lpnn
輩	djdl
輪	lwga
輫	ldjd
輬	lyiy
輭	ldmd
輮	lcbs
輯	lkbg
輰	ljgr
輱	ldgt
輲	lmdj
輳	ldwd
輴	lrfh
輵	ljqn
輶	lusg
輷	lqyg
輸	lwgj
輹	ltjt
輺	lgvl
輻	lgkl
輼	ljlg
輽	lcdl
輾	lnae
輿	wflw
輿	vlgw
轀	llwl
轁	levg
轂	fpgc
轃	ldwt
轄	lpdk
轅	lfke
轆	lynx
轇	lnwe
轈	lvjs
轉	lgjf
轊	ldhv
轋	llpy
轌	lfvg
轍	lyct
轎	ltdk
轏	lnbb
轐	logy
轑	ldui
轒	lfam
轓	ltol
轔	loqh
轕	lajn
轖	lfwk
轗	ldgn
轘	llge
轙	lugt
轚	lbml
轛	logf
轜	lfdj
轝	wfgl
轝	vgnl
轞	lahl
轟	lllj
轠	llll
轡	xlxk
轢	lxrs
轣	ldth
轤	lhal
轥	lauy
轪	ldy
轷	ltuh
辀	ltey
辁	lwgg
辌	lyiy
辒	ljlg
辝	ckuh
辠	thuj
辡	uuh
辢	gkiu
辤	epcu
辥	btwu
辦	uluh
辧	uvuh
辪	hwnu
辬	uyuh
辭	ecmu
辮	uxiu
辯	uyuh
農	made
辳	ssde
辴	kkje
辵	ehu
辷	gpd
辸	epv
辺	vpv
辻	fpk
込	typi
辿	mpk
迀	fpk
迃	fnpv
迆	bpv
迉	npe
迊	gmhp
迋	gpd
迌	epd
迍	gbnp
迏	dypi
迒	ympv
迖	dpi
迗	gdpi
迚	khpk
迠	hkpd
迡	nxpv
迣	anpv
迧	jhpk
迬	ygpd
迯	qhpi
迱	pxpv
迲	fcpi
迴	lkpd
迵	mgkp
迶	depd
迺	spd
迻	qqpi
迼	fkpd
迾	gqjp
迿	qjpd
逇	fbpv
逈	tmkp
逌	hlnp
逎	sgpd
逓	rfmp
逕	gvap
逘	ctdp
這	ypd
逜	gkpd
連	lpk
逤	iitp
逥	mjdp
逧	wwkp
逨	swwp
逩	dfap
逪	ajpd
逫	cccp
逬	tftp
逰	rtbp
週	mfkp
進	wypd
逳	ycep
逴	hjpk
逷	jqrp
逹	fufp
逺	fnwp
逺	fnep
逽	adkp
逿	jgqp
遀	daep
遃	utep
遅	nudp
遆	upmp
遈	jghp
遉	hmpi
遊	ytbp
運	plpk
遌	kkfp
過	mnmp
達	fudp
違	nhkp
遖	fmup
遙	qrmp
遚	vhcp
遜	btxp
遝	lipi
遞	rhap
遟	nupk
遠	fkwp
遠	fkep
遡	ubtp
遤	cpi
遦	xfmp
遧	ujpk
適	umdp
遪	cccp
遫	gkip
遬	gkip
遯	eepi
遰	aqpp
遱	lvpd
遱	kgkp
遲	nirp
遳	awwp
遶	fffp
遷	sdnp
選	nnap
遹	cbtp
遺	khgp
遻	kkup
遼	dujp
遾	tawp
邁	ajmp
還	lgkp
邅	ylkp
邆	wgkp
邇	gwmp
邉	thpp
邊	thpp
邌	tqtp
邍	tlvp
邎	qytp
邏	lxwp
邐	gmyp
邒	sbh
邔	nbh
邖	mbh
邘	gfbh
邚	vbh
邜	qbh
邞	fwbh
邟	ymbh
邠	wvbh
邤	rbh
邥	pqbh
邧	fqbh
邨	gbnb
邩	obh
邫	dtkc
邭	qkbh
邲	ntbh
邷	gnyb
邼	agbh
邽	ffbh
邿	ffbh
郀	dfnb
郂	yntb
郃	wgkb
郆	fkbh
郈	rgkb
郉	ftfb
郋	thbh
郌	ffkc
郍	tebh
郒	yvcc
郔	thpb
郕	dnnb
郖	gkub
郘	kkbh
郙	gehb
郚	gkbh
郞	yveb
郟	dwwb
郠	gjqb
郣	fpbb
郤	wwkb
郥	mbh
郩	qdeb
郪	gvhb
郬	gebh
郮	mfkb
郰	bcbh
郱	uabh
郲	swwb
郳	vqbh
郵	tgab
郶	ukkc
郷	xtvb
郹	hdbh
郺	qqvc
郻	hnvb
郼	nhkb
郿	nhbh
鄀	adkb
鄁	uxeb
鄃	wgeb
鄅	tkmb
鄆	plbh
鄇	wntb
鄈	wgdb
鄉	xtyb
鄊	xtbb
鄋	vhcb
鄌	yvhb
鄍	pjub
鄎	thnb
鄏	dfeb
鄐	yxlb
鄑	gogb
鄒	qbtb
鄓	thdb
鄔	wngb
鄕	xtrb
鄖	kmbh
鄗	ymkb
鄘	yveb
鄚	ajdb
鄛	vjsb
鄜	ynjb
鄝	nweb
鄟	gjhb
鄠	ffnb
鄡	wvgb
鄤	jlcb
鄥	wvgb
鄦	rlgb
鄧	wgkb
鄨	umic
鄩	vakb
鄪	xjmb
鄫	uljb
鄬	etnb
鄭	usgb
鄮	qyvb
鄰	oqab
鄲	kkjb
鄳	xbh
鄳	mggb
鄴	ogub
鄵	kkkb
鄶	wglb
鄷	magb
鄸	alpb
鄺	yamb
鄻	fwfb
鄼	fwfb
鄽	yjfb
鄾	depb
鄿	akkb
酀	aukb
酁	qkxb
酂	tfqb
酄	akkb
酅	mwyb
酇	tfqb
酈	gmyb
酏	sgbn
酑	sggf
酓	wyng
酔	sgvf
酕	sgtn
酖	sgpq
酘	sgmc
酙	sguf
酛	sgfq
酜	sgfw
酟	sghk
酠	sgsk
酦	sgny
酧	sgpf
酨	fasg
酫	sgwg
酭	sgde
酳	sgxe
酺	sggy
酻	sgeb
酼	sgyq
醀	sgwy
醁	sgvi
醂	sgss
醃	sgdn
醄	sgqm
醆	sgaa
醈	sgoo
醊	sgcc
醎	sgdt
醏	sgfj
醓	sgpl
醔	tosg
醕	sgyj
醖	sgjl
醗	sgwq
醘	sgfl
醙	sgvc
醜	sgrc
醝	sgua
醞	sgll
醟	oopg
醠	sgml
醡	sgpf
醤	uefg
醥	sgsi
醦	sgce
醧	sgak
醨	sgyc
醩	sggj
醫	atdg
醬	nhdg
醰	sgsj
醱	sgwc
醲	sgme
醳	sglf
醶	sgww
醷	sgun
醸	sgue
醹	sgfj
醻	sgff
醼	sgao
醽	sgfk
醾	sgyo
醿	sgyi
釀	sgye
釁	wfmv
釁	vmgv
釂	sgef
釃	sggx
釄	sgyd
釅	sgkt
釆	toi
釈	tony
釋	tolf
釐	fitf
釒	qtyg
釓	qnn
釔	qnn
釕	qbh
釖	qvn
釗	qjh
釘	qsh
釙	qhy
釚	qvn
釛	qln
針	qfh
釞	qtyy
釟	qwy
釠	qmn
釡	wqf
釢	qen
釣	qqyy
釤	qet
釥	qiy
釦	qkg
釧	qkh
釨	qbg
釩	qmyy
釪	qgfh
釫	qfnn
釬	qfh
釭	qag
釮	qftt
釯	qynn
釰	qvyy
釱	qdy
釲	qnn
釳	qtnn
釴	qay
釵	qcyy
釶	qbn
釷	qfg
釸	qqy
釹	qvg
釺	qtfh
釻	qvyy
釼	qvyy
釽	qrhy
釾	qaht
釿	qrh
鈀	qcn
鈁	qyn
鈂	qpqn
鈃	qgah
鈄	qufh
鈅	qeg
鈆	qwcy
鈇	qfwy
鈈	qgiy
鈉	qmwy
鈊	qny
鈋	qwxn
鈌	qnwy
鈍	qgbn
鈎	qqcy
鈏	qxhh
鈐	qwyn
鈑	qrcy
鈒	qeyy
鈓	qtfg
鈔	qitt
鈕	qnfg
鈖	qwvn
鈗	qcqn
鈘	qfcy
鈙	qhcy
鈚	qxxn
鈛	qat
鈜	qdcy
鈝	qrhh
鈞	qqug
鈟	qxhh
鈠	qmcy
鈡	qkhh
鈢	qsy
鈣	qghn
鈤	qjg
鈥	qoy
鈦	qdyy
鈧	qymn
鈨	qfqn
鈩	qynt
鈪	qdbn
鈫	qyy
鈬	qnyy
鈭	hxqf
鈮	qnxn
鈯	qbmh
鈰	qymh
鈱	qnan
鈲	qrcy
鈳	qskg
鈴	qwyc
鈵	qgmw
鈶	qckg
鈷	qdg
鈸	qdcy
鈹	qhcy
鈺	qgyy
鈻	qnhn
鈼	qthf
鈽	qdmh
鈾	qmg
鈿	qlg
鉀	qlh
鉁	qwet
鉂	qkqy
鉃	qtdy
鉄	qrwy
鉅	qang
鉆	qhkg
鉇	qtbn
鉈	qpxn
鉉	qyxy
鉊	qvkg
鉋	qqnn
鉌	qty
鉍	qntt
鉎	qtgg
鉏	qegg
鉐	qdg
鉑	qrg
鉒	qygg
鉓	qtmh
鉔	qamh
鉕	qakg
鉖	qtuy
鉗	qafg
鉘	qxjh
鉙	qkwy
鉚	qqtb
鉛	qmkg
鉜	qwfy
鉝	qug
鉞	qant
鉟	qgig
鉠	qmdy
鉡	qufh
鉢	qsgg
鉣	qfcy
鉤	qqkg
鉥	qsyy
鉦	qghg
鉧	qxgu
鉨	qqiy
鉩	qwiy
鉪	qann
鉫	qlkg
鉬	qhg
鉭	qjgg
鉮	qjhh
鉯	qnyw
鉰	qngk
鉱	qycy
鉲	qhhy
鉳	quxn
鉵	qjy
鉶	qgaj
鉷	qawy
鉸	quqy
鉹	qqqy
鉺	qbg
鉻	qtkg
鉼	quah
鉽	qaag
鉾	qcrh
鉿	qwgk
銀	qvey
銁	qqjg
銂	qyth
銃	qycq
銄	qtmk
銅	qmgk
銆	qdjg
銇	qdiy
銈	qffg
銉	qvfh
銊	qdgt
銋	qwtf
銌	qdhb
銍	qgcf
銏	qmmg
銐	gqjq
銑	qtfq
銒	qftf
銓	qwgg
銔	qgif
銕	qgxw
銖	qriy
銗	qrgk
銘	qqkg
銙	qdfn
銚	qiqn
銛	qtdg
銜	tqfh
銝	qwsy
銞	qjqf
銟	qmmh
銠	qftx
銡	qfkg
銢	qfiy
銣	qvkg
銤	qoy
銥	qyey
銦	qldy
銧	qiqn
銨	qpvg
銩	qtfc
銪	qdeg
銫	qqcn
銬	qftn
銭	qdxy
銯	qxiy
銰	qaqy
銱	qkmh
銲	qjfh
銳	qwkq
銴	rrqf
銵	qtmt
銶	qfiy
銷	qieg
銸	qbnn
銹	qten
銺	nhdq
銻	quxt
銼	qwwf
銽	qqak
銾	qaiy
銿	qceh
鋀	qgku
鋁	qkkg
鋂	qtxu
鋃	qyve
鋄	qgoc
鋅	quh
鋆	fquq
鋇	qmy
鋉	qgki
鋊	qwwk
鋋	qthp
鋌	qtfp
鋍	qfpb
鋎	qpfq
鋏	qdww
鋐	qpdc
鋑	qcwt
鋒	qtdh
鋓	qtjh
鋔	qqkq
鋕	qfny
鋖	qevg
鋗	qkeg
鋘	qkgd
鋙	qgkg
鋚	whtq
鋛	qkkh
鋜	qkhy
鋝	qefy
鋞	qgva
鋟	qvpc
鋠	qdfe
鋡	qwyk
鋢	qebg
鋣	qahb
鋤	qegl
鋥	qkgg
鋦	qnnk
鋧	qhqn
鋨	qtrt
鋩	qayn
鋪	qgey
鋫	tjqf
鋬	rrcq
鋭	qukq
鋮	qdnt
鋯	qtfk
鋰	qjfg
鋱	qany
鋲	qrgw
鋳	qdtf
鋴	qdqn
鋵	qtmn
鋶	qycq
鋷	qbcy
鋸	qndg
鋹	qdey
鋺	qpqb
鋻	ahnq
鋼	qmum
鋽	qhjh
鋾	qqrm
鋿	qimk
錀	qwga
錁	qjsy
錂	qfwt
錃	ihcq
錄	qxgi
錅	tqtq
錆	qgeg
錇	qukg
錈	qudb
錉	qqaj
錊	qywf
錋	qeeg
錌	qmdf
錍	qrtf
錎	qqvg
錏	qghg
錏	qgfg
錐	qwyg
錑	qynd
錒	qbsk
錓	qudn
錔	qijg
錕	qjxx
錖	hicq
錗	qtvg
錘	qtgf
錙	qvlg
錚	qqvh
錛	qdfa
錜	qwyn
錝	qpfi
錞	qybg
錟	qooy
錠	qpgh
錡	qdsk
錢	qaat
錣	qccc
錤	qadw
錥	qyce
錦	qrmh
錧	qpnn
錨	qalg
錩	qjjg
錪	qmaw
錫	qjqr
錬	qgji
錭	qmfk
錮	qldg
錯	qajg
錰	qsoy
錱	qggf
録	qviy
錳	qblg
錴	qfwf
錵	qawx
錶	qgey
錷	qlnn
錸	qsww
錹	qheg
錺	qayn
錻	qgah
錼	qdfi
錽	qgot
錿	qham
鍀	qjgf
鍁	qrqw
鍂	qqg
鍃	qqrn
鍄	qyiy
鍅	qifc
鍆	qug
鍇	qxxr
鍈	qamd
鍉	qjgh
鍊	qgli
鍋	qmnk
鍌	itfq
鍍	qyac
鍎	qrfh
鍏	qnhh
鍐	qqbt
鍑	qtjt
鍒	qcbs
鍓	qkbg
鍔	qkkn
鍕	qplh
鍖	qadn
鍗	quph
鍘	qmjh
鍙	iawq
鍚	qjgr
鍛	qwdc
鍜	qnhc
鍝	qjmy
鍞	qhmy
鍟	qjtg
鍠	qrgg
鍡	qlge
鍢	qgkl
鍣	qavk
鍤	qtfv
鍥	qdhd
鍦	qytb
鍧	qqyg
鍨	qwgd
鍩	qadk
鍫	toqf
鍬	qtoy
鍭	qwnd
鍮	qwgj
鍯	qqrn
鍰	qefc
鍱	qans
鍲	qnaj
鍳	ahnq
鍴	qmdj
鍵	qvfp
鍶	qlny
鍷	qdff
鍸	qdeg
鍹	qpgg
鍺	qftj
鍻	qjqn
鍼	qdgt
鍽	qyna
鍾	qtgf
鍿	qgvl
鎀	qwhe
鎁	qbbh
鎂	qugd
鎃	qire
鎄	qyey
鎅	qlwj
鎆	quej
鎇	qnhg
鎈	quda
鎉	qjng
鎊	qupy
鎋	qpdk
鎌	quvo
鎍	qfpi
鎎	qrno
鎐	qerm
鎑	qfcl
鎒	qdff
鎓	qwcn
鎔	qpwk
鎕	qyvk
鎖	qimy
鎗	qwyk
鎘	qgkh
鎙	qube
鎚	qwnp
鎛	qgef
鎜	temq
鎝	qawk
鎞	qtlx
鎟	qccs
鎠	qlgh
鎡	quxx
鎢	qwno
鎣	oopq
鎤	qjiq
鎥	whtq
鎦	qqyl
鎧	qmgu
鎨	qwyf
鎩	qqsc
鎪	qvhc
鎫	qtmt
鎬	qymk
鎭	qxhw
鎮	qfhw
鎯	qyvb
鎰	quwl
鎱	qfke
鎲	qipq
鎳	qths
鎴	qthn
鎵	qpey
鎶	qskk
鎷	qcy
鎸	qwye
鎹	qudp
鎺	qpyg
鎻	qvmy
鎼	qhar
鎽	qmth
鎾	qjlg
鎿	qwgr
鏀	qhlo
鏁	qvjs
鏂	qakk
鏃	qytd
鏄	qgjf
鏅	qwhe
鏆	qxfm
鏇	qyth
鏈	qlpy
鏉	qgkw
鏋	qamy
鏌	qajd
鏍	qlxi
鏎	qjaf
鏏	qdhv
鏐	qnwe
鏑	qumd
鏒	qcce
鏓	qtln
鏔	qpgw
鏕	qynx
鏗	qahf
鏘	qnhf
鏙	qmwy
鏚	qdht
鏛	qiph
鏜	qipf
鏝	qjlc
鏞	qyvh
鏟	qutg
鏠	qtdp
鏡	qujq
鏢	qsfi
鏣	qyao
鏤	qlvg
鏤	qkgv
鏥	qpwj
鏦	qtwh
鏧	fnmq
鏨	lrqf
鏩	qlrh
鏪	qgmj
鏫	qtjs
鏬	qhah
鏭	qton
鏮	qyvi
鏯	qdqq
鏰	qmee
鏱	qujh
鏲	qyxh
鏳	qulj
鏴	qkhk
鏵	qagf
鏶	qwys
鏷	qogy
鏸	qgjn
鏹	qxkj
鏺	qwxc
鏻	qoqh
鏼	qtgi
鏽	qvhh
鏽	qvfj
鏾	qaet
鏿	qips
鐀	qkhm
鐁	qadr
鐂	qgal
鐃	qffq
鐄	qamw
鐅	umiq
鐆	bueq
鐇	qtol
鐈	qtdk
鐉	qnnw
鐊	qbjr
鐋	qijr
鐌	qqje
鐍	qcbk
鐎	qwyo
鐏	qusf
鐐	qdui
鐑	qxfk
鐒	qool
鐓	qybt
鐔	qsjh
鐕	qaqj
鐖	qxxt
鐗	queg
鐘	qujf
鐙	qwgu
鐚	qghn
鐚	qgfn
鐛	qjyi
鐜	ybtq
鐝	qduw
鐞	qvaf
鐟	qfwj
鐠	quoj
鐡	qfau
鐢	sqqq
鐣	qipr
鐤	qhnn
鐥	qudk
鐦	quga
鐧	qujg
鐨	qxjm
鐩	quep
鐪	qhal
鐫	qwym
鐬	qhdt
鐭	qtmd
鐮	qyuo
鐯	qafj
鐰	qkks
鐱	qwgw
鐲	qlqj
鐳	qflg
鐴	qnku
鐵	qfag
鐶	qlge
鐷	qaas
鐸	qlff
鐹	qmnp
鐺	qipl
鐻	qhae
鐼	qfam
鐽	qfup
鐿	qujn
鑀	qept
鑁	qqot
鑁	qobt
鑂	qtgo
鑃	qnwy
鑄	qfnf
鑅	qoos
鑆	qogf
鑇	qyvf
鑇	qyjg
鑈	qgwq
鑉	qafl
鑊	qawc
鑋	lgvq
鑌	qpgm
鑍	mmqf
鑎	qakm
鑏	qpns
鑐	qfdj
鑑	qahl
鑒	ahnq
鑓	qkhp
鑔	qpwi
鑕	qrrm
鑖	qalt
鑗	qtqi
鑘	qlll
鑙	qtdj
鑚	qfwm
鑛	qyaw
鑜	qipm
鑝	qatp
鑞	qvln
鑟	qflm
鑠	qxrs
鑡	qhwb
鑡	qhbh
鑢	qhan
鑣	qyno
鑤	qjai
鑥	qqoj
鑦	qahm
鑧	qpay
鑨	qued
鑩	qgkk
鑪	qhal
鑬	qahq
鑭	qugi
鑮	qaif
鑯	qwwg
鑰	qwga
鑱	qqky
鑲	qyke
鑳	qpfh
鑴	qmwk
鑵	qaky
鑶	qadt
鑷	qbbb
鑸	qllf
鑹	qpwn
鑺	qhhy
鑻	qsqr
鑼	qlxy
鑽	qtfm
鑾	xyxq
鑿	oguq
钀	qhad
钁	qhhc
钂	qipo
钃	qnij
钄	qaui
钑	qeyy
钖	qnrt
钘	qgah
铇	qqnn
铏	qgaj
铑	qftx
铓	qayn
铔	qgog
铚	qgcf
铦	qtdg
铻	qgkg
铽	qany
锜	qdsk
锠	qjjg
锧	qrfm
锳	qamd
锽	qrgg
镃	quxx
镈	qgef
镋	qipq
镕	qpwk
镚	qmee
镠	qnwe
镮	qlge
镴	qvln
镵	qqky
長	deu
镸	dghy
镹	dqyy
镺	dtdy
镻	drwy
镼	dnbm
镽	ddui
镾	dgwq
門	uhng
閁	ute
閂	ugd
閃	uwi
閄	uwy
閅	usk
閆	udd
閇	ughi
閈	ufk
閉	ufte
閊	umk
開	ugak
閌	uymv
閍	uyv
閎	udci
閏	ugd
閐	utfn
閑	usi
閒	ued
間	ujd
閔	uyi
閕	uaht
閖	uii
閗	uufk
閘	ulk
閙	uymh
閚	uud
閛	uguh
閜	uskd
閝	uwyc
閞	ucak
閟	unte
閠	ugyi
閡	uynw
関	uudi
閣	utkd
閤	uwgk
閥	uwae
閦	uwww
閧	uawi
閨	uffd
閩	uji
閪	usd
閫	ulsi
閬	uyve
閭	ukkd
閮	utfp
閯	uiit
閰	uvd
閱	uwkq
閲	uukq
閳	ulk
閴	umi
閵	uwyd
閶	ujjd
閷	qsuw
閸	ughg
閸	ugfg
閹	udjn
閺	ujyi
閻	uqvd
閼	uywu
閽	uqaj
閾	uakg
閿	uepc
闀	uawn
闁	uud
闂	uudb
闃	uhdi
闄	usvd
闅	uhhc
闆	ukkk
闇	uujd
闈	unhh
闉	usfd
闊	uitd
闋	uwgd
闌	ugli
闍	uftj
闎	urii
闏	umtj
闐	ufhw
闑	uths
闒	ujnd
闓	umgu
闔	ufcl
闕	uubw
闖	uci
闗	uxxo
闘	ugkf
闙	uynk
闚	ufwq
闛	uipf
關	uxxg
闝	umti
闞	unbt
闟	uwgn
闠	ukhm
闡	ukkf
闢	unku
闣	uipl
闤	ulge
闥	ufup
闦	umau
闧	ufkp
闬	ufk
闿	umnv
阇	uftj
阓	ukhm
阘	ujnd
阛	ulge
阞	bln
阠	bnfh
阣	btnn
阤	bbn
阥	biy
阦	boy
阧	bufh
阨	bdbn
阩	btah
阫	bgiy
阬	bymn
阭	bcqn
阯	bhg
阰	bxxn
阷	bghg
阸	bynn
阹	bfcy
阺	bqay
阾	bwyc
陁	btbn
陃	bgmw
陊	bqqy
陎	briy
陏	bdeg
陑	bdmj
陒	bqdb
陓	bdfn
陖	bcwt
陗	bieg
陘	bgva
陙	bdfe
陚	bgah
陜	bdww
陝	bdty
陞	btaf
陠	bgey
陣	blh
陥	bqhj
陦	bdtf
陫	bdjd
陭	bdsk
陮	bwyg
陯	bwga
陰	bwyc
陱	bqoy
陳	bgji
陸	bfwf
陹	btaj
険	bwgw
陻	bsfg
陼	bftj
陽	bjgr
陾	bdmd
陿	badw
隀	btgf
隁	bajv
隂	bwdy
隃	bwgj
隄	bjgh
隇	bdgt
隉	bvag
隊	buey
隌	bujg
階	bxxr
隑	bmgu
隒	buvo
隓	bdaa
隕	bkmy
隖	bwno
隚	bipf
際	bwfi
隝	bwvo
隞	bgqt
隟	bvjs
隠	bevn
隡	butg
隢	bffq
隣	boqh
隤	bkhm
隥	bwgu
隦	bnku
隨	bdap
隩	btmd
險	bwgw
隫	bfam
隬	bgwq
隭	bfdj
隮	byvf
隮	byjg
隯	bfnf
隱	bean
隲	bitc
隴	bued
隵	bhaa
隷	ffii
隸	sfii
隺	pwyd
隻	wycu
隿	awyg
雂	wyny
雃	gawy
雈	gjgy
雊	qkwy
雋	wymm
雐	hawy
雑	vswy
雓	wtwy
雔	wywy
雖	kjwy
雗	fjwy
雘	myac
雙	wywc
雚	akky
雛	qbty
雜	ywwy
雝	vkcy
雞	exdy
雟	btwk
雡	nwey
離	ybmy
難	akfy
雤	wfqy
雤	vqqy
雥	wywy
雦	wywy
雧	wyws
雫	fghu
雬	fsu
雭	feyu
雮	ftfn
雰	fwvb
雱	fyb
雲	ffcu
雴	fuf
雵	fmdu
雸	faff
雺	fcbt
電	fjnb
雼	fdf
雽	ftuh
雿	fiqb
霂	fisu
霃	fipq
霅	fyf
霊	ffog
霋	fgvv
霌	fmfk
霐	fixc
霑	fihk
霒	ffcn
霔	fiyg
霕	ffcn
霗	fiwc
霘	fimk
霙	famd
霚	fcbt
霛	fxxx
霝	fkkk
霟	fiaw
霠	fuwn
霡	feyi
霢	fere
霣	fkmu
霤	fqyl
霥	fpge
霥	fpfe
霦	fsse
霧	fcbl
霨	fnff
霩	fybb
霫	fnrf
霬	flaw
霮	fian
霯	fwgu
霱	fcbk
霳	fbtg
霴	ffci
霵	fkbt
霶	fiuy
霷	fjjr
霺	ftmt
霻	fmau
霼	ffco
霽	fyvf
霽	fyjf
霿	fcbh
靀	fape
靁	flll
靂	fdth
靃	fwyy
靄	fyjn
靅	ffcm
靆	ffcp
靇	fued
靈	fkkw
靉	ffct
靊	fmdu
靊	fdhu
靋	fidh
靌	fpgm
靍	fwyo
靎	fqwo
靏	fpwo
靐	flfl
靑	gmhg
靔	gern
靕	ghge
靗	geiq
靘	geqc
靚	gehq
靜	geeh
靝	gero
靟	djdn
靣	dlkf
靤	dmjn
靦	dmjq
靧	dmjm
靨	djed
靪	afsh
靫	afcy
靬	affh
靭	afvy
靮	afqy
靯	affg
靰	afgq
靱	afvy
靲	afwn
靵	afnf
靷	afxh
靸	afey
靹	afmw
靺	afgs
靻	afeg
靽	afuf
靾	afan
靿	afxl
鞀	afvk
鞁	afhc
鞂	afty
鞃	afxc
鞄	afqn
鞆	afgw
鞇	afld
鞈	afwk
鞉	afiq
鞊	affk
鞌	pvaf
鞎	afve
鞏	amyf
鞐	afhh
鞓	afkg
鞕	afgq
鞖	afev
鞗	whtf
鞙	afke
鞚	afpa
鞛	afuk
鞜	afij
鞝	afik
鞞	afrf
鞟	afyb
鞡	afru
鞢	afas
鞤	ffff
鞥	afwa
鞦	afto
鞧	afug
鞨	afjn
鞩	afij
鞪	cbtf
鞬	afvp
鞮	afjh
鞰	afjl
鞱	afev
鞳	afak
鞵	afed
鞶	temf
鞷	gkmf
鞸	afjf
鞹	afyb
鞺	afif
鞻	aflv
鞻	afkv
鞼	afkm
鞽	aftk
鞾	afaf
鞿	afxt
韀	afyo
韁	afgg
韂	afqy
韃	affp
韄	afac
韅	afjo
韆	afsp
韇	affm
韈	afat
韉	afao
韊	afai
韋	nhkh
韌	nhky
韍	nhkc
韎	nhks
韏	udnh
韐	nhkk
韑	iqnh
韒	nhke
韓	fjnh
韔	nhke
韕	nhkb
韖	nhks
韗	nhkl
韘	nhks
韙	jghh
韚	nhkf
韛	nhke
韜	nhkv
韝	nhkf
韞	nhkl
韟	nhkf
韠	nhkf
韡	nhkf
韢	nhkn
韣	nhkj
韤	nhky
韤	nhkt
韥	nhkm
韨	fnhc
韮	adjg
韯	fadg
韰	hqcg
韱	wwag
韲	yvug
韲	ydjg
韴	ujgh
韷	ujbm
韸	ujth
韹	ujrg
韺	ujad
韻	ujkm
韼	ujtp
韽	wynj
韾	fnmj
響	xtyj
頀	ujac
頁	dmu
頂	sdmy
頃	xdmy
頄	vdmy
項	admy
順	kdmy
頇	fdmy
須	edmy
頉	hdmy
頊	gdmy
頋	dbdm
頌	wcdm
頍	fcdm
頎	rdmy
頏	ymdm
預	cbdm
頑	fqdm
頒	wvdm
頓	gbnm
頔	mdmy
頕	hkdm
頖	uddm
頗	hcdm
領	wycm
頙	ghdm
頚	cfdm
頛	didm
頜	wgkm
頝	uqdm
頞	pvdm
頟	tkdm
頠	qdbm
頡	fkdm
頢	tddm
頣	ahnm
頤	ahkm
頥	hahm
頦	yntm
頧	wnnm
頨	ndmy
頩	uadm
頪	odmy
頫	iqdm
頬	guwm
頭	gkum
頮	iadm
頯	qadm
頰	dwwm
頱	efdm
頲	tfpm
頳	fodm
頴	xfim
頵	vtkm
頶	tfkm
頷	wynm
頸	gvam
頹	tqdm
頺	tedm
頻	hidm
頼	gkim
頽	tmdm
頾	edmx
頿	ehxm
顀	wydm
顁	pghm
顂	swwm
顃	oodm
顄	bibm
顅	ynem
顆	jsdm
顇	ywwm
顈	xxim
顉	qdmy
顊	wnnm
顋	lndm
題	jghm
額	ptkm
顎	kkfm
顏	ydem
顐	pldm
顑	dgkm
顒	jmhm
顓	mdmm
顔	utem
顕	jogm
顖	tlqm
顗	mgkm
願	drim
顙	cccm
顚	xhnm
顛	fhwm
顜	fjgm
顝	medm
類	oddm
顟	nwem
顠	sfim
顡	uedm
顢	amhm
顣	dhim
顤	fffm
顥	jyim
顦	wyom
顧	ynwm
顨	dmdj
顩	wgkm
顪	hdgm
顫	ylkm
顬	fdmm
顭	alpm
顮	pgim
顯	jxxm
顰	hidf
顱	halm
顲	ooym
顳	bbbm
顴	akkm
颋	tfpm
颎	xodm
颒	iadm
颕	xfim
颙	jmhm
颣	oxim
風	mtji
颩	mtje
颪	ghmj
颫	mtjw
颬	mtjt
颭	mtjk
颮	mtjn
颯	umtj
颰	mtjc
颱	mtjk
颲	mtjj
颳	mtjd
颴	mtjh
颵	mtje
颶	mtjw
颷	mtjo
颸	mtjn
颹	mtjh
颺	mtjr
颻	ermj
颼	mtjc
颽	mgkj
颾	mtjj
颿	cmtj
飀	mtjl
飁	nrmj
飂	mtje
飃	mtji
飄	sfij
飅	mtjl
飆	dddj
飇	mtjd
飈	mtjo
飉	mtji
飊	oooj
飋	mtjt
飌	akkj
飍	mtjj
飏	mqnr
飐	mqhk
飔	mqln
飖	ermq
飗	mqql
飛	nutj
飛	nuth
飜	tolj
飜	tolh
飝	nutj
飝	nuth
飠	wyvc
飠	wpu
飡	uwye
飢	wyvm
飢	wpmn
飣	wyvs
飣	wpsh
飤	wyvw
飤	wpwy
飥	wyvn
飥	wpta
飦	wyvf
飦	wpfh
飩	wyvn
飩	wpgn
飪	wyvf
飪	wptf
飫	wyvd
飫	wptd
飬	udye
飭	wyvl
飭	wptl
飮	wyvw
飯	wyvc
飯	wprc
飰	wyvh
飰	wpyh
飱	gqwe
飲	wyvw
飲	wpqw
飳	wyvg
飳	wpyg
飴	wyvk
飴	wpck
飵	wyvf
飵	wptf
飶	wyvt
飶	wpnt
飷	wyvg
飷	wpeg
飸	kgne
飹	wyvb
飹	wpqb
飺	hxwe
飻	wyve
飻	wpwe
飼	wyvk
飼	wpnk
飽	wyvn
飽	wpqn
飾	wyvh
飾	wpth
飿	wyvm
飿	wpbm
餀	wyvq
餀	wpaq
餁	wyvf
餁	wpwf
餂	wyvd
餂	wptd
餃	wyvq
餃	wpuq
餄	wyvk
餄	wpwk
餅	wyva
餅	wpua
餆	wyvq
餆	wpiq
餇	wyvk
餇	wpmk
餈	uqwe
餉	wyvk
餉	wptk
養	udye
餋	udwe
餌	wyvb
餌	wpbg
餎	wyvk
餎	wptk
餏	wyve
餏	wpye
餑	wyvb
餑	wpfb
餒	wyvv
餒	wpev
餓	wyvt
餓	wptt
餔	wyvy
餔	wpgy
餕	wyvt
餕	wpct
餖	wyvu
餖	wpgu
餗	wyvi
餗	wpgi
餘	wyvt
餘	wpwt
餙	wyvh
餙	wpqh
餚	wyve
餚	wpqe
餛	wyvx
餛	wpjx
餜	wyvs
餜	wpjs
餝	wyvy
餝	wpay
餞	wyva
餞	wpaa
餟	wyvc
餟	wpcc
餠	wyvf
餠	wptf
餡	wyvv
餡	wpqv
餢	wyvk
餢	wpuk
餣	wyvn
餣	wpdn
餤	wyvo
餤	wpoo
餥	djde
餦	wyve
餦	wpde
餧	wyvv
餧	wptv
館	wyvn
館	wppn
餩	wyvw
餩	wpww
餪	wyvd
餪	wpdd
餫	wyvl
餫	wppl
餬	wyve
餬	wpde
餭	wyvg
餭	wprg
餯	wyve
餯	wpxe
餰	wyvh
餰	wpth
餱	wyvd
餱	wpwd
餲	wyvn
餲	wpjn
餳	wyvr
餳	wpjr
餴	wyva
餴	wpda
餵	wyve
餵	wple
餶	wyve
餶	wpme
餷	wyvg
餷	wpsg
餸	wyvd
餸	wpup
餹	wyvk
餹	wpyk
餺	wyvf
餺	wpgf
餻	wyvo
餻	wpuo
餼	wyvo
餼	wpro
餽	wyvc
餽	wprc
餾	wyvl
餾	wpql
餿	wyvc
餿	wpvc
饀	wyvv
饀	wpev
饁	wyvl
饁	wpfl
饂	wyvl
饂	wpjl
饃	wyvd
饃	wpad
饄	wyvf
饄	wpif
饅	wyvc
饅	wpjc
饆	wyvf
饆	wpjf
饇	wyvk
饇	wpak
饈	wyvf
饈	wpuf
饉	wyvg
饉	wpag
饊	wyvt
饊	wpat
饋	wyvm
饋	wpkm
饌	wyvw
饌	wpnw
饍	wyvk
饍	wpuk
饎	wyvk
饎	wpfk
饏	nbte
饐	wyvu
饐	wpfu
饑	wyvt
饑	wpxt
饒	wyvq
饒	wpfq
饓	wyvs
饓	wpis
饖	wyvt
饖	wpht
饗	xtye
饘	wyvg
饘	wpyg
饙	wyvm
饙	wpfm
饚	wyvl
饚	wpal
饛	wyve
饛	wpae
饜	djee
饝	wyvd
饝	wpyd
饞	wyvy
饞	wpqy
饟	wyve
饟	wpye
饠	wyvy
饠	wply
饡	wyvm
饡	wptm
饢	wyve
饢	wpge
饤	qnsh
饦	qnta
饳	qnbm
饸	qnwk
饹	qntk
饻	qnye
饾	qngu
馂	qnct
馃	qnjs
馉	qnme
馌	qnfl
馎	qngf
馚	tjwv
馛	tjdc
馜	tjnx
馝	tjnt
馞	tjfb
馟	tjeb
馠	tjwk
馡	tjdd
馢	tjaa
馣	tjdn
馤	tjjn
馦	tjuo
馧	tjjl
馩	tjfm
馪	tjpm
馫	tjtj
馬	cghy
馬	cggy
馭	ccy
馮	ucy
馯	cfh
馰	cqyy
馱	cdy
馲	ctan
馳	cbn
馴	ckh
馵	caj
馶	cfcy
馷	cgmh
馸	crh
馹	cjg
馺	ceyy
馻	ccqn
馼	cyy
馽	ckhj
馾	cpqn
馿	cynt
駀	cdnn
駁	cqqy
駂	xfcy
駃	cnwy
駄	cdyy
駅	cnyy
駆	caqy
駇	cty
駈	crgg
駉	cmkg
駊	chcy
駋	cvkg
駌	qbcu
駍	cguh
駎	cmg
駏	cang
駐	cygg
駑	vccu
駒	cqkg
駓	cgig
駔	cegg
駕	lkcu
駖	cwyc
駗	cwet
駘	cckg
駙	cwfy
駚	cmdy
駛	ckqy
駜	cntt
駝	cpxn
駞	ctbn
駟	clg
駠	cqtb
駡	kkcu
駢	cuah
駣	ciqn
駤	cgcf
駥	cadt
駦	udcu
駧	cmgk
駨	cqjg
駩	cwgg
駪	ctfq
駫	ciqn
駬	cbg
駭	cynw
駮	cuqy
駯	criy
駰	cldy
駱	ctkg
駲	cyth
駳	cthp
駴	caah
駵	cgan
駶	cnnk
駷	cgki
駸	cvpc
駹	cdne
駺	cyve
駻	cjfh
駼	cwty
駽	ckeg
駾	cukq
駿	ccwt
騀	ctrt
騁	cmgn
騂	cuh
騃	cctd
騄	cviy
騅	cwyg
騆	cmfk
騇	cwfk
騈	ctff
騉	cjxx
騊	cqrm
騋	csww
騌	cpfi
騍	cjsy
騎	cdsk
騏	cadw
騐	cwyn
騑	cdjd
騒	ccjy
験	cwgw
騔	cjqn
騕	csvg
騖	cbtc
騗	ynmc
騘	cqrn
騙	cyna
騚	cuej
騛	cnuj
騛	cnuh
騜	crgg
騝	cvfp
騞	cdhd
騟	cwgj
騠	cjgh
騡	criy
騢	cnhc
騣	cqbt
騤	cwgd
騥	ccbs
騦	clny
騧	cmnk
騨	cijf
騩	crqc
騪	cvhc
騫	pfjc
騬	ctux
騭	bhic
騮	cqyl
騯	cupy
騰	eudc
騱	cexd
騲	cajh
騳	ccy
騴	cjpv
騵	cdri
騶	cqbt
騷	ccyj
騸	cynn
騹	cakg
騺	fufc
騻	cdqq
騼	cynx
騽	cnrg
騾	clxi
騿	cujh
驀	ajdc
驁	gqtc
驂	ccce
驃	csfi
驄	ctln
驅	cakk
驆	cjaf
驇	fwfc
驈	ccbk
驉	chag
驊	cagf
驋	cwxc
驌	cvhh
驌	cvfj
驍	cffq
驎	coqh
驏	cnbb
驐	cybt
驑	cgjl
驑	cgal
驒	ckkf
驓	culj
驔	csjh
驕	ctdk
驖	cfag
驗	cwgw
驘	ynky
驙	cylg
驚	aqkc
驛	clff
驜	cogw
驝	cfps
驞	cpgm
驟	cbci
驠	cauo
驡	uegc
驢	chal
驣	cudc
驤	cyke
驥	cuxw
驦	cfsh
驧	cafo
驨	cmwk
驩	caky
驪	cgmx
驫	cccu
驲	cjg
骃	cldy
骉	cccf
骍	cuh
骎	cvpc
骔	cpfi
骕	cvij
骙	cwgd
骦	cfsh
骩	mevn
骪	memy
骫	mevy
骬	megf
骭	mefh
骮	meay
骯	meym
骲	meqn
骳	mehc
骴	mehx
骵	mesg
骹	meuq
骻	medn
骽	meev
骾	megq
骿	meua
髃	mejy
髄	medp
髆	megf
髇	meyk
髈	meuy
髉	mepy
髊	meua
髍	meys
髎	mene
髏	melv
髏	mekv
髐	mefq
髒	meaa
體	memu
髕	mepm
髖	mepy
髗	mehl
髙	yjfk
髚	ymkm
髛	ymkv
髜	ymka
髝	ymkl
髞	ymks
髠	demb
髢	debb
髣	deyb
髤	desu
髥	demf
髧	depq
髨	defq
髩	degn
髪	dedc
髬	degg
髮	dedc
髰	dean
髱	deqn
髲	dehc
髳	dect
髴	dexj
髵	dedj
髶	debf
髷	dema
髸	deaw
髺	detd
髼	deth
髽	dewf
髾	deie
髿	deit
鬀	deut
鬁	detj
鬂	derw
鬄	dejr
鬅	deee
鬆	desc
鬇	deqh
鬉	deqt
鬊	dedj
鬋	deuj
鬌	dede
鬍	dede
鬎	degj
鬐	defj
鬑	deuo
鬒	defw
鬔	detp
鬕	dead
鬖	dece
鬗	deay
鬘	dejc
鬙	deuj
鬚	deem
鬛	deln
鬜	deue
鬝	deuj
鬞	deme
鬠	dewj
鬡	deps
鬢	depm
鬤	deye
鬥	hggh
鬦	hggf
鬧	hggh
鬨	hggw
鬩	hggq
鬪	hggf
鬫	hggt
鬬	hggr
鬭	hggr
鬮	hggx
鬮	hggg
鬰	sqqe
鬱	srme
鬳	hagh
鬴	gkmy
鬵	aqah
鬶	fwmh
鬷	gkmt
鬸	gkml
鬹	fwhh
鬺	gkmr
鬽	rqce
鬾	rqcc
鬿	rqcr
魀	rqcj
魆	rqct
魊	rqcg
魋	rqcy
魌	rqcw
魎	rqcy
魐	rqco
魒	rqci
魓	rqcf
魕	rqct
魖	rqcg
魗	fnac
魘	djec
魙	ilrc
魚	qou
魛	qovn
魜	qowy
魝	qojh
魞	qoty
魟	qoag
魠	qota
魡	qoqy
魢	qonn
魣	qocb
魤	qowx
魥	qoey
魦	qoit
魧	qoym
魨	qogn
魩	qoqr
魪	qowj
魫	qopq
魬	qorc
魭	qofq
魮	qoxx
魯	qojf
魰	qoyy
魱	qogg
魲	qoyn
魳	qogh
魴	qoyn
魵	qowv
魶	qomw
魷	qodn
魸	qotn
魹	qotn
魺	qosk
魻	qolh
魼	qofc
魽	qoaf
魾	qogg
魿	qowc
鮀	qopx
鮁	qodc
鮂	qolw
鮃	qogh
鮄	qoxj
鮅	qont
鮆	hxqo
鮇	qofi
鮈	qoqk
鮉	qovk
鮊	qorg
鮋	qomg
鮌	qoyx
鮍	qohc
鮎	qohk
鮏	qotg
鮐	qock
鮑	qoqn
鮒	qowf
鮓	qotf
鮔	qoan
鮕	qodg
鮖	qodg
鮗	qotu
鮘	qowa
鮙	qong
鮚	qofk
鮛	qohi
鮜	qork
鮝	udqo
鮞	qodj
鮟	qopv
鮠	qoqb
鮡	qoiq
鮢	qori
鮣	qoqb
鮤	gqjo
鮥	qotk
鮦	qomk
鮧	qogw
鮨	qoxj
鮩	qoua
鮪	qode
鮫	qouq
鮬	qodn
鮭	qoff
鮮	qoud
鮯	qowk
鮰	qolk
鮱	qofx
鮲	qowd
鮳	qofn
鮴	qows
鮵	qouq
鮶	qovk
鮷	qout
鮸	qoqq
鮹	qoie
鮺	udqo
鮻	qoct
鮼	qovc
鮽	qowt
鮾	qoev
鮿	qobn
鯀	qoti
鯁	qogq
鯂	qosg
鯃	qogk
鯄	qofy
鯅	qotp
鯆	qogy
鯇	qopq
鯈	whto
鯉	qojf
鯊	iito
鯋	qoit
鯌	qotk
鯍	qoyq
鯎	qodt
鯏	qotj
鯐	qofh
鯑	qoqh
鯒	qoce
鯓	qott
鯔	qovl
鯕	qoaw
鯖	qoge
鯗	udyo
鯘	qotv
鯙	qoyb
鯚	qotb
鯛	qomk
鯜	qouv
鯝	qold
鯞	qovh
鯟	qogi
鯠	qosw
鯡	qodd
鯢	qovq
鯣	qojr
鯤	qojx
鯥	qoff
鯦	qotk
鯧	qojj
鯨	qoyi
鯩	qowa
鯪	qoft
鯫	qobc
鯬	tqto
鯭	qobl
鯮	qopi
鯯	qorj
鯰	qown
鯱	qohm
鯲	qoyu
鯳	qoyy
鯴	qonj
鯵	qoce
鯶	qopl
鯷	qojh
鯸	qowd
鯹	qojg
鯺	qofj
鯻	qogj
鯼	qoqt
鯽	qovb
鯾	qowq
鯿	qoya
鰀	qoec
鰁	qori
鰂	qomj
鰃	qole
鰄	qodt
鰅	qojy
鰆	qodj
鰇	qocs
鰈	qoas
鰉	qorg
鰊	qogi
鰋	qoav
鰌	qoug
鰍	qoto
鰎	qovp
鰏	qogl
鰐	qokn
鰑	qojr
鰒	qott
鰓	qoln
鰔	qodt
鰕	qonc
鰖	qode
鰗	qode
鰘	qopf
鰙	qoak
鰚	qopg
鰛	qojl
鰜	qouo
鰝	qoyk
鰞	qowo
鰟	qouy
鰠	qocj
鰡	qoql
鰢	qocy
鰣	qojf
鰤	qowh
鰥	qoli
鰦	qoux
鰧	eudo
鰨	qojn
鰩	qoem
鰪	qofl
鰫	qopk
鰬	qohy
鰭	qofj
鰮	qoll
鰯	qoxu
鰰	qoph
鰱	qolp
鰲	gqto
鰳	qoal
鰴	qomt
鰵	txgo
鰶	qowi
鰷	qows
鰸	qoak
鰹	qoaf
鰺	qoce
鰻	qojc
鰼	qonr
鰽	qogj
鰾	qosi
鰿	qogm
鱀	vcao
鱁	qoep
鱂	qonf
鱃	qouf
鱄	qogf
鱅	qoyh
鱆	qouj
鱇	qoyi
鱈	qofv
鱉	umio
鱊	qock
鱋	qohg
鱌	qoqe
鱍	qowc
鱎	qotk
鱏	qosj
鱐	qovj
鱐	qovh
鱑	qoaw
鱒	qouf
鱓	qokf
鱔	qouk
鱕	qotl
鱖	qodw
鱗	qooh
鱘	qovf
鱙	qofq
鱚	qofk
鱛	qouj
鱜	qoxb
鱝	qofm
鱞	qole
鱟	wfqo
鱟	vqqo
鱠	qowj
鱡	qomd
鱢	qoks
鱣	qoyg
鱤	qodn
鱥	qoht
鱦	qoxg
鱦	qomv
鱧	qomu
鱨	qoij
鱩	qofl
鱪	qojj
鱫	qoet
鱬	qofj
鱭	qoyj
鱭	qoyf
鱮	qoww
鱮	qovw
鱯	qoac
鱰	qolj
鱱	qody
鱲	qovn
鱳	qoxs
鱴	qoat
鱵	qott
鱶	qoue
鱷	qogk
鱸	qohl
鱹	qoay
鱺	qogx
鱻	qoqo
鱽	qgvn
鱾	qgnn
鲀	qggn
鲃	qgcn
鲄	qgsk
鲉	qgmg
鲊	qgtf
鲌	qgrg
鲏	qghc
鲓	qgfn
鲕	qgdj
鲖	qgmk
鲗	qgmj
鲘	qgrk
鲙	qgwc
鲝	udqg
鲪	qgvk
鲬	qgce
鲯	qgaw
鲴	qgld
鲹	qgce
鲾	qggl
鲿	qgic
鳀	qgjh
鳁	qgjl
鳂	qgle
鳈	qgri
鳉	qguf
鳋	qgcj
鳑	qguy
鳒	qguo
鳚	qgnf
鳛	qgnr
鳠	qgac
鳡	qgdn
鳣	qgyg
鳤	qgtn
鳥	wvgo
鳦	wvgn
鳧	wvgm
鳨	wvgl
鳩	vwvo
鳪	hwvo
鳫	dwvo
鳬	wvgm
鳭	vwvo
鳮	cwvo
鳯	mwvo
鳰	tywo
鳱	fwvo
鳲	nwvo
鳳	mdho
鳴	kwvo
鳵	nfwo
鳶	awvo
鳷	fcwo
鳸	ynwo
鳹	wyno
鳺	fwwo
鳻	wvwo
鳼	ywvo
鳽	gawo
鳾	gmho
鳿	gwvo
鴀	giwo
鴁	tdwo
鴂	nwwo
鴃	wvgw
鴄	aqwo
鴅	mywo
鴆	pqwo
鴇	xfwo
鴈	dwwo
鴉	ahto
鴊	ghwo
鴋	ywvo
鴌	gdwo
鴍	ywvo
鴎	aqwo
鴏	wvga
鴐	lkwo
鴑	vcwo
鴒	wyco
鴓	ntwo
鴔	tpwo
鴕	wvgx
鴖	nawo
鴗	uwvo
鴘	cawo
鴙	tdwo
鴚	wvgk
鴛	qbwo
鴜	hxwo
鴝	qkwo
鴞	kgno
鴟	qayo
鴠	jgwo
鴡	egwo
鴢	xlwo
鴣	dwvo
鴤	wvgu
鴥	wvgw
鴦	mdwo
鴧	pmwo
鴨	lwvo
鴩	rwwo
鴪	pwwo
鴫	lwvo
鴬	ipwo
鴭	wnno
鴮	dfno
鴯	dmjo
鴰	tdwo
鴱	aqwo
鴲	xjwo
鴳	pvwo
鴴	tfho
鴵	iqwo
鴶	fkwo
鴷	gqjo
鴸	riwo
鴹	udwo
鴺	gxwo
鴻	iawo
鴼	wvgk
鴽	vkwo
鴾	crho
鴿	wgko
鵀	wtfo
鵁	uqwo
鵂	wswo
鵃	tewo
鵄	gcfo
鵅	tkwo
鵆	twvh
鵇	rhfo
鵈	bwvo
鵉	yowo
鵊	dwwo
鵋	nnwo
鵌	wvgt
鵍	pfqo
鵎	evwo
鵏	geho
鵐	awwo
鵑	kewo
鵒	wwko
鵓	fpbo
鵔	wvgt
鵕	cwto
鵖	vcwo
鵗	qdmo
鵘	vtko
鵙	mwvo
鵚	tmwo
鵛	gvao
鵜	uxho
鵝	trno
鵞	trno
鵟	qtgo
鵠	tfko
鵡	gaho
鵢	tmdo
鵣	gkio
鵤	qewo
鵥	udjo
鵦	wvgi
鵧	uawo
鵨	wfko
鵩	ebco
鵪	djno
鵫	hjwo
鵬	eewo
鵭	qwvo
鵮	qvwo
鵯	rtfo
鵰	mfko
鵱	fwfo
鵲	ajwo
鵳	yneo
鵴	qowo
鵵	qkqo
鵶	ghgo
鵶	gfgo
鵷	pqbo
鵸	dsko
鵹	tqto
鵺	ywto
鵻	wvgy
鵼	pwao
鵽	ccco
鵾	jxxo
鵿	wvga
鶀	wvgw
鶁	yiwo
鶂	vqwo
鶃	wvgq
鶄	gewo
鶅	vlwo
鶆	swwo
鶇	gjio
鶈	gvho
鶉	ybwo
鶊	yvwo
鶋	ndwo
鶌	nbmo
鶍	jqro
鶎	pfio
鶏	efwo
鶐	sypo
鶑	oowo
鶒	gkio
鶓	alwo
鶔	cbto
鶕	ujwo
鶖	towo
鶗	jgho
鶘	dewo
鶙	upmo
鶚	kkfo
鶛	xxro
鶜	acbo
鶝	gklo
鶞	rfho
鶟	pwdo
鶠	ajvo
鶡	jqwo
鶢	efto
鶣	ynmo
鶤	plwo
鶥	nhwo
鶦	dewo
鶧	amdo
鶨	xewo
鶩	cbto
鶪	hdwo
鶫	glio
鶬	wyvo
鶭	xywo
鶮	ymko
鶯	oopo
鶰	kmwo
鶱	pfjo
鶲	wcno
鶳	wvgh
鶴	pwyo
鶵	qbto
鶶	yvho
鶷	pdho
鶸	xuxo
鶹	qyvo
鶺	iweo
鶻	mewo
鶼	uvoo
鶽	wyfo
鶾	fjwo
鶿	uxxo
鷀	uxxo
鷁	uwlo
鷂	ermo
鷃	jpvo
鷄	exdo
鷅	sswo
鷆	xhno
鷇	fpdc
鷈	wvgm
鷉	rhao
鷊	gkmo
鷋	awto
鷌	wvgc
鷍	thso
鷎	rdfo
鷏	fhwo
鷐	jdfo
鷑	tuwo
鷒	gjho
鷓	yaoo
鷔	gqto
鷕	kwyo
鷖	atdo
鷗	akko
鷘	gkio
鷙	fufo
鷚	nweo
鷛	yveo
鷜	lvwo
鷜	kgko
鷝	jafo
鷞	dqqo
鷟	ytto
鷠	qowo
鷡	rlgo
鷢	dubo
鷣	sjwo
鷤	kkjo
鷥	xxio
鷦	wyoo
鷧	fpgo
鷨	agao
鷩	umio
鷪	hhpo
鷫	vhto
鷫	vfjo
鷬	amwo
鷭	tolo
鷮	tdko
鷯	dujo
鷰	auko
鷱	thio
鷲	yido
鷳	uewo
鷴	uswo
鷵	nfto
鷶	lmwo
鷷	usgo
鷸	cbto
鷹	ywwo
鷺	khto
鷻	wvgt
鷼	ujwo
鷽	wfqo
鷽	vqqo
鷾	ujno
鷿	nkuo
鸀	lqjo
鸁	ynky
鸂	iexo
鸃	wvgt
鸄	ryto
鸅	lfuo
鸆	hako
鸇	ylko
鸈	oguo
鸉	sjgo
鸊	nkuo
鸋	pnlo
鸌	wvgc
鸍	gwmo
鸎	mmwo
鸏	apgo
鸏	apfo
鸐	nwyo
鸑	qtyo
鸒	wfgo
鸒	vgno
鸓	lllo
鸔	wvgi
鸕	halo
鸖	fwyo
鸗	uego
鸘	fsho
鸙	wgko
鸚	mmvo
鸛	akko
鸜	hhwo
鸝	gmyo
鸞	xyxo
鸤	nqyg
鸧	wbqg
鸮	kgng
鸰	wycg
鸴	ipqg
鸻	tfhg
鸼	teqg
鹀	awwg
鹍	jxxg
鹐	qvqg
鹒	yvwg
鹓	pqbg
鹔	vijg
鹖	jqwg
鹙	toqg
鹝	gkmg
鹟	wcng
鹠	qyvg
鹡	iweg
鹢	uwlg
鹥	atdg
鹮	lgkg
鹯	ylkg
鹲	apgg
鹲	apfg
鹴	fshg
鹵	hlqo
鹵	hlou
鹶	hlqn
鹶	hlon
鹷	hlqc
鹷	hloc
鹸	hlqw
鹸	hlow
鹹	hlqt
鹹	hloy
鹺	hlqa
鹺	hloa
鹻	hlqo
鹻	hloo
鹼	hlqw
鹼	hlow
鹽	ahnl
麀	ynjx
麁	qynx
麃	ynjo
麄	wvyx
麅	ynjn
麆	ynjg
麉	ffyx
麊	oynx
麌	ynjd
麍	ynjq
麎	ynje
麏	ynjk
麐	ynjk
麑	ynjq
麔	ynjk
麕	ynjt
麖	ynji
麗	gmyx
麘	ynjj
麙	ynjt
麚	ynjc
麛	ynjb
麜	ynjs
麞	ynjj
麠	ynjg
麡	ynjj
麡	ynjf
麢	ynjk
麣	ynjt
麤	ynjx
麥	swwt
麧	swwn
麨	swwt
麩	swww
麪	swwn
麫	swwn
麬	swwc
麭	swwn
麮	swwc
麯	swwa
麰	swwh
麱	swwy
麲	swwq
麳	swww
麵	swwd
麶	swwc
麷	swwu
麹	gtqo
麺	gtdd
麼	yssx
麿	yssk
黀	yssc
黁	yssj
黂	yssm
黃	agmw
黅	amwn
黆	amwq
黇	amwk
黈	amwg
黊	amwf
黋	iqaw
黌	wfqw
黌	vqqw
黐	twic
黒	jfou
黓	lfoa
黕	lfoq
黖	lfoq
黗	lfon
黙	jfdo
黚	lfof
點	lfok
黡	ddlo
黣	lfou
黤	lfon
黦	lfob
黨	ipko
黫	lfof
黬	lfot
黭	lfoa
黮	lfon
黰	lfow
黱	eudo
黲	lfoe
黳	atdo
黴	tmgt
黵	lfoy
黶	djeo
黷	lfom
黸	lfol
黺	oguv
黽	xhng
黽	mggv
黿	fqxf
黿	fqmv
鼀	fwxf
鼀	fwmv
鼁	fcxf
鼁	fcmv
鼂	jgxf
鼂	jgmv
鼃	ffxf
鼃	ffmv
鼄	rixf
鼄	rimv
鼅	tdkx
鼅	tdkv
鼆	pjux
鼆	pjuv
鼇	gqtx
鼇	gqtv
鼈	umix
鼈	umiv
鼉	kklx
鼉	kklv
鼊	nkux
鼊	nkuv
鼌	jgkn
鼏	phnn
鼑	hhnn
鼒	fthn
鼔	fkuc
鼕	fkuu
鼖	fafc
鼘	fkuh
鼘	fkug
鼚	fkue
鼛	fkuk
鼜	fkuj
鼝	ithc
鼝	ijgc
鼞	fkuf
鼟	fkuu
鼡	imfh
鼢	vnuv
鼣	vnud
鼤	vnuy
鼥	vnuc
鼦	vnuk
鼧	vnux
鼨	vnuu
鼩	vnuk
鼪	vnug
鼫	vnud
鼭	vnuf
鼮	vnup
鼰	vnum
鼱	vnue
鼲	vnul
鼳	vnud
鼴	vnuv
鼵	vnud
鼶	vnum
鼸	vnuo
鼺	vnul
鼼	thlh
鼿	thlq
齀	thln
齁	thlk
齂	thli
齃	thln
齄	thlg
齅	thld
齆	thlc
齇	thlg
齈	thle
齉	thle
齊	yvuf
齊	yjf
齋	yvui
齋	yjiu
齌	yvuo
齌	yjou
齍	yvul
齍	yjlf
齎	yvum
齎	yjmu
齏	yvug
齏	yjdg
齒	hwwb
齒	hbj
齓	hwwn
齓	hbnn
齔	hwwx
齔	hbxn
齕	hwwn
齕	hbtn
齖	hwwt
齖	hbat
齗	hwwr
齗	hbrh
齘	hwwj
齘	hbwj
齙	hwwn
齙	hbqn
齚	hwwf
齚	hbtf
齛	hwwn
齛	hban
齜	hwwx
齜	hbhx
齝	hwwk
齝	hbck
齞	hwww
齞	hbkw
齟	hwwg
齟	hbeg
齠	hwwk
齠	hbvk
齡	hwwc
齡	hbwc
齢	hobc
齣	hwwk
齣	hbqk
齤	udhb
齥	hwwx
齥	hbjx
齦	hwwe
齦	hbve
齧	dhvb
齨	hwwv
齨	hbvg
齩	hwwq
齩	hbuq
齪	hwwh
齪	hbkh
齫	hwws
齫	hbls
齬	hwwk
齬	hbgk
齭	hwwr
齭	hbrr
齮	hwwk
齮	hbdk
齯	hwwq
齯	hbvq
齰	hwwj
齰	hbaj
齱	hwwc
齱	hbbc
齲	hwwy
齲	hbty
齳	hwwl
齳	hbpl
齴	hwwe
齴	hbue
齵	hwwy
齵	hbjy
齶	hwwn
齶	hbkn
齷	hwwf
齷	hbnf
齸	hwwl
齸	hbul
齹	udab
齺	hwwt
齺	hbqt
齻	hwww
齻	hbfw
齼	hwwh
齼	hbsh
齽	hwwi
齽	hbsi
齾	hagb
龁	hwbn
龂	hwbr
龍	uegd
龎	dued
龏	uega
龐	yued
龑	uegd
龒	uegi
龓	deud
龔	uegw
龕	wgkd
龖	uegd
龗	fkkd
龘	uegd
龜	txd
龜	tmgg
龝	ttxg
龝	ttmg
龞	umix
龞	umig
龡	wgkw
龢	wgkt
龣	wgki
龤	wgkr
龥	wgkm
	rtt
	dgt
	ttg
	nnll
	nnll
	wqbt
	wqvg
	qtn
	bnn
	cny
	kkmw
	kunt
	kunt
	ihyt
	nhty
	nqbt
	nqvg
	rtgt
	rmqy
	rian
	rwyc
	rccy
	gggg
	aghg
	smqy
	gqkm
	idpy
	tfd
	dwi
	ipb
	nhd
	hovg
	tcde
	ttgy
	xmg
	pqb
	udr
	ugf
	fae
	dilx
	dilc
	vhgd
	efny
	apwl
	pukm
	pukm
	udi
	yrh
	yauo
	mgeg
	mgeg
	khf
	qynn
	qaht
	qnty
	qynn
	qafj
	qudk
	qhhc
	uwwf
	uqvh
	uwwf
	uqvh
	fjj
	oopb
	haqt
	qgqb
	qgdj
	qgug
	haqt
	eudg
	gmhg
	uqqg
	gqjg
	geqg
	hdqg
	rhag
	nkug
	dxgd
	xyxy
郎	yveb
凉	uyiy
秊	ttfj
裏	yjfe
隣	boqh
兀	gqv
嗀	fpgc
﨎	ywyc
﨏	fwwk
﨑	musk
﨑	mukh
﨓	sawf
﨔	siwr
礼	finn
﨟	aejn
蘒	attx
蘒	attg
﨡	jtgg
﨣	fhuf
﨤	eyyp
﨧	qftb
﨨	qfuf
﨩	bwvm
