的	rqyy
一	ggll
是	jghu
了	bnh
不	gii
在	dhfd
有	def
個	wldg
人	wwww
這	ypd
上	hhgg
中	khk
大	dddd
為	ytno
來	swwi
我	trnt
到	gcfj
出	bmk
要	svf
以	nywy
時	jffy
和	tkg
地	fbn
們	wug
得	tjgf
可	skd
下	ghi
對	oguf
生	tgd
也	bnhn
子	bbbb
就	yidn
過	mnmp
能	cexx
他	wbn
會	wglj
多	qqu
發	wxmc
説	yukq
而	dmjj
於	ywuy
自	thd
之	pppp
用	etnh
年	rhfk
行	tfhh
家	peu
方	yygn
後	txty
作	wthf
成	dnnt
開	ugak
面	dmjd
事	gkvh
好	vbg
小	ihty
心	nyny
前	uejj
所	rnrh
道	uthp
法	ifcy
如	vkg
進	wypd
着	udhf
同	mgkd
經	xgva
分	wvb
定	pghu
都	ftjb
然	qdou
與	wfgw
與	vgnw
本	sgd
還	lgkp
其	adwu
當	ipkl
起	fhnv
動	tgjl
已	nnnn
兩	gmhy
點	lfok
從	twwh
問	ukd
裏	yjfe
主	ygd
實	pxfm
天	gdi
高	ymkf
去	fcu
現	ghqn
長	deu
此	hxn
三	dggg
將	nhdf
無	rlgo
國	lakg
全	wgf
文	yygy
理	gjfg
明	jeg
日	jjjj
些	hxff
看	rhf
只	kwu
公	wcu
等	tffu
十	fgh
意	ujnu
正	ghd
外	qhy
想	shnu
間	ujd
把	rcn
情	ngeg
者	ftjf
沒	iqcy
重	tgjf
相	shg
那	vfbh
向	tmkd
知	tdkg
因	ldi
樣	sugi
學	wfqb
學	vqqb
應	ywwn
又	cccc
手	rtgh
但	wjgg
信	wyg
關	uxxg
使	wgkq
種	ttgf
見	hqb
力	ltn
名	qkf
二	fgg
處	hatm
門	uhng
並	uogf
口	kkkk
麼	yssx
先	tfqb
位	wug
頭	gkum
回	lkd
話	ytdg
很	tvey
再	gmfd
由	mhng
身	tmdt
入	tyi
內	mtyi
第	txht
平	guhk
被	puhc
給	xwgk
次	uqwy
別	kqjh
幾	xxdt
月	eeee
真	fhwu
立	uuuu
新	usrh
通	cepk
少	itr
機	sxxt
打	rsh
水	iiii
果	jsi
最	jbcu
部	ukbh
何	wskg
安	pvf
接	ruvg
報	fufc
聲	fnmb
才	fte
體	memu
今	wynb
合	wgkf
性	ntgg
西	sghg
你	wqiy
放	yty
表	geu
目	hhhh
加	lkg
常	ipkh
做	wdty
己	nngn
老	ftxb
四	lhng
件	wrhh
解	qevh
路	khtk
更	gjqi
走	fhu
比	xxn
總	xtln
金	qqqq
管	tpnn
光	iqb
工	aaaa
結	xfkg
提	rjgh
任	wtfg
東	gjii
原	drii
便	wgjq
美	ugdu
及	eyi
教	ftbt
難	akfy
世	anv
至	gcff
氣	rnou
神	pyjh
山	mmmm
數	lvty
數	kgkt
利	tjh
書	vfjf
代	way
直	fhf
色	qcb
場	fjgr
變	xyxt
記	ynn
張	xdey
必	nte
受	epcu
交	uqu
非	djdd
服	ebcy
化	wxn
求	fiyi
風	mtji
度	yaci
太	dyi
萬	ajmy
各	tkf
算	thaj
邊	thpp
王	gggg
什	wfh
快	nnwy
許	ytfh
連	lpk
五	gghg
活	itdg
思	lnu
該	yynw
步	hir
海	itxu
指	rxjg
物	trqr
則	mjh
女	vvvv
或	akgd
完	pfqb
馬	cghy
馬	cggy
強	xcjy
言	yyyy
條	whts
特	trff
命	wgkb
感	dgkn
清	igeg
帶	aqph
認	yvyn
保	wksy
望	yneg
轉	lgjf
傳	wgjf
兒	vqb
制	rmhj
幹	fjwf
計	yfh
民	nav
白	rrrr
住	wygg
字	pbf
它	pxb
義	ugtt
車	lghh
像	wqje
反	rci
象	qjeu
題	jghm
卻	wwkb
流	iycq
且	egd
即	vcbh
深	ipws
近	rpk
形	gaet
取	bcy
往	tygg
系	txiu
量	jgjf
論	ywga
告	tfkf
息	thnu
讓	yyke
決	inwy
未	fii
花	awxb
收	nhty
滿	iamy
每	txgu
華	agaf
業	oguw
南	fmuf
覺	wfqq
覺	vqqq
電	fjnb
空	pwaf
眼	hvey
聽	bgfn
遠	fkwp
遠	fkep
師	wnnh
元	fqb
請	ygeg
容	pwwk
她	vbn
軍	plj
士	fghg
百	djf
辦	uluh
語	ygkg
期	adwe
北	uxn
林	ssy
識	yuaj
半	ufk
夫	fwi
客	ptkf
戰	kkja
院	bpfq
城	fdnt
候	whnd
單	kkjf
音	ujf
台	ckf
死	gqxb
視	pyhq
領	wycm
失	rwi
司	ngkd
親	ushq
始	vckg
極	sbkg
雙	wywc
令	wycu
改	nty
功	aln
程	tkgg
愛	epnt
德	tfln
復	ttjt
切	avn
隨	bdap
李	sbf
員	kmu
離	ybmy
輕	lgva
觀	akkq
青	gef
足	khu
落	aitk
叫	knhh
根	svey
怎	thfn
持	rffy
精	ogeg
送	udpi
眾	lwwy
眾	lwww
眾	lwwu
影	jyie
八	wty
首	uthf
包	qnv
準	iwyf
興	wfmw
興	vmgw
紅	xag
達	fudp
早	jhnh
盡	vhgl
故	dty
房	ynyv
引	xhh
火	oooo
站	uhkg
似	wnyw
找	rat
備	wate
調	ymfk
斷	xxgr
設	ymcy
格	stkg
消	iieg
拉	rug
照	jvko
布	dmhj
友	dcu
整	gkih
術	tsyh
石	dgtg
展	naei
緊	ahni
據	rhae
終	xtuy
周	mfkd
式	aad
舉	wfgh
舉	vgnh
飛	nutj
飛	nuth
片	thgn
雖	kjwy
易	jqrr
運	plpk
笑	ttdu
雲	ffcu
建	vfhp
談	yooy
界	lwjj
務	cbtl
寫	pvqo
錢	qaat
商	umwk
樂	xrxs
推	rwyg
注	iygg
越	fhat
千	tfk
微	tmgt
若	adkf
約	xqyy
英	amdu
集	wysu
示	fiu
呢	knxn
待	tffy
坐	wwff
議	yugt
乎	tuhk
留	qyvl
稱	temf
品	kkkf
志	fnu
黑	lfou
存	dhbd
六	uygy
造	tfkp
低	wqay
江	iag
念	wynn
產	ydtg
刻	yntj
節	tvcb
爾	gwmq
吃	ktnn
勢	fwfl
依	wyey
圖	lkfk
共	awu
曾	uljf
響	xtyj
底	yqay
裝	nhde
具	hwu
喜	fkuk
嚴	kkdt
九	vtn
況	ikqn
跟	khve
羅	lxwy
須	edmy
顯	jxxm
熱	fwfo
病	ugmw
證	ywgu
剛	mumj
治	ickg
絕	xvcn
羣	vtkd
市	ymhj
陽	bjgr
確	dpwy
究	pwvb
久	qyi
除	bwty
聞	ubd
答	twgk
段	wdmc
官	pnhn
政	ghty
類	oddm
黃	agmw
武	gahd
七	agn
支	fcu
費	xjmu
父	wqu
統	xycq
府	ywfi
查	sjgf
般	temc
斯	adwr
倒	wgcj
突	pwdu
號	kgnm
樹	sfkf
拿	wgkr
克	dqb
初	puvn
廣	yamw
奇	dskf
願	drim
歡	akkw
希	qdmh
母	xgui
香	tjf
破	dhcy
誰	ywyg
致	gcft
線	xriy
急	qvnu
古	dghg
既	vcaq
句	qkd
京	yiu
甚	adwn
仍	wen
晚	jqkq
爭	evhj
遊	ytbp
龍	uegd
餘	wyvt
餘	wpwt
護	yawc
另	klb
器	kkdk
細	xlg
木	ssss
權	saky
星	jtgf
哪	kvfb
苦	adf
孩	bynw
試	yaag
朝	fjeg
阿	bskg
隊	buey
居	ndd
害	pdhk
獨	qtlj
講	yfjf
錯	qajg
局	nnkd
男	llb
差	udaf
參	ccce
社	pyfg
換	rqmd
選	nnap
止	hhhg
際	bwfi
假	wnhc
漢	iakw
夠	qqqk
訴	yryy
資	uqwm
密	pntm
案	pvsu
史	kqi
較	luqy
環	glge
投	rmcy
靜	geeh
寶	pgrm
專	gjhf
修	whte
室	pgcf
區	akkk
料	oufh
幫	fffh
衣	yeu
竟	ujqb
模	sajd
臉	ewgw
善	uduk
兵	rgwu
考	ftgn
規	fwhq
聯	bxxg
團	lgjf
冷	uwyc
玉	gyi
施	ytbn
派	irey
紀	xnn
採	resy
歷	dtth
顧	ynwm
春	dwjf
責	gmu
夜	ywty
畫	vflg
驚	aqkc
銀	qvey
負	qmu
續	xflm
嗎	kcy
簡	tujf
章	ujj
左	daf
塊	frqc
索	fpxi
酒	isgg
值	wfhg
態	cexn
按	rpvg
陳	bgji
河	iskg
巴	cnhn
衝	ttgh
陣	blh
境	fujq
助	egln
角	qej
户	yne
亂	ecmn
呼	ktuh
靈	fkkw
腳	ewwb
繼	xxxn
樓	slvg
樓	skgv
景	jyiu
怕	nrg
停	wyps
鐵	qfag
異	lawu
謝	ytmf
否	gikf
傷	wtjr
蘭	augi
置	lfhf
醫	atdg
良	yvei
承	bdii
福	pygl
科	tufh
屬	nilj
圍	lnhh
需	fdmj
退	vepi
基	adwf
右	dkf
速	gkip
適	umdp
藥	axrs
懷	nyle
擊	lbmr
買	lmu
素	gxiu
背	uxef
歲	hdgt
土	ffff
忙	nynn
充	ycqb
排	rdjd
價	wsmy
質	rrmu
遇	jmhp
端	umdj
列	gqjh
印	qgbh
貴	khgm
疑	xtdh
露	fkhk
哥	sksk
殺	qsmc
標	ssfi
招	rvkg
血	tld
禮	pymu
弟	uxht
亮	ypmb
齊	yvuf
齊	yjf
穿	pwat
腦	evtq
委	tvf
州	ytyh
某	afsu
順	kdmy
省	ithf
討	yfy
尚	imkf
維	xwyg
板	srcy
散	aety
項	admy
狀	nhdd
追	wnnp
筆	tvfh
副	gklj
層	nulj
沙	iitt
養	udye
讀	yflm
習	nrf
永	ynii
草	ajj
胡	deg
濟	iyvf
濟	iyjg
執	fufy
察	pwfi
歸	wnnh
富	pgkl
座	ywwf
雨	fghy
堂	ipkf
威	dgvt
忽	qrnu
蘇	aqot
船	temk
罪	ldjd
敢	nbty
婦	vvph
村	sfy
著	aftj
食	wyve
導	uthf
免	qkqb
温	ijlg
莫	ajdu
掌	ipkr
激	iryt
慢	njlc
託	ytan
勝	eudl
險	bwgw
尋	vakf
守	pfu
波	ihcy
雷	flf
沉	ipmn
秀	teb
職	buaj
驗	cwgw
靠	tfkd
楚	ssnh
略	ltkg
族	yttd
藏	adnt
麗	gmyx
漸	ilrh
劉	qyvj
僅	wakg
肯	hef
擔	rqdy
揚	rjgr
盤	teml
唐	yvhk
鍾	qtgf
級	xeyy
毛	tfnv
營	oopk
堅	ahnf
鬆	desc
皮	hci
供	wawy
店	yhkd
飯	wyvc
飯	wprc
範	tlbb
哈	kwgk
趕	fhjf
吧	kcn
雪	fvf
鬥	hggh
效	uqty
臨	ahnk
農	made
味	kfiy
惡	ghgn
惡	gfgn
煙	osfg
園	lfky
園	lfke
烈	gqjo
配	sgnn
雜	ywwy
短	tdgu
衞	tnhh
跳	khiq
孫	btxi
曲	mad
封	fffy
抓	rrhy
移	tqqy
頓	gbnm
律	tvfh
賣	flmu
藝	afwc
舊	awyv
朋	eeg
救	fiyt
防	byn
脱	eukq
翻	toln
劃	vflj
迎	qbpk
痛	ucek
校	suqy
窗	pwtq
宣	pgjg
鄉	xtyb
楊	sjgr
葉	aans
警	aqky
限	bvey
湖	ideg
軟	lqwy
掉	rhjh
財	mftt
詞	yngk
壓	djef
揮	rplh
超	fhvk
屋	ngcf
秋	toy
跑	khqn
忘	ynnu
館	wyvn
館	wppn
暗	jujg
班	gytg
黨	ipko
宗	pfiu
壞	fyle
技	rfcy
困	lsi
登	wgku
姐	vegg
預	cbdm
耳	bghg
席	yamh
夢	alpq
朱	rii
組	xegg
旁	upyb
份	wwvn
禁	ssfi
套	ddu
亞	ghgg
亞	gfgd
益	uwlf
探	rpws
康	yvii
增	fulj
詩	yffy
戲	haga
伯	wrg
曉	jffq
含	wynk
勞	oopl
恩	ldnu
頂	sdmy
君	vtkd
莊	anhf
謂	yleg
付	wfy
田	llll
畢	jafk
紙	xqan
研	dgah
虛	hang
怪	ncfg
寧	pnls
替	fwfj
犯	qtbn
燈	owgu
優	wdet
您	wqin
姓	vtgg
例	wgqj
絲	xxiy
蓋	afcl
誤	ykgd
架	lksu
幸	fufj
隱	bean
股	emcy
毒	gxgu
娘	vyve
佔	whkg
智	tdkj
佛	wxjh
牀	nhds
米	oyty
凡	myi
介	wjj
徵	tmgt
彩	eset
演	ipgw
射	tmdf
祖	pyeg
欲	wwkw
束	gkii
獲	qtac
舞	rlgh
聖	bkgf
夥	jsqq
梅	stxu
普	uogj
借	wajg
私	tcy
源	idri
鎮	qfhw
睡	htgf
緩	xefc
升	tak
納	xmwy
織	xuaj
歌	sksw
宮	pktk
概	svcq
野	jfcb
醒	sgjg
夏	dhtu
互	gxgd
積	tgmy
街	tffh
牌	thgf
休	wsy
搖	rqrm
洋	iudh
敗	mty
監	ahnl
骨	mef
批	rxxn
兄	kqb
刀	vnt
網	xmun
率	yxif
庭	ytfp
熟	ybvo
創	wyvj
訪	yyn
硬	dgjq
仁	wfg
菜	aesu
丁	sgh
綠	xxgi
牛	rhk
避	nkup
陰	bwyc
拍	rrg
雄	dcwy
祕	pynt
缺	rmnw
卷	udbb
姑	vdg
尼	nxv
油	img
恐	amyn
玩	gfqn
釋	tolf
遍	ynmp
握	rngf
球	gfiy
降	btah
慮	haln
榮	oops
策	tgmi
肉	mwwi
媽	vcy
迷	opi
檢	swgw
伸	wjhh
歐	akkw
攻	aty
練	xgli
育	ycef
危	qdbb
廳	ybgn
啊	kbsk
睛	hgeg
擺	rlcx
茶	awsu
勇	celb
判	udjh
材	sftt
抱	rqnn
亦	you
妻	gvhv
吸	keyy
喝	kjqn
趣	fhbc
嘴	khxe
逐	epi
操	rkks
午	tfj
吉	fkf
浪	iyve
輪	lwga
默	lfod
毫	yptn
冰	uiy
珠	griy
鼓	fkuc
階	bxxr
孔	bnn
徐	twty
固	ldd
偏	wyna
陸	bfwf
諸	yftj
遺	khgp
爺	wqbb
述	sypi
帝	upmh
閉	ufte
補	pugy
編	xyna
巨	and
透	tepv
弄	gaj
尤	dnv
魯	qojf
擁	ryxy
錄	qxgi
吳	kndu
牆	nhdk
貨	wxmu
弱	xuxu
敵	umdt
挑	riqn
寬	pahy
跡	khyo
抽	rmg
忍	vynu
折	rrh
輸	lwgj
穩	tean
皇	rgf
桌	hjsu
獻	hagd
蒙	apge
紛	xwvn
麻	yssi
洗	itfq
評	yguh
掛	rffh
童	ujff
尊	usgf
舍	wfkf
唯	kwyg
博	fgef
劇	haej
乃	etn
混	ijxx
彈	xkkf
附	bwfy
遲	nirp
敬	aqkt
杯	sgiy
魚	qou
控	rpwa
塞	pfjf
劍	wgkj
厚	djbd
佳	wffg
測	imjh
訓	ykh
牙	ahte
洞	imgk
淡	iooy
盛	dnnl
縣	hiti
芳	ayb
雅	ahty
革	afj
款	ffiw
橫	sagw
累	lxiu
擇	rlff
乘	tuxv
刺	gmij
載	falk
猛	qtbl
逃	iqpv
構	sfjf
趙	fhie
杜	sfg
慶	ynjt
途	wtpi
奔	dfaj
虎	hamv
巧	agnn
抗	rymn
針	qfh
徒	tfhy
圓	lkmi
閃	uwi
谷	wwkf
紹	xvkg
聚	bcti
額	ptkm
健	wvfp
誠	ydnt
鮮	qoud
淚	iynd
閒	ued
均	fqug
序	ycbk
震	fdfe
仿	wyn
緣	xxey
戴	falw
婚	vqaj
篇	tyna
亡	ynv
奶	ven
忠	khnu
煩	odmy
賽	pfjm
鬧	hggh
協	flll
傑	wqas
殘	gqaa
懂	natf
丹	myd
柳	sqtb
妹	vfiy
映	jmdy
橋	stdk
歎	akfw
愈	wgen
旅	ytey
授	repc
享	ybf
暴	jawi
偷	wwgj
藍	aahl
氏	qav
寒	pfju
宜	pegf
棄	ycgs
棄	ycas
豐	dhdu
延	thpd
輩	djdl
搶	rwyk
顏	ydem
贊	tfqm
典	mawu
冒	jhf
眉	nhd
燒	offq
廠	yimt
唱	kjjg
徑	tgva
庫	ylk
川	kthh
辭	ecmu
伴	wufh
怒	vcnu
型	gajf
純	xgbn
貝	mhny
票	sfiu
隔	bgkh
窮	pwtx
拜	rdfh
審	ptol
倫	wwga
悲	djdn
柔	cbts
啟	ynkt
減	idgt
頁	dmu
縱	xtwh
掃	rvph
偉	wnhh
迫	rpd
振	rdfe
瑞	gmdj
丈	dyi
樑	sivs
洲	iyth
槍	swyk
央	mdi
觸	qelj
予	cbj
孤	brcy
縮	xpwj
洛	itkg
損	rkmy
促	wkhy
番	tolf
罷	lcex
宋	psu
奮	dwyl
銷	qieg
幕	ajdh
猶	qtug
鎖	qimy
珍	gwet
抬	rckg
陪	bukg
妙	vitt
摸	rajd
峯	mtdh
勁	gval
鏡	qujq
沈	ipqn
奪	dwyf
昨	jthf
哭	kkdu
訊	ynfh
貌	eerq
謀	yafs
泰	dwiu
側	wmjh
貧	wvmu
扶	rfwy
阻	begg
貼	mhkg
申	jhk
岸	mdfj
彼	thcy
賞	ipkm
版	thgc
抵	rqay
澤	ilff
插	rtfv
迅	nfpk
憑	ucnu
伊	wvtt
潮	ifje
咱	kthg
仙	wmh
符	twfu
宇	pgfj
肩	yned
嘗	ipkj
遞	rhap
燕	auko
潔	idhi
拒	rang
郎	yvcb
凝	uxth
淨	ievh
遭	gmap
儀	wugt
薄	aigf
卡	hhu
末	gsi
勒	afln
烏	wngo
森	sssu
諾	yadk
呀	kaht
壯	nhdf
憂	dept
沿	imkg
慣	nxfm
丟	gcu
季	tbf
企	whf
壁	nkuf
惜	najg
婆	ihcv
袋	waye
朗	yvce
零	fwyc
辛	uygh
憶	nujn
努	vclb
舒	wfkb
枝	sfcy
鳳	mdho
滅	idgt
韓	fjnh
膽	eqdy
灰	dou
旦	jgf
孟	blf
陷	bqvg
俗	wwwk
繞	xffq
疾	utdi
瞧	hwyo
洪	iawy
甲	lhnh
帳	mhde
糊	odeg
泛	itpy
皆	xxrf
碰	duog
吹	kqwy
碼	dcy
奉	dwfh
箱	tshf
傾	wxdm
胸	eqqb
堆	fwyg
狂	qtgg
仲	wkhh
圈	ludb
冬	tuu
餐	hqce
厲	dajy
腿	evep
尖	idu
括	rtdg
佩	wmgh
鬼	rqci
欣	rqwy
垂	tgaf
躍	khny
港	iawn
騙	cyna
融	gkmj
撞	rujf
塔	fawk
紫	hxxi
蕩	aijr
敏	txgt
鄭	usgb
賴	gkim
滑	imeg
允	cqb
鳥	wvgo
課	yjsy
暫	lrjf
瓦	gnyn
祥	pyud
染	ivsu
滾	iuke
浮	iebg
粗	oegg
刑	gajh
輛	lgmy
狗	qtqk
撲	rogy
稍	tieg
秦	dwtu
扎	rnn
魂	fcrc
島	wvgm
騰	eudc
臣	ahnh
琴	ggwn
悉	tonu
絡	xtkg
摩	yssr
措	rajg
域	fakg
冠	pfqf
竹	ttgh
殊	gqri
豪	ypeu
呆	ksu
薩	abug
旋	ytnh
喊	kdgt
寄	pdsk
悄	nieg
倍	wukg
祝	pykq
剩	tuxj
督	hich
旗	ytaw
返	rcpi
召	vkf
徹	tyct
賓	pgim
甘	afd
吐	kfg
喬	tdkk
腰	esvg
拔	rdcy
幅	mhgl
違	nhkp
詳	yudh
臂	nkue
尺	nyi
飲	wyvw
飲	wpqw
顆	jsdm
涉	ihit
逼	gklp
競	ukqq
培	fukg
惠	gjhn
虧	hawn
叔	hicy
伏	wdy
喚	kqmd
雞	exdy
鄰	oqab
池	ibn
怨	qbnu
奧	tmtd
侯	wntd
騎	cdsk
漫	ijlc
拖	rtbn
俊	wcwt
尾	ntfn
恨	nvey
貫	xfmu
凌	ufwt
兼	uvou
詢	yqjg
碎	dywf
晨	jdfe
罰	lyjj
鋪	qgey
濃	imae
伍	wgg
宿	pwdj
泉	riu
井	fjk
繁	txgi
粉	owvn
緒	xftj
築	tams
恢	ndoy
匹	aqv
塵	ynjf
輝	iqpl
魔	yssc
仰	wqbh
董	atgf
描	ralg
距	khan
盜	iqwl
渡	iyac
勤	akgl
勸	akkl
蓮	alpu
坦	fjgg
搭	rawk
挺	rtfp
蹤	khth
幽	xxmk
截	fawy
荒	aynq
恰	nwgk
慧	dhdn
邦	dtbh
頗	hcdm
焦	wyou
醉	sgyf
廢	ywxc
掩	rdjn
籤	twwg
喪	fkke
災	vou
鼻	thlj
侵	wvpc
陶	bqrm
肅	vhth
肅	vfjk
裁	faye
俱	whwy
磨	yssd
析	srh
獎	nhdd
匆	qryi
瓶	uagn
泥	inxn
拾	rwgk
涼	iyiy
麥	swwt
鋼	qmum
湧	icel
潛	iaqj
隆	btgg
津	ivfh
搞	rymk
蛋	nhju
奈	dfiu
擾	rdet
耐	dmjf
傅	wgef
錦	qrmh
播	rtol
墨	lfof
偶	wjmy
捕	rgey
惑	akgn
飄	sfij
屈	nbmk
鳴	kwvo
擠	ryvf
擠	ryjg
毀	vfmc
斜	wtuf
啦	krug
污	ifnn
赤	fou
慰	nfin
飾	wyvh
飾	wpth
鋒	qtdh
覆	sttt
湯	ijgr
壽	fnaf
跨	khdn
羊	udj
航	teym
拳	udrj
盟	jelf
廷	tfpd
盧	hall
嚇	kfoo
寂	phic
荷	awsk
亭	ypsj
曼	jlcu
呂	ktkf
寸	fghy
衡	tqdh
狠	qtve
郭	ybbh
奏	dwgd
割	pdhj
閣	utkd
汗	ifh
箭	tuej
埋	fjfg
撥	rwxc
頻	hidm
屏	nuak
坡	fhcy
宏	pdcu
黎	tqti
猜	qtge
萊	asww
障	bujh
患	kkhn
牢	prhj
搜	rvhc
賢	ahnm
賀	lkmu
遷	sdnp
欺	adww
裂	gqje
鞋	afff
撫	rrlo
罵	lcu
乏	tpi
拼	ruah
俄	wtrt
闊	uitd
礙	dxth
搬	rtec
夾	dwwi
遙	qrmp
牽	yxph
駕	lkcu
爸	wqcb
踏	khij
添	igdn
襲	uege
扣	rkg
艾	aqu
鄧	wgkb
兇	qbqb
殿	nawc
訂	ysh
昏	qajf
肚	efg
匯	aiwy
驅	cakk
核	synw
桑	cccs
孝	ftbf
棋	sadw
咬	kuqy
疏	nhyq
邀	rytp
仔	wbg
巡	vpv
嘉	fkuk
冊	mak
仇	wvn
串	kkhk
糧	ojgf
齡	hwwc
齡	hbwc
宅	ptab
扭	rnfg
嫁	vpey
蒼	awyk
戒	aak
賈	smu
崇	mpfi
翠	nywf
嶽	mqtd
蟲	jjju
椅	sdsk
暖	jefc
曹	gmaj
慕	ajdn
灣	ixyx
彎	xyxx
捉	rkhy
濤	ifnf
柱	sygg
糾	xnhh
邪	ahtb
譯	ylff
刊	fjh
朵	msu
浩	itfk
翼	nlaw
吟	kwyn
悶	uni
幼	xln
昌	jjf
羽	nnyg
吾	gkf
柏	srg
植	sfhg
哀	yeu
慘	ncce
辯	uyuh
肥	ecn
憐	noqh
傲	wgqt
潤	iugg
扇	ynnd
聰	btln
聊	bqtb
纖	xwwg
鑑	qahl
吞	gdkf
估	wdg
赫	fofo
堪	fadn
陵	bfwt
趨	fhqt
牧	trty
漂	isfi
盈	eclf
攝	rbbb
欠	qwu
擴	ryaw
覽	ahnq
譽	wfgy
譽	vgny
姿	uqwv
霞	fnhc
豔	dhdl
豈	mgku
屍	ngqx
閲	uukq
幻	xnn
龐	yued
稀	tqdh
勃	fpbl
抖	rufh
瘋	umtj
御	trhb
療	udui
爬	rhyc
籍	tdij
敲	ymkc
愁	tonu
淺	iaat
憤	nfam
魏	tvrc
鑽	qtfm
馮	ucy
袖	pumg
悦	nukq
欄	sugi
櫃	sakm
塗	iwtf
飽	wyvn
飽	wpqn
揭	rjqn
邁	ajmp
卿	qtvb
倆	wgmy
躲	tmds
壇	fylg
巖	mkkt
勾	qci
偽	wyto
購	mfjf
汪	igg
韋	nhkh
霧	fcbl
曰	jhng
廟	yfje
貢	amu
租	tegg
呈	kgf
媒	vafs
艱	akfe
嫌	vuvo
窩	pwmk
矛	cbtr
葛	ajqn
循	trfh
旨	xjf
忌	nnu
燃	oqdo
豆	gkuf
呵	kskg
挖	rpwn
戀	xyxn
娜	vvfb
駐	cygg
跌	khrw
捷	rgvh
桃	siqn
赴	fhhi
誘	yten
僕	wogy
昂	jqbj
夕	qtny
甜	tdaf
昭	jvkg
厭	djed
摘	rumd
耶	bbh
脣	dfee
劫	fcln
爆	ojai
援	refc
姜	ugvf
稿	tymk
蒂	auph
辨	uytu
醜	sgrc
擦	rpwi
桂	sffg
梯	suxt
炮	oqnn
瓜	rcyi
腐	ywfw
銅	qmgk
瘦	uvhc
惟	nwyg
遵	usgp
慌	nayq
賭	mftj
叢	oguc
擋	ripl
税	tukq
爛	ougi
盒	wgkl
霸	fafe
逢	tdhp
牲	trtg
悟	ngkg
撐	ript
擬	rxth
扮	rwvn
酸	sgct
卓	hjj
漠	iajd
凱	mgkm
羞	udnf
署	lftj
刷	nmhj
廉	yuvo
炸	othf
熊	cexo
償	wipm
汽	irnn
彌	xgwq
績	xgmy
蕭	avhh
蕭	avfj
剪	uejv
盾	rfhd
宴	pjvf
售	wykf
億	wujn
帽	mhjh
痴	utdk
溝	ifjf
惱	nvtq
斤	rtth
寺	ffu
輯	lkbg
倉	wyvk
濕	ijxo
貪	wynm
滴	iumd
贏	ynky
疼	utui
痕	uvei
縫	xtdp
慈	uxxn
役	tmcy
悔	ntxu
殷	rvnc
賦	mgah
噴	kfam
伐	wat
漏	infy
蛇	jpxn
堡	wksf
鼠	vnun
脈	erey
撤	ryct
慎	nfhw
妨	vyn
玄	yxu
債	wgmy
扯	rhg
耀	iqny
禍	pymk
逸	qkqp
穆	trie
煉	ogli
爐	ohal
腹	etjt
戈	agnt
液	iywy
抑	rqbh
掙	revh
舟	tei
懸	hitn
勵	dajl
籌	tfnf
晶	jjjf
敍	wthc
迪	mpd
卧	ahnh
鍵	qvfp
碗	dpqb
鴻	iawo
芝	apu
渾	iplh
攔	rugi
纏	xyjf
鈴	qwyc
拆	rryy
恆	ngqg
恆	nghg
昆	jxxb
爹	wqqq
卜	hhy
嘛	kyss
耗	ditn
碧	grdf
髒	meaa
貓	eeal
悠	whtn
霍	fwyf
霜	fshf
拋	rdnl
謹	yakg
轟	lllj
苗	alf
轎	ltdk
奴	vcy
嶺	mwym
郵	tgab
繩	xxg
繩	xmgv
逆	ubtp
茫	aiyn
躺	tmdk
翁	wcnf
撒	raet
鷹	ywwo
暢	jhjr
紋	xyy
崔	mwyf
抹	rgsy
晴	jgeg
嬌	vtdk
吻	kqrt
繪	xwgj
披	rhcy
吊	kmhj
獄	qtyd
芬	awvb
敦	ybty
劣	itlb
溪	iexd
懼	nhhy
辱	dfef
昔	ajf
踐	khaa
辰	dfei
填	ffhw
晉	gccj
雕	mfky
鬱	srme
賜	mjqr
矩	tdan
冤	pqky
豬	eftj
狼	qtye
菲	adjd
勉	qkql
叉	cyi
跪	khqb
矣	ctdu
滋	iuxx
礎	dssh
姆	vxgu
兆	iqv
頸	gvam
衫	puet
捧	rdwh
賊	madt
睜	hevh
闖	uci
驟	cbci
毅	uemc
籠	tued
丘	rgd
妥	evf
衰	ykge
鋭	qukq
歇	jqww
湊	idwd
棉	srmh
柴	hxsu
韻	ujkm
胞	eqnn
墓	ajdf
巾	mhk
遂	uepi
恭	awnu
炎	oou
貞	hmu
誓	rryf
催	wmwy
脅	llle
檔	sipl
甫	gehy
玲	gwyc
虹	jag
棒	sdwh
馳	cbn
哲	rrkf
疊	lllg
傻	wtlt
璃	gybc
鞭	afwq
鵬	eewo
押	rlh
翔	udng
址	fhg
貿	qyvm
崗	mmum
腸	ejgr
廊	yyvb
胖	eufh
盼	hwvn
疲	uhci
駛	ckqy
舌	tdd
泄	iann
齒	hwwb
齒	hbj
戚	dhit
湘	ishg
臭	thdu
仗	wdyy
晃	jiqb
蝶	jans
蓬	atdp
謙	yuvo
餓	wyvt
餓	wptt
衷	ykhe
萍	aigh
漲	ixde
葬	agqa
幣	umih
吵	kitt
潘	itol
遮	yaop
拓	rdg
獵	qtvn
儲	wyfj
渴	ijqn
逝	rrpk
彭	fkue
惹	adkn
袁	fkeu
顫	ylkm
脆	eqdb
娃	vffg
瞬	heph
膚	hale
嫂	vvhc
灑	igmx
侍	wffy
履	nttt
挨	rctd
淑	ihic
廚	yfkf
獸	kkld
薛	awnu
旺	jgg
欽	qqwy
鶴	pwyo
婉	vpqb
械	saah
削	iejh
喘	kmdj
竊	pwtc
愧	nrqc
銘	qqkg
裕	puwk
帥	wnnh
宰	puj
杭	symn
紗	xitt
埃	fctd
樸	sogy
酷	sgtk
繡	xvhh
繡	xvfj
遣	khgp
贈	mulj
誼	ypeg
耕	difj
函	bibk
掘	rnbm
鏈	qlpy
豫	cbqe
賠	mukg
灌	iaky
斥	ryi
診	ywet
皺	qbtc
畏	lgeu
溜	iqyl
誇	ydfn
攜	rmwk
琳	gssy
粒	oug
愚	jmhn
屆	nfbk
穴	pwu
玻	ghcy
淵	ithh
淵	ijgg
筋	telb
輔	lgey
遼	dujp
帕	mhrg
攤	raky
裹	yjse
喂	klge
籲	twgm
屠	nftj
疆	xfgg
盆	wvlf
氛	rnwv
瑪	gcy
綜	xpfi
症	ughd
弗	xjk
闢	unku
峽	mdww
郊	uqbh
蔡	awfi
拐	rkln
筒	tmgk
挽	rqkq
棵	sjsy
糟	ogmj
攀	sqqr
菊	aqou
砍	dqwy
褲	puyl
眠	hnan
杆	sfh
蓄	ayxl
綁	xdtb
涵	ibib
綿	xrmh
啞	kghg
啞	kgfg
漁	iqoy
鑰	qwga
寡	pdev
諒	yyiy
慨	nvcq
凍	ugji
狐	qtry
軌	lvn
爵	elvf
拘	rqkg
懶	ngkm
枚	sty
犧	trut
煌	orgg
奸	vfh
碑	drtf
祭	wfiu
媚	vnhg
剝	xgij
鍋	qmnk
潑	iwxc
腔	epwa
妖	vtdy
乞	tnb
姚	viqn
歪	gigh
乙	nnll
芒	aynb
舅	vllb
扔	ren
枯	sdg
饒	wyvq
饒	wpfq
哩	kjfg
爽	dqqq
柯	sskg
趁	fhwe
譜	yuoj
契	dhvd
弦	xyxy
掠	ryiy
汝	ivg
寨	pfjs
鹽	ahnl
簾	tyuo
翰	fjwn
焰	oqvg
儒	wfdj
愉	nwgj
肖	ief
尉	nfif
裙	puvk
桶	sceh
俠	wdww
盯	hsh
訝	yaht
誕	ythp
隸	sfii
勿	qre
抄	ritt
姊	vtnt
礦	dyaw
袍	puqn
泡	iqnn
踢	khjr
倚	wdsk
泊	irg
咽	kldy
罩	lhjj
哦	ktrt
瓊	gqmt
乳	ebnn
倘	wimk
膀	eupy
堵	fftj
嚷	kyke
尹	vte
薦	ayno
囊	gkhe
竭	ujqn
矢	tdu
酬	sgyh
瞪	hwgu
焉	ghgo
淮	iwyg
塑	ubtf
乾	fjtn
畜	yxlf
剎	qsyj
頑	fqdm
磁	duxx
蔽	aumt
穎	xtdm
卑	rtfj
驕	ctdk
茲	axxu
泣	iug
脊	iwef
淫	ietf
聘	bmgn
蜜	pntj
懲	tmgn
堤	fjgh
駱	ctkg
茂	adnt
肌	emn
錫	qjqr
僧	wulj
恥	bny
徽	tmgt
煤	oafs
姻	vldy
蔣	anhf
顛	fhwm
暈	jplj
陌	bdjg
軀	tmdk
鼎	hndn
邏	lxwp
賺	muvo
蜂	jtdh
膝	eswi
釘	qsh
衍	tifh
寓	pjmy
豎	ahnu
蓉	apwk
蠻	xyxj
溢	iuwl
沾	ihkg
盲	ynhf
僱	wyny
哼	kybh
摔	ryxf
濱	ipgm
鈎	qqcy
駁	cqqy
遜	btxp
燭	olqj
歉	uvow
襯	puuq
晰	jsrh
妮	vnxn
夷	gxwi
嫩	vgkt
憲	pgln
燦	ohqo
糖	oyvk
瑰	grqc
腫	etgf
灘	iaky
峻	mcwt
哄	kawy
咐	kwfy
籃	tahl
囑	knij
嘲	kfje
瑟	ggnt
獅	qtwh
栽	fasi
軒	lfh
詐	ythf
聳	twwb
狹	qtdw
姨	vgxw
茅	acbt
蘋	ahim
雁	dwwy
趟	fhik
譚	ysjh
浙	irrh
巷	awnb
磚	dgjf
啼	kuph
弓	xngn
棺	spnn
餅	wyva
餅	wpua
佐	wdag
斑	gygg
掏	rqrm
掀	rrqw
魅	rqci
臘	evln
浴	iwwk
僵	wglg
娶	bcvf
紐	xnfg
粧	oyfg
俯	wywf
浦	igey
偵	whmy
庸	yveh
販	mrcy
捐	rkeg
挪	rvfb
胎	eckg
丫	uhk
歹	gqi
帆	mhmy
畝	ylqy
飢	wyvm
飢	wpmn
漆	iswi
鹿	ynjx
碩	ddmy
秒	titt
渠	ians
滯	iaqh
榜	supy
拂	rxjh
嘿	klfo
倦	wudb
咳	kynw
悽	ngvv
釣	qqyy
艙	tewk
株	sriy
擱	rutk
賤	maat
哉	fakd
喉	kwnd
稽	tdnj
喻	kwgj
坊	fyn
券	udvb
藤	aeui
澄	iwgu
媳	vthn
柄	sgmw
秩	trwy
憾	ndgn
矮	tdtv
殼	fpgc
窄	pwtf
脾	ertf
銜	tqfh
暮	ajdj
框	sagg
熙	ahko
肝	efh
鈞	qqug
貸	wamu
乖	tfux
躬	tmdx
壺	fphg
壺	fpfg
珊	gmmg
淋	issy
匙	jghx
荊	agaj
隙	biji
旬	qjd
樁	sdwv
搏	rgef
宛	pqbb
瞞	hamy
狄	qtoy
魄	rrqc
琪	gadw
枕	spqn
吼	kbnn
刮	tdjh
晌	jtmk
叛	udrc
崖	mdff
卸	rhbh
梳	sycq
歧	hfcy
嘻	kfkk
娛	vknd
拱	rawy
伺	wngk
旭	vjd
猴	qtwd
杏	skf
賬	mdey
崩	meef
寵	pued
怔	nghg
嘯	kvhh
嘯	kvfj
脹	edey
睹	hftj
妄	ynvf
祿	pyxi
怖	ndmh
辣	ugki
擅	rylg
辜	duj
邵	vkbh
汁	ifh
齋	yvui
齋	yjiu
嬰	mmvf
蔭	abwc
膠	enwe
藴	axjl
淘	iqrm
芙	afwu
罕	pwfj
肆	dvfh
浸	ivpc
鮑	qoqn
坑	fymn
莉	atjj
岡	mumk
腕	epqb
佑	wdkg
墳	ffam
棍	sjxx
棚	seeg
迭	rwpi
莎	aiit
捆	rlsy
兮	wgnb
喧	kpgg
塌	fjng
惶	nrgg
脖	efpb
墜	buef
堯	fffq
斂	wgkt
綢	xmfk
棟	sgji
頃	xdmy
耍	dmjv
廂	yshd
殖	gqfh
嵌	mafw
寞	pajd
騷	ccyj
雀	iwyf
哨	kieg
濫	iahl
蘆	ahal
姬	vahh
孕	ebf
劈	nkuv
懇	eevn
斬	lrh
靖	ugeg
愣	nlyn
鹹	hlqt
鹹	hloy
廈	ydht
簇	tytd
刃	vyi
卒	ywwf
笨	tsgf
眸	hcrh
匪	adjd
捏	rjfg
逗	gkup
涯	idff
枉	sgg
裸	pujs
邱	rgbh
炭	mdou
笛	tmf
弊	umia
噪	kkks
耿	boy
劑	yvuj
劑	yjjh
喲	kxqy
敞	imkt
彬	sset
裴	djde
彥	yder
屢	pkgv
屢	nlvd
屢	nkgv
弘	xcy
兔	qkqy
匠	ark
麟	ynjh
恍	niqn
墊	fuff
耽	bpqn
玫	gty
魁	rqcf
薪	ausr
粘	ohkg
輿	wflw
輿	vlgw
誦	yceh
潰	ikhm
巫	awwi
冶	uckg
簿	tigf
蹈	khev
綱	xmum
爍	oxrs
躁	khks
咖	klkg
杖	sdyy
慄	nssy
喃	kfmf
塘	fyvk
糕	ougo
啡	kdjd
蹲	khuf
鴨	lwvo
旱	jfj
頌	wcdm
禪	pykf
俺	wdjn
擎	aqkr
脂	exjg
犬	dgty
桐	smgk
頰	dwwm
叮	ksh
剖	ukjh
謊	yayq
胃	lef
阮	bfqn
祈	pyrh
勛	kmln
侄	wgcf
稚	twyg
楓	smtj
煞	qvto
聶	bbbf
禽	wybc
諷	ymtj
譁	yagf
攏	rued
縛	xgef
挫	rwwf
眷	udhf
丸	vyi
棧	saat
俏	wieg
宙	pmf
斌	ygah
襟	pusi
寇	pfqc
畔	lufh
陡	bfhy
肢	efcy
坎	fqwy
恕	vknu
唉	kctd
倡	wjjg
蝕	wyvj
蝕	wpjy
傍	wupy
罐	rmay
稻	tevg
薇	atmt
砸	damh
諧	yxxr
郝	fobh
暑	jftj
羨	ugiw
豹	eeqy
潭	isjh
桓	sgjg
蒸	abio
閻	uqvd
竄	pwvn
瑩	oopy
樊	sqqd
瑣	gimy
碌	dviy
奠	usgd
泳	iyni
擲	rusb
甩	env
澳	itmd
撕	radr
轄	lpdk
虞	hakd
妓	vfcy
鈔	qitt
嗚	kwno
肺	egmh
繳	xryt
暇	jnhc
疫	umci
鴉	ahto
滄	iwyk
篷	ttdp
倪	wvqn
昧	jfiy
滲	icce
妒	vynt
坤	fjhh
謠	yqrm
禿	tqb
僻	wnku
瞎	hpdk
苑	aqbb
淹	idjn
朽	sgnn
曠	jyaw
哇	kffg
瓣	urcu
瑤	gqrm
禱	pyff
粹	oywf
黛	walo
溶	ipwk
縷	xlvg
縷	xkgv
鄒	qbtb
烤	oftn
俞	wgej
晝	vfjg
翅	fcnd
蕾	aflf
屁	nxxv
冥	pjuu
鈕	qnfg
茵	aldu
帖	mhhk
乍	thfd
撈	rool
煥	oqmd
逾	wgep
頒	wvdm
瓷	uqwn
凜	uylt
幢	mhuf
咒	kkmb
綴	xccc
晤	jgkg
郡	vtkb
勻	qfd
鑄	qfnf
苟	aqkf
扁	ynma
壘	lllf
兜	qrnq
撰	rnnw
廓	yybb
敷	geht
爪	rhyi
譬	nkuy
懈	nqeh
窟	pwnm
吩	kwvn
沃	itdy
菱	afwt
窺	pwfq
逛	qtgp
斧	wqrj
逮	vipi
瀟	iavj
瀟	iavh
馨	fnmj
娟	vkeg
梨	tjsu
沛	igmh
焚	ssou
怡	nckg
陋	bgmn
啥	kwfk
龜	txd
龜	tmgg
蠢	dwjj
棠	ipks
刪	majh
絨	xadt
漿	nhdi
叩	kbh
沸	ixjh
緬	xdmd
厄	dbv
甸	qld
攬	rahq
妃	vnn
詠	yyni
駝	cpxn
猿	qtfe
葡	aqgy
絞	xuqy
巢	vjsu
瞻	hqdy
踩	khes
侖	wgma
陝	bdty
嗓	kccs
陀	bpxn
咕	kdg
裳	ipke
鄙	kflb
圾	feyy
膜	eajd
灼	oqyy
婿	vnhe
巍	mtvc
龔	uegw
怯	nfcy
瞥	umih
穢	thdt
囚	lwi
霄	fief
紳	xjhh
袱	puwd
舜	epqh
膩	eafm
拚	rcah
蠟	jvln
屑	nied
盞	aalf
撇	rumt
軸	lmg
鵝	trno
侮	wtxu
磊	dddf
嵐	mmtj
曬	jgmx
駭	cynw
摧	rmwy
煮	ftjo
櫻	smmv
綺	xdsk
艇	tetp
吶	kmty
翩	ynmn
禹	tkmy
挾	rdww
蘿	alxy
澀	ivyh
傘	wwwf
牟	crhj
滔	ievg
沫	igsy
兑	ukqb
匿	aadk
紡	xyn
萄	aqrm
廖	ynwe
艦	teal
揉	rcbs
喇	kgkj
蹄	khuh
攪	rwfq
攪	rvqq
炒	oitt
膏	ypke
芽	aaht
寢	pnhc
吏	gkqi
燙	ijgo
彰	ujet
冀	uxlw
洽	iwgk
侶	wktk
鞍	afpv
夭	tdi
廝	yadr
藉	adij
詭	yqdb
雍	yxty
鑲	qyke
撿	rwgw
蔬	anhq
訣	ynwy
磕	dfcl
蒲	aigy
凳	wgkm
俘	webg
襄	ykke
驢	chal
傭	wyvh
勘	adwl
冉	mfd
兢	dqdq
尿	nii
搗	rwvm
嘶	kadr
亨	ybj
曙	jlfj
哎	kaqy
詫	ypta
暉	jplh
岔	wvmj
釀	sgye
嫉	vutd
僑	wtdk
剔	jqrj
湛	iadn
宵	pief
蟻	jugt
熬	gqto
燥	okks
擒	rwyc
毯	tfno
噸	kgbm
膊	egef
摟	rlvg
摟	rkgv
斐	djdy
胳	etkg
槽	sgmj
碟	dans
榻	sjng
眨	htpy
賄	mdeg
奢	dftj
垃	fug
訟	ywcy
閨	uffd
砂	ditt
灶	ofg
棲	sgvv
壤	fyke
狡	qtuq
仕	wfg
姥	vftx
螺	jlxi
撓	rffq
絮	vkxi
纜	xahq
豁	pdhk
邢	gabh
叭	kwy
拙	rbmh
淳	iybg
凸	hgmg
廁	ymjk
緞	xwdc
鉛	qmkg
寥	pnwe
摯	fufr
倩	wgeg
愕	nkkn
奎	dfff
瀾	iugi
墮	bdaf
澆	iffq
艘	tevc
斟	adwf
棗	gmii
覓	ehqb
蜀	lqju
虐	haag
嬸	vptl
諮	yuqk
揀	rgli
貶	mtpy
屯	gbnv
戳	nwya
秉	tgvi
鞠	afqo
悼	nhjh
樞	sakk
鶯	oopo
蔓	ajlc
娥	vtrt
毋	xde
儉	wwgw
萌	ajef
莽	adaj
沁	iny
梧	sgkg
沐	isy
朔	ubte
膛	eipf
醬	nhdg
薰	atgo
狸	qtjf
慚	nlrh
丙	gmwi
濁	ilqj
琢	geyy
揪	rtoy
凹	mmgd
叨	kvn
嚼	kelf
霖	fssu
扳	rrcy
刁	ngd
凰	mrgd
闡	ukkf
伶	wwyc
棘	gmii
憎	nulj
諱	ynhh
祁	pybh
聾	uegb
蔚	anff
雯	fyu
遏	jqwp
鞏	amyf
尬	dnwj
芸	afcu
砌	davn
尷	dnal
鏢	qsfi
扛	rag
澡	ikks
驀	ajdc
綽	xhjh
廬	yhal
竅	pwrt
琦	gdsk
癱	uaky
牡	trfg
梭	scwt
滕	eudi
幟	mhuj
囂	kkdk
癢	uude
菩	aukf
彤	myet
孜	bty
弧	xrcy
蟬	jkkf
黯	lfoj
矯	tdtk
瞄	halg
謬	ynwe
抒	rcbh
徊	tlkg
饋	wyvm
饋	wpkm
嘔	kakk
梢	sieg
丐	ghnv
絹	xkeg
喀	kptk
稼	tpey
揣	rmdj
卵	qyty
駿	ccwt
錘	qtgf
衙	tgkh
坪	fguh
鍛	qwdc
緝	xkbg
菌	altu
淪	iwga
裔	yemk
斃	umix
炯	omkg
瀏	iqyj
肘	efy
芯	anu
晏	jpvf
緯	xnhh
醋	sgaj
鑼	qlxy
梗	sgjq
謎	yopy
黴	tmgt
邑	kcb
糞	olaw
迄	tnpv
慷	nyvi
貯	mpsh
槐	srqc
壩	ffae
殆	gqck
孰	ybvy
庶	yaoi
蚊	jyy
拷	rftn
鴿	wgko
琛	gpws
缸	rmag
渺	ihit
竿	tfj
咧	kgqj
詹	qdwy
瀑	ijai
徘	tdjd
洶	iqqb
撼	rdgn
漓	iybc
噓	khag
翹	fffn
楞	slyn
呻	kjhh
柵	smah
蠶	aqaj
兀	gqv
瑜	gwgj
腥	ejtg
烘	oawy
膨	efke
裘	fiye
窘	pwvk
葱	aqrn
彪	hame
馭	ccy
綻	xpgh
奕	yodu
侃	wkqn
妾	uvf
嘎	kdha
酌	sgqy
閥	uwae
孽	awnb
篤	tcu
庚	yvwi
襪	puat
炕	oymn
嗯	kldn
鏟	qutg
瀉	ipvo
陛	bxxf
柬	glii
皓	rtfk
朦	eape
韶	ujvk
攢	rtfm
竇	pwfm
赦	foty
檻	sahl
槓	samy
熾	ouaj
轍	lyct
奚	exdu
繆	xnwe
稟	ylkt
憋	umin
箏	tevh
贓	mdnt
肇	ynth
溯	iube
萎	atvf
煎	uejo
窯	pwuo
汲	ieyy
匣	alk
咎	thkf
茨	auqw
藩	aitl
叱	kxn
忿	wvnu
頹	tqdm
眶	hagg
跋	khdc
誡	yaah
僚	wdui
譏	yxxt
鑿	oguq
粥	xoxn
朧	eued
趴	khwy
葫	adef
熄	othn
蝴	jdeg
檐	sqdy
蔑	aldt
辮	uxiu
嶄	mlrj
炳	ogmw
帷	mhwy
絆	xufh
逞	kgpd
飼	wyvk
飼	wpnk
拭	raag
敖	gqty
璇	gyth
匡	agd
婷	vyps
啤	krtf
悍	njfh
蝦	jnhc
蠅	jxg
蠅	jmgv
圭	fff
繹	xlff
閘	ulk
虔	hayi
蛛	jriy
杉	set
蛙	jffg
濺	imaa
倏	whtd
瞅	htoy
靡	yssd
螞	jcy
懊	ntmd
樵	swyo
墅	jfcf
咯	ktkg
擰	rpns
篩	twnh
芭	acb
眯	hoy
炬	oang
皂	rab
募	ajdl
橡	sqje
戎	ade
嗣	kmak
筷	tnnw
釐	fitf
璧	nkuy
忖	nfy
婪	ssvf
唬	kham
嗽	kgkw
嗅	kthd
稜	tfwt
楷	sxxr
迸	uapk
軋	lnn
睦	hfwf
涕	iuxt
蟹	qevj
卦	ffhy
拯	rbig
癮	uben
矚	hnij
瘡	uwyk
惕	njqr
扒	rwy
汰	idyy
宂	pmb
蒜	afii
椒	shic
婁	lvf
婁	kgkv
庵	ydjn
峨	mtrt
札	snn
祠	pynk
錠	qpgh
淌	iimk
繃	xmee
髓	medp
怠	cknu
霓	fvqb
擂	rflg
漾	iugi
雛	qbty
禾	tttt
骸	meyw
苛	askf
靴	afwx
煒	onhh
哺	kgey
澗	iujg
渝	iwgj
蕊	annn
亟	bkcg
鱗	qooh
匈	qqbk
眺	hiqn
輻	lgkl
贖	mflm
錐	qwyg
餚	wyve
餚	wpqe
鋸	qndg
疇	lfnf
恬	ntdg
誣	yaww
窒	pwgf
蕪	arlo
粟	sou
棕	spfi
蹦	khme
沼	ivkg
硯	dhqn
嘟	kftb
虜	hall
睫	hgvh
糙	otfp
茄	alkf
乒	rgtr
茹	avkf
扼	rdbn
溺	ixuu
驛	clff
櫥	syff
隋	bdae
頤	ahkm
乓	rgyu
桔	sfkg
葦	anhh
庇	yxxv
褐	pujn
氓	ynna
澈	iyct
瓏	gued
渦	imnk
鬢	depm
眩	hyxy
瘤	uqyl
拴	rwgg
撩	rdui
孺	bfdj
隧	buep
懾	nbbb
拈	rhkg
膳	eudk
佟	wtuy
狽	qtmy
譴	ykhp
噢	ktmd
沮	iegg
曳	jxe
磋	duda
褥	pudf
漬	igmy
贅	gqtm
咚	ktuy
敝	umit
崎	mdsk
憫	nuyy
霎	fuvf
錚	qqvh
逍	iepd
誅	yriy
轅	lfke
茜	asf
駒	cqkg
閩	uji
紊	yxiu
冕	jqkq
苔	ackf
峙	mffy
闕	uubw
涅	ijfg
詣	yxjg
悵	ndey
籬	tyby
哆	kqqy
霆	ftfp
盔	dolf
踱	khyc
昊	jgdu
吭	kymn
寅	pgmw
垢	frgk
丞	bigf
媛	vefc
薔	afwk
弛	xbn
琉	gycq
攙	rqky
靶	afcn
捂	rgkg
遁	rfhp
晦	jtxu
嗜	kftj
嘍	klvg
嘍	kkgv
噬	ktaw
臻	gcft
咄	kbmh
嚨	kued
阱	bfjh
唾	ktgf
隴	bued
榆	swgj
恃	nffy
吱	kfcy
汀	ish
躊	khff
脯	egey
賂	mtkg
筍	tqjf
雌	hxwy
酣	sgaf
遐	nhfp
芷	ahf
恤	ntlg
鈍	qgbn
酥	sgty
滌	iwhs
藻	aiks
巳	nngn
瞳	hujf
萃	aywf
楠	sfmf
蹬	khwu
摻	rcce
瞿	hhwy
酉	sgd
祀	pynn
躇	khaj
聆	bwyc
腑	eywf
卉	faj
憊	watn
奄	djnb
締	xuph
肋	eln
彷	tyn
簧	tamw
髦	detn
嫣	vgho
賃	wtfm
羈	lafc
侈	wqqy
醇	sgyb
琵	ggxx
琅	gyve
羹	ugod
迢	vkpd
疚	uqyi
厥	dubw
馴	ckh
搓	ruda
迦	lkpd
褪	puvp
娼	vjjg
熒	oopo
鐸	qlff
秤	tguh
惚	nqrn
勺	qyi
烹	ybou
岑	mwyn
掣	rmhr
琶	ggcb
疤	ucv
啪	krrg
嫻	vusy
翎	wycn
箋	taar
寰	plge
俐	wtjh
圃	lgey
殃	gqmd
嘖	kgmy
穗	tgjn
睿	hpgh
窖	pwtk
宦	pahh
輒	lbnn
妞	vnfg
顱	halm
絳	xtah
隅	bjmy
儼	wkkt
峭	mieg
檀	sylg
啃	kheg
蕉	awyo
闌	ugli
曦	jugt
舵	tepx
毆	akkc
瑚	gdeg
梵	ssmy
嗤	kbhj
摹	ajdr
墾	eevf
椎	swyg
悖	nfpb
韌	nhky
腮	elny
妍	vgah
鎔	qpwk
栩	sng
犀	nirh
垮	fdfn
埠	fwnf
橙	swgu
炙	qou
葵	awgd
睬	hesy
砰	dguh
殲	gqwg
婢	vrtf
柿	symh
吆	kxy
滬	iync
亥	yntw
岱	wamj
捺	rdfi
鄂	kkfb
濾	ihan
屜	ntan
榴	sqyl
簫	tvhh
簫	tvfj
壟	uegf
閔	uyi
凋	umfk
粵	tmtn
咋	kthf
詔	yvkg
舶	terg
迂	gfpk
渭	ileg
釵	qcyy
邸	qayb
哮	kftb
繭	amhj
炫	oyxy
瑾	gakg
哽	kgjq
氈	ylkn
啄	keyy
藹	ayjn
匕	xtn
祟	bmfi
襖	putd
瑛	gamd
拇	rxgu
攘	ryke
瀝	idth
覷	haoq
靳	afrh
饅	wyvc
饅	wpjc
鴛	qbwo
偕	wxxr
綸	xwga
沌	igbn
筐	tagf
裊	wvge
笙	ttgf
嬉	vfkk
悴	nywf
拽	rjxt
鵑	kewo
亢	ymb
窪	pwif
惘	nmun
霹	fnku
猖	qtjj
戟	fjat
僥	wffq
猾	qtme
撮	rjbc
幀	mhhm
悸	ntbg
皋	rdfj
楣	snhg
剿	vjsj
忡	nkhh
輾	lnae
芹	arj
墟	fhag
翟	nwyf
芮	amwu
渣	isjg
喔	kngf
趾	khhg
掐	rqvg
綾	xfwt
磷	doqh
竺	tff
幌	mhjq
烙	otkg
酋	usgf
蠍	jjqw
訕	ymh
捻	rwyn
鴦	mdwo
猩	qtjg
繚	xdui
壑	hpgf
嗡	kwcn
瓢	sfiy
熔	opwk
鉗	qafg
寐	pnhi
鵲	ajwo
阜	wnnf
苞	aqnb
嗦	kfpi
癌	ukkm
愷	nmgu
浚	icwt
簸	tadc
曝	jjai
甄	sfgn
嘈	kgmj
翌	nuf
惰	ndae
捶	rtgf
黔	lfon
綏	xevg
釁	wfmv
釁	vmgv
憔	nwyo
吝	ykf
珀	grg
殯	gqpm
褂	pufh
螢	oopj
墩	fybt
褚	pufj
炊	oqwy
戮	nwea
韜	nhkv
莞	apfq
蜘	jtdk
醖	sgjl
嚕	kqoj
婭	vghg
婭	vgfg
姍	vmah
稠	tmfk
殉	gqqj
拗	rxln
拎	rwyc
矗	fhfh
瘩	uawk
憚	nkkf
猝	qtyf
偎	wlge
瀆	iflm
溉	ivcq
甥	tgll
鷗	akko
冢	peyu
迥	mkpd
縈	oopi
絢	xqjg
獰	qtps
惺	njtg
璋	gujh
鏽	qvhh
鏽	qvfj
倔	wnbm
蓓	awuk
磅	dupy
孚	ebf
垣	fgjg
屎	noi
璞	gogy
伽	wlkg
惋	npqb
氧	rnud
犁	tjrh
淤	iywu
瀕	ihim
揖	rkbg
淇	iadw
匾	ayna
蕙	agjn
雹	fqnb
搔	rcyj
咦	kgxw
嫖	vsfi
扉	yndd
惦	nyhk
隘	buwl
橘	scbk
栓	swgg
忱	npqn
嘰	kxxt
誨	ytxu
潦	idui
岐	mfcy
沂	irh
篡	thdc
麒	ynjw
貽	mckg
鋤	qegl
疙	utnv
憨	nbtn
蕃	atol
漱	igkw
黝	lfol
謁	yjqn
拌	rufh
蹊	khed
袒	pujg
矜	cbtn
沓	ijf
嗆	kwyk
蹌	khwk
屹	mtnn
訥	ymwy
瀛	iyny
磯	dxxt
沅	ifqn
箍	trah
驥	cuxw
鏘	qnhf
釗	qjh
噩	gkkk
嵩	mymk
瘟	ujld
恙	ugnu
珂	gskg
荔	alll
棣	sviy
泌	intt
踴	khcl
瘓	uqmd
踉	khye
翡	djdn
麓	ssyx
穹	pwxb
咪	koy
笠	tuf
筵	tthp
莖	agva
懦	nfdj
捎	rieg
騾	clxi
褒	ywke
諫	ygli
嘮	kool
澱	inac
礁	dwyo
璽	gwmy
渲	ipgg
嚎	kype
詛	yegg
缽	rmsg
暨	vcag
喳	ksjg
崛	mnbm
憧	nujf
痊	uwgd
諄	yybg
佇	wpsh
槳	nhds
蓀	abti
弩	vcxb
骯	meym
弼	xdjx
筠	tfqu
圳	fkh
瀚	ifjn
毓	txgq
煽	oynn
卯	qtbh
掄	rwga
薯	alfj
梓	suh
騁	cmgn
懺	nwwg
汕	imh
畸	ldsk
卞	yhu
瘸	ulkw
藕	adiy
蹙	dhih
萱	apgg
戍	dynt
澎	ifke
筱	twht
汛	infh
嗔	kfhw
胥	nhef
佯	wudh
跤	khuq
掖	rywy
毗	lxxn
菁	agef
椿	sdwj
篆	txeu
馱	cdy
錨	qalg
汾	iwvn
潺	inbb
雋	wymm
嘀	kumd
睞	hsww
鯨	qoyi
鸞	xyxo
烽	otdh
諦	yuph
攫	rhhc
揍	rdwd
唆	kcwt
剃	uxhj
淆	iqde
颯	umtj
蛾	jtrt
膺	ywwe
臀	nawe
跺	khms
闔	ufcl
帛	rmhj
滇	ifhw
盎	mdlf
腎	ahne
踞	khnd
怦	nguh
夙	mgqi
褻	yfwe
諜	yans
頷	wynm
餌	wyvb
餌	wpbg
瑕	gnhc
嶼	mwfw
嶼	mvgw
恣	uqwn
浣	ipfq
巔	mfhm
纓	xmmv
佼	wuqy
叟	vhcu
韁	afgg
邃	pwup
楨	shmy
餒	wyvv
餒	wpev
沽	idg
蹭	khuj
臾	vwi
燎	odui
呱	krcy
亙	gqug
亙	ghng
踵	khtf
漣	ilpy
蹺	khfq
廿	aghg
戌	dgnt
禎	pyhm
荀	aqjf
癲	ufhm
滷	ihlo
芥	awjj
嵇	tdnm
粱	ivwo
諭	ywgj
枷	slkg
霏	fdjd
痰	uooi
咀	kegg
佬	wftx
竣	ucwt
鯉	qojf
皎	ruqy
繽	xpgm
靂	fdth
朕	eudy
蛟	juqy
伎	wfcy
涎	ithp
咆	kqnn
湍	imdj
鏗	qahf
昕	jrh
煦	jqko
巒	xyxm
摳	rakk
憬	njyi
悻	nfuf
謗	yupy
緋	xdjd
鸚	mmvo
稷	tlwt
鞘	afie
璐	gkhk
塢	fwno
哧	kfoy
俟	wctd
攸	whty
恪	ntkg
吠	kdy
撂	rltk
蜒	jthp
餡	wyvv
餡	wpqv
籟	tgkm
拄	rygg
蔗	ayao
茸	abf
盅	khlf
蹋	khjn
輟	lccc
埔	fgey
薊	aqoj
蠕	jfdj
簌	tgkw
秧	tmdy
硫	dycq
硝	dieg
惻	nmjh
鎊	qupy
抉	rnwy
耘	difc
罔	muyn
旌	yttg
吮	kcqn
鑫	qqqf
蠱	jjjl
礫	dxrs
鈺	qgyy
鄔	wngb
榕	spwk
胭	eldy
悚	ngki
幺	xnny
懿	fpgn
鼈	umix
鼈	umiv
暄	jpgg
鰲	gqto
梟	wvgs
汶	iyy
纂	thdi
諺	yute
躋	khyj
躋	khyf
唔	kgkg
泓	ixcy
靄	fyjn
狩	qtpf
掬	rqoy
賑	mdfe
蛤	jwgk
漪	iqtk
捍	rjfh
袂	punw
惆	nmfk
樺	sagf
揩	rxxr
葆	awks
幡	mhtl
菇	avdf
椰	sbbh
臧	dndt
弨	xvkg
貳	afmi
銬	qftn
皿	lhng
簍	tlvf
簍	tkgv
偌	wadk
啜	kccc
湃	irdf
謔	yhag
冽	ugqj
嫵	vrlo
羔	ugou
髻	defk
胚	egig
氮	rnoo
噗	kogy
嫡	vumd
閏	ugd
抿	rnan
渥	ingf
訛	ywxn
窿	pwbg
苓	awyc
噎	kfpu
訶	yskg
甬	cej
邯	afbh
蜕	jukq
舔	tdgn
腆	emaw
鐲	qlqj
刨	qnjh
茉	agsu
碾	dnae
鷺	khto
忒	ani
叁	cddf
匱	akhm
坯	fgig
饞	wyvy
饞	wpqy
甭	giej
痺	urtf
丕	gigf
彝	xgoa
嗟	kuda
鋁	qkkg
唧	kvcb
珏	ggyy
杳	sjf
鳩	vwvo
帚	vpmh
坍	fmyg
祺	pyaw
噥	kmae
甕	yxtn
遽	haep
箕	tadw
鵡	gaho
暱	jaak
癖	unku
琨	gjxx
嬤	vysx
貂	eevk
蚌	jdhh
濮	iwoy
忻	nrh
晁	jiqb
覃	sjj
嗒	kawk
樟	sujh
橢	sbde
娣	vuxt
琥	gham
熠	onrg
渙	iqmd
嗨	kitu
磐	temd
擄	rhal
瑋	gnhh
茗	aqkf
贍	mqdy
猙	qteh
紂	xfy
燼	ovhl
袊	puwc
盂	gflf
躡	khbb
榭	stmf
徙	thhy
坷	fskg
曖	jept
摒	rnua
剌	gkij
晾	jyiy
蘑	aysd
憩	tdtn
璀	gmwy
蜿	jpqb
翊	ung
呃	kdbn
鍍	qyac
惴	nmdj
桀	qahs
偃	wajv
舷	teyx
舫	teyn
餃	wyvq
餃	wpuq
葷	aplj
筏	twar
匝	amhk
攆	rfwl
茬	adhf
濡	ifdj
瞟	hsfi
崽	mlnu
犢	trfm
熹	fkuo
簪	taqj
囗	lhng
餞	wyva
餞	wpaa
皖	rpfq
荼	awtu
臍	eyvf
臍	eyjg
閡	uynw
玷	ghkg
蝠	jgkl
禧	pyfk
羲	ugtt
涸	ildg
諳	yujg
飆	dddj
咫	nykw
撬	rtfn
愜	nadw
檳	spgm
泵	diu
氟	rnxj
羌	udnb
媲	vtlx
檬	sape
跛	khhc
桅	sqdb
臆	eujn
豚	eey
杞	snn
癟	utha
肪	eyn
緘	xdgt
瘴	uujk
饗	xtye
蜷	judb
俎	wweg
鬟	dele
渤	ifpl
腋	eywy
柑	safg
馥	tjtt
衢	thhh
醃	sgdn
瑙	gvtq
弈	yoaj
銓	qwgg
喋	kans
慟	ntgl
喏	kadk
徇	tqjg
晟	jdnt
叼	kngg
堰	fajv
掂	ryhk
嚀	kpns
鐫	qwym
扈	ynkc
詮	ywgg
詰	yfkg
濘	ipns
鹼	hlqw
鹼	hlow
沏	iavn
唁	kyg
攣	xyxr
瞰	hnbt
螃	jupy
娓	vntn
阪	brcy
焊	ojfh
聿	vfhk
垛	fmsy
涓	ikeg
梆	sdtb
漳	iujh
榨	spwf
漉	iynx
膿	emae
嶇	makk
儂	wmae
獗	qtdw
蝗	jrgg
謐	yntl
芋	agfj
噯	kept
捅	rceh
邇	gwmp
愴	nwyk
嚓	kpwi
睽	hwgd
蟠	jtol
硅	dffg
徨	trgg
臼	vthg
靚	gehq
縹	xsfi
璨	ghqo
騫	pfjc
蘸	asgo
撾	rmnp
戊	dnyt
氨	rnpv
誹	ydjd
瘠	uiwe
鱷	qogk
笆	tcb
驊	cagf
碳	dmdo
姣	vuqy
蝨	nfjj
璜	gamw
髏	melv
髏	mekv
颼	mtjc
逵	fwfp
轆	lynx
蛀	jygg
胄	mef
欖	sahq
曜	jnwy
蝸	jmnk
痞	ugik
疵	uhxv
烯	oqdh
藜	atqi
搪	ryvk
橄	snbt
骼	metk
癩	ugkm
劏	ipkj
躝	khui
燶	omae
餸	wyvd
餸	wpup
曇	jffc
踹	khmj
薈	awgj
謨	yajd
釜	wqfu
蟒	jada
藐	aeeq
宕	pdf
壕	fype
盹	hgbn
麾	yssn
痘	ugku
珞	gtkg
鏤	qlvg
鏤	qkgv
翱	rdfn
汩	ijg
嗇	fwwk
糜	ysso
鋅	quh
鵠	tfko
瞑	hpju
幔	mhjc
槌	swnp
嶸	moos
玖	gqyy
瞠	hipf
泗	ilg
璉	glpy
臊	ekks
潢	iamw
詼	ydoy
漩	iyth
啻	upmk
軼	lrwy
鐮	qyuo
睨	hvqn
搐	ryxl
莘	auj
猷	usgd
澇	iool
攥	rthi
黏	twik
呷	klh
霽	fyvf
霽	fyjf
賒	mwfi
潼	iujf
腺	eriy
氫	rnga
茁	abmj
俸	wdwh
楔	sdhd
籽	obg
蝙	jyna
蹴	khyn
忑	ghnu
踝	khjs
婕	vgvh
饃	wyvd
饃	wpad
芻	qbtt
峪	mwwk
杵	stfh
璣	gxxt
紉	xvyy
蟄	fufj
噙	kwyc
贛	ujtm
鍬	qtoy
廄	yvcc
啾	ktoy
褶	punr
囿	lded
靦	dmjq
瘁	uywf
跚	khmg
舀	evf
壹	fpgu
掇	rccc
醺	sgto
碘	dmaw
擯	rpgm
髯	demf
懋	scbn
苯	asgf
禺	jmhy
鼾	thlf
蜓	jtfp
紈	xvyy
紜	xfcy
榷	spwy
緲	xhit
忐	hnu
欒	xyxs
昱	juf
骷	medg
酵	sgfb
擻	rlvt
擻	rkgt
訖	ytnn
捱	rdff
隼	wyfj
淄	ivlg
崢	mevh
湄	inhg
荻	aqto
泠	iwyc
煜	ojug
斡	fjwf
敕	gkit
瞌	hfcl
荃	awgf
斕	yugi
韞	nhkl
隕	bkmy
懵	nalh
眈	hpqn
皙	srrf
牒	thgs
囱	tlqi
嫗	vakk
鄲	kkjb
鈸	qdcy
櫛	stvb
呸	kgig
喟	kleg
檸	spns
祚	pytf
蹣	khay
驍	cffq
顰	hidf
酪	sgtk
掰	rwvr
幗	mhlg
蒿	aymk
妲	vjgg
黍	twiu
撣	rkkf
臃	eyxy
迤	tbpv
痙	ugva
泯	inan
灸	qyou
戛	dhar
褸	pulv
褸	pukv
餉	wyvk
餉	wptk
柩	saqy
裨	purf
鐺	qipl
頎	rdmy
繕	xudk
湮	isfg
嫦	viph
箴	tdgt
瘧	uhag
垠	fvey
膘	esfi
羚	udwc
仄	dwi
猥	qtle
颶	mtjw
燁	oagf
咂	kamh
躥	khpn
怵	nsyy
箔	tirf
飩	wyvn
飩	wpgn
剁	msjh
皚	rmgu
黠	lfok
萼	akkn
蟾	jqdy
賁	famu
陲	btgf
襤	pual
仞	wvyy
佃	wlg
麝	ynjf
螂	jyvb
脛	egva
噤	kssi
沱	ipxn
婊	vgey
塾	ybvf
鐐	qdui
恿	cenu
壬	tfd
剽	sfij
熨	nfio
鎬	qymk
氯	rnvi
錮	qldg
骰	memc
佚	wrwy
蜚	djdj
燉	oybt
椽	sxey
縝	xfhw
孀	vfsh
謳	yakk
啐	kywf
隍	brgg
弋	agny
淖	ihjh
稈	tjfh
縐	xqbt
齧	dhvb
胯	edfn
儡	wlll
虯	jnhh
吒	ktan
龕	wgkd
撻	rfup
劾	yntl
孵	qytb
嚏	kfph
蜻	jgeg
罹	lnwy
訃	yhy
戾	yndi
祐	pydk
淅	isrh
佞	wfvg
慵	nyvh
鄱	tolb
劊	wglj
蹶	khdw
穌	qoty
濯	inwy
獺	qtgm
涇	igva
俑	wceh
羿	naj
雉	tdwy
瀘	ihal
涔	imwn
倭	wtvg
岌	meyu
遨	gqtp
洱	ibg
唄	kmy
痢	utjk
焱	ooou
耦	dijy
夯	dlb
挎	rdfn
郢	kgbh
殮	gqww
逕	gvap
泱	imdy
畹	lpqb
顴	akkm
祛	pyfc
彗	dhdv
砷	djhh
嬋	vkkf
罡	lghf
閂	ugd
胤	txen
倌	wpnn
蟆	jajd
閹	udjn
滸	iytf
唏	kqdh
劭	vkln
磬	fnmd
娑	iitv
銑	qtfq
疹	uwee
耆	ftxj
豺	eeft
粼	oqab
秸	tfkg
飈	mtjo
赳	fhnh
蚣	jwcy
儷	wgmx
抨	rguh
籮	tlxy
渚	iftj
溥	igef
謫	yumd
驪	cgmx
櫓	sqoj
町	lsh
溟	ipju
檜	swgj
諂	yqvg
鬃	depi
弜	xxn
綬	xepc
滓	ipuh
槁	symk
嘹	kdui
擷	rfkm
莓	atxu
咿	kwvt
叵	akd
鑾	xyxq
匍	qgey
孿	xyxb
婀	vbsk
旖	ytdk
閭	ukkd
瞼	hwgw
翦	uejn
蚓	jxhh
僮	wujf
囉	klxy
倜	wmfk
幄	mhnf
珩	gtfh
獷	qtyw
捋	refy
飪	wyvf
飪	wptf
狙	qteg
嗖	kvhc
芍	aqyu
窈	pwxl
軾	laag
愫	ngxi
俾	wrtf
慫	twwn
銖	qriy
駟	clg
岫	mmg
罄	fnmm
韭	djdg
諛	yvwy
蹂	khcs
宸	pdfe
噶	kajn
謾	yjlc
酗	sgqb
泅	ilwy
諉	ytvg
瀅	iooy
嚅	kfdj
鯊	iito
卅	gkk
礬	sqqd
仃	wsh
涿	ieyy
裱	puge
爿	nhde
囁	kbbb
傀	wrqc
鍥	qdhd
榛	sdwt
樽	susf
膾	ewgj
澹	iqdy
噠	kfup
曄	jagf
唷	kyce
洵	iqjg
揄	rwgj
粲	hqco
詡	yng
鉻	qtkg
鄺	yamb
撅	rduw
糯	ofdj
挹	rkcn
峋	mqjg
逅	rgkp
礪	dday
坳	fxln
蟀	jyxf
咔	khhy
釉	tomg
儺	waky
匐	qgkl
琮	gpfi
蜈	jkgd
躪	khay
侗	wmgk
艮	vei
囔	kgke
砧	dhkg
蜃	dfej
滂	iupy
灝	ijym
囡	lvd
鈉	qmwy
囤	lgbn
蚤	cyju
鰻	qojc
礴	daif
謅	yqbt
埂	fgjq
箸	tftj
啕	kqrm
菠	aihc
崓	mldg
莆	agey
笈	teyu
舐	tdqa
鴇	xfwo
潞	ikhk
宓	pntr
蒞	aiwu
邂	qevp
塹	lrff
譎	ycbk
巽	nnaw
嚶	kmmv
涪	iukg
衾	wyne
霾	feef
潁	xidm
侏	wriy
茱	ariu
潯	ivaf
鯽	qovb
恫	nmgk
頡	fkdm
窕	pwiq
柚	smg
砥	dqay
糠	oyvi
怏	nmdy
峒	mmgk
噫	kujn
蟋	jton
蚯	jrgg
衲	pumw
佰	wdjg
嬪	vpgm
蛆	jegg
拮	rfkg
佘	wfiu
藺	auwy
汴	iyhy
胺	epvg
靨	djed
嗑	kfcl
讒	yqky
翳	atdn
綹	xthk
裟	iite
遑	rgpd
恁	wtfn
滜	irdf
淬	iywf
窠	pwjs
觴	qmfr
頜	wgkm
牘	thgm
娩	vqkq
腴	evwy
胰	egxw
郴	ssbh
嬴	ynky
覬	mgkq
粽	opfi
搽	raws
琬	gpqb
僂	wlvg
聒	btdg
嗷	kgqt
濰	ixwy
碴	dsjg
鷲	yido
瘀	uywu
齷	hwwf
齷	hbnf
蛔	jlkg
媧	vmnk
昶	ynij
愠	njlg
邕	vkcb
齪	hwwh
齪	hbkh
揆	rwgd
婠	vpnn
瀨	igkm
覲	akgq
鈾	qmg
袈	lkye
罌	mmrm
夔	uhtt
祗	pyqy
鴕	wvgx
嗥	krdf
鉀	qlh
盥	qgil
恂	nqjg
稔	twyn
鯤	qojx
絀	xbmh
斫	drh
闋	uwgd
鐗	queg
囹	lwyc
廱	yvky
鉞	qant
旎	ytnx
庖	yqnv
畦	lffg
鈣	qghn
蹩	umih
啷	kyvb
瑁	gjhg
癸	wgdu
嵋	mnhg
詆	yqay
嶙	moqh
淞	iswc
歆	ujqw
庾	yvwi
皈	rrcy
縉	xgoj
覦	wgeq
驤	cyke
燮	oyoc
楫	skbg
鸝	gmyo
淼	iiiu
駙	cwfy
荏	awtf
桎	sgcf
仝	waf
魘	djec
襠	puil
耙	dicn
潸	isse
梏	stfk
烷	opfq
珉	gnan
氲	rnjl
剮	mnmj
檄	sryt
浹	idww
輦	fwfl
淙	ipfi
焙	oukg
榔	syvb
煊	opgg
誥	ytfk
楹	secl
囈	kafc
葩	arcb
鎧	qmgu
咻	kwsy
尕	eiu
灩	idhl
圻	frh
赧	fobc
捫	rug
摺	rnrg
邈	eerp
蠡	xejj
舸	tesk
斛	qeuf
閾	uakg
仟	wtfh
痣	ufni
耄	ftxn
磺	damw
鄴	ogub
鴣	dwvo
豢	udeu
黜	lfom
睢	hwyg
萋	agvv
騖	cbtc
悌	nuxt
櫺	sfkk
鑣	qyno
饌	wyvw
饌	wpnw
粕	org
徠	tsww
濂	iyuo
餛	wyvx
餛	wpjx
氤	rnld
柞	sthf
轡	xlxk
啖	kooy
蘅	atqh
鶉	ybwo
鋌	qtfp
鈿	qlg
摞	rlxi
篙	tymk
琰	gooy
涮	inmj
飭	wyvl
飭	wptl
餾	wyvl
餾	wpql
祉	pyhg
嗬	kawk
姝	vriy
賡	yvwm
屐	ntfc
芊	atfj
哂	ksg
棹	shjh
喙	kxey
篝	tfjf
湎	idmd
娉	vmgn
懣	iamn
袤	ycbe
鏖	ynjq
韃	affp
圇	lwga
儻	wipo
鰍	qoto
謄	eudy
蹇	pfjh
俚	wjfg
鈐	qwyn
澧	imau
儈	wwgj
莠	ateb
蕎	atdk
櫚	sukk
鳶	awvo
鎂	qugd
唰	knmj
軻	lskg
絛	whti
孑	bnhg
疽	uegd
菏	aisk
忤	ntfh
珮	gmgh
懨	ndjd
蹉	khua
鉉	qyxy
圜	llge
戩	gcca
傣	wdwi
赭	fofj
椏	sghg
椏	sgfg
徉	tudh
伉	wymn
酮	sgmk
蓑	ayke
鷓	yaoo
紓	xcbh
綦	adwi
酩	sgqk
袞	ukeu
贋	dwwm
麋	ynjo
逡	cwtp
幃	mhnh
嶂	mujh
綰	xpnn
鑠	qxrs
寮	pdui
苒	amff
酶	sgtu
蘄	akkr
燾	fnao
笞	tckf
玥	geg
兗	ukqb
瘍	ujgr
諶	yadn
獐	qtuj
暹	jwyp
踮	khyk
遴	oqap
餑	wyvb
餑	wpfb
驁	gqtc
釧	qkh
挈	dhvr
妤	vcbh
狎	qtlh
蝟	jleg
惲	nplh
熵	oumk
砒	dxxn
岷	mnan
闞	unbt
氅	imkn
輥	ljxx
鷂	ermo
殞	gqkm
碉	dmfk
螳	jipf
氵	iyyg
羸	ynky
姮	vgjg
鶩	cbto
歟	wfgw
歟	vgnw
豌	gkub
睇	huxt
忸	nnfg
挲	iitr
誑	yqtg
綃	xieg
褓	puws
剜	pqbj
菡	abib
駢	cuah
淦	iqg
橇	stfn
殫	gqkf
汨	ijg
鉅	qang
耷	dbf
昀	jqug
躅	khlj
汐	iqy
襁	puxj
莢	adww
郜	tfkb
佻	wiqn
鈦	qdyy
鉚	qqtb
佗	wpxn
杼	scbh
茴	alkf
徜	timk
揶	rbbh
嗄	kdht
肛	eag
玳	gway
噘	kduw
圩	fgfh
噼	knku
枇	sxxn
酊	sgsh
鄢	ghgb
掮	ryne
竽	tgfj
畿	xxal
遛	qyvp
爰	eftc
痔	uffi
氰	rnge
葳	adgt
臬	thsu
弁	caj
癆	uool
鎳	qths
陟	bhit
奼	vtan
遒	usgp
鸛	akko
誚	yieg
獼	qtxq
孱	nbbb
弝	xcn
汃	iwy
杓	sqyy
洙	iriy
驃	csfi
犛	fith
佝	wqkg
杴	sqwy
醴	sgmu
鰭	qofj
觥	qeiq
僉	wgkw
縊	xuwl
蔻	apfl
嬈	vffq
鋰	qjfg
陂	bhcy
嘭	kfke
煬	ojgr
怩	nnxn
姘	vuah
撳	rqqw
蛐	jmag
慪	nakk
囫	lqre
烴	ogva
艄	teie
顎	kkfm
倨	wndg
邋	vlqp
酈	gmyb
宥	pdef
鍘	qmjh
綄	xpfq
旄	yttn
刎	qrjh
燧	ouep
嫚	vjlc
痼	uldd
胱	eiqn
肱	edcy
鶚	kkfo
蘢	aued
楂	ssjg
邐	gmyp
媪	vjlg
犒	tryk
喁	kjmy
謖	ylwt
邡	ybh
歿	gqqc
顥	jyim
忝	gdnu
汞	aiu
遢	jnpd
氦	rnyw
儆	waqt
饈	wyvf
饈	wpuf
碣	djqn
篋	tadw
紕	xxxn
跎	khpx
墒	fumk
糅	ocbs
圄	lgkd
螟	jpju
弭	xbg
擘	nkur
阡	btfh
腈	egeg
簣	tkhm
傖	wwyk
霈	figh
擢	rnwy
猢	qtde
菅	apnn
燴	owgj
蝌	jtuf
趄	fheg
蘚	aqod
妊	vtfg
冪	pajh
甌	akkn
杷	scn
搡	rccs
滁	ibwt
俳	wdjd
蟑	jujh
莒	akkf
嶗	mool
濠	iype
呦	kxln
邛	abh
穰	tyke
崴	mdgt
頦	yntm
癬	uqod
豕	egty
蠹	gkhj
珈	glkg
牝	trxn
翕	wgkn
摜	rxfm
裾	pund
忪	nwcy
煨	olge
錕	qjxx
鋇	qmy
鵪	djno
酯	sgxj
喑	kujg
浜	irgw
轂	fpgc
僭	waqj
齜	hwwx
齜	hbhx
戕	nhda
胴	emgk
癇	uued
銼	qwwf
誆	yagg
閎	udci
灤	ixys
墀	fnih
箝	traf
垸	fpfq
蜥	jsrh
舛	qahh
崆	mpwa
炷	oygg
餿	wyvc
餿	wpvc
邙	ynbh
湜	ijgh
虻	jynn
矍	hhwc
囀	klgf
軛	ldbn
葺	akbf
鏞	qyvh
橐	gkhs
勖	jhln
奐	qmwd
鞬	afvp
琍	gtjh
琭	gviy
彀	fpgc
踽	khty
郗	qdmb
鷁	uwlo
犄	trdk
噝	kxxi
輅	ltkg
踅	rrkh
酰	sgtq
咭	kfkg
逶	tvpd
嵬	mrqc
孢	bqnn
珣	gqjg
鉸	quqy
嶠	mtdk
髭	dehx
漕	igmj
矽	dqy
噱	khae
苜	ahf
鄖	kmbh
羶	udyg
蛹	jceh
艹	aghh
呶	kvcy
輜	lvlg
殤	gqtr
粳	ogjq
闃	uhdi
闈	unhh
硒	dsg
釒	qtyg
齲	hwwy
齲	hbty
歙	wgkw
秣	tgsy
笳	tlkf
隗	brqc
鐙	qwgu
澍	ifkf
猗	qtdk
嬗	vylg
帙	mhrw
賅	mynw
攛	rpwn
悒	nkcn
絝	xdfn
亳	ypta
儔	wfnf
猻	qtbi
蚱	jthf
皝	rgiq
杈	scyy
傈	wssy
銨	qpvg
砭	dtpy
唳	kynd
貉	eetk
饕	kgne
氖	rneb
濛	iape
虢	efhm
鱔	qouk
郅	gcfb
鉑	qrg
暝	jpju
鏵	qagf
獠	qtdi
弒	qsya
愾	nrno
祜	pydg
罅	rmhh
砼	dwag
塋	oopf
烊	oudh
詬	yrgk
舢	temh
彙	xgps
胛	elh
鄆	plbh
牖	thgy
稗	trtf
篁	trgf
痂	ulkd
鴆	pqwo
醮	sgwo
蠊	jyuo
藪	alvt
藪	akgt
聃	bmfg
堇	akgf
鰥	qoli
鱸	qohl
恚	ffnu
癰	uvky
槨	sybb
愎	ntjt
樨	snih
嗝	kgkh
湟	irgg
苫	ahkf
獏	qtad
奩	dakk
畲	wfil
睾	tlff
鍔	qkkn
騮	cqyl
飴	wyvk
飴	wpck
鬻	xoxh
聵	bkhm
蕨	aduw
諍	yqvh
嗲	kwqq
婺	cbtv
痍	ugxw
偈	wjqn
銥	qyey
壅	yxtf
峁	mqtb
孳	uxxb
螫	fotj
蚪	jufh
媾	vfjf
佶	wfkg
儕	wyvf
儕	wyjg
諤	ykkn
僖	wfkk
珙	gawy
汊	icyy
舂	dwvf
柘	sdg
陘	bgva
蜢	jblg
摑	rlag
鮭	qoff
孬	givb
崧	mswc
硼	deeg
奘	nhdd
蜍	jwty
闇	uujd
皰	hcqn
庠	yudk
諡	ywgl
詁	ydg
柟	smfg
繅	xvjs
籩	tthp
瓔	gmmv
鶻	mewo
馗	vuth
弿	pfjx
癯	uhhy
訇	qyd
闐	ufhw
躕	khyf
鏃	qytd
瀧	iued
萸	avwu
綣	xudb
粑	ocn
蜴	jjqr
讕	yugi
娠	vdfe
堃	yyff
狒	qtxj
沆	iymn
鷙	fufo
篾	tldt
肓	ynef
妯	vmg
讎	wyyy
吋	kfy
盱	hgfh
墉	fyvh
訐	yfh
噔	kwgu
愆	tifn
磣	dcce
垓	fynw
諢	yplh
鍺	qftj
稞	tjsy
靛	geph
狷	qtke
鱘	qovf
笏	tqrr
魷	qodn
枸	sqkg
鳧	wvgm
惇	nybg
趔	fhgj
蚩	bhgj
嗩	kimy
靼	afjg
娌	vjfg
詒	yckg
沭	isyy
灞	ifae
褡	puak
藎	avhl
琊	gahb
蓿	apwj
鎰	quwl
桁	stfh
嘜	kswt
鈀	qcn
冼	utfq
賚	swwm
肄	xtdh
躑	khub
縞	xymk
嘁	kdht
葭	anhc
繾	xkhp
蒯	aeej
枰	sguh
噹	kipl
耋	ftxf
閬	uyve
磴	dwgu
錳	qblg
苕	avkf
仡	wtnn
譙	ywyo
炔	onwy
毖	xxnt
泫	iyxy
駑	vccu
廩	yylt
燊	ooos
邳	gigb
苧	apsj
轔	loqh
鎢	qwno
薺	ayvf
薺	ayjf
滎	oopi
櫈	swgm
薾	agwq
弅	wvaj
檵	sxxn
廥	ywgj
珋	gqtb
檷	sgwq
茯	awdu
舗	wfky
軫	lwet
櫏	ssdp
檲	slgf
弇	wgka
檿	djes
櫌	sdet
蹼	khoy
厝	dajd
眇	hitt
儐	wpgm
幛	mhuj
玢	gwvn
瞽	fkuh
亻	wth
詎	yang
穡	tfwk
衿	puwn
堊	ghgf
堊	gfgf
鮎	qohk
溧	issy
黿	fqxf
黿	fqmv
夤	qpgw
齟	hwwg
齟	hbeg
鬈	deub
紆	xgfh
眥	hxhf
驄	ctln
繇	ermi
扦	rtfh
睥	hrtf
謇	pfjy
鐳	qflg
韙	jghh
荑	agxw
咩	kudh
螻	jlvg
螻	jkgv
啁	kmfk
欹	dskw
騏	cadw
疥	uwjk
蠣	jday
簟	tsjj
蔫	agho
鼉	kklx
鼉	kklv
帔	mhhc
蓼	anwe
幷	tftf
鴟	qayo
瓤	ykky
悱	ndjd
糗	othd
哞	kcrh
柢	sqay
緹	xjgh
躉	ajmh
蒗	aiye
洌	igqj
崍	msww
倵	wgah
鏜	qipf
衽	putf
箬	tadk
篦	ttlx
耒	dii
摭	ryao
蜇	rrju
蠔	jype
杲	jsu
瓴	wycn
犟	xkjh
衩	pucy
褳	pulp
跆	khck
琚	gndg
雒	tkwy
腓	edjd
瓚	gtfm
暐	jnhh
邨	gbnb
瀲	iwgt
薌	axtb
牯	trdg
旯	jvb
珺	gvtk
扌	rghg
嗶	kjaf
孃	vyke
橛	sduw
齬	hwwk
齬	hbgk
瑗	gefc
釩	qmyy
碭	djgr
臏	epgm
旮	vjf
蓖	atlx
梔	srgc
寤	pnhk
樅	stwh
鋥	qkgg
氹	nii
崮	mldf
縵	xjlc
讖	ywwg
壎	ftgo
醛	sgag
虳	jqyy
蘧	ahap
逖	qtop
鬣	devn
柰	sfiu
齎	yvum
齎	yjmu
巋	mwnh
嬙	vfwk
瘢	utec
蛭	jgcf
碓	dwyg
漚	iakk
蜉	jebg
贇	ygam
嵯	muda
鐃	qffq
嘣	kmee
愀	ntoy
魑	rqcc
緇	xvlg
徼	tryt
鬮	hggx
鬮	hggg
樾	sfht
鈈	qgiy
檣	sfwk
踟	khtk
秭	ttnt
疸	ujgd
郄	qdcb
蓁	adwt
醪	sgne
饜	djee
郯	oobh
毽	tfnp
蟈	jlag
抻	rjhh
邰	ckbh
搴	pfjr
趿	khey
甯	pnej
髖	mepy
肽	edyy
盍	fclf
洮	iiqn
氙	rnmj
燜	ouny
贄	fufm
鈷	qdg
刈	qjh
縟	xdff
疣	udnv
羯	udjn
廡	yrlo
摶	rgjf
彠	vakc
齇	thlg
齦	hwwe
齦	hbve
頊	gdmy
坨	fpxn
拊	rwfy
菽	ahic
迨	ckpd
轤	lhal
腱	evfp
喵	kalg
鏑	qumd
漯	ilxi
屣	nthh
笄	tgaj
乜	nnv
捌	rklj
淥	ixgi
噻	kpff
昝	thjf
傴	wakk
溘	ifcl
曷	jqwn
乩	hknn
皴	cwtc
輳	ldwd
騡	criy
躚	khsp
摀	rwno
壠	fued
鮫	qouq
橈	sffq
倀	wdey
玟	gyy
鏨	lrqf
蓊	awcn
黧	tqto
懍	nylt
櫪	sdth
哐	kagg
唿	kqrn
榫	swyf
撟	rtdk
澠	ixg
澠	imgv
蓍	aftj
瀣	ihqg
罘	lgiu
櫱	btws
訾	hxyf
焯	ohjh
獾	qtay
豸	eer
酡	sgpx
麂	ynjm
籙	tqvi
疋	nhi
璦	gept
坻	fqay
酢	sgtf
簞	tkkf
孛	fpbf
稹	tfhw
爻	qqu
殛	gqbg
剡	oojh
慳	nahf
鬩	hggq
嘵	kffq
蒺	autd
磔	dqas
鰓	qoln
鵾	jxxo
頫	iqdm
釅	sgkt
嬡	vept
洸	iiqn
摁	rldn
啵	kihc
礆	dwgw
閽	uqaj
鷥	xxio
鑷	qbbb
茌	awff
埶	fwfy
逯	vipi
婧	vgeg
痾	ubsk
錙	qvlg
擼	rqoj
峴	mhqn
旃	ytmy
犭	qte
薜	anku
僳	wsoy
邗	fbh
鎵	qpey
觶	qekf
訌	yag
鱈	qofv
怫	nxjh
禳	pyye
櫟	sxrs
苴	aegf
蓴	agjf
棖	sdey
噌	kulj
戢	kbnt
伕	wfwy
佤	wgnn
笤	tvkf
煲	wkso
釆	toi
篪	trhm
軔	lvyy
蝣	jytb
逄	tahp
煢	oopf
侑	wdeg
湫	itoy
鄯	udub
彿	txjh
櫸	swfh
櫸	svgh
鉦	qghg
薏	aujn
魎	rqcy
嶷	mxth
萵	amnk
潾	ioqh
蚋	jmwy
殄	gqwe
翥	ftjn
莧	ahqb
捭	rrtf
呎	knyy
胝	eqay
鞣	afcs
釺	qtfh
鯁	qogq
崻	mtff
鞅	afmd
闥	ufup
猱	qtcs
鼐	ehnn
岬	mlh
蕖	aias
閶	ujjd
醍	sgjh
竦	ugki
擀	rfjf
迒	ympv
趲	fhtm
矓	hued
鎩	qqsc
懟	ogun
棻	awvs
珪	gffg
緗	xshg
魍	rqcn
鑊	qawc
柒	iasu
曩	jyke
仵	wtfh
嫫	vajd
襦	pufj
晷	jthk
搧	rynn
凇	uswc
莜	awht
唑	kwwf
槊	ubts
嵊	mtux
鷸	cbto
槿	sakg
菖	ajjf
澔	irtk
菬	aivk
漵	iwtt
糌	othj
倥	wpwa
玀	qtly
椋	syiy
楝	sgli
澐	iffc
眙	hckg
騅	cwyg
輊	lgcf
螭	jybc
洄	ilkg
磧	dgmy
鍇	qxxr
閆	udd
圉	lfuf
獪	qtwj
顓	mdmm
胼	euah
芨	aeyu
苣	aanf
跖	khdg
碇	dpgh
詈	lyf
癘	uajy
筮	taww
堖	fvtq
隹	wyg
圮	fnn
砝	dfcy
槭	sdht
螯	gqtj
嬖	nkuv
魈	rqce
饉	wyvg
饉	wpag
妁	vqyy
嘬	kjbc
矇	hape
蟮	judk
鉬	qhg
媯	vyto
紱	xdcy
檽	sfdj
傕	wpwy
矸	dfh
鋃	qyve
埭	fviy
瘻	ulvd
瘻	ukgv
甑	uljn
幪	mhae
愍	natn
狺	qtyg
廛	yjff
碚	dukg
泮	iufh
縶	fufi
槎	suda
蹕	khjf
騭	bhic
顳	bbbm
婛	vyiy
犖	ooph
醐	sgde
紇	xtnn
蕤	aetg
怙	ndg
銃	qycq
褊	puya
舨	terc
仨	wdg
詘	ybmh
邾	ribh
毳	tfnn
嶧	mlff
庥	ywsi
錡	qdsk
浼	iqkq
薨	alpx
櫳	sued
儋	wqdy
辶	pyny
髑	melj
喆	fkfk
彘	xgxx
鏹	qxkj
逋	gehp
嚦	kdth
緡	xnaj
呲	khxn
擤	rthj
邴	gmwb
鶿	uxxo
苻	awfu
龑	uegd
仫	wtcy
迓	ahtp
椐	sndg
卟	khy
鯔	qovl
蚜	jaht
鱒	qouf
餮	gqwe
圪	ftnn
砣	dpxn
楮	sftj
姒	vnyw
牠	trbn
觚	qery
廰	ybfn
痿	utvd
誾	uyd
檼	sean
蚨	jfwy
柙	slh
痧	uiit
琺	gifc
臠	xyxw
樗	sffn
亍	fhk
豉	gkuc
銻	quxt
虺	gqji
僨	wfam
牾	trgk
滹	ihah
嚃	klip
汜	inn
掾	rxey
醚	sgop
堞	fans
瓠	dfny
屨	ntlv
屨	ntkv
朐	eqkg
酐	sgfh
鯀	qoti
欷	qdmw
怍	nthf
酚	sgwv
卮	rgbv
隰	bjxo
帑	vcmh
妗	vwyn
霰	faet
扃	ynmk
氐	qayi
瑱	gfhw
搠	rube
瀠	iooi
桉	spvg
貲	hxmu
爨	wfmo
禇	pyfj
膂	ytee
搦	rxuu
翃	dcng
逑	fiyp
俅	wfiy
洨	iuqy
螓	jdwt
忭	nyhy
簋	tvel
嬛	vlge
髫	devk
軲	ldg
狍	qtqn
萇	adeu
咣	kiqn
鈑	qrcy
楸	stoy
藁	ayms
齏	yvug
齏	yjdg
飧	qwye
絰	xgcf
芄	avyu
蓽	ajaf
膈	egkh
蓱	aiua
雩	ffnb
懌	nlff
秈	tmh
畚	cdlf
傯	wtln
翮	gkmn
伷	wmg
雎	egwy
瓘	gaky
菀	apqb
睒	hooy
螄	jwnh
睃	hcwt
裎	pukg
菟	aqky
琿	gplh
尻	nvv
戇	ujtn
噲	kwgj
暌	jwgd
縻	yssi
纛	gxgi
纛	gxf
菘	aswc
禰	pygq
攖	rmmv
侉	wdfn
栲	sftn
郾	ajvb
珥	gbg
璫	gipl
杪	sitt
窨	pwuj
淝	iecn
閫	ulsi
匏	dfnn
刖	ejh
燠	otmd
荇	atfh
芾	agmh
燹	eeou
鄞	akgb
覿	flmq
鎏	iycq
彧	gkgy
彧	akge
腚	epgh
淶	isww
劬	qkln
菑	avlf
蛩	amyj
戧	wyva
煅	owdc
笥	tngk
塬	fdri
覘	hkhq
洎	ithg
炘	orh
罟	ldf
檮	sfnf
巿	gmhk
褔	pugl
鞫	afqy
劼	fkln
癤	utvb
悰	npfi
玎	gsh
勰	llln
戡	adwa
譫	yqdy
鑭	qugi
蒔	ajff
鱖	qodw
捩	rynd
冏	mwkd
霙	famd
媵	eudv
顙	cccm
褙	puue
砉	dhdf
紿	xckg
沔	ighn
蟎	jamy
紺	xafg
蜮	jakg
埡	fghg
埡	fgfg
晗	jwyk
羆	lceo
崐	mjxx
芘	axxb
阼	bthf
髀	merf
桷	sqeh
鼙	fkuf
忄	nyhy
檟	ssmy
砦	hxdf
洹	igjg
牤	tryn
酆	dhdb
嶴	tmom
羼	nudd
繒	xulj
蛉	jwyc
艏	teuh
鵜	uxho
祆	pygd
糹	xnny
蠃	ynky
勐	blln
拶	rvqy
溴	ithd
鮐	qock
怛	njgg
宀	pyyn
欏	slxy
菰	abry
鯢	qovq
礱	uegd
壙	fyaw
蜊	jtjh
趺	khfw
氘	rnjj
矞	cbtk
呔	kdyy
駘	cckg
縑	xuvo
嘏	dnhc
炁	aqou
櫗	salt
堀	fnbm
茭	auqu
蒡	aupy
痱	udjd
黷	lfom
晞	jqdh
麩	swww
萘	adfi
諞	yyna
蜆	jhqn
獚	qtaw
櫬	susq
甦	gjqg
麤	ynjx
茆	aqtb
妣	vxxn
鏍	qlxi
遄	mdmp
魃	rqcc
庹	yany
旒	ytyq
殂	gqeg
鷦	wyoo
鯕	qoaw
臚	ehal
叻	kln
獒	gqtd
瘖	uujd
鉺	qbg
鑌	qpgm
驂	ccce
蛄	jdg
坼	fryy
獱	qtpm
陬	bbcy
醯	sgyl
黢	lfot
芫	afqb
郇	qjbh
鰱	qolp
皤	rtol
苡	anyw
枳	skwy
齶	hwwn
齶	hbkn
裰	pucc
愔	nujg
崁	mfqw
隳	bdan
櫑	slll
鞳	afak
茀	axjj
焓	owyk
憒	nkhm
泔	iafg
鋮	qdnt
暾	jybt
麈	ynjg
莪	atrt
蕁	avaf
韉	afao
聬	bwcn
塍	eudf
岜	mcb
厙	dlk
阝	bnh
躓	khrm
騶	cqbt
挏	rmgk
狻	qtct
燔	otol
郛	ebbh
藿	afwy
硌	dtkg
憮	nrlo
筌	twgf
鉍	qntt
趑	fhuw
篳	tjaf
缶	rmk
幘	mhgm
钁	qhhc
芟	amcu
嘞	kafl
畋	lty
棰	stgf
蚶	jafg
纈	xfkm
溽	idff
趵	khqy
饢	wyve
饢	wpge
紘	xdcy
徂	tegg
犍	trvp
旆	ytgh
薹	afkf
囝	lbd
菸	aywu
鸕	halo
仉	wmn
梃	stfp
眄	hghn
跗	khwf
蒹	auvo
葸	alnu
貺	mkqn
徭	term
埕	fkgg
慊	nuvo
喱	kdjf
筲	tief
枋	syn
艟	teuf
攧	rfhm
瘳	unwe
鼬	vnum
穠	tmae
隈	blge
澌	iadr
嗵	kcep
嫠	fitv
睚	hdff
瞀	cbth
鬲	gkmh
蝮	jtjt
殍	gqeb
浬	ijfg
鶘	dewo
孌	xyxv
褫	purm
糲	oday
黼	oguy
椹	sadn
殳	mcu
佾	wweg
哏	kvey
杌	sgqn
槃	tems
縋	xwnp
痤	uwwf
喈	kxxr
秫	tsyy
涫	ipnn
檉	sbkg
黻	oguc
螈	jdri
蹁	khya
圯	fnn
磻	dtol
屙	nbsk
衤	pui
廨	yqeh
倕	wtgf
唣	kran
崟	mqf
吔	kbn
箐	tgef
篚	tadd
榘	tdas
蠲	uwlj
巹	bign
螅	jthn
釹	qvg
銧	qiqn
懃	akgn
鄹	bctb
鯖	qoge
懮	ndet
檁	sylt
孥	vcbf
蹓	khql
笸	takf
魴	qoyn
兕	mmgq
皸	plhc
鴰	tdwo
憷	nssh
麇	ynjt
刳	dfnj
滉	ijiq
脘	epfq
糝	occe
鶇	gjio
坭	fnxn
鯡	qodd
蕈	asjj
跣	khtq
簦	twgu
搥	rwnp
泚	ihxn
瞵	hoqh
嚯	kfwy
鏊	gqtq
猊	qtvq
籀	trql
昴	jqtb
楦	spgg
瀰	ixgq
絎	xtfh
櫝	sflm
蔟	aytd
蟯	jffq
縲	xlxi
蹀	khas
齠	hwwk
齠	hbvk
蠆	ajmj
瓿	ukgn
甾	vlf
溷	iley
髡	degq
佺	wwgg
硐	dmgk
鉭	qjgg
跫	amyh
鼴	vnuv
獁	qtcy
揎	rpgg
葚	aadn
吜	knfg
畈	lrcy
緱	xwnd
萁	aadw
郟	dwwb
呤	kwyc
鬯	qobx
鯛	qomk
鷯	dujo
釤	qet
廴	pny
蒽	aldn
肫	egbn
垧	ftmk
漶	ikkn
耜	dinn
冮	uag
綯	xqrm
嗾	kytd
伢	waht
訁	yygg
酹	sgef
葨	alge
鰣	qojf
芎	axb
硨	dlh
埴	ffhg
嗞	kuxx
紲	xann
媸	vbhj
浠	iqdh
桫	siit
彖	xeu
臁	eyuo
鱠	qowj
癭	ummv
滏	iwqu
踣	khuk
饔	yxte
淠	ilgj
慝	aadn
苾	antr
蟊	cbtj
歃	tfvw
鮒	qowf
桕	svg
糴	tyoy
笱	tqkf
吡	kxxn
犴	qtfh
啉	kssy
疔	usk
餈	uqwe
籜	trlf
凈	uevh
暪	jamy
桴	sebg
蹚	khif
槧	lrsu
頇	fdmy
腩	efmf
囓	kdhb
艿	aeb
蕷	acbm
焐	ogkg
謩	ajdy
嗪	kdwt
鉶	qgaj
裼	pujr
徬	tupy
蠙	jpgm
觳	fpgc
畀	lgjj
羥	udga
豇	gkua
蠐	jyvf
蠐	jyjg
濼	ixrs
鮁	qodc
氡	rntu
跬	khff
脲	eniy
鄠	ffnb
瘞	udwf
癜	unac
醢	sgdl
綮	ynti
逭	pnhp
鈮	qnxn
鰨	qojn
踔	khhj
蛺	jdww
輞	lmun
毿	cccn
舁	vaj
崤	mqde
恝	dhvn
畤	lffy
襉	puue
蟥	jamw
芰	afcu
閼	uywu
鍶	qlny
粢	uqwo
灃	idhu
妳	vqiy
殭	gqgg
屺	mnn
椴	swdc
笪	tjgf
顢	amhm
笫	ttnt
誄	ydiy
傪	wcce
譖	yaqj
筧	thqb
醅	sguk
緦	xlny
硰	iitd
黥	lfoi
讜	yipo
璩	ghae
肭	emwy
襝	puww
陔	bynw
菹	aieg
綤	vkbi
鎦	qqyl
钃	qnij
棼	sswv
潲	itie
埝	fwyn
荸	afpb
旰	jfh
湓	iwvl
糶	bmoy
悛	ncwt
芪	aqab
檾	oops
鰈	qoas
崚	mfwt
嗌	kuwl
瀦	iefj
崦	mdjn
疃	lujf
鄄	sfbh
塚	fpey
餳	wyvr
餳	wpjr
伲	wnxn
皦	rryt
蕞	ajbc
殪	gqfu
宄	pvb
愬	ubtn
窷	pwbb
亶	ylkg
呋	kfwy
疝	umk
埸	fjqr
窬	pwwj
薅	avdf
箜	tpwa
鋯	qtfk
鎘	qgkh
柝	sryy
鶼	uvoo
檪	sris
杻	snfg
溏	iyvk
篌	twnd
旻	jyu
嗐	kpdk
眭	hffg
砑	daht
蘼	aysd
蠖	jawc
纘	xtfm
猓	qtjs
蔢	aihv
熗	owyk
苷	aaff
澶	iylg
湔	iuej
虙	hant
殽	qdec
槅	sgkh
慔	najd
蔸	aqrq
劌	hdgj
貔	eetx
倬	whjh
聱	gqtb
鶓	alwo
蕻	adaw
紼	xxjh
鮪	qode
俁	wknd
埒	fefy
尥	dnqy
覯	fjgq
舄	vqou
澥	iqeh
堉	fyce
侔	wcrh
彳	ttth
迴	lkpd
壢	fdth
罾	lulj
澣	ifjf
傢	wpey
瘏	uftj
澺	iujn
亓	fjj
鋈	itdq
瑢	gpwk
瑒	gjgr
莨	ayve
饊	wyvt
饊	wpat
顗	mgkm
溱	idwt
螬	jgmj
蝰	jdff
倮	wjsy
揠	rajv
掊	rukg
斁	lfut
煳	odeg
挸	rhqn
楗	svfp
捽	rywf
蔌	agkw
啶	kpgh
躞	khoc
蔦	awvo
墁	fjlc
榧	sadd
濉	ihwy
呯	kguh
飫	wyvd
飫	wptd
蝥	cbtj
惝	nimk
秕	txxn
壚	fhal
祓	pydc
矬	tdwf
紵	xpsh
黽	xhng
黽	mggv
匭	alvv
蓯	atwh
瘂	ughg
瘂	ugfg
庳	yrtf
闏	umtj
柁	spxn
舡	teag
餼	wyvo
餼	wpro
祧	pyiq
猁	qttj
葑	afff
狴	qtxf
銫	qqcn
瞍	hvhc
莩	aebf
涑	igki
囟	tlqi
縭	xybc
蠓	jape
菫	agkg
耨	didf
洧	ideg
嗉	kgxi
髹	dews
簏	tynx
掎	rdsk
櫧	syfj
騸	cynn
錁	qjsy
埽	fvph
鵓	fpbo
霪	fief
熳	ojlc
黹	ogui
喹	kdff
狨	qtad
坫	fhkg
蓐	adff
諑	yeyy
妺	vgsy
苠	anab
揸	rsjg
凊	ugeg
曧	jgkj
筇	tabj
葒	axaf
芡	aqwu
戽	ynuf
詵	ytfq
枒	saht
猞	qtwk
岞	mthf
耬	dilv
耬	dikv
勣	gmln
皞	rrdf
硤	ddww
觫	qegi
唴	kudn
覡	awwq
袷	puwk
崑	mjxx
窶	pwlv
窶	pwkv
眚	tghf
仳	wxxn
鵂	wswo
梘	shqn
炆	oyy
邽	ffbh
牴	trqy
蜩	jmfk
蕢	akhm
婜	ahnv
誶	yywf
艉	tenn
鉈	qpxn
賾	ahkm
脩	whte
灱	ovn
菪	apdf
僦	wyin
濞	ithj
琹	ggsu
禕	pynh
獕	qtmy
嚳	wfqk
嚳	vqqk
斲	nngr
斲	anjr
芴	aqrr
酤	sgdg
曣	jauo
忮	nfcy
菓	ajsu
埤	frtf
詻	ytkg
袪	pufc
鎣	oopq
甍	alpn
垚	ffff
蹧	khgj
甙	aafd
帨	mhuq
昃	jdwu
萏	aqvf
薤	agqg
徳	tfln
鯧	qojj
齕	hwwn
齕	hbtn
鯿	qoya
褰	pfje
蛞	jtdg
笊	trhy
翬	nplj
讋	uegy
鄣	ujbh
瘰	ulxi
睏	hlsy
疄	loqh
岍	mgah
攮	rgke
吽	krhh
褢	yrqe
蚺	jmfg
銚	qiqn
蕘	affq
楙	scbs
鍚	qjgr
蚧	jwjh
檗	nkus
俜	wmgn
惛	nqaj
觿	qemk
蹐	khie
豳	eemk
畛	lwet
贐	mvhl
汔	itnn
郫	rtfb
曛	jtgo
愨	fpgn
諏	ybcy
酲	sgkg
酎	sgfy
戔	aar
襞	nkue
鱟	wfqo
鱟	vqqo
摽	rsfi
廾	agth
礌	dflg
祼	pyjs
撙	rusf
讞	yhad
畎	ldy
塄	flyn
鈹	qhcy
岢	mskf
溲	ivhc
袢	puuf
櫨	shal
螽	tujj
囮	lwxv
瞢	alph
艫	tehl
枵	skgn
毐	fxdr
岨	megg
呣	kxgu
轢	lxrs
嘸	krlo
堝	fmnk
檠	aqks
噦	khdt
凼	ibk
蚵	jskg
孓	byi
湆	iujg
翣	nuvf
蚍	jxxn
龢	wgkt
啗	kqvg
芩	awyn
夐	qmwt
刂	jhh
炅	jou
躐	khvn
柷	skqn
晡	jgey
勍	yiln
糸	xiu
屄	npwi
屝	ndjd
餂	wyvd
餂	wptd
碁	adwd
鞀	afvk
齔	hwwx
齔	hbxn
栳	sftx
傒	wexd
浡	ifpb
邠	wvbh
鯗	udyo
襻	pusr
敉	oty
飠	wyvc
飠	wpu
諼	yefc
嶝	mwgu
涷	igji
萆	artf
垡	waff
肊	enn
洇	ildy
埏	fthp
濪	igec
磽	dffq
箅	tlgj
頏	ymdm
懹	nyke
鈧	qymn
樫	sahf
餕	wyvt
餕	wpct
扆	ynye
尢	dnv
窆	pwtp
磾	dkkf
茛	aveu
瘐	uvwi
髁	mejs
邌	tqtp
疳	uafd
旛	yttl
跽	khnn
鎋	qpdk
鋏	qdww
耔	dibg
洫	itlg
瀋	iptl
絜	dhvi
琇	gten
槲	sqef
劓	thlj
躔	khyf
餷	wyvg
餷	wpsg
窳	pwry
囍	fkuk
鰩	qoem
瘼	uajd
齙	hwwn
齙	hbqn
獬	qtqh
貅	eews
晫	jhjh
櫰	syle
萑	awyf
訄	vyd
趼	khga
躦	khtm
鞽	aftk
櫞	sxxe
鮃	qogh
茍	gjgk
儇	wlge
硎	dgaj
堙	fsfg
胙	ethf
觜	hxqe
楾	sriy
靺	afgs
掯	rheg
舾	tesg
癧	udth
詿	yffg
銣	qvkg
繯	xlge
貊	eedj
噍	kwyo
壼	fpgg
礻	pyi
戥	jtga
噺	kusr
坩	fafg
瘙	ucyj
斝	kkpf
菝	ardc
祹	pyqm
閿	uepc
胗	ewet
嚌	kyvf
嚌	kyjg
蟣	jxxt
屌	nkmh
擐	rlge
姀	vty
姃	vghg
滘	ipwk
溮	iwnh
梶	sntn
氬	rngg
枘	smwy
靿	afxl
尪	dngd
濅	ipvc
翛	whtn
簰	tthf
悃	nlsy
禊	pydd
艋	tebl
纊	xyaw
蚰	jmg
袓	pueg
摤	rdqq
蜣	judn
澮	iwgj
碲	duph
嘓	klag
詧	wyf
飿	wyvm
飿	wpbm
餶	wyve
餶	wpme
霑	fihk
柶	slg
鄩	vakb
蘺	ayby
狓	qthc
耪	diuy
蒴	aube
栝	stdg
貰	anmu
洩	ijxt
臌	efkc
媿	vrqc
舴	tetf
丶	yyll
跂	khfc
饘	wyvg
饘	wpyg
蓳	aakg
偰	wdhd
蕥	aahy
龠	wgka
綞	xtgf
忉	nvn
滻	iutg
鞢	afas
脒	eoy
跏	khlk
鋨	qtrt
瘥	uuda
蠛	jalt
璺	wfmy
騍	cjsy
黌	wfqw
黌	vqqw
鉥	qsyy
謦	fnmy
塒	fjff
鏌	qajd
髟	det
竾	tbb
隄	bjgh
狳	qtwt
駹	cdne
嬲	llvl
蕕	aqtg
鍪	cbtq
偫	wtff
礅	dybt
捝	rukq
鋩	qayn
蝓	jwgj
裒	yveu
蘩	atxi
醑	sgne
僾	wept
玠	gwjh
紬	xmg
暸	jdui
骱	mewj
嵫	muxx
搿	rwgr
葖	apwd
衄	tlnf
唵	kdjn
遘	fjgp
砟	dthf
勱	ajml
坌	wvff
鷳	uewo
寔	pjgh
鄶	wglb
襆	puoy
釷	qfg
丌	gjk
銪	qdeg
錈	qudb
厶	cny
螗	jyvk
穭	tqoj
岣	mqkg
剴	mgkj
漀	fnmi
酞	sgdy
鰾	qosi
繐	xgjn
敔	gkty
垤	fgcf
躼	tmde
獍	qtuq
誒	yctd
汆	tyiu
揲	rans
岈	maht
磙	duce
憯	naqj
撢	rsjh
爝	oelf
蟛	jfke
浯	igkg
睌	hqkq
胍	ercy
蹘	khne
舯	tekh
鍤	qtfv
隉	bvag
庋	yfci
鱺	qogx
鰷	qows
咴	kdoy
癔	uujn
昉	jyn
婞	vfuf
矧	tdxh
簀	tgmu
笮	tthf
惓	nudb
艨	teae
莰	afqw
堍	fqky
嚁	knwy
腠	edwd
銦	qldy
錛	qdfa
碡	dgxu
鮓	qotf
臟	eadt
晢	rrjf
婄	vukg
苄	ayhu
羝	udqy
迶	depd
潷	itvh
樘	sipf
哌	krey
賻	mgef
醵	sghe
緄	xjxx
瑯	gyvb
鏝	qjlc
罱	lfmf
髕	mepm
嶁	mlvg
嶁	mkgv
烀	otuh
偲	wlny
縗	xyke
檫	spwi
嗛	kuvo
旐	ytiq
鎯	qyvb
酃	fkkb
瘌	ugkj
蠑	joos
悝	njfg
恧	dmjn
挌	rtkg
曈	jujf
拏	vcrj
鏐	qnwe
泐	ibln
畠	rlf
翽	hdgn
抐	rmwy
蓰	athh
犎	fffh
堋	feeg
忳	ngbn
釕	qbh
嚭	fkuk
鴝	qkwo
芑	anb
吲	kxhh
鷣	sjwo
拃	rthf
邞	fwbh
黲	lfoe
嵛	mwgj
鼯	vnuk
亹	ywfg
亹	yvmg
閵	uwyd
牂	nhdd
堬	fwgj
皜	rymk
綆	xgjq
菔	aebc
捀	rtdh
瓛	ghad
畬	wtlf
迍	gbnp
榿	smgu
蔞	alvf
蔞	akgv
蜾	jjsy
劁	wyoj
迕	tfpk
湲	iefc
肼	efjh
鵒	wwko
嚘	kdet
壻	fnhe
緼	xjlg
鍰	qefc
倖	wfuf
晳	srjf
礽	pyen
甡	tgtg
僬	wwyo
烔	omgk
朊	efqn
唸	kwyn
毹	wgen
皠	rmwy
枟	sfcy
嚮	xtyk
迻	qqpi
犰	qtvn
昩	jgsy
讚	ytfm
撚	rqdo
堠	fwnd
軹	lkwy
氽	wiu
匚	agn
儦	wyno
徦	tnhc
帟	yomh
霅	fyf
瀹	iwga
墼	gjff
嗍	kube
鋦	qnnk
偊	wtky
鰉	qorg
鰹	qoaf
緙	xafh
嚤	kysr
桖	stlg
脤	edfe
荽	aevf
勅	gkil
悕	nqdh
癀	uamw
儵	whto
臑	efdj
冫	uyg
妬	vdg
槔	srdf
綟	xynd
舳	temg
蝤	jusg
狖	qtpw
盃	gilf
炱	ckou
爎	opdi
頱	efdm
怽	nfiy
甏	fkun
氾	ibn
廑	yakg
綈	xuxt
磿	dttd
桄	siqn
烿	omye
捨	rwfk
欘	snij
黟	lfoq
眵	hqqy
崙	mwga
惵	nans
炤	ovkg
唻	ksww
搮	rssy
葎	atvh
嚩	kxgf
晱	jooy
呬	klg
駯	criy
詖	yhcy
摛	rybc
溈	iyto
顬	fdmm
苤	agig
耱	diyd
熘	oqyl
唪	kdwh
垌	fmgk
飉	mtji
艽	avb
諝	ynhe
骺	merk
搛	ruvo
偓	wngf
厴	djel
洳	ivkg
砬	dug
攄	rhan
譾	yuen
墬	bxef
袠	yrwe
唼	kuvg
劚	nilj
洚	itah
貘	eead
潿	ilnh
咼	mnmk
鯫	qobc
剄	gvaj
啣	krhb
鐔	qsjh
娺	vccc
鴯	dmjo
罨	ldjn
鈃	qgah
緶	xwgq
氉	kkkn
珹	gdnt
璠	gtol
騋	csww
迺	spd
璪	gkks
羋	gkgh
炻	odg
鯒	qoce
颮	mtjn
髂	mepk
胩	ehhy
浥	ikcn
彡	ettt
脷	etjh
駔	cegg
鯓	qott
矘	hipo
釃	sggx
栘	sqqy
佷	wvey
篥	tssu
漭	iada
姁	vqkg
輶	lusg
呴	kqkg
妡	vrh
鋣	qahb
罍	lllm
廒	ygqt
糈	onhe
碹	dpgg
碸	dmtj
慁	lenu
鱅	qoyh
膦	eoqh
蟪	jgjn
穸	pwqu
筢	trcb
煸	oyna
嘌	ksfi
鐿	qujn
鐦	quga
鈰	qymh
鎇	qnhg
蟶	jbkg
羰	udmo
氪	rndq
塏	fmgu
卣	hlnf
鼢	vnuv
鯝	qold
鯇	qopq
骶	meqy
鑔	qpwi
鈁	qyn
釔	qnn
銎	amyq
螵	jsfi
蛸	jieg
籪	txxr
崞	mybg
垵	fpvg
哚	kmsy
	efny
	vhgd
	dilc
	dilx
	fae
	ugf
	udr
	pqb
	xmg
	ttgy
	tcde
	hovg
	nhd
	ipb
	dwi
	tfd
	idpy
	gqkm
	smqy
	aghg
	gggg
	rccy
	rwyc
	rian
	rmqy
	rtgt
	nqvg
	nqbt
	nhty
	ihyt
	kunt
	kunt
	kkmw
	cny
	bnn
	qtn
	wqvg
	wqbt
	nnll
	nnll
	ttg
	dgt
	rtt
	dxgd
	nkug
	rhag
	hdqg
	geqg
	gqjg
	uqqg
	gmhg
	eudg
	haqt
	qgug
	qgdj
	qgqb
	haqt
	uqvh
	uwwf
	uqvh
	uwwf
	qhhc
	qudk
	qafj
	qynn
	qnty
	qaht
	qynn
	khf
	mgeg
	mgeg
	yauo
	yrh
	xyxy
	oopb
	fjj
	udi
	pukm
	pukm
	apwl
鼽	thlv
鼷	vnud
麴	swwo
鹺	hlqa
鹺	hloa
鸌	wvgc
鷚	nweo
鶥	nhwo
鵯	rtfo
鱧	qomu
鰵	txgo
鰳	qoal
鰠	qocj
鰒	qott
鱝	qofm
鯴	qonj
鯪	qoft
鱭	qoyj
鱭	qoyf
鮞	qodj
鮚	qofk
鬏	deto
驏	cnbb
馘	uthg
鞴	afae
韝	nhkf
鞔	afqq
陴	brtf
阽	bhkg
阢	bgqn
閌	uymv
鑹	qpwn
鐠	quoj
鐓	qybt
鑥	qqoj
鏷	qogy
鏇	qyth
鎿	qwgr
鐨	qxjm
鎄	qyey
鎪	qvhc
錟	qooy
錇	qukg
鍃	qqrn
鍀	qjgf
鍩	qadk
錆	qgeg
錒	qbsk
鋟	qvpc
鋶	qycq
鋝	qefy
鋱	qany
錸	qsww
鐒	qool
鐋	qijr
鉿	qwgk
銩	qtfc
銱	qkmh
銠	qftx
鈽	qdmh
鉕	qakg
鈳	qskg
鈄	qufh
鈥	qoy
鍆	qug
釙	qhy
釓	qnn
鐾	nkuq
醭	sgoy
醣	sgyk
醌	sgjx
酴	sgwt
酏	sgbn
邶	uxbh
迮	thfp
輇	lwgg
軺	lvkg
軤	ltuh
軎	gjfk
蹯	khtl
踺	khvp
躒	khxs
賧	mooy
賕	mfiy
諗	ywyn
觖	qenw
裉	puve
袼	putk
蠼	jhhc
蟓	jqje
螋	jvhc
蝽	jdwj
蝻	jfmf
蜱	jrtf
蜞	jadw
蛘	judh
蛑	jcrh
蚴	jxln
虼	jtnn
虍	hav
薷	afdj
蕺	akbt
蕹	ayxy
蘞	awgt
蒎	aire
蒈	axxr
蕆	admt
葶	ayps
葜	adhd
葙	ashf
萜	amhk
菥	asrj
薟	awgw
莛	atfp
葤	axfu
蕒	almu
茼	amgk
茺	aycq
茳	aiaf
茚	aqgb
茈	ahxb
茇	adcu
苊	adbb
藶	adth
芤	abnb
芏	aff
艴	xjqc
艚	tegj
舭	texx
艤	teut
膪	eupk
膣	epwf
腽	ejlg
腧	ewgj
腙	epfi
腡	emnk
脬	eebg
脞	ewwf
脎	eqsy
胲	eynw
胬	vcmw
腖	egji
胂	ejhh
肷	eqwy
肟	efnn
肜	eet
肀	vhk
聹	bpns
耵	bsh
耩	diff
耥	diik
耮	diol
耠	diwk
耖	diit
羧	udct
繰	xkks
繢	xkhm
鞝	afik
糨	oxkj
餱	wyvd
餱	wpwd
粞	osg
篼	tqrq
箢	tpqb
筻	tgjq
筘	trkf
筅	ttfq
窀	pwgn
稃	tebg
稂	tyve
禚	pyuo
礤	dawi
礞	dape
礓	dglg
磲	dias
磉	dccs
碥	dyna
硭	dayn
硪	dtrt
硇	dtlq
砹	daqy
砩	dxjh
砘	dgbn
眢	qbhf
瞘	hakk
癍	ugyg
癃	ubtg
瘵	uwfi
瘭	usfi
瘛	udhn
瘕	unhc
瘊	uwnd
癉	ukkf
瘃	ueyi
痦	ugkd
痄	uthf
痃	uyxi
疰	uygd
疒	uygg
甓	nkun
瓞	rcyw
璁	gtln
瑭	gyvk
珧	giqn
獯	qtto
猹	qtsg
猸	qtnh
獫	qtww
狃	qtnf
狁	qtcq
犏	trya
犋	trhw
牿	trtk
牮	warh
煺	ovep
灬	oyyy
瀵	iolw
澉	inbt
漤	issv
灄	ibbb
溻	ijng
渫	ians
浞	ikhy
湞	ihmy
澩	wfqi
澩	vqqi
泖	iqtb
沲	itbn
氚	rnkj
氕	rntr
氍	hhwn
氌	tfnj
氆	tfnj
毪	tfnh
檑	sflg
檎	swyc
櫫	efts
榱	syke
榍	snie
榀	skkk
楱	sdwd
桊	udsu
柃	swyc
榪	scy
敫	ryty
攵	ttgy
攴	hcu
攉	rfwy
擗	rnku
撖	rnbt
搌	rnae
搋	rrhm
揞	rujg
掭	rgdn
捃	rvtk
戤	ecla
憝	ybtn
怊	nvkg
彐	vngg
弳	xgva
庀	yxv
幬	mhff
巰	gvaq
巛	vnnn
嵴	miwe
崾	msvg
崬	mgji
岵	mdg
屮	bhk
尜	idiu
嫜	vujh
嫘	vlxi
夼	dkj
夂	ttny
墚	fivs
塥	fgkh
坶	fxgu
圬	ffnn
圊	lged
嚆	kayk
嘧	kpnm
哿	lksk
哳	krrh
唚	kvpc
吖	kuhh
卩	bnh
勹	qtn
劐	awyj
劂	dubj
剞	dskj
凵	bnh
冱	ugxg
冖	pyn
冂	mhn
囅	kkje
傺	wwfi
佴	wbg
佧	whhy
仂	wln
亠	yyg
乇	tav
丿	ttll
丬	uygh
丨	hhll
﨩	bwvm
﨨	qfuf
﨧	qftb
﨤	eyyp
﨣	fhuf
﨡	jtgg
蘒	attx
蘒	attg
﨟	aejn
礼	finn
﨔	siwr
﨓	sawf
﨑	musk
﨑	mukh
﨏	fwwk
﨎	ywyc
嗀	fpgc
兀	gqv
隣	boqh
裏	yjfe
秊	ttfj
凉	uyiy
郎	yveb
龥	wgkm
龤	wgkr
龣	wgki
龡	wgkw
龞	umix
龞	umig
龝	ttxg
龝	ttmg
龘	uegd
龗	fkkd
龖	uegd
龓	deud
龒	uegi
龏	uega
龎	dued
齗	hwwr
齗	hbrh
齾	hagb
齽	hwwi
齽	hbsi
齼	hwwh
齼	hbsh
齻	hwww
齻	hbfw
齺	hwwt
齺	hbqt
齹	udab
齸	hwwl
齸	hbul
齵	hwwy
齵	hbjy
齴	hwwe
齴	hbue
齳	hwwl
齳	hbpl
齱	hwwc
齱	hbbc
齰	hwwj
齰	hbaj
齯	hwwq
齯	hbvq
齮	hwwk
齮	hbdk
齭	hwwr
齭	hbrr
齫	hwws
齫	hbls
齩	hwwq
齩	hbuq
齨	hwwv
齨	hbvg
齥	hwwx
齥	hbjx
齤	udhb
齣	hwwk
齣	hbqk
齢	hobc
齞	hwww
齞	hbkw
齝	hwwk
齝	hbck
齛	hwwn
齛	hban
齚	hwwf
齚	hbtf
齘	hwwj
齘	hbwj
齖	hwwt
齖	hbat
齓	hwwn
齓	hbnn
齍	yvul
齍	yjlf
齌	yvuo
齌	yjou
齉	thle
齈	thle
齆	thlc
齅	thld
齃	thln
齂	thli
齁	thlk
齀	thln
鼿	thlq
鼼	thlh
鼺	vnul
鼸	vnuo
鼶	vnum
鼵	vnud
鼳	vnud
鼲	vnul
鼱	vnue
鼰	vnum
鼮	vnup
鼭	vnuf
鼫	vnud
鼪	vnug
鼩	vnuk
鼨	vnuu
鼧	vnux
鼦	vnuk
鼥	vnuc
鼤	vnuy
鼣	vnud
鼡	imfh
鼟	fkuu
鼞	fkuf
鼝	ithc
鼝	ijgc
鼜	fkuj
鼛	fkuk
鼚	fkue
鼘	fkuh
鼘	fkug
鼖	fafc
鼕	fkuu
鼔	fkuc
鼒	fthn
鼑	hhnn
鼏	phnn
鼂	jgxf
鼂	jgmv
鼊	nkux
鼊	nkuv
鼇	gqtx
鼇	gqtv
鼆	pjux
鼆	pjuv
鼅	tdkx
鼅	tdkv
鼄	rixf
鼄	rimv
鼃	ffxf
鼃	ffmv
鼁	fcxf
鼁	fcmv
鼀	fwxf
鼀	fwmv
黺	oguv
黸	lfol
黶	djeo
黵	lfoy
黳	atdo
黱	eudo
黰	lfow
黮	lfon
黭	lfoa
黬	lfot
黫	lfof
黦	lfob
黤	lfon
黣	lfou
黚	lfof
黙	jfdo
黗	lfon
黖	lfoq
黕	lfoq
黓	lfoa
黒	jfou
黐	twic
黋	iqaw
黊	amwf
黈	amwg
黇	amwk
黆	amwq
黅	amwn
黂	yssm
黁	yssj
黀	yssc
麿	yssk
麪	swwn
麷	swwu
麶	swwc
麵	swwd
麳	swww
麲	swwq
麱	swwy
麰	swwh
麯	swwa
麮	swwc
麭	swwn
麬	swwc
麫	swwn
麨	swwt
麧	swwn
麣	ynjt
麢	ynjk
麡	ynjj
麡	ynjf
麠	ynjg
麞	ynjj
麜	ynjs
麛	ynjb
麚	ynjc
麙	ynjt
麘	ynjj
麖	ynji
麕	ynjt
麔	ynjk
麑	ynjq
麐	ynjk
麏	ynjk
麎	ynje
麍	ynjq
麌	ynjd
麊	oynx
麉	ffyx
麆	ynjg
麅	ynjn
麄	wvyx
麃	ynjo
麁	qynx
麀	ynjx
鹻	hlqo
鹻	hloo
鹸	hlqw
鹸	hlow
鹷	hlqc
鹷	hloc
鹶	hlqn
鹶	hlon
鹵	hlqo
鹵	hlou
鸘	fsho
鸏	apgo
鸏	apfo
鸇	ylko
鷖	atdo
鶺	iweo
鶹	qyvo
鶲	wcno
鷊	gkmo
鶖	towo
鶡	jqwo
鷫	vhto
鷫	vfjo
鵷	pqbo
鶊	yvwo
鵮	qvwo
鵐	awwo
鵃	tewo
鴴	tfho
鷽	wfqo
鷽	vqqo
鴒	wyco
鴞	kgno
鶬	wyvo
鳲	nwvo
鸜	hhwo
鸙	wgko
鸗	uego
鸖	fwyo
鸔	wvgi
鸓	lllo
鸒	wfgo
鸒	vgno
鸑	qtyo
鸐	nwyo
鸎	mmwo
鸍	gwmo
鸋	pnlo
鸊	nkuo
鸉	sjgo
鸈	oguo
鸆	hako
鸅	lfuo
鸄	ryto
鸃	wvgt
鸂	iexo
鸁	ynky
鸀	lqjo
鷿	nkuo
鷾	ujno
鷼	ujwo
鷻	wvgt
鷷	usgo
鷶	lmwo
鷵	nfto
鷴	uswo
鷱	thio
鷰	auko
鷮	tdko
鷭	tolo
鷬	amwo
鷪	hhpo
鷩	umio
鷨	agao
鷧	fpgo
鷤	kkjo
鷢	dubo
鷡	rlgo
鷠	qowo
鷟	ytto
鷞	dqqo
鷝	jafo
鷜	lvwo
鷜	kgko
鷛	yveo
鷘	gkio
鷕	kwyo
鷔	gqto
鷒	gjho
鷑	tuwo
鷐	jdfo
鷏	fhwo
鷎	rdfo
鷍	thso
鷌	wvgc
鷋	awto
鷉	rhao
鷈	wvgm
鷇	fpdc
鷆	xhno
鷅	sswo
鷄	exdo
鷃	jpvo
鷀	uxxo
鶾	fjwo
鶽	wyfo
鶸	xuxo
鶷	pdho
鶶	yvho
鶵	qbto
鶳	wvgh
鶱	pfjo
鶰	kmwo
鶮	ymko
鶭	xywo
鶫	glio
鶪	hdwo
鶨	xewo
鶧	amdo
鶦	dewo
鶤	plwo
鶣	ynmo
鶢	efto
鶠	ajvo
鶟	pwdo
鶞	rfho
鶝	gklo
鶜	acbo
鶛	xxro
鶙	upmo
鶗	jgho
鶕	ujwo
鶔	cbto
鶒	gkio
鶑	oowo
鶐	sypo
鶏	efwo
鶎	pfio
鶍	jqro
鶌	nbmo
鶋	ndwo
鶈	gvho
鶆	swwo
鶅	vlwo
鶄	gewo
鶃	wvgq
鶂	vqwo
鶁	yiwo
鶀	wvgw
鵿	wvga
鵽	ccco
鵼	pwao
鵻	wvgy
鵺	ywto
鵹	tqto
鵸	dsko
鵶	ghgo
鵶	gfgo
鵵	qkqo
鵴	qowo
鵳	yneo
鵱	fwfo
鵰	mfko
鵭	qwvo
鵫	hjwo
鵩	ebco
鵨	wfko
鵧	uawo
鵦	wvgi
鵥	udjo
鵤	qewo
鵣	gkio
鵢	tmdo
鵟	qtgo
鵞	trno
鵛	gvao
鵚	tmwo
鵙	mwvo
鵘	vtko
鵗	qdmo
鵖	vcwo
鵕	cwto
鵔	wvgt
鵏	geho
鵎	evwo
鵍	pfqo
鵌	wvgt
鵋	nnwo
鵊	dwwo
鵉	yowo
鵈	bwvo
鵇	rhfo
鵆	twvh
鵅	tkwo
鵄	gcfo
鵁	uqwo
鵀	wtfo
鴾	crho
鴽	vkwo
鴼	wvgk
鴺	gxwo
鴹	udwo
鴸	riwo
鴷	gqjo
鴶	fkwo
鴵	iqwo
鴳	pvwo
鴲	xjwo
鴱	aqwo
鴮	dfno
鴭	wnno
鴬	ipwo
鴫	lwvo
鴪	pwwo
鴩	rwwo
鴧	pmwo
鴥	wvgw
鴤	wvgu
鴢	xlwo
鴡	egwo
鴠	jgwo
鴜	hxwo
鴚	wvgk
鴙	tdwo
鴘	cawo
鴗	uwvo
鴖	nawo
鴔	tpwo
鴓	ntwo
鴑	vcwo
鴐	lkwo
鴏	wvga
鴎	aqwo
鴍	ywvo
鴌	gdwo
鴋	ywvo
鴊	ghwo
鴈	dwwo
鴅	mywo
鴄	aqwo
鴃	wvgw
鴂	nwwo
鴁	tdwo
鴀	giwo
鳿	gwvo
鳾	gmho
鳽	gawo
鳼	ywvo
鳻	wvwo
鳺	fwwo
鳹	wyno
鳸	ynwo
鳷	fcwo
鳵	nfwo
鳱	fwvo
鳰	tywo
鳯	mwvo
鳮	cwvo
鳭	vwvo
鳬	wvgm
鳫	dwvo
鳪	hwvo
鳨	wvgl
鳦	wvgn
鱣	qoyg
鱤	qodn
鱯	qoac
鰼	qonr
鰜	qouo
鰟	qouy
鱂	qonf
鰁	qori
鰃	qole
鰛	qojl
鯷	qojh
鱨	qoij
鰏	qogl
鰺	qoce
鮶	qovk
鮺	udqo
鮜	qork
鰂	qomj
鮦	qomk
鮳	qofn
鮍	qohc
鮊	qorg
鮋	qomg
魺	qosk
魨	qogn
魢	qonn
魛	qovn
鱻	qoqo
鱹	qoay
鱶	qoue
鱵	qott
鱴	qoat
鱳	qoxs
鱲	qovn
鱱	qody
鱰	qolj
鱮	qoww
鱮	qovw
鱬	qofj
鱫	qoet
鱪	qojj
鱩	qofl
鱦	qoxg
鱦	qomv
鱥	qoht
鱢	qoks
鱡	qomd
鱞	qole
鱜	qoxb
鱛	qouj
鱚	qofk
鱙	qofq
鱕	qotl
鱓	qokf
鱑	qoaw
鱐	qovj
鱐	qovh
鱏	qosj
鱎	qotk
鱍	qowc
鱌	qoqe
鱋	qohg
鱊	qock
鱇	qoyi
鱆	qouj
鱄	qogf
鱃	qouf
鱁	qoep
鱀	vcao
鰿	qogm
鰽	qogj
鰸	qoak
鰶	qowi
鰴	qomt
鰰	qoph
鰯	qoxu
鰬	qohy
鰫	qopk
鰪	qofl
鰧	eudo
鰦	qoux
鰤	qowh
鰢	qocy
鰡	qoql
鰞	qowo
鰝	qoyk
鰚	qopg
鰙	qoak
鰘	qopf
鰗	qode
鰖	qode
鰕	qonc
鰔	qodt
鰑	qojr
鰐	qokn
鰎	qovp
鰌	qoug
鰋	qoav
鰊	qogi
鰇	qocs
鰆	qodj
鰅	qojy
鰄	qodt
鰀	qoec
鯾	qowq
鯼	qoqt
鯻	qogj
鯺	qofj
鯹	qojg
鯸	qowd
鯶	qopl
鯵	qoce
鯳	qoyy
鯲	qoyu
鯱	qohm
鯰	qown
鯯	qorj
鯮	qopi
鯭	qobl
鯬	tqto
鯩	qowa
鯦	qotk
鯥	qoff
鯣	qojr
鯠	qosw
鯟	qogi
鯞	qovh
鯜	qouv
鯚	qotb
鯙	qoyb
鯘	qotv
鯑	qoqh
鯐	qofh
鯏	qotj
鯎	qodt
鯍	qoyq
鯌	qotk
鯋	qoit
鯈	whto
鯆	qogy
鯅	qotp
鯄	qofy
鯃	qogk
鯂	qosg
鮿	qobn
鮾	qoev
鮽	qowt
鮼	qovc
鮻	qoct
鮹	qoie
鮸	qoqq
鮷	qout
鮵	qouq
鮴	qows
鮲	qowd
鮱	qofx
鮰	qolk
鮯	qowk
鮬	qodn
鮩	qoua
鮨	qoxj
鮧	qogw
鮥	qotk
鮤	gqjo
鮣	qoqb
鮢	qori
鮡	qoiq
鮠	qoqb
鮟	qopv
鮝	udqo
鮛	qohi
鮙	qong
鮘	qowa
鮗	qotu
鮖	qodg
鮕	qodg
鮔	qoan
鮏	qotg
鮌	qoyx
鮉	qovk
鮈	qoqk
鮇	qofi
鮆	hxqo
鮅	qont
鮄	qoxj
鮂	qolw
鮀	qopx
魿	qowc
魾	qogg
魽	qoaf
魼	qofc
魻	qolh
魹	qotn
魸	qotn
魶	qomw
魵	qowv
魳	qogh
魲	qoyn
魱	qogg
魰	qoyy
魮	qoxx
魭	qofq
魬	qorc
魫	qopq
魪	qowj
魩	qoqr
魧	qoym
魦	qoit
魥	qoey
魤	qowx
魣	qocb
魡	qoqy
魠	qota
魟	qoag
魞	qoty
魝	qojh
魜	qowy
魙	ilrc
魗	fnac
魖	rqcg
魕	rqct
魓	rqcf
魒	rqci
魐	rqco
魌	rqcw
魋	rqcy
魊	rqcg
魆	rqct
魀	rqcj
鬿	rqcr
鬾	rqcc
鬽	rqce
鬺	gkmr
鬹	fwhh
鬸	gkml
鬷	gkmt
鬵	aqah
鬴	gkmy
鬳	hagh
鬰	sqqe
鬭	hggr
鬬	hggr
鬫	hggt
鬪	hggf
鬨	hggw
鬦	hggf
鬤	deye
鬡	deps
鬠	dewj
鬞	deme
鬝	deuj
鬜	deue
鬛	deln
鬚	deem
鬙	deuj
鬘	dejc
鬗	deay
鬖	dece
鬕	dead
鬔	detp
鬒	defw
鬑	deuo
鬐	defj
鬎	degj
鬍	dede
鬌	dede
鬋	deuj
鬊	dedj
鬉	deqt
鬇	deqh
鬅	deee
鬄	dejr
鬂	derw
鬁	detj
鬀	deut
髿	deit
髾	deie
髽	dewf
髼	deth
髺	detd
髸	deaw
髷	dema
髶	debf
髵	dedj
髴	dexj
髳	dect
髲	dehc
髱	deqn
髰	dean
髮	dedc
髬	degg
髪	dedc
髩	degn
髨	defq
髧	depq
髥	demf
髤	desu
髣	deyb
髢	debb
髠	demb
髞	ymks
髝	ymkl
髜	ymka
髛	ymkv
髚	ymkm
髙	yjfk
髗	mehl
髐	mefq
髎	mene
髍	meys
髊	meua
髉	mepy
髈	meuy
髇	meyk
髆	megf
髄	medp
髃	mejy
骿	meua
骾	megq
骽	meev
骻	medn
骹	meuq
骵	mesg
骴	mehx
骳	mehc
骲	meqn
骮	meay
骭	mefh
骬	megf
骫	mevy
骪	memy
骩	mevn
驦	cfsh
騤	cwgd
驌	cvhh
驌	cvfj
騌	cpfi
駸	cvpc
騂	cuh
驫	cccu
駰	cldy
馹	cjg
驩	caky
驨	cmwk
驧	cafo
驣	cudc
驡	uegc
驠	cauo
驞	cpgm
驝	cfps
驜	cogw
驙	cylg
驘	ynky
驖	cfag
驔	csjh
驓	culj
驒	ckkf
驑	cgjl
驑	cgal
驐	cybt
驎	coqh
驋	cwxc
驉	chag
驈	ccbk
驇	fwfc
驆	cjaf
騿	cujh
騽	cnrg
騼	cynx
騻	cdqq
騺	fufc
騹	cakg
騵	cdri
騴	cjpv
騳	ccy
騲	cajh
騱	cexd
騯	cupy
騬	ctux
騪	cvhc
騩	crqc
騨	cijf
騧	cmnk
騦	clny
騥	ccbs
騣	cqbt
騢	cnhc
騠	cjgh
騟	cwgj
騞	cdhd
騝	cvfp
騜	crgg
騛	cnuj
騛	cnuh
騚	cuej
騘	cqrn
騗	ynmc
騕	csvg
騔	cjqn
験	cwgw
騒	ccjy
騑	cdjd
騐	cwyn
騊	cqrm
騉	cjxx
騈	ctff
騇	cwfk
騆	cmfk
騄	cviy
騃	cctd
騀	ctrt
駾	cukq
駽	ckeg
駼	cwty
駻	cjfh
駺	cyve
駷	cgki
駶	cnnk
駵	cgan
駴	caah
駳	cthp
駲	cyth
駮	cuqy
駬	cbg
駫	ciqn
駪	ctfq
駩	cwgg
駨	cqjg
駧	cmgk
駦	udcu
駥	cadt
駤	cgcf
駣	ciqn
駡	kkcu
駠	cqtb
駞	ctbn
駜	cntt
駚	cmdy
駗	cwet
駖	cwyc
駓	cgig
駏	cang
駎	cmg
駍	cguh
駌	qbcu
駋	cvkg
駊	chcy
駉	cmkg
駈	crgg
駇	cty
駆	caqy
駅	cnyy
駄	cdyy
駃	cnwy
駂	xfcy
駀	cdnn
馿	cynt
馾	cpqn
馽	ckhj
馼	cyy
馻	ccqn
馺	ceyy
馸	crh
馷	cgmh
馶	cfcy
馵	caj
馲	ctan
馰	cqyy
馯	cfh
馫	tjtj
馪	tjpm
馩	tjfm
馧	tjjl
馦	tjuo
馤	tjjn
馣	tjdn
馢	tjaa
馡	tjdd
馠	tjwk
馟	tjeb
馞	tjfb
馝	tjnt
馜	tjnx
馛	tjdc
馚	tjwv
餺	wyvf
餺	wpgf
饁	wyvl
饁	wpfl
餜	wyvs
餜	wpjs
餖	wyvu
餖	wpgu
餏	wyve
餏	wpye
餎	wyvk
餎	wptk
餄	wyvk
餄	wpwk
飥	wyvn
飥	wpta
飣	wyvs
飣	wpsh
饡	wyvm
饡	wptm
饠	wyvy
饠	wply
饟	wyve
饟	wpye
饝	wyvd
饝	wpyd
饛	wyve
饛	wpae
饚	wyvl
饚	wpal
饙	wyvm
饙	wpfm
饖	wyvt
饖	wpht
饓	wyvs
饓	wpis
饑	wyvt
饑	wpxt
饐	wyvu
饐	wpfu
饏	nbte
饎	wyvk
饎	wpfk
饍	wyvk
饍	wpuk
饇	wyvk
饇	wpak
饆	wyvf
饆	wpjf
饄	wyvf
饄	wpif
饂	wyvl
饂	wpjl
饀	wyvv
饀	wpev
餽	wyvc
餽	wprc
餻	wyvo
餻	wpuo
餹	wyvk
餹	wpyk
餵	wyve
餵	wple
餴	wyva
餴	wpda
餲	wyvn
餲	wpjn
餰	wyvh
餰	wpth
餯	wyve
餯	wpxe
餭	wyvg
餭	wprg
餬	wyve
餬	wpde
餫	wyvl
餫	wppl
餪	wyvd
餪	wpdd
餩	wyvw
餩	wpww
餧	wyvv
餧	wptv
餦	wyve
餦	wpde
餥	djde
餤	wyvo
餤	wpoo
餣	wyvn
餣	wpdn
餢	wyvk
餢	wpuk
餠	wyvf
餠	wptf
餟	wyvc
餟	wpcc
餝	wyvy
餝	wpay
餙	wyvh
餙	wpqh
餗	wyvi
餗	wpgi
餔	wyvy
餔	wpgy
餋	udwe
餇	wyvk
餇	wpmk
餆	wyvq
餆	wpiq
餁	wyvf
餁	wpwf
餀	wyvq
餀	wpaq
飻	wyve
飻	wpwe
飺	hxwe
飹	wyvb
飹	wpqb
飸	kgne
飷	wyvg
飷	wpeg
飶	wyvt
飶	wpnt
飵	wyvf
飵	wptf
飳	wyvg
飳	wpyg
飱	gqwe
飰	wyvh
飰	wpyh
飮	wyvw
飬	udye
飦	wyvf
飦	wpfh
飤	wyvw
飤	wpwy
飡	uwye
飝	nutj
飝	nuth
飜	tolj
飜	tolh
飀	mtjl
颻	ermj
颸	mtjn
颭	mtjk
颺	mtjr
飍	mtjj
飌	akkj
飋	mtjt
飊	oooj
飇	mtjd
飅	mtjl
飃	mtji
飂	mtje
飁	nrmj
颿	cmtj
颾	mtjj
颽	mgkj
颹	mtjh
颷	mtjo
颵	mtje
颴	mtjh
颳	mtjd
颲	mtjj
颱	mtjk
颰	mtjc
颬	mtjt
颫	mtjw
颪	ghmj
颩	mtje
纇	oxim
顒	jmhm
頴	xfim
頮	iadm
熲	xodm
頲	tfpm
顲	ooym
顮	pgim
顭	alpm
顪	hdgm
顩	wgkm
顨	dmdj
顦	wyom
顤	fffm
顣	dhim
顡	uedm
顠	sfim
顟	nwem
顝	medm
顜	fjgm
顚	xhnm
顖	tlqm
顕	jogm
顔	utem
顑	dgkm
顐	pldm
顋	lndm
顊	wnnm
顉	qdmy
顈	xxim
顇	ywwm
顅	ynem
顄	bibm
顃	oodm
顂	swwm
顁	pghm
顀	wydm
頿	ehxm
頾	edmx
頽	tmdm
頼	gkim
頺	tedm
頶	tfkm
頵	vtkm
頳	fodm
頯	qadm
頬	guwm
頪	odmy
頩	uadm
頨	ndmy
頧	wnnm
頥	hahm
頣	ahnm
頢	tddm
頠	qdbm
頟	tkdm
頞	pvdm
頝	uqdm
頛	didm
頚	cfdm
頙	ghdm
頖	uddm
頕	hkdm
頔	mdmy
頍	fcdm
頋	dbdm
頉	hdmy
頄	vdmy
頀	ujac
韾	fnmj
韽	wynj
韼	ujtp
韺	ujad
韹	ujrg
韸	ujth
韷	ujbm
韴	ujgh
韲	yvug
韲	ydjg
韱	wwag
韰	hqcg
韯	fadg
韮	adjg
韍	nhkc
韥	nhkm
韤	nhky
韤	nhkt
韣	nhkj
韢	nhkn
韡	nhkf
韠	nhkf
韟	nhkf
韛	nhke
韚	nhkf
韘	nhks
韗	nhkl
韖	nhks
韕	nhkb
韔	nhke
韒	nhke
韑	iqnh
韐	nhkk
韏	udnh
韎	nhks
韊	afai
韈	afat
韇	affm
韆	afsp
韅	afjo
韄	afac
韂	afqy
韀	afyo
鞿	afxt
鞾	afaf
鞼	afkm
鞻	aflv
鞻	afkv
鞺	afif
鞹	afyb
鞸	afjf
鞷	gkmf
鞶	temf
鞵	afed
鞱	afev
鞰	afjl
鞮	afjh
鞪	cbtf
鞩	afij
鞨	afjn
鞧	afug
鞦	afto
鞥	afwa
鞤	ffff
鞡	afru
鞟	afyb
鞞	afrf
鞜	afij
鞛	afuk
鞚	afpa
鞙	afke
鞗	whtf
鞖	afev
鞕	afgq
鞓	afkg
鞐	afhh
鞎	afve
鞌	pvaf
鞊	affk
鞉	afiq
鞈	afwk
鞇	afld
鞆	afgw
鞄	afqn
鞃	afxc
鞂	afty
鞁	afhc
靾	afan
靽	afuf
靻	afeg
靹	afmw
靸	afey
靷	afxh
靵	afnf
靲	afwn
靱	afvy
靰	afgq
靯	affg
靮	afqy
靭	afvy
靬	affh
靫	afcy
靪	afsh
靧	dmjm
靤	dmjn
靣	dlkf
靟	djdn
靝	gero
靘	geqc
靗	geiq
靕	ghge
靑	gmhg
靐	flfl
靏	fpwo
靎	fqwo
靍	fwyo
靌	fpgm
靋	fidh
靊	fmdu
靊	fdhu
靉	ffct
靇	fued
靆	ffcp
靅	ffcm
靃	fwyy
靁	flll
靀	fape
霿	fcbh
霼	ffco
霻	fmau
霺	ftmt
霷	fjjr
霶	fiuy
霵	fkbt
霴	ffci
霳	fbtg
霱	fcbk
霯	fwgu
霮	fian
霬	flaw
霫	fnrf
霩	fybb
霨	fnff
霦	fsse
霥	fpge
霥	fpfe
霤	fqyl
霣	fkmu
霢	fere
霠	fuwn
霟	fiaw
霝	fkkk
霛	fxxx
霚	fcbt
霘	fimk
霗	fiwc
霕	ffcn
霔	fiyg
霒	ffcn
霐	fixc
霌	fmfk
霋	fgvv
霊	ffog
霃	fipq
霂	fisu
雿	fiqb
雽	ftuh
雼	fdf
雺	fcbt
雸	faff
雵	fmdu
雴	fuf
雱	fyb
雰	fwvb
雮	ftfn
雭	feyu
雬	fsu
雫	fghu
雧	wyws
雦	wywy
雥	wywy
雤	wfqy
雤	vqqy
雡	nwey
雟	btwk
雝	vkcy
雚	akky
雘	myac
雗	fjwy
雔	wywy
雓	wtwy
雑	vswy
雐	hawy
雊	qkwy
雈	gjgy
雃	gawy
雂	wyny
隿	awyg
隻	wycu
隺	pwyd
隷	ffii
隵	bhaa
隲	bitc
隯	bfnf
隮	byvf
隮	byjg
隭	bfdj
隬	bgwq
隫	bfam
隩	btmd
隦	bnku
隥	bwgu
隤	bkhm
隣	boqh
隢	bffq
隡	butg
隠	bevn
隟	bvjs
隞	bgqt
隝	bwvo
隚	bipf
隖	bwno
隓	bdaa
隒	buvo
隑	bmgu
隌	bujg
隇	bdgt
隃	bwgj
隂	bwdy
隁	bajv
隀	btgf
陿	badw
陾	bdmd
陼	bftj
陻	bsfg
険	bwgw
陹	btaj
陱	bqoy
陯	bwga
陮	bwyg
陭	bdsk
陫	bdjd
陥	bqhj
陠	bgey
陞	btaf
陜	bdww
陚	bgah
陙	bdfe
陗	bieg
陖	bcwt
陓	bdfn
陒	bqdb
陑	bdmj
陏	bdeg
陎	briy
陊	bqqy
陃	bgmw
陁	btbn
阾	bwyc
阺	bqay
阹	bfcy
阸	bynn
阷	bghg
阰	bxxn
阯	bhg
阭	bcqn
阬	bymn
阫	bgiy
阩	btah
阨	bdbn
阧	bufh
阦	boy
阥	biy
阤	bbn
阣	btnn
阠	bnfh
阞	bln
闤	ulge
闒	ujnd
闠	ukhm
闍	uftj
闓	umgu
閈	ufk
闧	ufkp
闦	umau
闣	uipl
闟	uwgn
闝	umti
闛	uipf
闚	ufwq
闙	uynk
闘	ugkf
闗	uxxo
闑	uths
闎	urii
闉	usfd
闆	ukkk
闅	uhhc
闄	usvd
闂	uudb
闁	uud
闀	uawn
閺	ujyi
閸	ughg
閸	ugfg
閷	qsuw
閴	umi
閳	ulk
閰	uvd
閯	uiit
閮	utfp
閪	usd
閧	uawi
閦	uwww
閤	uwgk
関	uudi
閠	ugyi
閟	unte
閞	ucak
閝	uwyc
閜	uskd
閛	uguh
閚	uud
閙	uymh
閗	uufk
閖	uii
閕	uaht
閑	usi
閐	utfn
閍	uyv
閊	umk
閇	ughi
閅	usk
閄	uwy
閁	ute
镾	dgwq
镽	ddui
镼	dnbm
镻	drwy
镺	dtdy
镹	dqyy
镸	dghy
鑱	qqky
鑞	qvln
鐶	qlge
鏰	qmee
钂	qipo
鎛	qgef
鎡	quxx
鍠	qrgg
鍈	qamd
鑕	qrrm
錩	qjjg
鋙	qgkg
銛	qtdg
銍	qgcf
錏	qghg
錏	qgfg
鉋	qqnn
鈒	qeyy
钄	qaui
钀	qhad
鑻	qsqr
鑺	qhhy
鑸	qllf
鑶	qadt
鑵	qaky
鑴	qmwk
鑳	qpfh
鑯	qwwg
鑮	qaif
鑬	qahq
鑪	qhal
鑩	qgkk
鑨	qued
鑧	qpay
鑦	qahm
鑤	qjai
鑢	qhan
鑡	qhwb
鑡	qhbh
鑟	qflm
鑝	qatp
鑜	qipm
鑛	qyaw
鑚	qfwm
鑙	qtdj
鑘	qlll
鑗	qtqi
鑖	qalt
鑓	qkhp
鑒	ahnq
鑐	qfdj
鑏	qpns
鑎	qakm
鑍	mmqf
鑋	lgvq
鑉	qafl
鑈	qgwq
鑇	qyvf
鑇	qyjg
鑆	qogf
鑅	qoos
鑃	qnwy
鑂	qtgo
鑁	qqot
鑁	qobt
鑀	qept
鐽	qfup
鐼	qfam
鐻	qhae
鐹	qmnp
鐷	qaas
鐴	qnku
鐱	qwgw
鐰	qkks
鐯	qafj
鐭	qtmd
鐬	qhdt
鐪	qhal
鐩	quep
鐧	qujg
鐥	qudk
鐤	qhnn
鐣	qipr
鐢	sqqq
鐡	qfau
鐟	qfwj
鐞	qvaf
鐝	qduw
鐜	ybtq
鐛	qjyi
鐚	qghn
鐚	qgfn
鐘	qujf
鐖	qxxt
鐕	qaqj
鐑	qxfk
鐏	qusf
鐎	qwyo
鐍	qcbk
鐌	qqje
鐊	qbjr
鐉	qnnw
鐈	qtdk
鐇	qtol
鐆	bueq
鐅	umiq
鐄	qamw
鐂	qgal
鐁	qadr
鐀	qkhm
鏿	qips
鏾	qaet
鏼	qtgi
鏻	qoqh
鏺	qwxc
鏸	qgjn
鏶	qwys
鏴	qkhk
鏳	qulj
鏲	qyxh
鏱	qujh
鏯	qdqq
鏮	qyvi
鏭	qton
鏬	qhah
鏫	qtjs
鏪	qgmj
鏩	qlrh
鏧	fnmq
鏦	qtwh
鏥	qpwj
鏣	qyao
鏠	qtdp
鏛	qiph
鏚	qdht
鏙	qmwy
鏕	qynx
鏔	qpgw
鏓	qtln
鏒	qcce
鏏	qdhv
鏎	qjaf
鏋	qamy
鏉	qgkw
鏆	qxfm
鏅	qwhe
鏄	qgjf
鏂	qakk
鏁	qvjs
鏀	qhlo
鎾	qjlg
鎽	qmth
鎼	qhar
鎻	qvmy
鎺	qpyg
鎹	qudp
鎸	qwye
鎷	qcy
鎶	qskk
鎴	qthn
鎲	qipq
鎱	qfke
鎭	qxhw
鎫	qtmt
鎨	qwyf
鎥	whtq
鎤	qjiq
鎠	qlgh
鎟	qccs
鎞	qtlx
鎝	qawk
鎜	temq
鎚	qwnp
鎙	qube
鎗	qwyk
鎕	qyvk
鎓	qwcn
鎒	qdff
鎑	qfcl
鎐	qerm
鎎	qrno
鎍	qfpi
鎌	quvo
鎉	qjng
鎈	quda
鎆	quej
鎅	qlwj
鎃	qire
鎁	qbbh
鎀	qwhe
鍿	qgvl
鍽	qyna
鍼	qdgt
鍻	qjqn
鍹	qpgg
鍸	qdeg
鍷	qdff
鍴	qmdj
鍳	ahnq
鍲	qnaj
鍱	qans
鍯	qqrn
鍮	qwgj
鍭	qwnd
鍫	toqf
鍨	qwgd
鍧	qqyg
鍦	qytb
鍣	qavk
鍢	qgkl
鍡	qlge
鍟	qjtg
鍞	qhmy
鍝	qjmy
鍜	qnhc
鍙	iawq
鍗	quph
鍖	qadn
鍕	qplh
鍓	qkbg
鍒	qcbs
鍑	qtjt
鍐	qqbt
鍏	qnhh
鍎	qrfh
鍌	itfq
鍊	qgli
鍉	qjgh
鍅	qifc
鍄	qyiy
鍂	qqg
鍁	qrqw
錿	qham
錽	qgot
錼	qdfi
錻	qgah
錺	qayn
錹	qheg
錷	qlnn
錶	qgey
錵	qawx
錴	qfwf
録	qviy
錱	qggf
錰	qsoy
錭	qmfk
錬	qgji
錪	qmaw
錧	qpnn
錥	qyce
錤	qadw
錣	qccc
錞	qybg
錝	qpfi
錜	qwyn
錗	qtvg
錖	hicq
錔	qijg
錓	qudn
錑	qynd
錎	qqvg
錍	qrtf
錌	qmdf
錋	qeeg
錊	qywf
錉	qqaj
錅	tqtq
錃	ihcq
錂	qfwt
錀	qwga
鋿	qimk
鋾	qqrm
鋽	qhjh
鋻	ahnq
鋺	qpqb
鋹	qdey
鋷	qbcy
鋵	qtmn
鋴	qdqn
鋳	qdtf
鋲	qrgw
鋬	rrcq
鋫	tjqf
鋧	qhqn
鋢	qebg
鋡	qwyk
鋠	qdfe
鋞	qgva
鋜	qkhy
鋛	qkkh
鋚	whtq
鋘	qkgd
鋗	qkeg
鋖	qevg
鋕	qfny
鋔	qqkq
鋓	qtjh
鋑	qcwt
鋐	qpdc
鋎	qpfq
鋍	qfpb
鋋	qthp
鋊	qwwk
鋉	qgki
鋆	fquq
鋄	qgoc
鋂	qtxu
鋀	qgku
銿	qceh
銾	qaiy
銽	qqak
銺	nhdq
銹	qten
銸	qbnn
銶	qfiy
銵	qtmt
銴	rrqf
銲	qjfh
銰	qaqy
銯	qxiy
銭	qdxy
銤	qoy
銢	qfiy
銡	qfkg
銟	qmmh
銞	qjqf
銝	qwsy
銙	qdfn
銗	qrgk
銕	qgxw
銔	qgif
銒	qftf
銐	gqjq
銏	qmmg
銌	qdhb
銋	qwtf
銊	qdgt
銉	qvfh
銈	qffg
銇	qdiy
銆	qdjg
銄	qtmk
銂	qyth
銁	qqjg
鉾	qcrh
鉽	qaag
鉼	quah
鉹	qqqy
鉷	qawy
鉵	qjy
鉳	quxn
鉲	qhhy
鉱	qycy
鉰	qngk
鉯	qnyw
鉮	qjhh
鉫	qlkg
鉪	qann
鉩	qwiy
鉨	qqiy
鉧	qxgu
鉣	qfcy
鉡	qufh
鉠	qmdy
鉟	qgig
鉝	qug
鉜	qwfy
鉙	qkwy
鉘	qxjh
鉖	qtuy
鉔	qamh
鉓	qtmh
鉒	qygg
鉐	qdg
鉏	qegg
鉎	qtgg
鉌	qty
鉊	qvkg
鉇	qtbn
鉆	qhkg
鉄	qrwy
鉃	qtdy
鉂	qkqy
鉁	qwet
鈼	qthf
鈻	qnhn
鈶	qckg
鈵	qgmw
鈲	qrcy
鈱	qnan
鈯	qbmh
鈭	hxqf
鈬	qnyy
鈫	qyy
鈪	qdbn
鈩	qynt
鈨	qfqn
鈤	qjg
鈢	qsy
鈡	qkhh
鈠	qmcy
鈟	qxhh
鈝	qrhh
鈜	qdcy
鈛	qat
鈚	qxxn
鈙	qhcy
鈘	qfcy
鈗	qcqn
鈖	qwvn
鈓	qtfg
鈏	qxhh
鈌	qnwy
鈋	qwxn
鈊	qny
鈇	qfwy
鈆	qwcy
鈅	qeg
鈂	qpqn
釿	qrh
釾	qaht
釽	qrhy
釼	qvyy
釻	qvyy
釸	qqy
釶	qbn
釴	qay
釳	qtnn
釲	qnn
釱	qdy
釰	qvyy
釯	qynn
釮	qftt
釭	qag
釬	qfh
釫	qfnn
釪	qgfh
釨	qbg
釦	qkg
釥	qiy
釢	qen
釡	wqf
釠	qmn
釟	qwy
釞	qtyy
釛	qln
釚	qvn
釖	qvn
釈	tony
釄	sgyd
釂	sgef
醿	sgyi
醾	sgyo
醽	sgfk
醼	sgao
醻	sgff
醹	sgfj
醸	sgue
醷	sgun
醶	sgww
醳	sglf
醲	sgme
醱	sgwc
醰	sgsj
醩	sggj
醨	sgyc
醧	sgak
醦	sgce
醥	sgsi
醤	uefg
醡	sgpf
醠	sgml
醟	oopg
醝	sgua
醙	sgvc
醘	sgfl
醗	sgwq
醕	sgyj
醔	tosg
醓	sgpl
醏	sgfj
醎	sgdt
醊	sgcc
醈	sgoo
醆	sgaa
醄	sgqm
醂	sgss
醁	sgvi
醀	sgwy
酼	sgyq
酻	sgeb
酺	sggy
酳	sgxe
酭	sgde
酫	sgwg
酨	fasg
酧	sgpf
酠	sgsk
酟	sghk
酜	sgfw
酛	sgfq
酙	sguf
酘	sgmc
酖	sgpq
酕	sgtn
酔	sgvf
酓	wyng
酑	sggf
酇	tfqb
酅	mwyb
酄	akkb
酁	qkxb
酀	aukb
鄿	akkb
鄾	depb
鄽	yjfb
鄼	fwfb
鄻	fwfb
鄸	alpb
鄷	magb
鄵	kkkb
鄳	xbh
鄳	mggb
鄮	qyvb
鄬	etnb
鄫	uljb
鄪	xjmb
鄨	umic
鄦	rlgb
鄥	wvgb
鄤	jlcb
鄡	wvgb
鄟	gjhb
鄝	nweb
鄜	ynjb
鄛	vjsb
鄚	ajdb
鄘	yveb
鄗	ymkb
鄕	xtrb
鄓	thdb
鄑	gogb
鄐	yxlb
鄏	dfeb
鄎	thnb
鄍	pjub
鄌	yvhb
鄋	vhcb
鄊	xtbb
鄈	wgdb
鄇	wntb
鄅	tkmb
鄃	wgeb
鄁	uxeb
鄀	adkb
郿	nhbh
郼	nhkb
郻	hnvb
郺	qqvc
郹	hdbh
郷	xtvb
郶	ukkc
郳	vqbh
郲	swwb
郱	uabh
郰	bcbh
郮	mfkb
郬	gebh
郪	gvhb
郩	qdeb
郥	mbh
郤	wwkb
郣	fpbb
郠	gjqb
郞	yveb
郚	gkbh
郙	gehb
郘	kkbh
郖	gkub
郕	dnnb
郔	thpb
郒	yvcc
郍	tebh
郌	ffkc
郋	thbh
郉	ftfb
郈	rgkb
郆	fkbh
郃	wgkb
郂	yntb
郀	dfnb
邿	ffbh
邼	agbh
邷	gnyb
邲	ntbh
邭	qkbh
邫	dtkc
邩	obh
邧	fqbh
邥	pqbh
邤	rbh
邟	ymbh
邜	qbh
邚	vbh
邘	gfbh
邖	mbh
邔	nbh
邒	sbh
邎	qytp
邍	tlvp
邉	thpp
邆	wgkp
邅	ylkp
遾	tawp
遻	kkup
遹	cbtp
遶	fffp
遳	awwp
遱	lvpd
遱	kgkp
遰	aqpp
遯	eepi
遬	gkip
遫	gkip
遪	cccp
遧	ujpk
遦	xfmp
遤	cpi
遡	ubtp
遟	nupk
遝	lipi
遚	vhcp
遖	fmup
遌	kkfp
遉	hmpi
遈	jghp
遆	upmp
遅	nudp
遃	utep
遀	daep
逿	jgqp
逽	adkp
逺	fnwp
逺	fnep
逹	fufp
逷	jqrp
逴	hjpk
逳	ycep
週	mfkp
逰	rtbp
逬	tftp
逫	cccp
逪	ajpd
逩	dfap
逨	swwp
逧	wwkp
逥	mjdp
逤	iitp
逜	gkpd
逘	ctdp
逓	rfmp
逎	sgpd
逌	hlnp
逈	tmkp
逇	fbpv
迿	qjpd
迾	gqjp
迼	fkpd
迵	mgkp
迲	fcpi
迱	pxpv
迯	qhpi
迬	ygpd
迧	jhpk
迣	anpv
迡	nxpv
迠	hkpd
迚	khpk
迗	gdpi
迖	dpi
迏	dypi
迌	epd
迋	gpd
迊	gmhp
迉	npe
迆	bpv
迃	fnpv
迀	fpk
辿	mpk
込	typi
辻	fpk
辺	vpv
辸	epv
辷	gpd
辵	ehu
辴	kkje
辳	ssde
辬	uyuh
辪	hwnu
辧	uvuh
辥	btwu
辤	epcu
辢	gkiu
辡	uuh
辠	thuj
辝	ckuh
輼	ljlg
輬	lyiy
輈	ltey
軑	ldy
轥	lauy
轣	ldth
轠	llll
轞	lahl
轝	wfgl
轝	vgnl
轜	lfdj
轛	logf
轚	lbml
轙	lugt
轘	llge
轗	ldgn
轖	lfwk
轕	lajn
轓	ltol
轒	lfam
轑	ldui
轐	logy
轏	lnbb
轌	lfvg
轋	llpy
轊	ldhv
轈	lvjs
轇	lnwe
轃	ldwt
轁	levg
輽	lcdl
輺	lgvl
輹	ltjt
輷	lqyg
輵	ljqn
輴	lrfh
輲	lmdj
輱	ldgt
輰	ljgr
輮	lcbs
輭	ldmd
輫	ldjd
輨	lpnn
輧	ltff
輤	lgeg
輣	leeg
輢	ldsk
輡	lqvg
輠	ljsy
輚	laat
輙	lbcy
輘	lfwt
輗	lvqn
輖	lmfk
輓	lqkq
輑	lvtk
輐	lpfq
輏	lsgg
輎	lieg
輍	lwwk
輌	lgmm
輋	mdlj
輆	lynw
輄	liqn
輂	awlj
輁	lawy
輀	ldmj
軿	luah
軽	lcfg
軷	ldcy
軶	lynn
軵	lwfy
軴	lygg
軳	lqnn
軱	lrcy
軰	uxlj
軯	lguh
軮	lmdy
軭	lagg
軬	cdlj
軪	lxln
軩	lckg
軨	lwyc
軧	lqay
軦	lkqn
軥	lqkg
軣	liu
転	lfcy
軡	lwyn
軠	ltfg
軞	ltfn
軝	lqan
軜	lmwy
軚	ldyy
軙	lhcy
軘	lgbn
軗	lmcy
軖	lgg
軕	lmh
軓	lmyy
軐	lnfh
軏	lgqn
軉	tmdm
軈	tmdn
軇	tmdf
軆	tmdu
軅	tmdy
軄	tmdj
軃	tmdf
軂	tmdl
軁	tmdv
躿	tmdi
躾	tmdd
躽	tmdv
躻	tmda
躹	tmdo
躸	tmdk
躷	tmdv
躶	tmds
躵	tmdn
躴	tmde
躳	tmdk
躱	tmds
躰	tmdg
躮	tmdv
躭	tmdq
躩	khhc
躨	khut
躧	khgx
躤	khaj
躣	khhy
躢	khun
躠	awnh
躟	khye
躛	tnhh
躙	khuy
躘	khud
躗	tnhh
躖	khxh
躖	khxg
躎	khgq
躌	khrh
躈	khrt
躆	khhe
躄	nkuh
躃	khnu
躂	khfp
躀	khxm
蹾	khyt
蹽	khdi
蹻	khtk
蹹	khwn
蹸	khoh
蹷	dubh
蹵	yidh
蹳	khwc
蹱	khuf
蹮	khsn
蹫	khck
蹪	khkm
蹨	khqo
蹥	khlp
蹢	khud
蹡	khnf
蹠	khyo
蹟	khgm
蹞	khxm
蹝	khth
蹜	khpj
蹛	khah
蹗	khyx
蹖	khdv
蹔	lrkh
蹏	khrm
蹎	khfw
蹍	khne
蹆	khvp
蹅	khsg
蹃	khak
踿	khto
踾	khgl
踼	khjr
踻	khmk
踸	khan
踷	khfj
踶	khjh
踳	khdj
踲	khrh
踰	khwj
踭	khqh
踫	khug
踨	khwh
踧	khhc
踦	khdk
踥	khuv
踤	khyf
踡	khub
踠	khpb
踜	khft
踛	khff
踚	khwa
踙	khbc
踘	khqo
踗	khwn
踖	khaj
踕	khgh
踓	khwy
踒	khtv
踑	khaw
踎	khgk
踍	khfb
踋	khfb
踈	khgi
踇	khtu
踆	khct
踄	khhi
踃	khie
踂	khbn
踁	khga
踀	khkh
跿	khfh
跾	whth
跼	khnk
跴	khsg
跲	khwk
跱	khff
跰	khua
跮	khgf
跭	khth
跩	khjx
跧	khwg
跦	khri
跥	khes
跢	khqq
跠	khgw
跜	khnx
跙	kheg
跘	khuf
跕	khhk
跔	khqk
跓	khyg
跒	khsk
跐	khhx
跍	khdg
跊	khfi
跉	khwc
跈	khwe
跇	khan
跅	khry
跁	khcn
跀	kheg
趽	khyn
趻	khwn
趹	khnw
趷	khtn
趶	khgf
趰	fhgq
趯	fhny
趮	fhks
趭	fhwo
趬	fhfq
趫	fhtk
趪	fhaw
趩	fhlw
趧	fhjh
趦	fhuk
趥	fhug
趤	fhpd
趢	fhvi
趡	fhwy
趠	fhhj
趞	fhaj
趝	fhwn
趜	fhqo
趛	fhqd
趚	fhgi
趘	fhnn
趗	fhkh
趖	fhwf
趓	fhms
趒	fhiq
趐	fhnd
趏	fhtd
趎	fhri
趍	fhqq
趌	fhfk
趉	fhbm
趈	fhhk
趇	fhud
趆	fhqy
趃	fhrw
趂	fhqi
趀	fhtt
赿	fhqa
赾	fhrk
赽	fhnw
赼	fhqw
赻	fhit
赺	fhwn
赹	fhqu
赸	fhmk
赲	fhlv
赱	fuyu
赯	foyk
赮	fonc
赬	fohm
赩	foqc
赨	fojy
赥	foqw
賵	mjhg
賙	mmfk
贔	mmmu
貟	cmu
贜	madt
贚	mued
贙	hamm
贘	mipm
贕	qytm
贒	ahnm
贑	ujam
贎	majy
贌	mogy
贉	msjh
贆	mddd
贃	mkkn
贂	mcce
贁	mmty
贀	atdm
賿	mnwe
賹	muwl
賸	eudm
賷	fkkm
賶	mwyk
賳	mfak
賲	wksm
賱	mplh
賰	mdwj
賯	mqjb
賮	vhgm
賫	fwwm
賩	mpfi
賨	pfim
賥	mywf
賟	mmaw
賝	mpws
賛	fwfm
賘	myfy
賗	mkkh
賖	mwty
賔	pnmu
賐	mcwt
賏	mmy
賎	mdxy
賍	myfg
賌	yntm
賋	muqy
賉	mtlg
賆	muah
貾	mqay
貹	mtgg
貵	cdmu
貱	mhcy
貮	gami
貭	rfmi
貦	mfqn
貥	mymn
貤	mbn
貣	amu
貜	eehc
貛	eeay
貚	eekf
貙	eeak
貗	eelv
貗	eekv
貖	eeul
貕	eeed
貒	eemj
貑	eenc
貐	eewj
貏	eerf
貎	eevq
貍	eejf
貋	eejf
貈	eete
貇	eeve
貆	eegg
貄	eevh
貃	eerg
貁	eepw
貀	eebm
豿	eeqk
豾	eegg
豽	eemw
豼	eexx
豻	eefh
豷	efpu
豶	efam
豵	etwh
豴	eumd
豲	edri
豱	ejlg
豰	fpgc
豯	eexd
豭	enhc
豩	eey
豨	eqdh
豧	egey
豦	haei
豥	eynw
豤	evey
豣	eftf
豠	eegg
豟	eynn
豞	eqkg
豝	ecn
豜	egah
豛	emcy
豙	ueu
豘	egbn
豗	gqei
豖	eyi
豓	dhdl
豒	dhdt
豑	magt
豏	gkuo
豍	gkuf
豋	wgku
豊	magu
豅	wwkd
豄	wwkm
豃	wwkt
豂	wwke
豀	wwkd
谿	exdk
谾	wwka
谽	wwkk
谼	wwkw
谻	wwkt
谺	wwkt
谹	wwkc
谸	tdwk
讅	yptl
譸	yfnf
詗	ymkg
訩	yqbh
訒	yvyy
讟	yfly
讝	ykkt
讛	yafc
讙	yaky
讘	ybbb
讗	ymwk
讔	yben
讑	ywga
讐	wywy
讏	tnhy
讍	ygkk
讌	yauo
讉	ykhp
讈	ydth
讇	yuqv
讆	tnhy
讄	ylll
讃	yfwm
讂	yqmt
讁	yump
譿	ydhn
譼	ahny
譻	mmyf
譺	yxth
譹	yype
譶	yyyf
譵	yogf
譳	yfdj
譲	yufe
譱	udyy
譮	ywgj
譭	yvac
譪	yajn
譩	yujn
譨	ymae
譧	yyuo
譥	ryty
譤	yryt
譣	ywgw
譢	yuep
譡	yipl
譠	yylg
譟	ykks
譞	ylge
譝	yxg
譝	ymgv
譛	yfwj
譗	ytwk
譕	yrlo
譔	ynnw
譓	ygjn
譒	ytol
譑	ytdk
譐	yusf
譍	ywwy
譌	yeto
譋	yueg
譊	yffq
譈	yybt
譇	ydfj
譆	yfkk
譅	yvyh
譄	yulj
譃	yhag
譂	ykkf
譀	ynbt
謿	yfje
謽	xkjy
謼	yhah
謻	ytqq
謺	fufy
謸	ygqt
謷	gqty
謶	yyao
謵	ynrg
謴	yxfm
謲	ycce
謱	ylvg
謱	ykgv
謰	ylpy
謯	yhag
謮	ygmy
謭	yuev
謪	yumk
謧	yybc
謥	ytln
謤	ysfi
謣	yffn
謢	ywyc
謡	yerm
謟	yevg
謞	yymk
謜	ydri
謚	yuwl
謘	ynuh
謕	yrhm
謓	yfhw
謒	ywyk
謑	yexd
謏	yvhc
謍	oopy
謌	yskk
謋	yqas
謉	yrqc
謈	jawy
謆	yynn
謃	yjtg
諿	ykbg
諽	yafh
諻	yrgg
諹	yjgr
諵	yfmf
諴	ydgt
諲	ysfg
諰	ylny
諯	ymdj
諬	tdny
諪	yyps
諩	yuog
諨	ygkl
諥	ytgf
諣	ymnk
諠	ypgg
諟	yjgh
諚	ypgh
諙	yqaj
諘	ygey
諕	yham
諔	yhic
諓	yaat
諐	wkqy
諎	yajg
諌	ygji
諊	yqoy
諈	ytgf
諆	yadw
諅	adwy
諃	yssy
諁	yccc
諀	yrtf
誽	yvqn
誻	yijg
誺	ysww
誸	yxyx
誷	ymun
誵	yqde
誴	ypfi
誳	ynbm
誱	ygvh
誯	yjjg
誮	yawx
読	yfpq
誫	ydfe
誩	yyg
誧	ygey
誢	yhqn
誟	yftb
誝	ywyk
誜	ycwt
誛	yvpc
誙	ygva
誗	ytjh
誖	yfpb
誔	ytfp
誐	ytrt
誏	yyve
誎	ygki
誌	yfny
誋	ynny
誈	ygcf
誃	yqqy
誂	yiqn
誁	yuah
誀	ybg
詾	yqqb
詽	yftf
詺	yqkg
詸	yoy
詷	ymgk
詶	yyth
詴	ydeg
詯	ythg
詪	yvey
詨	yuqy
詥	ywgk
詤	ywnq
詝	ypsh
詜	ybhc
詚	yjgg
詙	ydcy
詓	yfcy
詑	ypxn
詏	yxln
詍	yann
詌	yafg
詋	ykqn
詊	yufh
詉	yvcy
詇	ymdy
詅	ywyc
詄	yrwy
詃	yyxy
詂	ywfy
詀	yhkg
訿	yhxn
訽	yqkg
証	yghg
註	yygg
訹	ysyy
訸	yty
訷	yjhh
訵	ylg
訳	ynyy
訲	ykhh
訰	ygbn
訯	yeyy
訮	ygah
訬	yitt
訫	yny
訨	yhg
訧	ydnn
訦	ypqn
訤	yqqy
訢	yrh
訡	ywyn
訠	yxhh
訞	ytdy
訜	ywvn
訙	yvyy
訔	myf
訑	ybn
訏	ygfh
訍	ycyy
訋	yqyy
訉	ymyy
訆	ynhh
訅	yvn
觾	qeao
觽	qemm
觼	qeqt
觻	qexs
觺	xtde
觹	qewm
觷	wfqe
觷	vqqe
觵	qeaw
觲	qeuh
觱	dgke
觰	qmfj
觮	qevi
觭	qedk
觬	qevq
觪	qeuh
觩	qefy
觨	qeai
觧	qeud
觤	qeqb
觢	dhve
觡	qetk
觠	udqe
觟	qeff
觝	qeqy
觛	qejg
觙	qeey
觘	qeit
觗	qeqa
觕	trqe
觔	qeln
觓	qenh
覥	mawq
覎	hqbd
覾	ptoq
覼	gwmq
覻	hagq
覹	hqtt
覸	ujhq
覶	ecmq
覵	uehq
覴	wgkq
観	rwyq
覱	lrhq
覰	haeq
覮	oopq
覭	pjuq
覫	upyq
覩	ftjq
覨	kkfq
覧	ahnq
覤	hamq
覣	tvhq
覢	oohq
覠	vtkq
覟	fnhq
覞	hqhq
覝	fohq
覜	iqhq
覛	rehq
覚	iphq
覙	qihq
覗	ngkq
覕	nthq
覔	gihq
覒	tfnq
覑	thgq
覐	hqqq
覍	ihqb
覌	chqn
覊	safc
覉	safk
覇	safe
覅	svqr
覄	swdu
覂	stpu
覀	sghg
襾	gmjg
襽	puai
襼	puac
襺	puaj
襹	pugx
襸	putm
襷	puwr
襷	puvr
襶	pufw
襵	pubb
襴	puui
襳	puwg
襱	puud
襰	pugm
襮	puji
襭	pufm
襬	pulx
襫	pudj
襩	pufm
襨	puof
襧	pugq
襥	puwy
襣	putj
襢	puyg
襡	pulj
襜	puqy
襛	pume
襚	puup
襙	puks
襘	puwj
襗	pulf
襔	puay
襓	pufq
襒	puut
襑	puvf
襐	puqe
襏	puwc
襎	putl
襍	puws
襌	pukf
襋	pugi
襊	pujc
襈	punw
襇	puuj
襅	pujf
襃	yqge
襂	puce
襀	pugm
褿	pugj
褾	pusi
褽	nfie
褼	pusn
褺	fufe
褹	pufy
褷	puth
褵	puyc
褱	ylie
褯	puyh
褮	oope
褭	yceu
褬	pucs
褩	teme
褨	puua
褧	boye
褦	pucx
褤	pufe
褣	pupk
褠	puff
褟	pujn
褞	pujl
褝	puif
褜	eqne
褘	punh
褗	puav
褖	puxe
褕	puwj
褑	puec
褏	yqge
褎	yqge
褍	pumj
褌	pupl
褋	puas
褉	pudd
褈	putf
複	putt
褆	pujh
褅	puuh
褄	pugv
褃	puhe
褁	jseu
褀	puaw
裿	pudk
製	rmhe
裻	hice
裺	pudn
裷	puub
裶	pudd
裵	ydje
裲	pugy
裯	pumk
裮	pujj
裭	puhm
裬	puft
裫	puth
裫	pujg
裪	puqm
裩	pujx
裧	puoo
裦	yqge
裡	pujf
裠	vtke
裞	puuq
裛	yceu
裚	rrye
裗	puyq
裖	pude
裓	puaa
裑	putt
裐	puke
裍	puls
裌	pudw
裋	pugu
裇	putl
裄	puth
裃	puhh
裀	puld
袿	puff
袾	puri
袽	puvk
袻	pudj
袺	pufk
袹	pudj
袸	pudb
袶	puth
袵	puwf
袴	pudn
袳	puqq
袲	yqqe
袰	xgue
袮	puti
袬	ycke
袩	puhk
袨	puyx
袧	puqk
袦	pubm
袥	pudg
袣	puan
袡	pumf
袟	purw
袝	puwf
袛	puqy
袚	pudc
袙	purg
袘	putb
袗	puwe
袕	pupw
袔	pusk
袑	puvk
袐	punt
袏	puda
袎	puxl
袌	yqne
袉	pupx
袇	pumy
袃	avye
袀	puqu
衼	pufc
衻	pumf
衺	yahe
衹	puqa
衸	puwj
衶	pukh
衵	pujg
衴	pupq
衳	puwc
衱	puey
衯	puwv
衭	pufw
衪	pubn
衧	pugf
衦	pufh
衠	tfhh
衟	tvdh
衜	tuth
衚	tdeh
衘	trhh
衖	tawh
衕	tmgh
衒	tyxh
衑	twyh
衐	tanh
衏	tfqh
衎	tffh
衋	vfhl
衊	tlat
衉	tltk
衈	tlbg
衇	tlre
衃	tlgi
衂	tlvy
衁	yntl
蠿	vxxj
蠾	jnij
蠽	iwyj
蠺	gdgj
蠸	jaky
蠷	jhhy
蠵	jmwk
蠴	jalj
蠳	jmmv
蠰	jyke
蠯	yrtj
蠮	jatn
蠭	tdhj
蠬	jued
蠫	eejj
蠪	uegj
蠩	jyfj
蠨	javj
蠨	javh
蠧	fpdj
蠦	jhal
蠥	btwj
蠤	usgj
蠠	dmjj
蠞	tvcj
蠝	jlll
蠜	sqqj
蠚	adkj
蠘	jfay
蠗	jnwy
蠒	gwmj
蠏	jqeh
蠎	jada
蠌	jlff
蠋	jlqj
蠉	jlge
蠈	madj
蠇	jajy
蠄	jwyc
蠂	jaas
蠁	xtyj
蠀	juqm
蟿	lbmj
蟽	jfup
蟼	aqkj
蟺	jylg
蟸	ejju
蟷	jipl
蟵	jdgf
蟴	adwj
蟳	jvaf
蟱	jrlo
蟰	jvhh
蟰	jvfj
蟭	jwyo
蟫	jsjh
蟩	jduw
蟨	dubj
蟧	jool
蟦	jfam
蟤	jnnw
蟢	jfkk
蟡	jeto
蟟	jdui
蟞	umij
蟝	jias
蟜	jtdk
蟚	fkuj
蟙	juaj
蟘	jwam
蟗	gkhj
蟖	jadr
蟕	jhxe
蟔	jlfo
蟐	jiph
蟍	jtjs
蟌	jtln
蟉	jnwe
蟇	ajdj
蟅	jyao
蟃	jjlc
蟂	jwvs
蟁	najj
螿	nhdj
螾	jpgw
螼	jakg
螹	jlrh
螸	wwkj
螷	yrtj
螶	anjj
螴	bgjj
螲	jpwf
螱	nfij
螰	jynx
螮	jaqh
螪	jumk
螩	jwhs
螧	jftj
螦	jgxi
螥	jwyk
螤	yjjw
螣	eudj
螡	yjju
螠	juwl
螝	jrqc
螜	fpgj
螛	jpdk
螚	cexj
螙	sjju
螘	jmgu
螖	jmeg
螕	jtlx
螔	jrhm
螒	fjwj
螑	jthd
螐	jwno
螏	jutd
螎	jgkh
螌	temj
螊	juvo
螉	jwcn
螇	jexd
螆	juxx
螁	jvep
蝿	jjjn
蝺	jtky
蝹	jjlg
蝷	jyut
蝵	toju
蝳	jgxu
蝲	jgkj
蝱	ynjj
蝯	jefc
蝭	jjgh
蝬	jqbt
蝫	jftj
蝪	jjgr
蝩	jtgf
蝧	jamd
蝢	jdmy
蝡	jdmd
蝞	jnhg
蝝	jxey
蝜	jqmy
蝛	jdgt
蝚	jcbs
蝘	jajv
蝖	jpgg
蝔	jxxr
蝒	jdmd
蝑	jnhe
蝐	jjhg
蝏	jyps
蝍	jvcb
蝋	jimh
蝊	jpgh
蝆	jgkf
蝅	gdgj
蝄	jmun
蝃	jccc
蝂	jthc
蝁	ghgj
蝁	gfgj
蝀	jgji
蜽	jgmy
蜼	jwyg
蜺	jvqn
蜹	jamw
蜸	ahnj
蜶	jywf
蜵	jthh
蜵	jjgg
蜳	jybg
蜲	jtvg
蜰	ecju
蜯	jdwh
蜭	jqvg
蜬	jbib
蜫	jjxx
蜪	jqrm
蜨	jgvh
蜧	jynd
蜦	jwga
蜤	srju
蜠	jlty
蜟	jyce
蜝	adwj
蜛	jndg
蜙	jswc
蜖	jmjd
蜔	jqlg
蜑	thpj
蜐	jfcl
蜏	jten
蜎	jkeg
蜌	jxxf
蜋	jyve
蜅	jgey
蜄	jdfe
蜁	jtnh
蛿	jwyk
蛽	jmy
蛼	jlh
蛷	jfiy
蛶	jefy
蛵	jgva
蛯	jftx
蛬	awju
蛫	jqdb
蛪	dhvj
蛨	jdjg
蛧	jmqq
蛦	jgxw
蛥	jqqy
蛣	jfkg
蛢	juah
蛡	jng
蛠	jlll
蛝	jvey
蛜	jwvt
蛚	jgqj
蛗	wnnj
蛖	jdne
蛕	jdeg
蛓	faji
蛒	jtkg
蛍	ipju
蛌	jrcy
蛈	jrwy
蛅	jhkg
蛃	jgmw
蛂	jdcy
蛁	jvkg
蚿	jyxy
蚾	jhcy
蚽	jgig
蚼	jqkg
蚻	snju
蚹	jwfy
蚸	jryy
蚷	jang
蚳	jqay
蚲	jguh
蚮	jway
蚭	jnxn
蚫	jqnn
蚦	jmfg
蚥	jwqy
蚢	jymn
蚡	jwvn
蚠	wvju
蚟	jgg
蚞	jsy
蚛	jkhh
蚚	jrh
蚙	jwyn
蚘	jdnn
蚗	jnwy
蚖	jfqn
蚔	jqan
蚒	jmyg
蚑	jfcy
蚐	jqug
蚏	jeg
蚎	jjg
蚉	yju
蚈	jgah
蚇	jnyy
蚆	jcn
蚅	jdbn
蚄	jyn
虸	jbg
虷	jfh
虶	jgfh
虵	jbn
虴	jtan
虲	jhy
虰	jsh
虭	jvn
虪	hamo
虩	ijim
虨	hase
虦	aahm
虥	hama
虤	hamm
虣	gahm
虡	haow
虠	uqhm
虝	hamr
虘	haeg
虗	harg
虖	hath
虓	vham
虒	rham
虌	aumx
虌	aumv
虋	awfv
虋	avmv
虊	axys
虉	agko
虈	akkk
虇	axay
虆	alli
虅	aeuc
虄	ajtg
虃	aiwg
虂	afkk
虁	gjgt
虁	auht
虀	ayvg
虀	aydg
蘾	afye
蘽	alls
蘻	albi
蘹	anye
蘷	gjgt
蘶	atvc
蘵	abuj
蘴	adhu
蘳	aamf
蘲	allf
蘱	aodm
蘰	axjc
蘯	aijl
蘮	aldj
蘬	awnh
蘫	aial
蘪	ayno
蘨	aeri
蘦	afkk
蘥	awga
蘤	areo
蘣	aamg
蘡	ammv
蘠	anhk
蘟	aben
蘝	awgw
蘜	aafo
蘛	aade
蘙	aatn
蘘	ayke
蘗	anks
蘕	axtp
蘔	axtm
蘓	atqo
蘒	atqn
蘐	ayec
蘏	axfm
蘎	afec
蘍	atgl
蘌	atri
蘉	alpc
蘈	atmm
蘃	ahhs
蘂	anns
蘁	agkk
蘀	arlf
藾	agkm
藽	ausq
藼	apgn
藸	aefj
藷	ayfj
藵	awke
藳	aymt
藲	asak
藱	aurc
藰	aqyj
藯	anfn
藮	aswo
藭	apwx
藬	abkm
藫	aisj
藨	ayno
藧	axec
藦	aysr
藣	alcx
藢	atmt
藡	aump
藠	arrr
藟	alll
藞	addd
藛	apvo
藚	aflm
藙	auec
藘	ahan
藗	agkp
藖	aahm
藔	apdi
藒	atjn
藑	aqmt
藌	apnj
藋	anwy
藊	atya
藈	ahwd
藇	awfw
藇	avgw
藆	apfr
藅	alyj
藄	aadi
藃	aymw
藂	abci
藀	aooo
薿	axth
薽	asfn
薼	aynf
薻	aivs
薸	aisi
薶	aeef
薵	afnf
薴	apns
薳	afkp
薲	apgm
薱	aogf
薭	atrf
薬	aris
薫	atgo
薧	aypx
薥	alqj
薣	afkc
薢	aqeh
薡	ahnn
薠	aodm
薞	agqe
薝	aqdy
薚	agqr
薙	atdy
薘	afup
薗	alfy
薗	alfe
薖	amnp
薕	ayuo
薓	aivc
薒	ahqo
薑	aglg
薐	atft
薎	alpa
薍	aecn
薋	auqm
薉	ahdt
薆	aept
薃	aiyk
薂	aryt
薁	atmd
薀	aill
蕿	aoec
蕽	amae
蕼	advh
蕸	anhp
蕶	afwc
蕵	aqwe
蕳	aujf
蕱	atie
蕯	abtg
蕮	avqo
蕬	axxi
蕫	aujf
蕧	attt
蕦	aedm
蕣	aeph
蕡	afam
蕠	avki
蕟	awxc
蕝	axqc
蕜	adjn
蕛	atut
蕚	akkn
蕗	akhk
蕔	afuc
蕓	affc
蕑	auef
蕐	agwh
蕏	aqtj
蕍	aiwj
蕌	ajjj
蕋	ahhh
蕇	akkf
蕅	aijy
蕄	aunu
蕂	aeul
蕀	agmi
蒍	ayto
蔾	atqs
蔶	agmu
蔵	adat
蔴	ayss
蔳	aige
蔲	apft
蔱	aqsc
蔰	aync
蔯	abgi
蔮	alag
蔪	alrj
蔩	apgw
蔨	alub
蔧	adhv
蔤	apnm
蔠	axtu
蔝	ahou
蔜	agqt
蔛	aqef
蔙	ayth
蔘	acce
蔖	ahag
蔕	aaqh
蔔	aqgl
蔒	avto
蔐	aumd
蔏	aumk
蔎	aymc
蔍	aynx
蔋	aihc
蔊	aojf
蔉	auke
蔈	asfi
蔇	avcq
蔆	aift
蔅	auvf
蔄	aukf
蔃	axkj
蔁	aujj
蔀	aukb
蓾	ahlo
蓻	afuy
蓺	afwy
蓹	atrb
蓸	agmj
蓷	arwy
蓶	akwy
蓵	argh
蓲	aakk
蓭	aydn
蓫	aepu
蓪	acep
蓩	acbl
蓨	awhe
蓧	awhs
蓤	auft
蓢	ayve
蓡	aivc
蓞	aevf
蓜	asgn
蓛	agmt
蓚	awhe
蓙	aywf
蓘	auce
蓗	atfh
蓕	asff
蓔	augo
蓒	alfj
蓏	arcy
蓎	ayvk
蓌	awwt
蓈	ayvb
蓇	amef
蓆	ayah
蓅	aiyq
蓃	avhc
蓂	apju
蒾	aopu
蒻	axuu
蒷	akmu
蒶	axwv
蒵	aexd
蒳	axmw
蒱	argy
蒰	atec
蒮	apwy
蒭	aqbt
蒬	apqy
蒫	auda
蒪	agef
蒩	ateg
蒨	awge
蒧	adht
蒦	awyc
蒥	aqyl
蒤	aiwt
蒣	atwt
蒢	abwt
蒠	athn
蒟	auqk
蒝	adri
蒛	armw
蒚	agkh
蒘	avkr
蒖	afhw
蒀	ajlf
蒓	axgn
蒒	awnh
蒑	arvc
蒐	arqc
蒊	awxx
蒆	aamv
蒅	aivs
蒄	apff
蒃	axeu
蒁	asyp
葿	anhf
葾	aqbn
葽	asvf
葼	aqbt
葻	amtj
葹	aytb
葴	adgt
葲	ariu
葰	awct
葯	axqy
葮	awdc
葪	aqej
葧	afpl
葥	auej
葢	adyl
葠	awvc
葟	argf
葞	axbf
葝	agvl
葘	agvl
葕	atih
葔	awnd
葓	aiaw
葐	awvl
葏	aivh
葍	agkl
葌	avvv
葋	aeqk
葊	awga
葈	acks
葇	acbs
葅	awwg
葄	aetf
葃	ajtf
葂	aqkl
葁	augv
葀	artd
萿	aitd
萾	aecl
萻	aujf
萺	ajhf
萹	ayna
萷	aiej
萶	adwj
萴	amjj
萳	afmf
萲	aefc
萰	agli
萯	aqmu
萮	awgj
萭	atky
萫	atjf
萪	atuf
萩	atou
萣	apgh
萢	aiqn
萡	airf
萠	aeef
萟	atvy
萞	amwx
萛	ahaj
萙	aspq
萗	apfi
萖	avqb
萕	ayjf
萔	arvk
萓	apeg
萒	aucq
萐	agvh
萉	aecb
萈	ahqy
萅	agbj
萂	atkf
萀	aham
菿	agcj
菾	agdn
菼	aoou
菻	assu
菺	ayne
菷	avph
菶	adwh
菵	amun
菴	adjn
菳	aqf
菮	ayvw
菭	aick
菨	auvf
菧	ayqy
菦	arpu
菤	audb
菣	aahc
菢	arqn
菞	atqt
菛	auf
菚	aaar
菙	atgf
菗	armf
菕	awga
菒	ajsu
菐	oguy
菎	ajxx
菍	awyn
菋	akfi
菉	aviu
菈	aruf
菆	abcu
菄	agji
菃	aian
菂	arqy
莿	agmj
莾	adfa
莻	aekx
莵	atky
莯	aisu
莮	allb
莭	avcb
莬	aqkq
莦	aief
莥	aqtf
莤	asgf
莣	aynn
莡	akhu
莟	awyk
莝	awwf
莚	athp
莙	avtk
莗	alj
莕	askf
莔	alwm
莑	atdh
莐	aipq
莏	arit
莍	afiy
莌	aukq
莋	awtf
莈	aimc
莇	aegl
莄	agjq
莃	aqdh
莂	aklj
莁	aaww
莀	adfe
荿	adnt
荾	acwt
荺	afqu
荹	ahir
荶	akwn
荵	avyn
荴	arfw
荳	agku
荲	ajff
荱	antn
荰	asff
荢	apgf
荘	auff
荗	adyt
荖	aftx
荕	aelb
荓	auaj
荎	agcf
荍	anht
荌	apvf
荋	admj
荈	aqah
荅	awgk
荄	aynw
荂	adfn
荁	agjg
茿	aamy
茾	agaj
茽	awkh
茻	btbh
茷	awar
茰	ajqu
茮	ahiu
茪	aiqb
茩	argk
茦	agmi
茥	afff
茤	aqqu
茣	akgd
茢	agqj
茡	apbf
茠	awsu
茟	avfh
茞	aahh
茝	aahh
茙	aadr
茘	avvv
茖	atkf
茓	apwu
茒	aqbj
茐	aqry
茋	aqay
茊	argf
苿	afiu
苽	arcy
苼	atgf
苺	axgu
苸	atuh
苶	awiu
苵	arwu
苳	atuu
苲	athf
苰	axcu
苮	awmj
苭	axlb
苬	alwu
苪	agmw
苩	arf
苨	anxb
苢	anhn
苝	auxb
苚	aej
苙	auf
苖	amf
苐	axht
苉	aaqb
苆	aavb
苅	aqjj
苃	adcu
苂	aou
苀	aymb
芿	aweb
芼	atfn
芺	atdu
芶	aqcu
芵	anwu
芲	awxb
芧	acbj
芣	agiu
芢	awff
芠	ayu
芞	arnb
芛	avtr
芚	agbn
芖	adu
芕	aqu
芔	bhbh
芓	abf
芐	aghu
芌	afnb
芉	afj
芇	amhj
芆	acyu
芅	aau
芃	amyu
芁	amb
芀	avb
艼	asj
艻	alb
艸	btbh
艷	dhdc
艶	magc
艵	uaqc
艭	tewc
艬	teqy
艪	teqj
艩	teyj
艩	teyf
艧	teac
艥	tekt
艣	tehl
艢	tefk
艡	teil
艠	tewu
艞	tetq
艝	tefv
艜	teah
艛	telv
艛	tekv
艗	teul
艖	teua
艕	teuy
艔	teyc
艓	teas
艒	tejh
艑	teya
艐	teqt
艎	terg
艍	tend
艌	tewn
艊	terh
艈	teyq
艆	teye
艅	tewt
艃	tejf
艂	teth
艁	tetk
艀	teeb
舿	tedn
舽	teth
舼	teaw
舺	telh
舲	tewc
舮	teyn
舩	tewc
舧	tety
舦	tedy
舥	tecn
舤	temy
舠	tevn
舝	nhvh
舚	tdqy
舙	tdtd
舘	wfkn
舖	wfky
舕	tdoo
舓	tdjr
舑	tdmf
舏	tdnh
舎	wfkf
舋	wfmg
舋	vmgg
舃	vgno
臿	tfvd
臽	qvf
臹	gcft
臸	gcff
臷	fagf
臶	gcfb
臵	gcfk
臲	thsb
臱	thpy
臰	thgx
臯	thif
臮	thwy
臮	thww
臮	thwu
臫	thnn
臩	nhaj
臦	nhah
臤	ahnc
臢	etfm
臡	akfw
臞	ehhy
臝	ynky
臛	efwy
臙	eauo
臗	epay
臖	wfme
臖	vmge
臕	eyno
臔	eahm
臓	eadt
臒	eawc
臐	etgo
臎	enyf
臋	naww
臈	eajn
臇	ewym
臅	elqj
臄	ehae
膼	emnp
膹	efam
膸	edap
膷	extb
膶	eugg
膵	eayf
膴	erlo
膲	ewyo
膱	euaj
膰	etol
膯	ewgu
膮	effq
膭	ekhm
膬	etfn
膫	edui
膧	muuf
膧	eujf
膥	gsdw
膤	efvg
膢	elvg
膢	ekgv
膡	eudh
膟	eyxf
膞	egjf
膙	exkj
膗	emwy
膖	etdp
膕	elag
膔	eynx
膓	etjr
膒	eakk
膐	ytew
膎	eexd
膍	etlx
膌	eiwe
膋	oope
膉	euwl
膇	ewnp
膆	egxi
膅	eyvk
膄	evhc
膁	euvo
腷	egkl
腶	ewdc
腵	enhc
腲	elge
腯	erfh
腬	ecbs
腪	eplh
腨	emdj
腤	eujg
腣	euph
腢	ejmy
腟	epgf
腞	exey
腝	edmd
腜	eafs
腛	engf
腗	emgj
腒	endg
腏	eccc
腍	ewyn
腉	evqn
腇	etvg
腅	eooy
腄	etgf
腃	eudb
腂	ejsy
腁	etff
腀	ewga
脿	egey
脽	ewyg
脼	egmy
脻	egvh
脺	eywf
脵	ekgd
脴	egik
脳	eiqb
脰	egku
脮	eevg
脭	ekgg
脪	eqdh
脨	egki
脧	muct
脧	ecwt
脦	eany
脥	edww
脢	etxu
脡	etfp
脠	ethp
脟	eefy
脝	eybh
脜	edhg
脙	efiy
脗	eqrk
脕	eqkq
脌	erhf
脋	vvve
脇	elll
脄	edoy
脃	eqcn
脁	muiq
脁	eiqn
脀	bige
胿	effg
胾	famw
胻	etfh
胹	edmj
胷	qqbe
胵	egcf
胮	etah
胦	emdy
胣	etbn
胢	eskg
胠	efcy
胟	exgu
胘	eyxy
胕	ewfy
胔	hxmw
胓	eguh
胒	enxn
胑	ekwy
胐	mubm
胐	ebmh
胏	etnt
胋	ehkg
胊	muqk
胊	eqkg
胉	erg
胈	edcy
胇	exjh
胅	erwy
肻	hpef
肹	ewgn
肸	ewfh
肶	exxn
肵	erh
肳	eqrt
肰	edy
肬	ednn
肨	edhh
肧	egiy
肦	muwv
肦	ewvn
肣	ewyn
肞	ecyy
肙	kef
肗	evg
肕	evyy
肔	ebn
肒	evyy
肑	eqyy
肐	etnn
肏	tymw
肎	pef
肍	evn
肈	ynah
肂	gqvh
肁	ynvh
聼	nbfn
聻	ilrb
聺	bpwi
聸	bqdy
聴	bfln
聮	bxxo
聭	brqc
聫	bxxd
聨	bxxa
聧	bwgd
聦	bqrn
聥	btky
聤	byps
聣	bvqn
聢	bpgh
聡	bwcn
聠	buah
聟	tdkb
聝	bakg
聜	bpwa
聛	brtf
聙	bgeg
聗	bdww
聕	btfk
聓	amyb
聑	bbg
聐	bfkg
聏	bdmj
聎	biqn
聉	bbmh
聈	bxln
聇	bghg
聅	btdy
聄	bwet
聁	bwvn
聀	bat
耾	bdcy
耼	bmfg
耺	bfcy
耹	bwyn
耴	bnn
耲	diye
耰	didt
耯	diac
耭	dixt
耫	digm
耤	diaj
耣	diwa
耡	diel
耟	dian
耞	dilk
耝	dieg
耛	dick
耚	dihc
耓	dish
耑	mdmj
耏	dmje
耎	dmjd
耊	ftgf
耉	fttk
耈	ftxk
耇	ftqk
耂	fte
翿	fnan
翾	lgkn
翺	thin
翸	famn
翷	oqan
翶	rifn
翵	nwvo
翴	nlpy
翲	sfin
翯	nymk
翭	nwnd
翫	nrfq
翪	nqbt
翨	njgh
翧	pgjn
翤	kman
翢	mfkn
翞	nyiy
翝	pdcn
翜	ndww
翗	qqng
翖	wgkn
翓	fkng
翑	nqkg
翐	nrwy
翏	nwer
翍	nhcy
翋	nug
翉	sgng
翈	lng
翇	ndcu
翆	nvfj
翄	nfcy
翂	nwvn
翀	nkhh
羾	nag
羻	udyt
羺	udfj
羷	udww
羵	udfm
羴	udud
羳	udtl
羱	uddi
羮	ugoy
羭	udwj
羬	uddt
羫	udpa
羪	udye
羦	udpq
羢	udad
羠	udgw
羜	udps
羛	ugxj
羙	ugou
羘	eudh
羗	udnc
羖	udmc
羕	ugyi
羓	udcn
羒	udwv
羑	ugqy
羐	gjgy
羏	udet
羍	dudj
羉	lxyi
羇	lafk
羄	lxhj
羃	lajh
羂	lxke
羀	mqql
罿	lujf
罽	ldoj
罼	ljaf
罻	lnff
罺	lvjs
罸	lyfu
罶	lqyl
罳	llnu
罯	lujf
罭	lakg
罬	lccc
罫	lffh
罧	lssu
罦	lebf
罥	lkef
罤	luxt
罣	lfff
罠	lnab
罞	lcbt
罝	legf
罜	lygf
罛	lrcy
罙	pwsu
罖	lwyu
罓	mqi
罒	lhng
罏	rmhl
罎	rmjc
罋	yxtm
罊	lbmm
罉	rmir
罈	rmsj
罇	rmuf
罆	rmxm
罃	oopm
罁	rmmm
罀	rmiq
缿	rmrk
缾	rmua
缼	rmqw
缻	rmgn
缹	rmou
缷	rmbh
緓	xamd
綌	xwwk
紖	xxhh
紝	xtfg
纞	xxyn
纝	xlli
纚	xgmx
纙	xlxy
纗	xmwk
纕	xyke
纒	xyjf
纑	xhal
纐	xuqm
纎	xfag
纍	llli
纋	xdet
纉	xfwm
纆	xlff
纅	xxrs
纄	xatp
纃	xyvf
纃	xyjg
纁	xtgo
纀	xwoy
繿	xahl
繻	xfdj
繺	xqvo
繸	xuep
繷	xmae
繶	xujn
繵	xylg
繴	nkui
繲	xqeh
繱	xaqn
繬	xfwk
繫	lbmi
繨	xfup
繧	xffc
繦	xxkj
繥	xfkk
繤	ahdi
繣	xvfg
繠	nnni
繟	xkkf
繝	xueg
繜	xusf
繛	gxij
繙	xtol
繘	xcbk
繗	xoqh
繖	xaet
繓	xjbc
繑	xtdk
繏	xnnw
繎	xqdo
繍	xvoj
繌	xtlt
繋	lmci
繊	xfag
繉	xhiq
繈	xxcj
繄	atdi
繂	xyxf
繀	xmwy
縿	xcce
縼	xyth
縺	xlpy
縸	xajd
縴	xyxh
縳	xgjf
縰	xthh
縯	xpgw
縬	xdht
縪	xjaf
縩	xwfi
縨	xjiq
縧	xwhs
縦	xtuh
縥	xdwt
縤	xgxi
縢	eudi
縡	xpuh
縠	fpgc
縜	xkmy
縚	xevg
縙	xabg
縘	xexd
縖	xpdk
縔	xccs
縓	xdri
縒	xuda
縏	temi
縎	xmeg
縍	xupy
縌	xubp
縇	xpgg
緪	xngg
縅	xdgt
縄	xjjn
縃	xnhe
縂	xukn
縁	xvey
縀	xnhc
緿	xckn
緾	xdjf
緽	xhmy
緻	xgct
緺	xmnk
緸	xsfg
緷	xplh
緵	xqbt
緳	ydhi
緰	xwgj
緮	xtjt
緭	xleg
緫	xqrn
緧	xusg
緥	xwks
緤	xans
緢	xalg
緟	xtgf
緜	rmhi
緛	xdmd
緖	xftj
緕	xyjg
緕	xyjf
緔	ximk
緑	xviy
緐	txgi
総	xwcn
緎	xakg
緍	xqaj
緌	xtvg
緉	xgmy
緈	xfuf
緆	xjqr
緅	xbcy
緃	xwwh
緂	xooy
緁	xgvh
緀	xgvv
綼	xrtf
綷	xywf
綶	xjsy
綵	xesy
綳	xeeg
綫	xaat
綪	xgeg
綩	xpqb
綨	xadw
綧	xybg
綥	xlgj
綡	xyiy
綝	xssy
綛	xvyn
続	xfpq
継	xonn
綘	xtdh
綗	xmwk
綖	xthp
綕	xfny
綔	dfni
綒	xebg
綑	xlsy
綐	xukq
綎	xtfp
綍	xfpb
綋	xpdc
綊	xdww
綉	xten
綇	xsgg
綅	xvpc
綂	xyqn
綀	xgki
絿	xfiy
絾	xdnt
絽	xkkg
絼	xeet
絻	xqkq
絺	xqdh
絸	xhqn
絶	xqcn
絵	xwfc
絴	xudh
絯	xynw
絭	udxi
絬	xtdg
絫	ccci
絪	xldy
絩	xiqn
絧	xmgk
絥	xwdy
絤	xsg
絣	xuah
絠	xdeg
絟	xwgg
絚	xgqg
絚	xghg
絙	xgjg
絘	xuqw
絗	xlkg
絖	xiqn
絔	xdjg
絓	xffg
絒	xyth
絑	xriy
絏	xjxt
絏	xjnt
絍	xwtf
経	xcfg
絋	xycy
絊	xsgg
絉	xsyy
絈	xrg
絇	xqkg
絅	xmkg
絃	xyxy
絁	xtbn
紾	xwet
紽	xpxn
紻	xmdy
紸	xygg
紷	xwyc
紶	xfcy
紴	xhcy
紮	snxi
紭	xxcy
紪	xhxn
紩	xrwy
紨	xwfy
紦	xcn
紥	rnxi
紤	xrh
紣	xvfh
紟	xwyn
紞	xpqn
紒	xwjh
紑	xgiy
紏	xufh
紎	xdy
紌	xdnn
紃	xkh
紁	xcyy
糿	xvn
糽	xsh
糼	xln
糺	xnn
糷	oaui
糵	awno
糳	oguo
糱	btwo
糰	olgf
糮	oahl
糭	oqot
糭	oobt
糬	olfj
糫	olge
糪	nkuo
糩	owgj
糦	ofkk
糥	odmj
糤	oaet
糣	oaqj
糢	oajd
糡	oujq
糛	oipf
糚	oanf
糘	opey
糔	ocyj
糓	fpgc
糒	oate
糑	oxuu
糐	ogef
糏	onie
糎	odjf
糋	ouej
糆	odmd
糄	oyna
糃	ojgr
糂	oadn
糀	oawx
粿	ojsy
粻	odey
粺	ortf
粸	oadw
粷	oqoy
粶	oviy
粴	ojfg
粰	oebg
粯	ohqn
粭	owgk
粬	omag
粫	odmj
粩	oftx
粨	odjg
粦	oqah
粣	ommg
粡	omgk
粠	oawy
粛	vojk
粚	otbn
粙	omg
粖	ogsy
粔	oang
粓	oafg
粐	oynt
粏	odyy
粎	onyy
粍	otfn
粌	oxhh
粋	ovfh
粊	xxou
粈	onfg
粇	oymn
粆	oitt
粅	oqrt
粄	orcy
粃	oxxn
粂	qyou
粁	otfh
粀	odyy
籿	ofy
籾	ovyy
籺	otnn
籹	ovg
籸	onfh
籷	otan
籶	omn
籵	ofh
籱	tfwy
籰	thhc
籯	tyny
籭	tgmx
籫	ttfm
籨	twgw
籧	thap
籦	tqtf
籥	twga
籣	tugi
籢	twgt
籡	trww
籞	ttri
籝	tyny
籛	tqaa
籚	thal
籘	teui
籗	tfwy
籖	tfag
籕	tsql
籔	tlvt
籔	tkgt
籓	titl
籒	trgl
籑	thde
籐	teui
籏	tytw
籎	txth
籋	tgwq
籊	tnwy
籉	tfkf
籈	tsfn
籇	type
籆	tawc
籅	twfw
籅	tvgw
籄	takm
籂	twyh
籂	twph
簽	twgw
簼	trff
簻	tmnp
簺	tpff
簹	tipl
簷	tqdy
簶	tpyi
簵	tltk
簴	thaw
簳	tfjf
簲	terf
簱	tyaw
簯	tsaw
簮	tfwj
簭	tawk
簬	tkhk
簩	tool
簨	tnnw
簥	ttdk
簤	tlmu
簢	tuyu
簠	tgel
簝	tdui
簜	tijr
簛	tadr
簚	tlah
簙	tfgf
簘	tvoj
簗	tivs
簕	tafl
簔	tyge
簓	tmfe
簒	thdc
簑	tyke
簐	tlqw
簎	traj
簊	tadf
簉	ttfp
簈	tntf
簆	tpfc
簅	tutg
簄	tync
簃	ttqq
簂	tlag
簁	tthh
篿	tgjf
篽	ttrb
篻	tsfi
篺	trrf
篹	thdb
篸	tcce
篶	tgho
篵	ttwh
篴	tepu
篲	tdhv
篰	tukb
篭	tujn
篬	twyk
篫	tamr
篨	tbwt
篧	tpwy
篣	tupy
篢	tamu
篠	twhs
篟	twge
篞	tijf
篜	tbio
篛	txuu
篘	tqbt
篗	twyc
篖	tyvk
篕	tfcl
篔	tkmu
篒	twye
篐	tsah
篏	tafw
篎	thit
篍	ttou
篊	tiaw
篈	tfff
篅	tmdj
篃	tnhf
篂	tjtg
箿	tkbf
箾	tiej
箽	ttgf
箼	tngf
箻	ttvh
箺	tdwj
箹	txqy
箷	tytb
箶	tdef
箵	tith
箳	tnua
箲	titq
箰	tqjb
箯	twgq
箮	tpgg
箥	tihc
箤	tywf
箣	tgmj
箠	ttgf
箟	tjxx
箞	tudb
箛	tbry
箚	twgj
箙	tebc
箘	tltu
箖	tssu
箒	tvph
箑	tgvh
箎	tham
箌	tgcj
箊	tywu
箉	trkl
箈	tick
箇	tldf
箆	tmwx
箄	trtf
箃	tbcu
箂	tsww
箁	tukf
筽	tkgd
筺	tagy
筸	tjfj
筶	ttfk
筴	tdww
筳	ttfp
筰	twtf
筯	tegl
筭	tgaj
筬	tdnt
筫	tmu
筪	talj
筩	tcej
筨	twyk
筦	tpfq
筥	tkkf
筤	tyve
筣	ttjj
筡	twtu
筟	tebf
筞	tpsu
筙	tdiu
筗	twkh
筕	ttfh
筓	tftf
筎	tvkf
筊	tuqu
筈	ttdf
筄	tiqb
筃	tldu
筂	tibb
筁	tmaf
筀	tfff
笿	ttkf
笽	tlf
笻	tabj
笹	tanb
笷	tqtb
笶	ttdu
笵	tibb
笴	tskf
笲	tcaj
笰	txjj
笯	tvcu
笭	twyc
笩	twau
笧	tmmg
笣	tqnb
笢	tnab
笡	tegf
笟	trcy
笝	tlcu
笜	tbmj
笚	tlj
笘	thkf
笗	ttuu
笖	tnyw
笓	txxb
笒	twyn
笐	tymb
笎	tfqb
笍	tmwu
笌	taht
笉	tquf
笇	tyhu
笅	tqqu
笂	tvyu
笁	taf
笀	tynb
竼	tmyu
竻	tlb
竸	ujqq
竷	ujtt
竵	ugkh
竴	uusf
竳	uwgu
竲	uulj
竱	ugjf
竰	udjf
竮	unua
竬	utky
竫	uqvh
竪	ahnu
竩	upeg
竨	uhjh
竧	utmt
竤	updc
竢	uctd
竡	udjg
竝	uug
竜	ujnb
竛	uwyc
竚	upsh
竘	uqkg
竗	uitt
竕	uwvn
竔	utah
竓	utfn
竒	uskf
竒	ukhj
竑	udcy
竐	umcy
竏	utfh
竎	uaj
竍	ufh
竌	umn
竉	pwud
竆	pwtk
竃	pwfn
竂	pwdi
竁	pwtn
竀	pwgq
窾	pwfw
窽	pwxw
窼	pwvs
窻	pwtn
窹	pwnk
窸	pwtn
窵	pwwo
窴	pwfw
窲	pwof
窱	pwws
窰	pwem
窫	pwdd
窧	pwhj
窤	pwjx
窣	pwyf
窢	pwag
窡	pwcc
窞	pwqv
窛	pwfv
窚	pwdt
窙	pwfb
窔	pwuq
窓	pwcn
窐	pwff
窏	pwif
窌	pwqb
窋	pwbm
窊	pwry
窉	pwgw
窇	pwqn
窅	pwhf
窂	pwrh
穾	pwtd
穽	pwfj
穼	pwsu
穻	pwgf
穵	pwnb
穳	ttfm
穲	tgmx
穱	telf
穯	tfkk
穮	tyno
穬	tyaw
穫	tawc
穪	tgwq
穨	tmkm
穧	tyvf
穧	tyjg
穦	tpgm
穥	twfw
穥	tvgw
穤	tfdj
穣	tufe
穟	tuep
穝	tjbc
穜	tujf
穛	twyo
穚	ttdk
穙	togy
穘	tffq
穖	txxt
穕	twys
穔	tamw
穓	tlaw
穒	twvo
穐	tqjn
穏	tevn
穋	tnwe
穊	tvcq
穉	tnih
穈	ysst
穇	tcce
穅	tyvi
穄	twfi
穃	tpwk
穂	tgmn
穂	tgjn
穁	tabg
穀	fpgc
稾	ymkt
稺	tnuh
稸	tyxl
稶	tgky
稶	take
稵	tuxx
稴	tuvo
稲	tehj
稰	tnhe
稯	tqbt
稭	txxr
稬	tdmd
稫	tgkl
稪	ttjt
稩	tleg
稨	tyna
稧	tdhd
稦	tnhh
稥	tojf
稤	tyiy
稢	takg
稡	tywf
稝	teeg
稛	tlty
稙	tfhg
稘	tadw
稖	tukg
稕	tybg
稓	tajg
稒	tldg
稑	tfwf
稐	twga
稏	tghg
稏	tgfg
稌	twty
稊	tuxt
稉	tgjq
稇	tlsy
稄	tcwt
稁	yptu
秿	tgey
秼	triy
秺	tpta
秹	twtf
秷	tgcf
秶	uqwt
秵	tldy
秴	twgk
秳	ttdg
秲	tffy
秱	tmgk
秮	tckg
秬	tang
秪	tqay
秨	tthf
秥	thkg
秢	twyc
秡	tdcy
秠	tgig
秞	tmg
秝	tty
秜	tnxn
秛	thcy
秚	tufh
秙	tdg
秗	ttdy
秖	tqan
秔	tymn
秓	tfcy
秐	tfcy
秏	ttfn
秎	twvn
秌	oty
秊	ttfj
秇	tvyy
秅	ttan
秄	tbg
秂	twu
禼	hlqc
禸	mci
禷	pyom
禶	pytm
禵	pyjm
禴	pywa
禲	pydy
禯	pyme
禭	pyup
禬	pywj
禫	pysj
禩	pylw
禨	pyxt
禦	trhi
禥	pyaf
禤	pyln
禣	pygf
禢	pyjn
禡	pycy
禠	pyrm
禟	pyyk
禞	pyyk
禝	pylt
禜	oopi
禛	pyfw
禙	pyue
禘	pyuh
禗	pyln
禖	pyas
禔	pyjh
禓	pyjr
禒	pyxe
禑	pyjy
禐	pyec
禌	pyux
禋	pysf
禉	pyug
禈	pypl
禆	pyrf
禃	pyfh
禂	pymk
祾	pyft
祽	pyyf
祻	pyld
祶	pyut
祵	pyls
祴	pyaa
祳	pyde
祲	pyvc
祱	pyuq
祰	pytk
祮	pyfk
祬	pygf
祫	pywk
祪	pyqb
祩	pyri
祦	pykd
祤	pyng
祣	pyte
祡	hxfi
祙	pyfi
祘	fifi
祔	pywf
祒	pyvk
祑	pyrw
祏	pydg
祍	pytf
祌	pykh
祋	pymc
祊	pyyn
祇	pyqa
祅	pytd
祄	pywj
祂	pybn
礿	pyqy
礹	dkkt
礸	dtfm
礷	daal
礶	daky
礵	dfsh
礳	dysd
礲	dued
礰	ddth
礯	dooi
礮	dcuq
礭	dfwy
礩	drrm
礨	llld
礧	dlll
礥	dahm
礣	dalt
礢	dude
礡	dagf
礠	duxn
礟	dcqq
礝	dfdj
礜	wfgd
礜	vgnd
礛	dahl
礚	dafl
礘	djxo
礗	dpgm
礖	dwfw
礖	dvgw
礕	nkud
礔	dnku
礒	dugt
礑	dipl
礐	wfqd
礐	vqqd
礏	dogw
礍	dajn
礋	dlff
礊	lbmd
礉	dryt
礈	duep
礇	dtmd
礄	dtdk
礃	dipr
礂	dfkk
礀	dueg
磼	dwys
磹	dsjh
磸	dusd
磶	dvqo
磵	dujg
磳	dulj
磱	dool
磰	dudk
磮	dmwa
磭	ddfe
磫	dtwh
磪	dmwy
磩	ddht
磦	dsfi
磥	dlxi
磤	drvc
磢	ddqq
磡	dadl
磠	dhlo
磟	dnwe
磞	dmee
磝	dgqt
磜	dwfi
磛	lrdf
磘	derm
磗	dgef
磖	dnrg
磓	dwnp
磒	dkmy
磑	dmgu
磏	duvo
磎	dexd
磍	dpdk
磌	dfhw
磈	drqc
磇	dtlx
磆	dmeg
磄	dyvk
磃	drhm
磂	dqyl
磀	dubp
碿	dnie
碽	damy
碻	dymk
碷	drfh
碶	ddhd
碵	dhmy
碯	dvtq
碮	djgh
碬	dnhc
碫	dwdc
碪	dadn
碨	dlge
碦	dptk
碤	damd
碢	dmnk
碠	dyps
碞	kkkd
碝	ddmd
碙	dmum
碖	dwga
碕	ddsk
碔	dgah
碒	dqg
碐	dfwt
碏	dajg
碋	dmsk
碊	daat
碈	dqaj
碆	ihcd
碅	dlty
碄	dssy
碃	dgeg
碂	dpfi
碀	dqvh
硿	dpwa
硾	dtgf
硽	ddjn
硻	ahnd
硺	deyy
硹	dswc
硸	dmdf
硶	dmwn
硴	dawx
硳	dfoy
硲	dwwk
硱	dlsy
硩	rrdf
硧	dceh
硦	dgah
硥	ddne
硣	dftb
硢	dwty
硡	dpdc
硠	dyve
硟	dthp
硞	dtfk
硜	dgva
硛	dyoy
硘	dlkg
硔	dawy
硓	dftx
硑	duah
硏	dftf
硍	dvey
硋	dynw
硊	dqdb
硉	dvfh
硈	dfkg
硆	dwgk
硄	diqn
硃	driy
硂	dwgg
砿	dycy
砽	deh
砶	drg
砵	dsgg
砳	ddg
砲	dqnn
砱	dwyc
砯	dyiy
砮	vcdf
砫	dygg
砪	dxgu
砨	dynn
砤	dtbn
砢	dskg
砡	dgyy
砠	degg
砞	dgsy
砛	dwyn
砙	dgnn
砕	dvfh
砓	dmcy
砐	deyy
砏	dwvn
砎	dwjh
砋	dhg
砊	dymn
砈	ddbn
砇	dyy
砆	dfwy
砅	diy
砄	dnwy
砃	dmyg
矼	dag
矻	dtnn
矺	dtan
矹	dgqn
矷	dbg
矵	djh
矴	dsh
矲	tdlx
矱	tdac
矰	tduj
矪	tdte
矨	tdtd
矦	qdtd
矤	xtdy
矡	cbtc
矠	cbtj
矟	cbte
矝	cbtc
矙	hunt
矖	hgmx
矕	xyxh
矔	haky
矒	halh
矑	hhal
矐	hfwy
矏	hthy
矎	hqmt
矌	hyaw
矋	hday
矊	hxrh
矉	hpgm
矈	hrpy
矆	hawc
矅	hnwy
矄	htgo
矃	hpns
矂	hkks
矁	hton
矀	htmt
瞾	hhpa
瞺	hwgj
瞹	hept
瞸	haas
瞷	hujg
瞶	hkhm
瞴	hrlo
瞲	hcbk
瞱	hagf
瞯	hueg
瞮	hyct
瞭	hdui
瞫	hsjh
瞨	hogy
瞦	hfkk
瞤	hugg
瞣	hkkn
瞡	hfwq
瞝	hybc
瞜	hlvg
瞜	hkgv
瞛	htwh
瞚	hpgw
瞙	hajd
瞗	htvo
瞖	atdh
瞕	hujh
瞔	hgmy
瞓	hykh
瞐	hhhf
瞏	lfke
瞋	hfhw
瞊	hyvk
瞉	fpgc
瞈	hwcn
瞇	hopy
瞃	hrfh
瞂	rfhc
瞁	hhdy
睼	hjgh
睻	hpgg
睺	hwnd
睸	hnhg
睷	hvfp
睶	hdwj
睵	hfak
睴	hplh
睳	hdff
睲	hjtg
睱	hnhc
睰	hadk
睯	nath
睮	hwgj
睭	hmfk
睪	lfuf
睩	hviy
睧	hqaj
睤	hlgj
睠	hudb
睟	hywf
睝	tqth
睙	hynd
睘	lgke
睗	hjqr
睖	hfwt
睕	hpqb
睔	hwga
睓	hmaw
睎	hqdh
睍	hhqn
睋	htrt
睊	hkeg
睉	hwwf
睈	hkgg
睆	hpfq
睅	hjfh
睄	hieg
睂	wwhh
眿	hyni
眽	hrey
眻	hudh
眹	hudy
眴	hqjg
眳	hqkg
眲	hbg
眱	hgxw
眰	hgcf
眮	hmgk
眫	hufh
眪	hgmw
眧	hvkg
眤	hnxn
眣	hrwy
眡	hqay
眞	xhnw
眝	hpsh
眜	hgsy
眛	hfiy
眘	duhf
眗	hqkg
眖	hkqn
眕	hwet
眔	liu
眓	hant
眒	hjhh
眑	hxln
眐	hghg
眏	hmdy
眎	hfiy
県	hniu
眊	htfn
眆	hyn
眅	hrcy
眃	hfcy
眂	hqan
眀	heg
盿	hyy
盽	hdhh
盻	hwgn
盺	hrh
盷	hqug
盶	hfqn
盵	htnn
盳	hynn
盰	hfh
盭	xful
盬	ahnl
盫	wgkl
盪	ijgl
盩	fufl
盨	edml
盦	wynl
盢	ldlf
盠	xelf
盝	vilf
盚	fiyl
盙	gehl
盕	imyl
盓	igfl
盌	qblf
盋	dclf
盉	tlf
盇	dylf
盄	xhlf
盁	elf
盀	hlf
皾	flmc
皽	ylkc
皼	fpgc
皻	haec
皹	hcpl
皷	fkuc
皶	sjgc
皵	ajhc
皳	fiyc
皯	hcfh
皭	relf
皬	rfwy
皫	ryno
皪	rxrs
皩	rgjq
皨	rrrf
皧	rept
皥	rthf
皣	ragf
皢	rffq
皡	rrif
皟	rgmy
皛	rrrf
皘	rgeg
皗	rmfk
皕	djdj
皔	rjfh
皒	rtrt
皐	rifj
皏	ruah
皍	rxbj
皌	rgsy
皊	rwyc
皉	rhxn
皅	rcn
皃	rqb
皀	rxb
癿	rnn
発	wfqb
癹	wmcu
癷	wfj
癶	wnyt
癵	uxyw
癴	uxyr
癳	ulli
癪	utgm
癨	ufwy
癦	ulff
癥	utmt
癠	uyvf
癠	uyjd
癝	uyli
癛	uylt
癚	uqdy
癙	uvnn
癗	ufld
癕	uyxy
癓	utmt
癒	uwgn
癑	umae
癐	uwgj
癏	ulge
癎	uujd
癋	ughn
癋	ugfn
癊	ubwc
癈	uwxc
癅	ugal
癄	uwyo
癁	uttt
瘽	uakg
瘺	unfi
瘹	uqqy
瘷	ugkt
瘶	ugkw
瘲	utwh
瘱	udwn
瘯	uytd
瘮	ucce
瘬	uxde
瘨	ufhw
瘣	urqc
瘝	ulii
瘜	uthn
瘚	uubw
瘔	uadd
瘒	uplk
瘑	umnk
瘎	uadn
瘉	uwgj
瘈	udhd
瘇	utgf
瘄	uajd
痽	uwyd
痻	uqaj
痸	urmj
痷	udjn
痶	umaw
痵	utbd
痳	ussi
痲	usfq
痯	upnn
痮	udei
痭	ueed
痬	ujqr
痩	ujhc
痥	uukq
痡	ugey
痠	ucwt
痟	uied
痝	udne
痜	utmv
痚	uftb
痗	utxu
痓	ugcf
痑	uqqi
痐	ulkd
痏	uded
痎	uynw
痌	umgk
痋	uji
痆	unxv
痁	uhkd
痀	uqkd
疿	uxjk
疻	ukwi
疺	utpi
疷	uqay
疶	uanv
疪	uxxv
疩	uvfk
疨	uaht
疧	uqav
疦	unwi
疢	uoi
疞	ufnv
疜	ughi
疛	ufi
疘	uad
疕	uxv
疓	uev
疐	fplh
疎	nhgi
疍	nhjg
疌	gvhi
疉	lllg
疈	gkll
疅	lglg
疂	lipg
疁	lnwe
疀	vlgh
畾	lllf
畽	ltgf
畼	ljgr
畻	ludf
畺	glgg
畷	lccc
畵	vflb
畳	lpeg
畱	gajl
畯	lcwt
畮	ltxu
畭	lwty
畩	lyey
畨	olf
畧	ltkf
畣	wgkl
畡	lynw
畟	lwtu
畞	flqy
畘	lmfg
畗	ylf
畖	lrcy
畕	llf
畓	ilf
畒	ylwy
畑	olg
畐	gklf
畍	lwjh
畊	lfjh
畉	lfwy
畇	lqug
畆	ylcy
畄	ilf
畃	jhqy
畂	lqyy
畁	mgjj
甿	lynn
甽	lkh
甼	lsj
甹	mgnb
甶	tld
甴	jhk
甮	qrej
甪	tek
甧	tgte
甤	etgd
産	uttg
甠	jtgg
甞	ipkf
甝	hamf
甛	aftd
甗	hagn
甖	mmgn
甔	qdwn
甒	rlgn
甐	oqan
甎	gjhn
甋	umdn
甊	lvgn
甊	kgkn
甉	uvon
甈	thsn
甇	oopn
甆	uxxn
甅	gnyf
甃	togn
甂	ynmn
甁	tftn
甀	tgan
瓾	tvgn
瓽	ipkn
瓼	gnyf
瓻	qdmn
瓺	dgnn
瓹	kegn
瓸	gnyj
瓵	ckgn
瓳	dgnn
瓲	gnyn
瓱	gnyn
瓰	gnyv
瓭	pqgn
瓬	ygnn
瓫	wvgn
瓪	gnyc
瓩	gnyf
瓨	agnn
瓧	gnyf
瓥	rcyj
瓡	fufy
瓟	rcyn
瓝	rcyy
瓙	gfno
瓗	gmwk
瓖	gyke
瓕	xgwy
瓓	gugi
瓑	gdth
瓐	ghal
瓎	ggkm
瓍	gbdp
瓌	gyle
瓋	gump
瓉	gfwm
瓈	gtqi
瓇	gdet
瓆	grrm
瓅	gxrs
瓄	gflm
瓃	glll
瓂	gafl
瓁	gawc
瓀	gfdj
璿	ghph
璾	gyvf
璾	gyjg
璼	gahl
璻	gnyf
璹	gfnf
璸	gpgm
璷	gget
璶	gvhl
璵	gwfw
璵	gvgw
璴	gssh
璳	grim
璲	guep
璱	gggt
璯	gwgj
璮	gylg
璭	gplp
璬	gryt
璥	gaqt
璤	ggjn
璢	ggal
璡	gwyp
璟	gjyi
璝	gkhm
璛	gvhh
璛	gvfj
璚	gcbk
璙	gdui
璘	goqh
璗	ijgy
璖	gias
璕	gvaf
璔	gulj
璓	gate
璒	gwgu
璑	grlo
璏	gxgx
璍	gagf
璌	gpgw
璊	gamy
璈	ggqt
璆	gnwe
璅	gvjs
璄	gujq
璂	gadf
瑿	atdy
瑽	gtwh
瑼	ggjf
瑻	gxfm
瑺	giph
瑹	gawt
瑵	gcyj
瑴	fpgc
瑳	guda
瑲	gwyk
瑮	gssy
瑬	iycy
瑫	gevg
瑨	ggoj
瑧	gdwt
瑦	gwno
瑥	gjlg
瑡	gwnh
瑠	gqyl
瑝	grgg
瑘	gbbh
瑖	gwdc
瑔	griy
瑓	ggli
瑑	gxey
瑐	guej
瑏	gpwt
瑎	gxxr
瑍	gqmd
瑌	gdmd
瑊	gdgt
瑉	gnaj
瑈	gcbs
瑇	ggxu
瑆	gjtg
瑅	gjgh
瑄	gpgg
瑃	gdwj
瑂	gnhg
瑀	gtky
琾	glwj
琽	gftj
琻	gqg
琸	ghjh
琷	gudn
琲	gdjd
琱	gmfk
琯	gpnn
琫	gdwh
琩	gjjg
琧	ghgy
琧	gfgy
琤	gqvh
琣	gukg
琡	ghic
琠	gmaw
琟	gwyg
琞	jegy
琝	gjyy
琜	gsww
琙	gakg
琘	gqaj
琗	gywf
琖	gaat
琕	grtf
琔	gpgh
琓	gpfq
琒	gtdh
琑	gieg
琌	gmwn
琋	gqdh
琈	gebg
琄	gkeg
琂	gyg
琁	gtnh
琀	gwyk
珿	gkhy
珽	gtfp
珼	gmy
珻	gtxu
珸	ggkg
珷	ggah
珶	guxt
珵	gkgg
珴	gtrt
珳	gyet
珱	givg
珯	gftx
珬	gdgt
珫	gycq
珨	gwgk
珦	gtmk
珤	grmh
珢	gvey
珡	ggwu
珟	gmgq
珝	gng
珜	gudh
珛	gdeg
珚	gldy
珘	gtey
珗	gtfq
珖	giqn
珕	glll
珔	gdhb
珓	guqy
珒	gvfh
珎	gqiy
珌	gntt
珇	gegg
珆	gckg
珅	gjhh
珄	gtgg
珃	gmfg
珁	ggnn
玿	gvkg
玾	glh
玽	gqkg
玼	ghxn
玹	gyxy
玸	gqnn
玶	gguh
玵	gafg
玴	gann
玭	gxxn
玬	gmyg
玪	gwyn
玨	ggg
玧	gcqn
玦	gnwy
玤	gdhh
玣	gyhy
玡	gaht
玞	gfwy
玝	gtfh
玜	gwcy
玘	gnn
玗	ggfh
玕	gfh
玔	gkh
玓	gqyy
玒	gag
玐	gwy
玏	gln
玍	tff
玌	gnn
玊	gyi
玈	yxte
玆	yxyx
玅	yxit
玃	qthc
玂	qtar
玁	qtkt
獿	qtdt
獽	qtye
獹	qthl
獶	qtdt
獴	qtae
獳	qtfj
獮	qtgq
獩	qtht
獧	qtle
獦	qtan
獥	qtrt
獤	qtyt
獣	ilgd
獢	qttk
獡	qtvo
獟	qtfq
獞	qtuf
獝	qtck
獜	qtoh
獛	qtoy
獙	qtut
獘	umid
獖	qtfm
獔	qtrf
獓	qtgt
獑	qtlr
獌	qtjc
獋	qttf
獊	qtwk
獉	qtdt
獈	qtul
獇	qtuc
獆	qtrf
獃	mgkd
獂	qtdi
獀	qtvc
猽	qtpu
猼	qtgf
猺	qtem
猵	qtya
猳	qtnc
猲	qtjn
猰	qtdd
猯	qtmj
猭	qtxe
猨	qtec
猧	qtmk
猦	qtmj
猤	qtwd
猣	qtqt
猠	qtmw
猟	qtih
猚	qtwy
猘	qtrj
猔	qtpi
猒	jedy
猑	qtjx
猐	qtun
猏	qtye
猍	qtsw
猌	swwd
猋	dddu
猉	qtaw
猈	qtrf
猇	qthm
猆	djdd
猅	qtdd
猄	qtyi
猂	qtjf
猀	qtit
狿	qttp
狾	qtrr
狶	qtqh
狵	qtde
狫	qtfx
狪	qtmk
狧	qttd
狦	qtmj
狥	qtqj
狤	qtfk
狣	qtiq
狢	qttk
狟	qtgg
狜	qtdg
狛	qtrg
狚	qtjg
狘	qtat
狕	qtxl
狔	qtnx
狑	qtwc
狏	qttb
狌	qttg
狋	qtfi
狊	hdu
狉	qtgg
狇	qtsy
狆	qtkh
狅	qttf
犿	qtyh
犾	qtdy
犽	qtat
犼	qtbn
犻	qtgh
犺	qtym
犵	qttn
犳	qtqy
犲	qtft
犱	qtvy
犮	dcu
犫	wyyh
犪	trut
犩	tvrh
犨	wywh
犦	trji
犥	tryo
犤	trlx
犣	trvn
犡	trdy
犠	trut
犞	trtk
犝	truf
犜	tryt
犚	nfih
犙	trce
犘	yssh
犗	trpk
犕	trae
犔	trro
犓	trqt
犑	trhd
犐	trtf
犌	trnc
犉	tryb
犈	trub
犇	rhth
犆	trfh
犅	trmm
犃	truk
犂	tqth
牼	trga
牻	trde
牸	trpb
牷	trwg
牶	udrh
牳	trxu
牱	trsk
牰	trmg
牭	trlg
牬	trtt
牫	trat
牪	trrh
牨	trym
牥	tryn
牣	trvy
牞	trln
牜	trd
牚	ipkt
牗	thgh
牕	thgn
牔	thgf
牓	thgy
牑	thga
牐	thgv
牏	thgj
牎	thgn
牋	thga
牊	thgk
牉	thgf
牅	nhdh
牄	nhdk
牃	nhds
牁	nhdk
爼	qqeg
爴	laky
爳	etnb
爯	emff
爮	rhyn
爫	etyt
爩	osre
爧	ofkw
爦	oahq
爥	onij
爤	oaui
爣	oipo
爢	ysso
爡	oajj
爠	ohhy
爟	oaky
爞	ojjj
爜	oogc
爚	owga
爙	oyke
爘	ohqe
爗	ojaf
爖	oued
爕	oyoo
爔	ougt
爓	ouqv
爒	qodi
爑	oawo
爏	odth
爌	oyaw
爋	otgo
爊	oyno
爉	ovln
爈	ohan
爇	afwo
爅	olff
爄	oday
爃	ooos
爂	wfmo
爂	vmgo
爁	oahl
爀	ofoo
燿	onwy
燽	ofnf
燻	otgo
燺	oyms
燸	ofdj
燷	oyli
燵	ofup
燳	ojvo
燲	ollm
燱	oujn
燰	oept
燯	ofwc
燬	ovac
燫	oyuo
燪	oaqn
燩	oryt
燨	ougt
燤	oajy
燣	oylt
燢	wfqo
燢	vqqo
燡	olff
燞	wyqo
燝	ojyi
燛	nhao
燚	oooo
燘	ouyy
燗	oueg
燖	ovaf
燓	sqqo
燑	oujf
燐	ooqh
燏	ocbk
燍	oadr
燌	ofam
燋	owyo
燇	ousf
燆	otdk
燅	fwfo
燄	qvoo
燂	osjh
燀	okkf
熿	oamw
熽	ovhh
熽	ovfj
熼	olaw
熻	owgn
熺	ofkk
熸	oaqj
熷	oulj
熶	ojbc
熴	omjx
熰	oakk
熯	oakw
熮	onwe
熭	dhdo
熫	oyao
熪	otqq
熩	oync
熧	twwo
熦	oiwy
熥	ocep
熤	onug
熣	omwy
熢	otdp
熡	olvg
熡	okgv
熞	oahf
熝	oynx
熜	otln
熛	osfi
熚	ojaf
熖	oevg
熕	oamy
熓	owno
熑	ouvo
熐	opju
熎	oerm
熍	opkk
熌	ouwy
熋	cexo
熉	okmy
熈	taho
熇	oymk
熆	ofcl
煴	ojlg
熃	cbto
熂	orno
熁	olle
熀	ojiq
煿	ogef
煾	oldn
煼	oqbt
煻	oyvk
煹	ofjf
煷	oypm
煶	ojgh
煵	ofmf
煱	omnk
煰	okkk
煯	oxxr
煭	vgqo
煫	ouey
煪	ousg
煣	ocbs
煡	ovfp
煠	oans
煟	oleg
煝	onhg
煛	hhou
煚	jano
煘	odgt
煗	odmd
煖	oefc
煕	ahho
煔	oohk
煓	omdj
煑	ftjo
煐	oamd
煏	ogkl
煍	otoy
煋	ojtg
煈	omtj
煇	oplh
煆	onhc
煄	otgf
煃	odff
煂	oafh
煁	oadn
煀	onbm
焿	oyvw
焾	owyn
焽	jeou
焼	ofaq
焻	ojjg
焺	ojta
焹	omun
焸	jjou
焷	ortf
焵	omum
焴	oyce
焳	owyg
焲	oywy
焮	orqw
焭	oopm
焬	ojqr
焫	oamw
焪	opwx
焩	oeeg
焨	ojeg
焧	owcn
焥	opqb
焤	ywfo
焣	bcou
焢	opwa
焠	oywf
焟	oajg
焞	oybg
焝	oqaj
焜	ojxx
焛	uoi
焗	onnk
焔	oqhj
焒	okkg
焑	olsy
焏	bkco
焎	rrou
焍	ouxt
焌	ocwt
焋	nhdo
焈	ynno
焇	oieg
焆	okeg
焅	otfk
焄	vtko
焃	ofoy
焂	whto
焁	kqwo
焀	owwk
烾	ooff
烼	oey
烻	othp
烺	oyve
烸	otxu
烶	otfp
烵	oaqy
烳	ogey
烲	rrou
烱	omwk
烰	oebg
烮	gqjo
烪	oudy
烥	oahh
烣	odoy
烢	opta
烡	oawu
烠	odeg
烞	oshy
烝	bigo
烜	ogjg
烚	owgk
烗	oynw
烖	faoi
烕	dgot
烓	offg
烒	oaag
烑	oiqn
烐	otey
烎	gaou
烍	otfq
烌	owsy
烋	wsou
烉	qmwo
烇	owgg
烆	otfh
烅	otlg
烄	ouqy
炿	otmy
炾	okqn
炶	ohkg
炵	otuy
炴	omdy
炲	ockg
炰	qnou
炪	obmh
炩	owyc
炨	opxn
炧	otbn
炦	odcy
炥	oxjh
炣	oskg
炢	osyy
炡	oghg
炠	olh
炟	ojgg
炞	oyhy
炛	owxb
炚	joy
炗	aou
炓	oufh
炑	osy
炐	odhh
炏	ooy
炍	orcy
炌	owjh
炋	ogiy
炈	omcy
炇	oty
炄	onfg
炃	wvou
炂	owcy
灻	fou
灺	obn
灹	otan
灷	oaj
灴	oag
灳	qoi
灲	ojh
灮	oqb
灪	isre
灨	iujm
灧	idhc
灦	ijxm
灥	riri
灢	igke
灡	iaui
灠	iahq
灟	inij
灜	iyny
灛	iukf
灚	iwfq
灚	ivqq
灙	iipo
灗	ijyg
灖	iysd
灕	iyby
灔	imac
灓	xyxi
灒	itfm
灐	iooq
灎	imal
灍	iuuw
灋	iync
灊	iaqh
灉	ivky
灈	ihhy
灇	iogc
灆	iaal
灅	illf
灂	ielf
灁	iuri
灀	ifsh
瀿	itxi
瀽	ipfh
瀼	iyke
瀻	ifaw
瀺	iqky
瀸	iwwg
瀷	inlw
瀶	iahk
瀴	immv
瀳	iayo
瀱	ildj
瀯	iook
瀮	ifss
瀭	ilwj
瀬	igkm
瀫	ifpc
瀪	txgi
瀩	itmm
瀥	inyk
瀤	iyle
瀢	ikhp
瀡	ibdp
瀞	igeh
瀜	igkj
瀙	iusq
瀗	ipdn
瀖	ifwy
瀔	ifpc
瀓	itmt
瀒	iswk
瀐	ifag
瀎	ialt
瀍	iyjf
瀌	iyno
瀊	itel
瀈	inpl
瀇	iyaw
瀄	itvb
瀃	imjr
瀂	iqoj
瀁	iude
瀀	idet
濿	iday
濽	ifwm
濻	ibkm
濹	ijff
濸	iawk
濷	iiay
濶	iutd
濵	ipnm
濴	iooi
濳	itfj
濲	ifpc
濭	iafl
濬	ihph
濩	iawc
濨	iuxn
濧	iogf
濦	iean
濥	iqpw
濣	ifjf
濢	inyf
濝	iadi
濜	ivhl
濚	ioos
濙	iooo
濗	iajh
濖	ilfj
濔	igwq
濓	iuto
濐	ijfj
濏	iggt
濎	ihnn
濍	iaqn
濌	tgjj
濋	issh
濊	ihdt
濈	ikbt
濇	ifwk
濆	ifam
濄	imnp
澿	issi
澾	ifup
澽	ihae
澼	inku
澻	iuep
澸	idgn
澷	ijly
澵	iusr
澴	ilge
澲	iogw
澰	iwgw
澯	ihqo
澭	iyxy
澬	iuqm
澫	iajy
澪	ifwc
澨	itaw
澦	icbm
澢	iipl
澟	iylt
澞	ihad
澝	ipne
澚	itmn
澙	ivgo
澘	issj
澖	iusy
澕	iagf
澓	ittt
澒	iadm
澑	igal
澏	ikkm
澋	ijyi
澊	iusf
澅	ivfg
澃	edmi
澂	imgt
澁	ihhh
潽	iuoj
潻	itwi
潹	isss
潶	ilfo
潵	iaet
潳	infj
潱	ifpu
潬	ikkf
潫	iudi
潪	itdj
潩	ilaw
潀	ilwy
潀	ilww
潀	ilwu
潧	iulj
潥	isoy
潣	iuyy
潡	iybt
潠	innw
潟	ivqo
潝	iwgn
潚	ivhh
潚	ivfj
潗	iwys
潖	iggc
潕	irlo
潓	igjn
潒	iqje
潐	iwyo
潏	icbk
潎	iumt
潌	ipwf
潊	iwtc
潉	imjx
潈	itle
潅	irwy
潄	igkt
潃	itte
潂	imug
漽	inih
漼	imwy
漻	inwe
漺	idqq
漹	igho
漷	iybb
漴	impi
漰	imee
漮	iyvi
漨	itdp
漧	ifjn
漦	fiti
漥	ipwf
漡	itjr
漟	iipf
漞	iehq
漝	inrg
漜	issf
漛	iudi
漙	igjf
漘	idfe
漗	itln
漖	iftt
漒	ixkj
漑	irxq
漐	fufi
漎	itwh
漍	ilag
漌	iakg
漋	ibtg
漊	ilvg
漊	ikgv
漈	iwfi
漇	ithh
漅	ivjs
漄	imdf
漃	iphc
滽	iyvh
滼	issy
滺	iwhn
滶	igqt
滵	ipnm
滳	iumk
滱	ipfc
滰	iujq
滮	ihae
滭	ijaf
滫	iwhe
滧	iuqt
滣	idfk
滝	iujn
滛	ierm
滙	iawy
滖	iyke
滒	iskk
滐	iqas
滍	ibhj
滊	irno
滈	iymk
滆	igkh
滃	iwcn
滀	iyxl
溿	iluf
溾	irqc
溹	ifpi
溸	igxi
溵	irvc
溳	ikmy
溰	imgu
溭	ilwt
溬	iudc
溩	iwno
溨	ifas
溦	imgt
溤	icy
溣	iwwa
溡	ijff
溠	iuda
溞	icyj
溛	ipwy
溚	iawk
溙	idwi
溗	itux
溕	ipge
溔	iugo
溓	iuvo
溒	ifke
溑	iimy
溎	isff
溍	igoj
溌	iwfq
溋	iecl
溊	inhc
溄	imth
溂	igkj
満	iamm
湽	igvl
湼	ivag
湻	iyjg
湺	iwks
湹	idjf
湸	iypm
湷	idwj
湶	iriy
湵	iugy
湴	iuog
湳	ifmf
湱	idhd
湰	itgg
湭	iusg
湬	toiu
湪	ixey
湩	itgf
湨	ihdy
湦	ijtg
湥	ipwd
湤	iytb
湣	inaj
湢	igkl
湡	ijmy
湠	imdo
湝	ixxr
湚	itxn
湙	iyod
湗	ifff
湕	ivfp
湒	ikbg
湑	inhe
湐	isrg
湏	idmy
湌	iwye
湋	inhh
湉	intd
湈	iafs
湇	iueg
湅	igli
湂	ikkn
湁	irwk
湀	iwgd
渿	isfi
渽	ifak
渼	iugd
渻	iith
渹	iqyg
渷	iukq
渶	iamd
渵	ialg
渳	ixbg
渱	ijag
渰	iwga
渮	iask
渪	itky
渨	ilge
渧	iuph
渢	imtj
渟	iyps
渞	iuth
渜	idmd
渘	icbs
渕	iudj
渓	iefw
渒	irtf
渏	idsk
渋	ihiy
渉	ihit
済	iyjg
済	iyjf
渇	ijqx
渆	iuaj
渄	idjd
渃	iadk
渂	ijyy
渁	iiiy
渀	idfa
淿	irmh
淾	qiu
淽	iahg
淸	igmg
淴	iqrn
淲	iham
淰	iwyn
淯	iyce
淭	iyns
淩	ifwt
淧	ipnt
淣	ivqn
淢	iakg
淟	imaw
淜	ieeg
淛	irmj
淗	iqoy
淕	ifwf
淔	ifhg
淓	iayn
淒	igvv
淐	ijjg
淏	ijgd
淎	idwh
淍	imfk
淊	iqvg
淉	ijsy
淈	inbm
淃	iudb
淂	ijgf
淁	iuvg
涾	iijg
涽	iqaj
涻	iwfk
涺	indg
涹	itvg
涶	itgf
涴	ipqb
涳	ipwa
涱	idey
涰	iccc
涭	iepc
涬	ifuf
涥	iybh
涜	ifpq
涚	iukq
涙	iynd
涘	ictd
涖	iwug
涒	ivtk
涐	itrt
涏	itfp
涍	iftb
涋	ipdy
涊	ivyn
涆	ijfh
涄	imgn
涃	ilsy
涁	iset
涀	ihqn
浿	imy
浾	ifoy
浽	ievg
浻	imwk
浺	inkh
浶	iprh
浵	imye
浳	iaeg
浲	itdh
浱	idfe
浰	itjh
浭	igjq
浫	ipwf
浨	ipsy
浧	ikgg
浤	ipdc
浢	igku
浟	iwht
浝	idne
浛	iwyk
浘	intn
浗	ifiy
浖	iefy
浌	iwat
浄	iqvh
浂	iudy
浀	imag
洿	idfn
洺	iqkg
洷	igcf
洴	iuah
洰	iang
洯	dhvi
洭	iagg
洬	imgq
洦	idjg
洤	iwgg
洣	ioy
洢	iwvt
洡	idiy
洠	icrh
洟	igxw
洝	ipvg
洜	tkiu
洘	iftn
洖	ikgd
洕	iweg
洔	iffy
洓	igmi
洑	iwdy
洐	itfh
洏	idmj
洍	iahh
洊	idhb
洉	irgk
洈	iqdb
洆	ibig
洅	igmf
洃	idoy
洂	iyoy
洀	itey
泿	ivey
泹	ijgg
泴	ilf
泲	itnt
泭	iwfy
泬	ipwy
泩	itgg
泧	iant
泦	invn
泤	inyw
泟	ighg
泝	iryy
泜	iqay
泙	iguh
泘	ituh
泒	ircy
泑	ixln
泏	ibmh
泎	ithf
泍	isgg
泋	ifah
泈	ituy
泇	ilkg
泆	irwy
泃	iqkg
泂	imkg
泀	ingk
沺	ilg
沷	idcy
沶	ifiy
沵	iqiy
沴	iwet
沰	idg
沯	idf
沬	ifiy
沢	inyy
沠	irhy
沞	igmh
沝	iiy
沜	ithn
沚	ihg
沘	ixxn
沗	gdiu
沖	ikhh
沕	iqrt
沑	infg
沎	iwxn
沍	igxg
沋	idnn
沊	pqii
沇	icqn
沄	ifcy
沀	icbh
汿	icbh
汼	irhh
汻	itfh
汸	iyn
汷	ity
汵	iwyn
汳	ircy
汱	idy
汯	idcy
汮	iqug
汭	imwy
汬	fjiu
汫	ifjh
汧	igah
汦	iqan
汥	ifcy
汣	iqyy
汢	ifg
汚	ifnn
汙	igfh
汘	itfh
汖	miu
汓	ibg
汒	iynn
汑	itan
汏	idy
汎	imyy
汍	ivyy
汌	ikh
汋	iqyy
汈	ingg
汅	ignn
汄	iwy
氿	ivn
氼	iwu
氻	iln
氺	ihyy
氷	yii
氶	bii
氱	rnjr
氭	rngi
氥	rnsf
氠	rnjh
氞	rngw
氝	rnmw
氜	rnjf
気	rnqu
氒	qafj
氎	llln
氋	apgn
氋	apfn
氊	tfng
氄	cbtn
氃	ujfn
氂	fitn
氁	tfnd
氀	lvtn
氀	kgkn
毾	jntn
毼	jqwn
毻	daen
毺	tfnj
毸	tfnn
毷	jhtn
毴	tfnd
毲	cccn
毱	tfno
毰	tfnk
毮	ritn
毭	gkun
毬	tfny
毩	tfno
毨	tfnq
毧	tfnd
毦	btfn
毥	tfnj
毤	wcqn
毣	ntfn
毢	tfns
毠	lktn
毟	ittn
毞	xxtn
毝	tfne
毜	tfni
毚	qkxy
毘	lxxb
毑	xgub
毎	txfj
毌	xfk
毊	fnmk
毉	atdw
毈	qytc
毇	vomc
毄	lkmc
毃	ymkc
殾	ftjc
殻	fpmc
殹	atdc
殸	fnmc
殶	ygmc
殱	gqfg
殰	gqfm
殬	gqlf
殩	gqho
殨	gqkm
殧	gqyn
殦	gqwo
殥	gqpw
殣	gqag
殢	gqah
殠	gqtd
殟	gqjl
殝	gqdt
殜	gqas
殙	gqqj
殗	gqdn
殕	gquk
殔	gqvi
殑	gqdq
殐	gqgi
殏	gqfy
殎	gqdw
殌	gqga
殈	gqtl
殅	gqtg
殀	gqtd
歾	gqqr
歽	gqrh
歺	hqu
歶	hxjy
歵	hgmy
歴	dssh
歳	hdgt
歱	htgf
歰	vyvh
歯	hobj
歮	hhhf
歭	hffy
歬	hteu
歫	hang
歩	hitr
歨	hhu
歠	cccw
歞	jxxw
歝	lfuw
歜	lqjw
歛	wgkw
歚	uduw
歘	ooow
歗	vhtw
歗	vfjw
歖	fkuw
歕	famw
歔	haow
歓	rwyw
歒	umdw
歑	hatw
歏	akgw
歍	wngw
歋	rhaw
歊	ymkw
歈	wgew
歅	sfqw
歄	mnmw
歂	mdmw
歁	adww
歀	sfiw
欿	qvqw
欼	cccw
欻	ooqw
欸	ctdw
欶	gkiw
欵	xtdw
欴	yvcw
欳	hmaw
欱	wgkw
欰	tlqw
欯	fkqw
欮	ubtw
欭	ldqw
欬	yntw
欫	rhqw
欪	bmqw
欩	vkqw
欨	qkqw
欦	wynw
欥	jqwy
欟	sakq
欞	sfkw
欝	sqqf
欜	sgke
欛	sfae
欚	sxej
欙	slli
欗	saui
欕	skkt
欔	shhc
欓	sipo
欑	stfm
欐	sgmx
欎	sqqf
欍	sawv
欌	sadt
欋	shhy
欉	sogc
欈	smwk
欇	sbbb
欆	swyc
欅	swfr
欅	svgr
欃	sqky
欂	saif
欁	smas
欀	syke
櫿	sook
櫾	seri
櫽	beas
櫼	swwg
櫹	savj
櫹	savh
櫷	stxg
櫷	stmg
櫶	spdn
櫵	sawo
櫴	sgkm
櫲	scbe
櫯	sqot
櫮	sgkk
櫭	svcg
櫩	suqv
櫦	synt
櫤	stuj
櫣	salp
櫢	slvt
櫢	skgt
櫡	stfj
櫠	sywc
櫜	gkhs
櫙	saak
櫘	sdhn
櫖	shan
櫕	sfwm
櫔	sday
櫒	sawi
櫐	llls
櫎	syaw
櫍	srrm
櫋	sthy
櫊	sutk
櫉	sdff
櫇	shcm
櫆	srqf
櫅	syvf
櫅	syjg
櫄	stgo
櫂	snwy
櫁	spnj
櫀	sadi
檺	sype
檹	sytk
檶	sdak
檴	sawc
檱	staw
檰	sxrh
枱	sckg
檭	sqve
檨	sugw
檧	saqn
檦	ssfj
檥	sugt
檤	sutp
檡	slff
檞	sqeh
檝	skbt
檛	smnp
檚	sssh
檙	shnn
檘	snku
檖	suep
檕	lbms
檓	svac
檒	ssmj
檏	sogw
檍	sujn
檌	sldd
檋	sawl
檊	sfjf
檈	slge
檇	swyn
檆	sook
檅	shdt
檃	beas
檂	smae
橿	sglg
橾	skks
橽	sfup
橻	snff
橺	sujg
橸	sjjj
橷	surq
橶	sfja
橵	saet
橴	shxi
橳	seul
橲	sfkk
橰	sthf
橯	sool
橮	sqym
橭	sduh
橬	saqj
橪	sqdo
橩	soof
橨	sfam
橧	sulj
橦	sujf
橤	nnns
橣	spne
橠	syqe
橞	sgjn
橝	ssjh
橜	dubs
橚	svhh
橚	svfj
橗	saje
橖	sips
橕	sipt
橔	sybt
橓	seph
橒	sffc
橑	sdui
橏	sudk
橎	stol
橍	sugg
橌	sueg
橊	sgal
橉	soqh
橆	rlgs
橅	srlo
橃	swxc
橂	susd
橁	stqj
橀	sycl
樿	skkf
樼	snbb
樻	skhm
樷	ssbc
樶	sjbc
樴	suaj
樳	svaf
樲	safm
樰	sfvg
樮	ssoy
樮	sgjo
樭	sadf
樬	stln
権	srwy
樧	sqsc
樦	styg
樥	sath
樤	swhs
樢	swvo
樠	samy
樝	shag
樜	syao
樛	snwe
樚	synx
樖	wgkk
樕	sgkw
樔	svjs
樒	spnm
樐	shlo
樏	slxi
樎	spwj
樍	sgmy
樌	sxfm
樋	scep
樉	sdqq
樈	sujq
樇	swhe
樆	sybc
樄	sbgi
樃	syve
樀	sumd
槾	sjlc
槼	fwhs
槻	sfwq
槺	syvi
槹	srif
槸	sfwy
槷	fwfs
槶	slag
槵	skkn
槴	sync
槱	ssgo
槰	stdp
槯	smwy
槮	scce
槬	sdfy
槫	sgjf
槪	srxq
槩	rxas
槦	syvh
槥	sdhv
槤	slpy
槣	spdk
槢	snrg
槡	sccs
槞	sujn
槝	swvm
槜	swye
槙	sfhw
様	sugi
槗	sdkk
槖	fpds
槕	shjs
槒	syxl
槑	ksks
槏	suvo
槉	sutd
槈	sdff
槇	sxhw
槆	saqj
槄	sevg
槂	sbti
槀	ymks
榾	smeg
榽	sexd
榼	sfcl
榺	euds
榹	srhm
榸	sfjf
榶	syvk
榵	sabg
榳	sytp
榅	sjlg
榰	sftj
榯	sjff
榬	sfke
榩	shay
榦	fjws
榥	sjiq
榤	sqas
榣	serm
榢	spey
榡	sgxi
榠	spju
榟	spuh
榞	sdri
榚	sugo
榙	sawk
榗	sgoj
榖	fptc
榓	sntl
榒	sxuu
榑	sgef
榐	snae
榏	suwl
榎	sdht
榌	snuj
榌	snuh
榋	svvv
榊	spyh
榃	sslf
榁	spgf
楿	stjg
楽	risu
楻	srgg
楺	scbs
楶	uqws
楴	suph
楳	safs
楲	sdgt
楰	svwy
楯	srfh
楬	sjqn
楪	sans
楩	swgq
楧	samd
楥	sefc
楤	sqrn
楢	susg
楡	swgb
楟	syps
楜	sdeg
楛	sadg
楘	cbts
楖	svcb
楕	sdae
楒	slny
楑	swgd
楐	slwj
楏	sdff
楎	splh
楍	skkk
楌	sute
楋	sgkj
楉	sadk
楈	snhe
楇	smnk
楆	ssvg
楅	sgkl
楄	syna
楃	sngf
楁	sptk
楀	stky
椾	suej
椼	stih
椻	sajv
椺	swks
椸	sytb
椷	sdgt
椶	sqbt
椵	snhc
椳	slge
椲	snhh
椱	stjt
椯	smdj
椬	speg
椪	suog
椩	syvw
椨	sywf
椧	swgb
椦	sudl
椥	stdk
椣	smaw
椡	sgcj
椞	srsu
検	swgw
椛	sawx
椚	sug
椙	sjjg
椘	sspu
椗	spgh
椖	syny
椕	swvs
椔	svlg
椓	seyy
椑	srtf
椌	spwa
椊	sywf
椉	yqas
椈	sqoy
椇	shwy
椆	smfk
椄	suvg
椃	sham
椂	sviy
椀	spqb
棿	svqn
棾	sspm
棽	sswn
棸	bcsu
棷	sbcy
棶	ssww
棴	sebc
棳	sccc
棯	swyn
棭	sywy
棬	sudb
棫	sakg
棪	sooy
棩	sthh
棩	sjgg
棨	ynts
棦	sqvh
棥	sqqs
棤	sajg
棢	smun
棡	smum
棞	slty
棝	sldg
棜	sywu
棛	syce
棙	synd
棔	sqaj
棓	sukg
棑	sdjd
棐	djds
棏	sjgf
棎	spws
棌	sesy
棊	adws
棈	sgeg
棇	swcn
棆	swga
棅	stgi
棃	tqts
棁	sukq
梽	sfny
梻	swxj
梺	ssgh
梹	srgw
梸	stjh
梷	hkcs
梴	sthp
梱	slsy
梮	snnk
梬	smgn
梫	svpc
梪	sgku
梩	sjfg
梥	pwcs
梤	smwv
梣	smwn
梡	spfq
梠	skkg
梞	snny
梜	sdww
梛	svfb
梚	sqkq
梙	skkh
梖	smy
梕	svyn
梒	swyk
梑	sqto
梐	sxxf
梎	srxn
梍	sran
梌	swty
梋	skeg
梊	rrsu
梉	snhf
梈	sybh
梇	sgah
梄	ssgg
梂	sfiy
梀	sgki
桿	sjfh
桾	svtk
桽	swwf
桼	swiu
桻	stdh
桺	sgan
桹	syve
桸	sqdh
桵	sevg
桳	scdf
桲	sfpb
桱	sgva
桰	sqak
桯	skgg
桮	sgik
桭	sdfe
桬	iits
桟	sdxy
桟	sdny
桞	sqbh
桝	sqah
桜	sivg
桛	shgh
桚	svqy
桙	scrh
桘	swnn
桗	sesy
桒	fasu
桏	sabh
桍	sdfn
桋	sgxw
桇	vksu
栿	swdy
栻	saag
栺	sxjg
栶	sldy
栵	sgqj
栴	stmy
栱	sawy
栰	swat
栯	sdeg
栮	sbg
栭	sdmj
栬	sqcn
栫	sdhb
栨	suqw
栧	sjxt
栦	syth
栥	uqws
栤	suiy
栣	swtf
栢	sdjg
栠	wtfs
栟	suah
栞	gdfs
栜	sgmi
栛	slll
栚	sudy
栙	stah
栕	sahh
栔	dhvs
栒	sqjg
栐	syni
栍	stgg
栆	gkwu
栆	gkhu
栄	ipsu
栃	srdn
栂	sxgu
栁	sqbh
柾	sghg
柼	spwy
査	segf
枴	skvn
柹	stnt
柸	sgig
柲	sntt
柮	sbmh
柭	sdcy
柫	sxjh
柪	sxln
柨	sdmh
柧	srcy
柦	sjgg
柤	segg
柣	srwy
柡	sfiy
柛	sjhh
柗	swkg
柖	svkg
柕	scbt
柎	swfy
柍	smdy
柌	sngk
柋	wasu
柊	stuy
柉	stpy
柈	sufh
柇	sty
柆	sug
柅	snxn
柂	stbn
柀	shcy
枿	sfah
枾	sfjg
枽	fasu
枼	ansu
枻	sann
枺	sgsy
枹	sqnn
枲	cksu
枮	shkg
枬	smyg
枩	swcu
枦	synt
枤	sdy
枡	stah
枠	svfh
枛	srhy
枙	sdbn
枖	stdy
枔	swyn
枓	sufh
枑	sgxg
枏	smfg
枎	sfwy
枍	swgn
枌	swvn
枊	sqbh
枈	xxsu
枆	stfn
枅	sgah
枃	squg
枂	seg
枀	wcsu
杽	srh
杺	sny
杹	swxn
杸	smcy
杶	sgbn
杮	sgmh
杬	sfqn
杫	shg
杧	synn
杦	sqyy
杤	sdnn
杣	smh
杢	saf
杝	sbn
杛	sxn
杚	stnn
杙	say
杘	nsi
杗	ynsu
杕	sdy
杔	stan
杒	svyy
杍	sbg
杋	smyy
杊	skh
杇	sfnn
杅	sgfh
杄	stfh
杁	styy
朿	gmii
朾	ssh
朼	sxn
朻	snhh
朹	svn
朸	sln
朷	svn
朶	esu
朳	swy
朲	swy
朰	snb
朮	fqyi
朩	sghy
朥	muol
朥	eool
朤	eeee
朣	eujf
朢	ahng
朡	eqbt
朠	eamd
朞	adwe
朜	eybg
朚	ynje
朙	lwme
朘	ecwt
朖	eyve
朓	eiqn
朒	emww
朑	muan
朑	eann
朏	ebmh
朎	ewyc
朌	ewvn
朇	wglf
朆	uljr
朅	fcjn
朄	jhgi
朂	jblb
朁	aqaj
曽	uljf
曻	jqah
曺	gmjf
曺	gjhj
曶	qrjf
曵	jxyi
曱	jhk
曯	jnij
曮	jkkt
曭	jipo
曫	xyxj
曪	jlxy
曨	jued
曥	jhal
曤	jfwy
曢	jpdi
曡	jjjg
曟	jjje
曞	jday
曚	jape
曘	jfdj
曗	jogw
曕	jqdy
曔	jaqt
曓	jbmf
曒	jryt
曑	jjje
曐	jjjg
曏	jxtb
曎	jlff
曍	jthf
曌	jepa
曋	jsjh
曊	jxjm
曆	dttj
曅	jagh
曅	jagf
曃	jvip
曂	jamw
曁	rxag
曀	jfpu
暿	jfkk
暽	joqh
暼	umij
暻	jjyi
暺	jkkf
暷	jgjf
暶	jyth
暵	jakw
暳	jdhv
暲	jujh
暰	jtwh
暯	jajd
暭	jrif
暬	fwfj
暩	jwfi
暦	dssj
暥	jjpv
暤	jrdf
暣	jrno
暡	jwcn
暠	jymk
暟	jmgu
暞	jths
暜	uujf
暛	juda
暚	jerm
暙	jdwj
暘	jjgr
暕	jgli
暔	jfmf
暓	cbtj
暒	jjtg
暏	jftj
暎	jamd
暍	jjqn
暋	natj
暊	jdmy
暆	jytb
暃	jdjd
暁	jfaq
暀	jtyg
晿	jjjg
晽	jssy
晼	jpqb
晻	jdjn
晹	jjqr
晸	jght
晵	yntj
晲	jvqn
晭	jmfk
晬	jywf
晪	jmaw
晩	jqjq
晧	jtfk
晥	jpfq
晣	jrrh
晠	jdnt
晜	juxt
晛	jhqn
晙	jcwt
晘	jjfh
晑	jtmk
晐	jynw
晎	jawy
晍	jmgk
晊	jgcf
晈	juqy
晇	jdfn
晆	jffg
晅	jgjg
晄	jiqn
晀	jiqn
昿	jycy
昻	jabj
昺	jgmw
昹	jyni
昸	jtuy
昷	jlf
昳	jrwy
昲	jxjh
昰	jghf
昮	jalb
昬	najf
昫	jqkg
昪	jcaj
昦	jdjj
昤	jwyc
昣	jwet
昢	jbmh
昡	jyxy
昞	jgmw
昜	jgqr
昛	jang
昚	dujf
昘	jyb
昗	juu
昖	jwcy
昒	jqrt
昑	jwyn
昐	jwvn
昍	jjg
昋	tdjf
昈	jynt
昇	jtaj
昅	jeyy
昄	jrcy
昁	jgmh
旿	jtfh
旾	gbnj
旽	jgbn
旼	jyy
旹	bhgj
旵	jmj
旴	jgfh
旳	jqyy
旲	jdu
旫	jvn
旪	jfh
旤	mnmq
旣	rxaq
旡	aqv
旟	ytww
旟	ytvw
旞	ytup
旝	ytwj
旜	ytyg
旚	ytsi
旙	ytol
旘	yuaj
旕	ywux
旔	yvfp
旓	ytie
旑	ydsk
旍	ytwc
旊	ytgn
旉	gehy
旈	yycq
旇	ythc
旂	ytrh
旀	yciy
斿	ytbg
斾	ytmh
斻	ytmn
斺	ywjh
斸	nilr
斶	rlqj
斵	qyvr
斴	oqar
斳	akgr
斱	ftjr
斮	ajrh
斪	qkrh
斨	nhdr
斦	rrh
斣	lqjf
斢	amwf
斠	fjgf
斞	vwuf
斚	ccpf
斘	qufh
斖	ywfg
斖	yvmg
斔	yjvw
斒	yyna
斏	yyve
斎	yjiu
斎	yjfi
斍	yhqb
斊	ybf
斉	yjff
斈	ybf
斆	wfqt
斆	vqqt
斅	wfqc
斅	vqqc
斄	fitw
斀	lqjc
敿	tdkt
敾	udut
敽	tdkc
敼	fkuc
敻	qmwt
敺	akkc
敹	hptt
敶	bgjt
敳	mgkt
敱	mgkc
敯	najc
敮	tfvc
敭	jgqt
敪	ccct
敨	ukty
敧	dskc
敥	oohc
敤	jshc
敡	jqrc
敠	cccc
敟	mawt
敜	wynt
敚	ukqt
敒	wjht
敐	dfet
敎	qdbt
敋	tkty
敊	hihc
敇	gmit
敆	wgkc
敄	cbtt
敃	naty
敂	qkty
敁	hkhc
敀	rty
攽	wvty
攼	fty
攺	nty
攷	gnty
攳	fcvf
攲	dskc
攱	ufcy
攰	fclv
攭	rxej
攩	ripo
攨	rpwy
攦	rgmx
攡	ryby
攠	rysd
攟	rynt
攞	rlxy
攚	rook
攗	ryno
攕	rwwg
攓	rpfh
攑	rwfh
攑	rvgh
攐	rpfe
攎	rhal
攍	ryny
攌	rlle
攋	rgkm
攊	rdth
攈	rynt
攇	rpdn
攅	rfwm
攃	rawi
攂	rlll
攁	rude
擿	rump
擽	rxrs
擹	rakw
擸	rvln
擶	rtuj
擵	rysr
擳	rtvb
擮	rfay
擭	rawc
擫	rdjd
擪	djer
擩	rfdj
擨	rrhw
擧	wfgr
擧	vgnr
擥	ahnr
擣	rfnf
擟	rgwq
擝	rjel
擛	raas
擙	rtmd
擖	rajn
擕	rwym
擓	raiy
擑	rkbt
擏	raqt
擌	rtdw
擉	rlqj
擈	rogw
擆	rafj
擃	rmae
撽	rryt
撹	ripq
撶	ragf
撴	rybt
撱	rbde
撯	rudh
撪	rcdl
撨	rwyo
撧	rxqc
撦	rdfj
撡	rccn
撠	rfja
撝	reto
撜	rwgu
撛	roqh
撘	rtwk
撗	ramw
撔	rjyi
撏	rvaf
撎	rfpu
撍	raqj
撌	rkhm
撋	rugg
撊	rueg
撉	ybtr
撆	umir
撃	lmcr
撁	ryxh
撀	fnmr
摿	rwuj
摾	rxkj
摼	rahf
摷	rvjs
摵	rdht
摴	rffn
摲	rlrh
摱	rjlc
摰	fwfr
摮	gqtr
摬	rujq
摫	rfwq
摪	rnhf
摨	rnih
摦	rdfy
摥	rtjr
摣	rhag
摢	rhah
摡	rvcq
摠	rtln
摝	rynx
摚	ripf
摙	rlpy
摗	rgkw
摖	rwfi
摕	raqh
摓	rtdp
摐	rtwh
摏	rdwv
摎	rnwe
摍	rpwj
摌	rutg
摋	rqsc
摉	rpwq
摃	ramy
摂	rbiy
搾	rpwf
搼	rudr
搻	wgkr
搹	rgkh
搸	rdwt
搷	rfhw
揾	rjlg
搳	rpdk
搲	rpwy
搱	rnuh
搰	rmeg
搯	revg
搫	temr
搩	rqas
搨	rjng
搤	ruwl
搣	rdgt
搢	rgoj
搟	rlfh
搝	rthd
搚	rlle
搙	rdff
搘	rftj
搕	rfcl
搒	rupy
搑	rabg
搎	rbti
搊	rqbt
搉	rpwy
搈	rpwk
搇	rwye
搆	rfjf
揯	rngg
搃	rukn
揼	rdiy
揻	rdgt
揺	refb
揹	ruxe
揷	rtgh
揷	rtfv
揵	rvfp
揳	rdhd
揱	iejr
揰	rtgf
揬	rpwd
揫	torj
揨	ryps
揧	gkir
揦	rgkj
揥	ruph
揤	rvcb
揢	rptk
揟	rnhe
揝	rthj
揜	rwga
揙	ryna
揘	rrgg
揗	rrfh
揕	radn
揔	rqrn
揓	rytb
揑	rvag
揌	rlny
揋	rlge
揊	rgkl
揈	rqyg
揇	rfmf
揅	dgar
揃	ruej
揂	rusg
揁	rhmy
掿	radk
掽	ruog
掻	rcjy
掹	rblg
掶	ryvw
掵	rwgb
掲	rjqx
掱	rrrj
掫	rbcy
掦	rjqr
掤	reeg
掟	rpgh
掞	rooy
掝	rakg
掜	rvqn
掚	rgmy
掗	rghg
掗	rgfg
掕	rfwt
掔	ahnr
掓	rhic
掑	radw
掍	rjxx
掋	ryqy
掆	rmum
掅	rgeg
掁	rdey
捿	rgvv
捾	rpnn
捼	rtvg
捹	rdfa
捸	rviy
捵	rmaw
捴	rwcn
捳	rrgm
捲	rudb
捰	rjsy
捯	rgcj
捬	rywf
捪	rqaj
捦	rqg
捥	rpqb
捤	rntn
捠	rrgw
捜	rjhc
捛	rkkg
捚	rjfg
捙	rlh
捘	rcwt
捗	rhit
捖	rpfq
捔	rqeh
捓	rahb
捒	rgki
捑	rjgy
捊	rebg
捈	rwty
捇	rfoy
捄	rfiy
捁	rtfk
挿	rtgh
挿	rtfj
挼	revg
挻	rthp
挷	rdtb
挶	rnnk
挵	rgah
挴	rtxu
挳	rgva
挱	riit
挰	rkgg
挮	ruxt
挭	rgjq
挬	rfpb
挧	rng
挙	iwrj
挘	ritl
挗	rgxw
挕	rbg
挔	ryey
挓	rpta
挒	rgqj
挐	vkrj
挍	ruqy
挋	rahh
挊	rhgh
挆	rmsy
挅	resy
挄	riqn
挃	rgcf
挀	rrey
拻	rdoy
拺	rgmi
拹	rlll
拸	rqqy
拵	rdhb
拲	awrj
拰	rwtf
拫	rvey
拪	rsg
拤	rhhy
拡	rycy
拠	rtmn
拞	rrgg
拝	rdfh
拕	rpxn
拑	rafg
拁	rlkg
拀	rkqn
抾	rfcy
抺	rfiy
抸	rtpy
抷	rgig
抶	rrwy
抴	rann
抳	rnxn
抲	rskg
抰	rmdy
抯	regg
抮	rwet
抭	rpmn
抪	rdmh
抩	rmfg
抧	rkwy
抦	rgmw
抣	rqug
択	rnyy
抝	rxnn
抜	rdcy
抙	rrh
抔	rgiy
抏	rfqn
抎	rfcy
抍	rtah
抌	rpqn
抋	rny
抈	reg
抇	rjg
抆	ryy
抅	rqcy
抃	ryhy
抂	rgg
抁	rcqn
扽	rgbn
扻	rqwy
扺	rqan
扸	rthn
扷	rtdy
扵	rwuy
扴	rwjh
扲	rwyn
扱	reyy
扨	rvyy
扥	rtan
扤	rgqn
扢	rtnn
扡	rbn
扠	rcyy
扟	rnfh
扞	rfh
扝	rfnn
扜	rgfh
扚	rqyy
扙	rdyy
扗	rfg
扖	rtyy
払	rcy
扐	rln
扏	rvn
扊	ynoo
扅	ynqq
扄	yntk
扂	ynhk
戼	angn
戻	yndi
戺	ynnn
戹	ynnv
戸	gnr
戵	hhwa
戱	hana
戭	pgma
戫	deag
戨	sksa
戦	ijfa
戣	wgda
戠	uajd
戞	depa
戝	mat
戜	akgd
戙	mgka
戓	akd
戉	anyt
戉	anty
戅	ujan
戄	nhhc
戃	nipo
戂	nysd
戁	akfn
懽	naky
懻	nuxw
懴	nfag
懳	ndhn
懱	nalt
懰	nqyj
懯	gehn
懭	nyaw
懬	yamn
懫	nrrm
懪	njai
懩	nude
懧	npns
懥	nfph
懤	nfnf
懢	nahl
懡	nysc
懠	nyvf
懠	nyjg
懞	nape
懝	nxth
懜	nalq
懛	nfkf
懚	nean
懙	nwfw
懙	nvgw
懘	iaqn
懗	nfoo
懖	qtdn
懕	djen
懓	nept
懐	nyle
懏	nwym
懎	nfwk
懆	nkks
懅	nhae
懄	nakl
懁	nlge
懀	nwgj
憿	nryt
憽	naqn
憼	aqkn
憻	nylg
憺	nqdy
憹	nmae
憸	nwgw
憵	nkun
憴	nxg
憴	nmgv
憳	nvaf
憱	nyin
憰	ncbk
憭	ndui
憪	nueg
憦	nool
憥	oopn
憣	ntol
憢	nffq
憡	ntgi
憠	dubn
憟	nsoy
憞	nybt
憜	nbde
憛	nsjh
憙	fkun
憘	nfkk
憗	swwn
憖	swwn
憕	nwgu
憓	ngjn
憏	nwfi
憍	ntdk
憌	qqun
憉	nfke
憈	nhag
憇	tdan
憆	nipf
憅	tgjn
憄	tfhn
憃	dwvn
憁	ntln
憀	nnwe
慿	ughn
慾	wwkn
慽	ndht
慼	dhin
慻	nudh
慺	nlvg
慺	nkgv
慹	fufn
慸	aqpn
慴	nnrg
慲	namy
慱	ngjf
慯	ntjr
慬	nakg
慩	nlpy
慦	fiyn
慥	ntfp
慤	fpmn
慡	ndqq
慠	ngqt
慞	nujh
慜	txgn
慛	nmwy
慙	lrnu
慗	gkin
慖	nlag
慓	nsfi
慒	ngmj
慐	amnu
慏	npju
慉	nyxl
慇	rvnn
慆	nevg
慅	ncyj
慃	nwcn
慂	icen
慀	nexd
愽	ngef
愼	nxhw
愻	btxn
愺	najh
愹	npwk
愸	swwn
愶	nlle
愵	nxuu
愳	hhnu
愲	nmeg
愱	nutd
愰	njiq
愯	nwyc
愮	nerm
愭	nftj
愪	nkmy
愩	namy
愥	namd
愢	nlny
愡	nqrn
愞	ndmd
愝	najv
愙	ptkn
愘	nptk
愗	cbtn
愖	nadn
愓	njgr
愒	njqn
愑	ncel
愐	ndmd
愌	nqmd
愋	nefc
愊	ngkl
愇	nnhh
愅	nafh
愄	nlge
愃	npgg
愂	fpbn
惿	njgh
惾	nqbt
惽	nnaj
惼	nyna
惸	nqjb
惷	dwjn
惪	fhnu
惥	vwnu
惤	nxyx
惣	trqn
惢	nnnu
惞	nrqw
惙	nccc
惗	nwyn
惖	jqrn
惔	nooy
惒	tknu
惐	nakg
惏	nssy
惎	adwn
惍	nqg
惌	pqbn
惉	ihkn
惈	njsy
惄	hicn
惃	njxx
惂	nqvg
惁	srnu
惀	nwga
悿	ngdn
悾	npwa
悺	npnn
悹	pnhn
悷	nynd
悳	fhnn
悞	nknd
悪	gkjn
悩	niqb
悧	ntjh
悥	ynu
悤	tlqn
悢	nyve
悡	tjnu
悜	nkgg
悙	nybh
悘	atdn
悗	nqkq
悓	nhqn
悑	ngey
悐	qton
悏	ndww
悎	ntfk
悋	nykg
悊	rrnu
悈	naah
悇	nwty
悆	wtnu
悂	nxxf
悁	nkeg
悀	nceh
恾	nayn
恷	wsnu
恵	gmnu
恴	yjnu
恲	nuah
恱	nwcq
恮	nwgg
恦	ntmk
恡	nqdc
恠	ndhf
恟	nqqb
恞	ngxw
恜	naag
恛	nlkg
恘	nwsy
恗	ndfn
恖	tlqn
恔	nuqy
恓	nsg
恑	nqdb
恏	vbnu
恎	ngcf
恌	niqn
恊	nlll
恉	nxjg
恈	ncrh
恇	nagg
恅	nftx
恄	nfkg
恀	nqqy
怾	nkwy
怺	nyni
怹	wbnu
怸	synu
怷	fqyn
怶	nhcy
怴	nant
怳	nkqn
怲	ngmw
怱	qryn
怰	nyxy
怮	nxln
怭	nntt
怬	nlg
怤	wfnu
怣	rwnu
怢	nrwy
怟	nqay
怞	nmg
怚	negg
怘	dnu
怗	nhkg
怓	nvcy
怑	nufh
怐	nqkg
怌	ngig
怋	nnan
怉	nqnn
怈	nann
怇	nang
忼	nymn
忺	nqwy
忹	ngg
忷	nqbh
忶	nfcy
忴	nwyn
忲	ndyy
忰	nvfh
忯	nqan
忬	ncbh
忩	wcnu
忨	nfqn
忦	nwjh
忥	rnnu
忣	neyy
忢	gnu
忟	nyy
忞	ynu
応	yni
忛	nmyy
忚	nbn
忕	ndy
忔	ntnn
忓	nfh
忎	tfnu
忋	nnn
忊	nsh
忈	fnu
忇	nln
忂	thhy
忁	tjbi
忀	tyke
徿	tued
徾	tmyt
徻	twgj
徺	tffq
徸	tujf
徶	tumt
徴	tmgt
徲	tnih
徱	tsfi
徰	tghh
徯	texd
徫	tnhh
徧	tyna
徥	tjgh
徤	tvfp
徣	tajg
徢	tgvh
徟	tmfk
徝	tfhg
徛	tdsk
徚	tgli
徖	tpfi
徔	tapy
従	tuhy
徏	thit
徎	tkgg
徍	tffg
徆	tsg
徃	ttgg
彾	twyc
彽	tqay
彺	tgg
彸	twcy
彶	teyy
彵	tbn
彴	tqyy
彲	gmye
彯	sfie
彮	pwwe
彫	mfke
彣	yee
彞	voxa
彜	xgoa
彛	vowa
彚	vpjs
彔	xgiu
彑	xgd
彏	xhhc
彍	xyaw
彋	xlge
彊	xglg
彉	xamw
彇	xvhh
彇	xvfj
彆	umix
彅	xuev
彄	xakk
彃	xjaf
彂	ogxd
彁	xskk
弾	xijf
弽	xans
弻	xglx
弸	xeeg
弶	xyiy
弴	xybg
弲	xkeg
弰	xieg
弮	udxb
弬	xahh
弫	xahh
弤	xqay
弣	xwfy
弢	xbhc
弡	xang
弞	xqwy
弚	uxhj
弙	xgfh
弖	xgf
弔	xhk
弐	gafd
弎	add
弍	afd
弌	agd
弉	nhda
弆	fcaj
廽	mjdp
廼	spd
廻	lkpd
廹	rpd
廸	mpd
廵	vpv
廲	ygmx
廯	yqod
廮	ymmv
廭	ytgm
廫	yene
廧	yfwk
廦	ynku
廤	ylkx
廞	yqqw
廜	ynfj
廙	ylaw
廘	yynx
廗	yaqh
廕	ybwc
廔	ylvd
廔	ykgv
廐	yrxq
廏	yrxc
廎	yxdm
廍	yukb
廌	ynjo
廋	yvhc
廇	yqyl
廆	yrqc
廅	yfcl
廃	ywfq
廀	ypoc
庿	yald
庽	yjmy
庻	yaww
庺	ywcs
庴	yajd
庲	ysww
庱	yfwt
庰	yuak
庯	ygey
庮	ysgd
庬	ydne
庪	yrfc
庩	ywti
庨	yftb
庤	yffi
庣	yiqv
庢	ygcf
庡	yyei
庝	ytui
庛	yhxv
庘	ylk
庒	yfyi
庎	ywjk
庍	yrk
庌	yaht
庉	ygbn
庈	ywyn
庅	ytci
広	yci
庂	ywi
庁	ysk
幵	ftfh
幱	mhui
幰	mhpn
幯	mhtb
幮	mhyf
幭	mhat
幩	mhfm
幨	mhqy
幧	mhks
幦	nkuh
幥	mhir
幤	imkh
幠	mhro
幝	mhkf
幜	mhji
幚	dtbh
幙	mhad
幖	mhsi
幓	mhce
幒	mhtn
幑	tmtt
幐	eudh
幏	mhpe
幎	mhpu
幍	mhev
幋	temh
幊	mham
幉	mhas
幈	mhna
幇	fffh
幆	mhjn
幁	mhdm
帿	mhwd
帾	mhfj
帺	mhaw
帹	mhuv
帵	mhpb
帴	mhaa
帲	mhtf
帰	ytvh
帯	gmph
帯	gkgh
帬	vtkh
帪	mhde
帩	mhie
帤	vkmh
帣	udmh
帢	mhwk
帡	mhua
帠	vmhj
帞	mhdj
帗	mhdc
帓	mhgs
帒	wamh
帎	mhpq
帍	ynmh
帋	qamh
帊	mhcn
帉	mhwv
帇	vmhk
帄	mhsh
帀	gmhk
巼	ckxb
巻	udnb
巺	nngw
巸	ahkn
巶	vknn
巵	rgcv
巭	alfw
巬	amfw
巪	annb
巤	vlqn
巣	ijsu
巠	gvaf
巟	ynqb
巜	bnn
巚	mhad
巙	muht
巘	mhad
巗	mkkt
巕	muwv
巓	mxhm
巑	mtfm
巐	myma
巏	maky
巎	mdht
巌	midt
巊	mmmv
巉	mqky
巈	mafo
巇	mhaa
巆	mook
巄	mued
巃	mued
巂	mwyk
巁	mday
巀	miwa
嶿	mfdj
嶾	mean
嶻	mfay
嶹	mfnf
嶶	mtmt
嶵	mldd
嶳	meff
嶲	mwym
嶱	majn
嶰	mqeh
嶯	mkbt
嶮	mwgw
嶭	mwnu
嶬	mugt
嶫	mogw
嶪	mogw
嶩	mmae
嶨	wfqm
嶨	vqqm
嶦	mqdy
嶥	mduw
嶤	mffq
嶣	mwyo
嶢	mffq
嶡	mduw
嶟	musf
嶞	bdam
嶜	maqj
嶛	mdui
嶚	mdui
嶘	msaa
嶖	mwgn
嶕	mwyo
嶔	mqqw
嶓	mtol
嶒	mulj
嶑	mqje
嶐	mbtg
嶏	mdsn
嶎	mnff
嶍	mnrg
嶌	mwvo
嶋	mwvo
嶊	mrwy
嶉	mkwy
嶈	mnhf
嶆	mgmj
嶅	gqtm
嶃	mlrh
嶀	mffn
嵿	msdm
嵾	mcce
嵽	maqh
嵼	mutg
嵻	myvi
嵺	mnwe
嵹	mxkj
嵸	mtwh
嵷	mtwh
嵶	mxuu
嵵	mjff
嵳	muda
嵲	mths
嵱	mpwk
嵰	muvo
嵮	mfhw
嵭	mupy
嵪	mymk
嵨	mwno
嵧	mqyl
嵦	mmgu
嵥	mqas
嵤	oopm
嵣	myvk
嵢	mwyk
嵡	mwcn
嵠	mexd
嵟	mdwy
嵞	wtmm
嵜	musk
嵜	mukh
嵙	mtuf
嵗	mdgt
嵖	msjg
嵕	mqbt
嵔	mlge
嵓	mkkk
嵒	kkkm
嵑	mjqn
嵏	mqbt
嵎	mjmy
嵍	cbtm
嵉	myps
嵈	mefc
嵆	tdnm
嵅	mdgt
嵄	mugd
嵃	mute
嵂	mtvh
嵁	madn
嵀	msyg
崿	mkkn
崼	mjgh
崺	mytb
崹	muph
崸	mdmy
崷	musg
崶	mfff
崵	mjgr
崳	mwgj
崲	mrgg
崱	mmjj
崰	mvlg
崯	mqg
崫	mnbm
崪	mywf
崨	mgvh
崥	mrtf
崣	mtvf
崡	mbib
崠	mgji
崝	mgeg
崜	mtgf
崘	mwga
崕	mdff
崒	mywf
崏	mqaj
崌	mndg
崋	mgaf
崊	mssy
崉	mijg
崈	pfim
崅	mqeh
崀	myve
峿	mgkg
峾	irmj
峼	mtfk
峺	mgjq
峹	wtmj
峸	mdnt
峷	muj
峵	mpdc
峳	mwht
峲	mtjj
峱	qtnm
峮	mvtk
峬	mgey
峫	mahb
峩	mtrt
峧	muqy
峢	mgqj
峠	mhgh
峟	mdef
峞	mqdb
峝	mmgk
峜	mwhf
峛	mgqj
峚	mdff
峘	mgjg
峗	mqdb
峖	mpvg
峕	myjf
峔	mftx
峓	mgxw
峑	mwgf
峐	mynw
峏	mdmj
峎	mveu
峍	mvfh
峌	mgcf
峊	wnnm
峉	mtkf
峈	mtkg
峇	mwgk
峆	mwgk
峅	mcah
峂	mtuy
峀	mmf
岾	mhkg
岼	mguh
岻	mqay
岺	mwyc
岹	mvkg
岶	mrg
岴	mrgg
岲	mkqn
岰	mxln
岯	mgig
岮	mpxn
岪	mxjj
岧	mvkf
岦	muf
岥	mhcy
岤	mpwy
岠	mang
岟	mmdy
岝	mthf
岕	mwjj
岓	mrh
岒	mwyn
岏	mfqn
岎	mwvn
岋	meyy
岊	cmj
岉	mqrt
岇	mqbj
岆	mtdy
岅	mrcy
岄	meg
岃	mvyu
岀	mmj
屾	mmh
屽	mfh
屼	mgqn
屻	mvyy
屸	mag
屷	men
屶	mvb
屵	mdr
屴	mlb
屳	tymj
屲	tmj
屰	ubtr
屭	nmmm
屫	nnhk
屪	npdi
屩	nttk
屧	ntas
屟	nans
屛	ntff
屚	nfi
屘	ntfb
屗	ntff
屖	nuk
屔	rgnx
屓	nmi
屒	ndfe
屇	nld
尶	gqal
尵	dnkm
尳	dnme
尲	dnuo
尰	dntf
尯	dnqb
尮	dnes
尭	faqb
尫	gqgd
尩	wqgd
尨	dnee
尦	wqqy
尣	wqb
尡	iqjx
尠	adwt
尟	jght
尞	duji
尛	iiiu
尙	imkf
尗	hiu
尓	tiu
尒	wiu
尐	iyu
尌	fkuf
尅	dqfi
尃	gehf
専	gmfu
尀	akfy
対	yfy
寽	efu
寷	pdhu
寴	pusq
寳	pgqm
寲	pxth
寱	pnhs
寯	pwym
寭	pgjn
寪	peto
寣	pnhy
寠	plvf
寠	pkgv
寜	pnlh
寛	pahq
寚	pgrm
寙	prcy
寘	pfhw
寗	pntf
寖	pivc
寕	pdls
寑	pwvc
寏	pqmd
寎	pnhw
寍	pnlf
寋	pfjb
寊	phmu
寉	pwyf
寈	pgef
寃	pqky
寁	pgvh
寀	pesu
宼	pfqv
宻	pcum
宺	pkgq
宷	ptou
宲	pksu
宱	pwtf
宯	pftb
宭	pvtk
宬	pdnt
宩	pou
宨	piqb
宧	pahh
実	pdwu
宖	pxcu
宔	pygf
宒	ptfn
宑	pfjj
宐	pqyg
宐	phng
宎	ptdu
宍	puu
宊	pdu
宆	pxb
孾	bmmv
孼	btwb
孻	bvhl
孹	nkub
孷	fitb
孶	yxyb
孴	bbbj
孲	bghg
孲	bgfg
孯	ahnb
孮	bpfi
孭	bmy
孨	bbbf
孧	xlbf
孡	bckg
孠	ngkb
孞	bnu
孖	bbg
孒	bgd
孏	vaui
孎	vnij
孍	vkkt
孋	vgmx
孊	vysd
孉	vaky
孈	vmwk
孇	vwyc
孆	vmmv
孅	vwwg
孄	vugi
孂	vtvl
孁	fkkv
嬿	vauo
嬾	vgkm
嬽	vlhd
嬼	vqyj
嬻	vflm
嬺	vaan
嬹	vwfw
嬹	vvmw
嬶	vthj
嬵	vxrh
嬳	vawc
嬱	ilrv
嬯	vfkf
嬮	djev
嬭	vgwq
嬬	vfdj
嬫	voos
嬩	vwfw
嬩	vvgw
嬨	vuxn
嬧	vvhl
嬦	vfnf
嬥	vnwy
嬣	vpns
嬢	vufe
嬠	vkks
嬟	vugt
嬞	vatf
嬝	vwve
嬜	ujqv
嬚	vyuo
嬘	vuep
嬕	vlff
嬔	vqkg
嬓	vryt
嬒	vwgj
嬑	vujn
嬐	vwgw
嬏	vtol
嬎	vqkg
嬍	vmgt
嬊	aukv
嬇	vkhm
嬆	vwgn
嬅	vagf
嬄	vfpu
嬃	edmv
嬂	vuaj
嬁	vwgu
嫿	vvfg
嫾	voqh
嫽	vdui
嫼	vlfo
嫹	vamw
嫸	vudk
嫷	vbde
嫶	vwyo
嫴	vduh
嫳	umiv
嫲	vyss
嫰	vgkw
嫯	gqtv
嫮	vffn
嫭	vhah
嫬	vyao
嫪	vnwe
嫨	vakw
嫧	vgmy
嫥	vgjf
嫤	vakg
嫢	fwhv
嫟	vaak
嫞	vyvh
嫝	vyvi
嫛	atdv
嫙	vyth
嫕	vatn
嫓	vqmx
嫑	gisv
嫐	vllv
嫏	vyvb
嫎	vupy
嫍	vevg
嫊	vgxi
嫈	oopv
嫇	vpju
嫆	vpwk
嫅	vuda
嫄	vdri
嫃	vfhw
嫀	vdwt
媻	temv
媺	vmgt
媹	vqyl
媷	vdff
媶	vabg
媴	vfke
媱	verm
媰	vqbt
媮	vwgj
媬	vwks
媫	vhvh
媩	vdeg
媨	vusg
媦	vleg
媥	vyna
媤	vlny
媣	vivs
媢	vjhg
媡	vgli
媠	vdae
媟	vans
媞	vjgh
媝	tovf
媜	vhmy
媙	vdgt
媘	vxxr
媗	vpgg
媖	vamd
媕	vwga
媔	vdmd
媓	vrgg
媑	vtgf
媐	ahkv
媏	vmdj
媎	vftj
媍	vqmy
媌	valg
媋	vdwj
媊	vuej
媉	vngf
媈	vplh
媇	vusy
媆	vdmd
媅	vadn
媄	vugd
媃	vcbs
媂	vuph
媁	vnhh
媀	vjmy
婾	vwgb
婽	vnhc
婼	vadk
婻	vfmf
婹	vsvg
婸	vjgr
婲	vawx
婱	xyxv
婰	vmaw
婯	gmyv
婮	vndg
婬	vetf
婫	vjxx
婩	vmdf
婨	vwga
婥	vhjh
婤	vmfk
婣	vthh
婣	vjgg
婡	vsww
婟	vldg
婝	vpgh
婙	vqvh
婘	vudb
婗	vvqn
婖	vgdn
婔	vdjd
婓	djdv
婒	vooy
婑	vtvg
婐	vjsy
婏	vqky
婎	vwyg
婍	vdsk
婌	vhic
婋	vham
婈	vfwt
婇	vesy
婅	vqoy
婃	vpfi
婂	vrmh
娿	bskv
娾	vdff
娽	vviy
娻	vgji
娹	vxyx
娸	vadw
娷	vtgf
娵	vbcy
娳	vtjh
娰	vwnw
娯	vknw
娮	vyg
娭	vctd
娬	vgah
娫	vthp
娪	vgkg
娨	vjfh
娧	vukq
娦	vrgw
娤	nhdv
娢	vwyk
娡	vfny
娞	vevg
娝	vgik
娚	vlln
娙	vgva
娗	vtfp
娖	vkhy
娕	vgki
娔	vdqn
娒	vtxu
娐	vebg
娏	vdne
娎	rrvf
娍	vdnt
娋	vieg
娊	vhqn
娂	vawy
娀	vadt
姾	vwgg
姽	vqdb
姼	vqqy
姺	vtfq
姸	vftf
姷	vdeg
姶	vwgk
姵	vmgh
姴	gqjv
姳	vqkg
姲	vpvg
姱	vdfn
姰	vqjg
姯	viqn
姭	lllv
姫	vahh
姪	vgcf
姩	vrhf
姧	vvfh
姦	vvvf
姤	vrgk
姢	vceg
姡	vtdg
姠	vtmk
姟	vynw
姞	vfkg
姛	vmgk
姙	vwtf
姖	vang
姕	hxvf
姏	vafg
姎	vmdy
姌	vmfg
姉	vgmh
姈	vwyc
姇	wfvf
姅	vufh
姄	vnan
姂	vtpy
妿	lkvf
妽	vjhh
妼	vntt
妸	vskg
妷	vrwy
妶	vyxy
妵	vygg
妴	qbvf
妱	vvkg
妰	vthf
妭	vdcy
妧	vfqn
妦	vdhh
妢	vwvn
妠	vmwy
妟	jvf
妜	vnwy
妛	bhgv
妚	vgiy
妘	vfcy
妕	vkhh
妔	vymn
妑	vcn
妐	vwcy
妏	vyy
妎	vwjh
妌	vfjh
妋	vfwy
妉	vpqn
妅	vag
妀	nvg
奿	vyvd
奾	vmh
奻	vvg
奺	vqyy
奷	vtfh
奵	vsh
奲	dftf
奱	xyxd
奰	llld
奯	dhdt
奭	ddjj
奬	nhdd
奫	dith
奫	dijg
奨	uefd
奦	cbtd
奤	ddmd
奣	gdje
奡	dhdj
奟	deef
奞	dwyf
奝	dmfk
奜	djdd
奛	djef
奙	cdjn
奓	dqqu
奒	dynw
奍	udjj
奌	hkdu
奊	ffgy
奆	danf
奅	dqtb
奃	dqay
奀	gidu
夿	dcb
夽	dfcu
夻	dkf
夶	ddy
夵	diu
夳	dff
夲	dfj
夰	djj
夬	nwi
夨	gnyi
夦	adwq
夣	yclq
夡	qqfk
夞	qhkx
夝	qtgg
夛	vqu
夘	qbh
夗	qbn
夓	vdht
夒	dhht
夑	oyot
夎	wwft
夌	fwtu
夋	cwtu
夊	qyi
変	yotu
夈	tou
夆	tdhj
夅	tahj
夃	eci
夁	flld
夀	fnkf
壿	fusf
壾	fkun
壷	fpkg
壵	ffff
壴	fkuf
売	fpqb
壱	fpxb
壭	fbj
壪	fxyx
壨	lllf
壧	fkkt
壦	faky
壥	fdlf
壣	fbxg
壡	hpgf
壝	fkhp
壜	fjfc
壛	fuqv
壗	fvhl
壖	ffdj
壔	ffnf
壒	fafl
壐	gwmf
壏	fahl
壍	ilrf
壌	fufe
壋	fipl
壊	ffle
壉	fhae
壈	fylt
壆	wfqf
壆	vqqf
壄	scbf
壃	fglg
壂	nawf
壀	fnku
墿	flff
墽	fryt
墻	ffwk
墺	ftmd
墹	fujg
墸	fafj
墷	fagf
墶	ffup
墵	fffc
墴	famw
墲	frlo
墱	fwgu
墰	fsjh
墯	ndaf
墭	fdnl
墫	fusf
墪	ybtf
墧	ftdk
墦	ftol
墥	fujf
墤	fkhm
墣	fogy
墢	fwxc
墡	fudk
墠	fkkf
墝	fffq
墛	fnff
墘	ffjn
増	fulj
墖	fwgl
墕	fgho
墔	fmwy
墑	fumd
墐	fakg
墏	nhdf
墎	fybb
墍	rxaf
墌	fyao
墋	fcce
墈	fadl
墇	fujh
墆	faqh
墄	fdht
墂	fsfi
塿	flvg
塿	fkgv
塽	fdqq
塼	fgjf
塻	fajd
塺	yssf
塸	fakk
塷	fhlo
塶	fynx
塴	fmee
塳	ftdp
塲	ftjr
塱	yvcf
塰	itxf
塯	fqyl
塮	ftmf
塭	fjlg
塪	fevg
塩	ftkl
塨	fawn
塧	fuwl
塦	blff
塤	fkmy
塣	ikgf
塡	fxhw
塠	fwnp
塟	agqf
塝	fupy
塜	fpge
塜	fpfe
塛	fssy
塙	fymk
塖	ftux
塕	fwcn
塓	fpju
塐	fgxi
塎	fpwk
塉	fiwe
塈	vcaf
塇	fpgg
塅	fwdc
塃	fayq
塂	fawn
塁	liff
塀	fnua
堿	fdgt
堾	fdwj
堽	flgh
堼	ffff
堻	ivff
堺	flwj
堹	ftgf
堸	fmtj
堷	fujg
堶	fdae
堳	fnhg
堲	vcbf
堮	fkkn
堭	frgg
堫	fqbt
堩	fngg
堨	fjqn
堧	fdmd
堦	fxxr
堥	cbtf
堣	fjmy
堢	fwks
堟	fxey
堜	fgli
堛	fgkl
堚	fplh
堘	fudf
堗	fpwd
堔	fpws
堓	fmdf
堒	fjxx
堐	fdff
堏	syff
堎	ffwt
堌	fldg
堈	fmum
堄	fvqn
堁	fjsy
埿	inxf
埾	bcff
埼	fdsk
埻	fybg
埵	ftgf
埳	fqvg
埲	fdwh
埱	fhic
埰	fesy
埮	fooy
埬	fgji
埫	fimk
埪	fpwa
埩	fqvh
埨	fwga
埧	fhwy
埦	fpqb
埥	fgeg
埣	fywf
埢	fudb
埞	fpgh
埜	ssff
埛	fmwk
埗	fhit
埖	fawx
埓	fefy
埑	rrff
埐	fvpc
埍	fkeg
埌	fyve
埊	miff
埉	fdww
埈	fcwt
埇	fceh
埆	fqeh
埅	byff
埄	ftdh
埁	fmwn
埀	tguf
埀	tfuf
垿	fycb
垾	fjfh
垽	irff
垼	tmcf
垻	fmy
垺	febg
垹	fdtb
垷	fhqn
垶	fuh
垳	ftfh
垰	fhgh
垬	fawy
垪	fuah
垨	fpfy
垥	fwgk
垟	fudh
垞	fpta
垝	fqdb
垜	fesy
垙	fiqn
垘	fwdy
垗	fiqn
垖	fwnn
垕	rgkf
垔	sff
垑	fqqy
垐	uqwf
垏	fvfh
垎	ftkg
垍	fthg
垊	fnan
垉	fqnn
垈	waff
垇	fmmg
垁	ftdy
垀	ftuh
坿	fwfy
坾	fpsh
坽	fwyc
坺	fdcy
坹	fpwy
坸	fqkg
坵	frgg
坴	fwff
坲	fxjh
坱	fmdy
坰	fmkg
坮	fckg
坬	frcy
坧	fdg
坥	fegg
坣	ipff
坢	fufh
坙	gvff
坘	fgxg
坖	fqff
坕	rhyf
坔	iff
坓	fjff
坒	xxff
坋	fwvn
坉	fgbn
坈	fpmn
坆	fty
坅	fwyn
坄	fmcy
坃	ffqn
坁	fqan
圿	fwjh
圽	fqrt
圼	jff
圸	fmh
圷	fghy
圶	dff
圵	fhg
圴	fqyy
圲	ftfh
圱	tdfg
圫	ftan
圧	dfd
圦	ftyy
圥	fqb
圤	fhy
圢	fsh
圡	fyi
圠	fnn
圞	lxys
圝	lxyx
圛	llff
圚	lkhm
圙	lwdd
圗	lcfd
圕	lvfj
圔	lfcl
圑	lgef
圐	llyv
圏	ludn
圎	lcmi
圌	lmdj
圅	cluf
圂	lei
圁	lyd
圀	lwyv
囼	lckd
囻	lnav
囸	lghd
囷	lti
囶	lwfd
図	luqi
囲	lfjk
囯	lgd
囬	mjdd
囬	ljfd
囩	lfci
囨	lgii
囧	lwmv
囦	lii
囥	lymv
団	lfi
囜	lci
囙	lnd
囘	mnv
囖	ktly
囕	kahq
囒	kaui
囐	khad
囏	akfk
囎	kmuj
囌	kaqt
囋	ktfm
囇	kgmx
囆	kajj
囄	kyby
囃	kywy
嚿	kawv
嚾	kaky
嚽	kgqm
嚻	kkdk
嚺	klup
嚹	krmh
嚸	klfk
嚵	kqky
嚲	ybkf
嚱	khaa
嚰	kysd
嚬	khim
嚫	kusq
嚪	kuqv
嚧	khal
嚥	kauo
嚢	gkhe
嚡	kaff
嚠	kqyj
嚟	ktqi
嚞	fkfk
嚝	kyaw
嚜	klff
嚛	kxrs
嚚	kkak
嚙	khwb
嚙	khbh
嚗	kjai
嚖	kdhn
嚔	kfph
嚒	kysx
嚑	ktgo
嚐	kipj
嚍	kvhl
嚋	kfnf
嚊	kthj
嚉	kogf
嚈	kdjd
嚄	kawc
嚂	kahl
噿	knyf
噾	kpwj
噽	fkug
噷	kujw
噵	uthk
噳	khad
噰	kyxy
噮	klge
噭	kryt
噧	kajy
噣	klqj
噡	kqdy
噟	ywwk
噞	kwgw
噛	khob
噚	kvaf
噖	kggn
噕	etnk
噒	koqh
噑	krif
噐	kkak
噏	kwgn
噋	kybt
噊	kcbk
噉	knbt
噈	kyin
噇	kujf
噆	kaqj
噅	keto
噄	kdhi
噃	ktol
噂	kusf
噁	kghn
噁	kgfn
噀	knnw
嘾	ksjh
嘽	kkkf
嘼	kklk
嘺	ktdk
嘷	kthf
嘳	kkhm
嘫	kqdo
嘪	klmy
嘩	kagf
嘨	kvoj
嘦	kwsv
嘥	kthh
嘢	kjfb
嘡	kipf
嘠	kdea
嘝	kqef
嘚	ktjf
嘙	kihv
嘕	kgho
嘒	kdhv
嘑	khah
嘐	knwe
嘋	kftt
嘊	kmdf
嘇	kcce
嘅	kvcq
嘄	kwvs
嘃	kyvh
嘂	kknk
嗿	kwym
嗼	kajd
嗻	kyao
嗺	kmwy
嗹	klpy
嗸	gqtk
嗴	kudc
嗱	kwgr
嗰	kwld
嗮	kjsg
嗭	fhkx
嗧	lkwa
嗢	kjlg
嗠	ebtk
嗙	kupy
嗘	kexd
嗗	kmeg
嗕	kdff
嗏	kaws
嗋	klle
嗊	kamy
嗈	kvkc
嗃	kymk
嗂	kerm
嗁	krhm
嗀	fpgc
喿	kkks
喼	kqvn
喺	kwti
喸	gehx
営	ipkk
喴	kdgt
喰	kwye
喯	kdfa
喭	kute
喫	kdhd
喩	kwgb
喨	kypm
喦	kkkm
喥	kyac
喤	krgg
喣	kqko
喢	ktfv
喡	knhh
喠	ktgf
喞	krxb
喛	kefc
喗	kplh
喖	ksdg
喕	kdmd
喓	ksvg
喒	kthj
喐	kdeb
喎	kmnk
喍	khxs
喌	kkyh
喅	kjug
啿	kadn
啽	kwga
啺	kjgr
啹	kndg
啳	kudb
啲	krqy
啱	kmdg
啫	kftj
啩	kffh
啨	kgeg
啢	kgmy
啠	rrkf
啝	ktkg
啛	kgvv
啚	kflk
啙	hxkk
啘	kpqb
啔	ynak
啒	knbm
啑	kgvh
啎	tfgk
啍	kybg
啌	kpwa
啋	kesy
啈	kfuf
啇	umdf
啅	khjh
啂	kebn
啀	kdff
唽	ksrh
唺	kmaw
唹	kywu
唶	kajg
唲	kvqn
唭	kadw
唫	kqg
唩	ktvg
唨	kbeg
唦	kiit
唥	kuwc
唟	fckx
唞	kruf
唜	gskx
唙	kqto
唘	dckf
唗	kfhy
唖	kgkg
唕	krfh
唓	klh
唒	ksgg
唎	ktjh
唍	kpfq
唌	kthp
唋	kwty
唊	kdww
唈	kkcn
唅	kwyk
唃	kqeh
唂	kwwk
唀	kten
哾	kukq
哻	kjfh
哹	kebg
哸	kevg
哷	kefy
哶	kgjf
哵	kklj
哴	kyve
哱	kfpb
哰	kprh
哯	khqn
哬	kwsk
哫	kkhy
哤	kdne
哣	kgku
哢	kgah
哠	ktfk
哛	kxwv
哘	ktfh
哖	krhf
哋	kfbn
哊	kdeg
哅	kqqb
哃	kmgk
咾	kftx
咺	kgjg
咹	kpvg
咷	kiqn
咶	ktdg
咵	kdfn
咲	kudy
咰	kqjg
咮	kriy
咥	kgcf
咢	kkfn
咡	kbg
咠	kbf
咟	kdjg
咞	kgah
咜	kpxn
咘	kdmh
咗	kdag
咓	kgnn
咑	krsh
咍	kckg
咊	kty
咉	kmdy
咈	kxjh
咇	kntt
咅	ukf
咃	kwbn
咁	kafg
呿	kfcy
呾	kjgg
呺	kkgn
呹	krwy
呰	hxkf
呮	kkwy
呭	kann
呫	khkg
呪	kkqn
呩	kfiy
呧	kqay
呥	kmfg
呡	knan
呠	ksgg
呟	kyxy
呞	kngk
呝	kynn
呚	kty
呑	tdkf
呏	ktah
呍	kfcy
呌	kufh
呉	kngw
呇	ikf
呅	kyy
呄	edf
呁	kqug
吿	rhkf
吺	kmcy
吷	knwy
吰	kdcy
吪	kwxn
吥	kgiy
吤	kwjh
吢	nkf
吚	kvtt
吙	koy
吘	ktfh
吇	kbg
吅	kkg
吂	ynkf
吀	ktfh
叿	kag
叾	bkf
叺	ktyy
叴	vkf
叧	kvb
叡	hpgc
叞	nfic
叝	fcbc
叜	pocu
叚	nhfc
叕	cccc
叓	gkhc
叒	cccu
叐	tdcu
叏	nhcu
収	nhcy
叅	cccn
叀	gjhc
厾	nfci
厽	cccu
厼	ciu
厺	dcu
厹	vcu
厸	ccy
厷	dcu
厵	drii
厳	idnt
厱	dwgw
厰	dimt
厯	dssn
厬	djtk
厫	dgqt
厪	dakg
厧	dfhw
厤	dtti
厡	drii
厠	dmjk
厞	ddjd
厜	dtgf
厛	dkrk
厗	duk
厖	ddne
厔	dgcf
厓	dffd
厒	drmk
厑	dkxv
厏	dthf
厎	dqay
厊	daht
厈	dfk
厇	dtav
厃	qdr
厁	wtub
厀	swib
卾	kkfb
卽	rxbh
卼	gqqb
卹	tlbh
卶	qqbh
卲	vkbh
卭	abh
卬	qbh
卪	byi
卨	hmnk
卥	hlry
卝	gjgd
卛	xyxf
卙	adwf
単	ijfj
卐	nghg
卐	ghgn
卍	nhgh
卍	hghn
卌	glk
卌	fjfh
卋	faf
卆	vfj
卄	aghh
卂	nfk
匽	ajvd
匼	awgk
匸	agn
匷	ahhy
匶	aawv
匵	aflm
匴	atha
匳	awgw
匲	adkk
匰	akkf
匬	awgj
匫	aqrj
匩	abhg
匨	anhf
匧	adww
匥	acak
匤	agyi
匢	aqre
匟	aymv
匞	aad
匜	abv
匛	aqyi
匘	xvtq
匔	qtmk
匓	qvcc
匒	qawk
匑	qtmx
匎	qdjn
匌	qwgk
匋	qrmk
匊	qoi
匉	qguh
匇	qqi
匄	qynv
匃	qwnv
匂	qxv
匁	qtyi
匁	qqi
勽	qwi
勼	qvv
勷	ykkl
勶	tycl
勴	hall
勲	tgjo
勯	ylkl
勮	hael
勭	ujfl
勬	udxl
勫	toll
勪	tdkl
勩	anml
勨	qjel
勧	rwyl
勦	vjsl
勥	xkjl
勡	sfil
勠	nwel
勜	wcnl
勗	jegl
勔	dmjl
勓	xxrl
勑	swwl
勏	ukln
勎	fwfl
勌	udbl
勊	dqlv
勈	celn
勆	yvcl
勄	txgl
勂	tfkl
勀	dqln
劽	gqjl
劻	agln
劺	crhl
効	uqln
劸	ffln
劷	udln
劶	rgkl
劵	udlb
労	iplb
劰	rln
劯	dln
劮	rwln
劧	rln
劦	lllb
劥	ymln
劤	rln
劜	lnn
劙	xejj
劘	yssj
劗	tfqj
劖	qkxj
劕	rrmj
劔	wgky
劒	wgky
劎	wgkv
劋	kkkj
劆	yuvj
劅	lqjj
劄	twgj
劀	cbtj
剾	akkj
剼	cccj
剻	meej
剺	fitv
剹	nwej
剸	gjhj
剷	uttj
剶	xejh
剳	awgj
剱	wgky
剰	tgaj
剭	ngcj
剬	mdmj
剫	yacj
剨	dhdj
剦	djnj
剤	yjjh
剤	yjfj
剣	wgkj
剢	eyjh
剠	yijh
剟	cccj
剚	gkvj
剙	uavw
剘	adwj
剗	aajh
剕	djdj
剓	tqtv
剒	ajjh
剏	uavy
剋	dqjk
剉	wwfj
剈	kejh
剆	yvcj
剅	gkuj
刼	fcvy
刵	bjh
刴	esjh
刲	ffjh
刱	fjvw
刯	gjgj
刧	fcvn
刦	fcjh
刣	ckjh
刢	wycj
刡	najh
刟	vkjh
刞	egjh
刜	xjjh
刕	vvvb
刔	nwjh
刓	fqjh
刐	myjh
刏	rnjh
刌	fjh
刋	tdjh
刉	tnjh
刅	vwi
刄	vyi
凾	bkcb
凷	fbk
凴	ucmb
凲	muvo
凮	mdjd
凬	mgjd
凪	mhd
凩	msi
凨	mfci
凧	mmhk
処	tmv
凥	nmv
凣	hmv
凢	tmv
凟	uflm
凞	utao
凚	ussi
凙	ulff
凘	uadr
凗	umwy
凖	uwyf
凕	upju
凔	uwyk
凓	ussy
凒	umgu
凐	usfg
凎	uqg
凅	uldg
凃	uwty
凂	uqkq
凁	ugki
冿	uvfh
冾	uwgk
冺	unan
冹	udcy
冸	uufh
冴	uaht
冭	duu
冩	pvqo
冨	pgkl
冧	pssu
冦	pfqc
冣	pbcu
冡	pgeu
冡	pfeu
冟	prxb
冞	pou
冝	pegf
冚	pmj
冘	pqv
冔	jkgf
冓	fjgf
冐	jef
冎	mnmb
冋	mkd
冇	dmb
円	mhgd
冄	mfd
冃	mfd
兿	urvc
兾	ulaw
兺	wvkx
兲	gwu
兯	ubj
兪	wgeb
兦	tynv
兤	iqyw
兣	dqdf
兡	dqdj
兠	urxq
兟	tfqq
兞	dqtn
兝	dqwv
兛	dqtf
兙	dqfk
兘	fqck
兓	aqaq
児	hjqb
兏	dhqv
兎	tkqy
兊	wcqb
兂	aqv
儾	wgke
儽	wlli
儹	wtfm
儸	wlxy
儶	wmwk
儴	wyke
儳	wqky
儱	wued
儰	waeo
儯	wudc
儮	wdth
儭	wusq
儬	wgeq
儫	wype
儩	wmjr
儨	wrrm
儧	wfwm
儥	wflm
儤	wjai
儣	wyaw
儢	whan
儠	wvln
儞	wgwq
儝	woos
儜	wpns
儛	wrlh
儚	walq
儙	wkhp
儘	wvhl
儗	wxth
儖	wahl
儓	wfkf
儑	wjxo
儏	whqo
儎	wfal
儍	wqot
儍	wobt
儌	wryt
儊	wssh
儅	wipl
儃	wylg
儁	wwym
僿	wpff
僽	wton
僼	wmau
僺	wkks
僸	wssi
僷	waas
僶	wxg
僶	wmgv
僴	wujg
僲	wsqh
僰	gmiw
僯	woqh
僫	wghn
僫	wgfn
僪	wcbk
僩	wueg
僤	wkkf
僣	wfwj
僢	weph
僡	wgjn
僠	wtol
僟	wxxt
僝	wnbb
僜	wwgu
僛	wadw
僙	wamw
僘	wimt
僗	wool
僔	wusf
僓	wkhm
僒	wpwk
僐	wudk
僎	wnnw
働	wtgl
僌	wlty
僋	wwym
僊	wsdn
僈	wjlc
僇	wnwe
僆	wlpy
僄	wsfi
僃	waqe
僁	wton
僀	waqh
傿	wgho
傽	wujh
傼	wakw
傹	wujq
傸	wdqq
傶	wdht
傱	wtwh
傰	wmee
傮	wgmj
傫	wlxi
傦	wmeg
傡	wuug
傠	wyfy
傟	wwcn
傞	wuda
傝	wjng
傜	werm
傛	wpwk
傚	wuqt
傗	wyxl
傔	wuvo
傓	wynn
傐	wymk
傏	wyvk
傎	wfhw
傌	wcy
傋	wfjf
傊	wkmy
傉	wdff
傇	wabg
傆	wdri
傄	wduh
傃	wgxi
傂	wrhm
傁	wvhc
偼	whvh
偺	wthj
偹	whtl
偸	wwgb
偳	wmdj
偱	wrfh
偯	wyey
偮	wkbg
偭	wdmd
偪	wgkl
偩	wqmy
偨	whxs
偧	wdqq
偦	wnhe
偤	wusg
偣	wujg
偢	wtoy
偡	wadn
偠	wsvg
偟	wrgg
偞	wans
偝	wuxe
偛	wtfv
偙	wuph
偘	wkkk
偗	with
偖	wftj
偔	wkkn
偒	wjgr
偑	wmtj
偐	wute
偍	wjgh
偋	wnua
偆	wdwj
偅	wtgf
偄	wdmd
偂	wuej
偁	wemf
偀	wamd
倿	wuvg
倽	wwfk
倻	wbbh
倹	wwgw
倸	wesy
倷	wdfi
倶	whgw
倴	wdfa
倳	wgkh
倲	wgji
倱	wjxx
倰	wfwt
倯	wswc
倧	wpfi
値	wfhn
倣	wyty
倢	wgvh
倠	wwyg
倞	wyiy
倝	fjwy
倛	wadw
倗	weeg
倓	wooy
倐	whto
倎	wmaw
倊	wwcn
倈	wsww
倇	wpqb
倅	wywf
倄	wqde
倃	wthk
倂	wtff
倁	wtdk
俿	wham
俽	wrqw
俼	wyce
俻	wtlg
俹	wghg
俹	wgfg
俷	wecn
俶	whic
俵	wgey
俴	waat
俲	wuql
俰	wtkg
俬	wtcy
俧	wfny
俥	wlh
俤	wuxt
俢	wtet
俛	wqkq
俙	wqdh
俖	wgik
俕	wpsy
俔	whqn
俓	wgva
俒	wpfq
俍	wyve
俌	wgey
俋	wkcn
俉	wgkg
俈	wtfk
俇	wqtg
俆	wwty
係	wtxi
俀	wevg
侾	wftb
侽	wlln
侼	wfpb
侻	wukq
侺	wmwn
侹	wtfp
侸	wgku
侷	wnnk
侴	wgnj
侳	wwwf
侲	wdfe
侱	wkgg
侰	wvtk
侫	wynv
侤	wftn
侢	wgmf
価	wsg
侟	wdhb
侞	wvkg
侜	wtey
侚	wqjg
侙	waag
侘	wpta
侕	wdmj
侓	wvfh
侒	wpvg
侐	wtlg
侎	woy
侌	wync
侊	wiqn
侇	wgxw
侅	wynw
侂	wyta
侁	wtfq
侀	wgaj
佽	wuqw
佹	wqdb
佸	wtdg
併	wuah
佲	wqkg
佱	wfhf
佮	wwgk
佭	wtah
佫	wtkg
佪	wlkg
佨	wqnn
佦	wdg
佢	wang
佡	wwmh
佖	wntt
佒	wmdy
佌	whxn
佋	wvkg
佊	whcy
佉	wfcy
佈	wdmh
佅	wfiy
佄	wafg
佂	wghg
佁	wckg
佀	whnn
伿	wkwy
伾	wgig
伻	wguh
伹	wegg
伵	wlg
伳	wann
伱	wwiy
伮	wvcy
伭	wyxy
伬	wnyy
伩	wyy
伨	wqug
伝	wfcy
伜	wvfh
伖	wdcy
伔	wpmn
伓	wgiy
伒	wrh
伌	wdbn
伋	weyy
伈	wny
伇	wmcy
伆	wqrt
伅	wgbn
伄	wxhh
伃	wcbh
伂	wgmh
伀	wwcy
仾	wgxg
仼	wgg
仺	wagf
仹	wdhh
仸	wtdy
仴	weg
仱	wwyn
仯	witt
仮	wrcy
仭	wvyy
仩	whg
仧	hwu
仦	wiy
仢	wqyy
仠	wfh
仜	wag
仛	wtan
仚	wmj
仒	wuu
仐	wfj
仏	wcy
仌	wwu
仈	wwy
亾	wnv
亽	wyu
亼	wgf
亷	utvo
亴	ypfv
亱	ywjg
亰	yjiu
亯	yjf
亪	yoyu
亣	yjj
亝	cccf
亜	gkjg
亗	mff
亖	fff
亐	fnv
亊	guvh
亇	qhj
亅	hhll
亄	fpgn
亃	oqan
亁	fjfn
亀	qjjn
乿	exin
乽	ftjn
乼	iygn
乻	ywun
乺	rnrn
乹	fjnn
乸	bxgu
乷	iitn
乶	gehn
乵	unn
乴	rrnb
乲	uqwn
乯	tuhn
乮	qtbn
乭	dnb
乬	annb
乫	lknb
乪	nld
乨	cknn
乧	ufnb
乥	tunb
乤	ghnb
乣	xnn
乢	mnn
乛	nnll
乚	nnll
乗	tgas
乕	rfmh
乑	tii
乊	tur
乆	nwi
乄	nyi
乂	qty
乁	yyll
乀	yyll
丼	fjyi
丷	uyt
丵	oguf
丳	kkjk
丱	njhg
丯	ehk
丮	nfhk
丩	nhk
丣	gajn
両	gmmk
丠	uxgf
丗	gmk
丗	gkgd
丒	vygf
丏	ghnn
丆	dgt
丅	ghk
丄	hgd
丂	gnv
〇	llll
万	dnv
与	gngd
丑	nfd
专	fnyi
业	ogd
丛	wwgf
东	aii
丝	xxgf
丢	tfcu
两	gmww
严	godr
丧	fueu
个	whj
丰	dhk
临	jtyj
为	ylyi
丽	gmyy
举	iwfh
么	tcu
义	yqi
乌	qngd
乐	qii
乔	tdjj
习	nud
乡	xte
书	nnhy
买	nudu
乱	tdnn
争	qvhj
于	gfk
亏	fnv
云	fcu
亘	gjgf
亚	gogd
产	ute
亩	ylf
亲	usu
亵	yrve
亸	ybuf
亿	wnn
仅	wcy
仆	why
从	wwy
仑	wxb
仓	wbb
仪	wyqy
们	wun
价	wwjh
众	wwwu
优	wdnn
伙	woy
会	wfcu
伛	waqy
伞	wuhj
伟	wfnh
传	wfny
伡	wlh
伣	wmqn
伤	wtln
伥	wtay
伦	wwxn
伧	wwbn
伪	wyly
伫	wpgg
体	wsgg
余	wtu
佣	weh
佥	wgif
侠	wguw
侣	wkkg
侥	watq
侦	whmy
侧	wmjh
侨	wtdj
侩	wwfc
侪	wyjh
侬	wpey
侭	wnyu
俣	wkgd
俦	wdtf
俨	wgod
俩	wgmw
俪	wgmy
俫	wgoy
俭	wwgi
债	wgmy
倾	wxdm
偬	wqrn
偻	wovg
偾	wfam
偿	wipc
傤	wfal
傥	wipq
傧	wprw
储	wyfj
傩	wcwy
僞	weto
儿	qtn
兌	wkqb
兖	ucqb
党	ipkq
兰	uff
关	udu
兴	iwu
兹	uxxu
养	udyj
兽	ulgk
冁	ujfe
内	mwi
冈	mqi
册	mmgd
冑	mef
冗	pmb
写	pgng
军	plj
农	pei
冯	ucg
冲	ukhh
决	unwy
况	ukqn
冻	uaiy
净	uqvh
凄	ugvv
准	uwyg
凉	uyiy
减	udgt
凑	udwd
凛	uyli
几	mtn
凤	mci
凫	qynm
凭	wtfm
凯	mnmn
凶	qbk
击	fmk
凿	ogub
刍	qvf
划	ajh
刘	yjh
则	mjh
刚	mqjh
创	wbjh
删	mmgj
别	kljh
刬	gjh
刭	cajh
刹	qsjh
刽	wfcj
刾	guwj
刿	mqjh
剀	mnjh
剂	yjjh
剐	kmwj
剑	wgij
剥	vijh
剧	ndjh
劝	cln
办	lwi
务	tlb
劢	dnln
动	fcln
励	ddnl
劲	caln
劳	aplb
势	rvyl
勋	kmln
勚	anml
勳	tgll
匀	qud
匦	alvv
匮	akhm
区	aqi
医	atdi
华	wxfj
协	flwy
单	ujfj
卖	fnud
占	hkf
卢	hne
卤	hlqi
卫	bgd
却	fcbh
卺	bigb
厂	dgt
厅	dsk
历	dlv
厉	ddnv
压	dfyi
厌	ddi
厍	dlk
厐	ddxv
厕	dmjk
厘	djfd
厢	dshd
厣	ddlk
厦	ddht
厨	dgkf
厩	dvcq
厮	dadr
县	egcu
参	cder
叄	cccd
叆	fcec
叇	fcvp
双	ccy
发	ntcy
变	yocu
叙	wtcy
叠	cccg
叶	kfh
号	kgnb
叹	kcy
叽	kmn
吁	kgfh
后	rgkd
吓	kghy
吕	kkf
吗	kcg
吣	kny
吨	kgbn
听	krh
启	ynkd
吴	kgdu
呐	kmwy
呒	kfqn
呓	kann
呕	kaqy
呖	kdln
呗	kmy
员	kmu
呙	kmwu
呛	kwbn
呜	kqng
咏	kyni
咙	kdxn
咛	kpsh
咝	kxxg
咤	kpta
咨	uqwk
咸	dgkt
响	ktmk
哑	kgog
哒	kdpy
哓	katq
哔	kxxf
哕	kmqy
哗	kwxf
哙	kwfc
哜	kyjh
哝	kpey
哟	kxqy
唇	dfek
唛	kgty
唝	kamy
唠	kapl
唡	kgmw
唢	kimy
唤	kqmd
啓	yntk
啧	kgmy
啬	fulk
啭	klfy
啮	khwb
啯	klgy
啰	klqy
啴	kujf
啸	kvij
喷	kfam
喽	kovg
喾	iptk
嗫	kbcc
嗳	kepc
嘆	kakw
嘘	khag
嘤	kmmv
嘱	knty
噜	kqgj
嚣	kkdk
团	lfte
囪	tlry
园	lfqv
围	lfnh
囵	lwxv
国	lgyi
图	ltui
圆	lkmi
圣	cff
圹	fyt
场	fnrt
坂	frcy
坏	fgiy
块	fnwy
坚	jcff
坛	ffcy
坜	fdln
坝	fmy
坞	fqng
坟	fyy
坠	bwff
垄	dxff
垅	fdxn
垆	fhnt
垒	cccf
垦	veff
垩	gogf
垫	rvyf
垭	fgog
垯	fdpy
垱	fivg
垲	fmnn
垴	fybh
埘	fjfy
埙	fkmy
埚	fkmw
埯	fdjn
堑	lrff
堕	bdef
塆	fyox
墙	ffuk
壮	ufg
声	fnr
壳	fpmb
壶	fpog
壸	fpgg
处	thi
备	tlf
复	tjtu
够	qkqq
头	udi
夸	dfnb
夹	guwi
夺	dfu
奁	daqu
奂	qmdu
奋	dlf
奖	uqdu
奥	tmod
妆	uvg
妇	vvg
妈	vcg
妝	nhdv
妩	vfqn
妪	vaqy
妫	vyly
姗	vmmg
姹	vpta
娄	ovf
娅	vgog
娆	vatq
娇	vtdj
娈	yovf
娱	vkgd
娲	vkmw
娴	vusy
婳	vglb
婴	mmvf
婵	vujf
婶	vpjh
媭	edmv
媼	vlwl
嫋	vxuu
嫒	vepc
嫔	vprw
嫱	vfuk
嫺	vueg
嬀	veto
嬷	vysc
孙	biy
学	ipbf
孪	yobf
宁	psj
宝	pgyu
实	pudu
宠	pdxb
审	pjhj
宪	ptfq
宫	pkkf
宽	pamq
宾	prgw
寝	puvc
对	cfy
寻	vfu
导	nfu
寿	dtfu
将	uqfy
尔	qiu
尘	iff
尝	ipfc
尧	atgq
尴	dnjl
尸	nngt
尽	nyuu
层	nfci
屃	nmi
屉	nanv
届	nmd
属	ntky
屡	novd
屦	ntov
屿	mgng
岁	mqu
岂	mnb
岖	maqy
岗	mmqu
岘	mmqn
岙	tdmj
岚	mmqu
岛	qynm
岩	mdf
岭	mwyc
岳	rgmj
岽	maiu
岿	mjvf
峃	ipmj
峄	mcfh
峡	mguw
峣	matq
峤	mtdj
峥	mqvh
峦	yomj
峰	mtdh
崂	mapl
崃	mgoy
崄	mwgi
崭	mlrj
嵘	maps
嵚	mqqw
嵝	movg
巅	mfhm
巩	amyy
巯	cayq
币	tmhk
帅	jmhh
师	jgmh
帏	mhfh
帐	mhty
帘	pwmh
帜	mhkw
带	gkph
帧	mhhm
帮	dtbh
帱	mhdf
帻	mhgm
帼	mhly
幂	pjdh
幞	mhoy
干	fggh
并	uaj
广	yygt
庄	yfd
庆	ydi
床	ysi
庐	yyne
庑	yfqv
库	ylk
应	yid
庙	ymd
庞	ydxv
废	ynty
庼	yxdm
廪	yyli
开	gak
异	naj
弃	ycaj
弑	qsaa
张	xtay
弥	xqiy
弪	xcag
弯	yoxb
弹	xujf
强	xkjy
归	jvg
当	ivf
录	viu
彟	vfac
彦	uter
彨	gmye
彻	tavn
征	tghg
径	tcag
徕	tgoy
忆	nnn
忏	ntfh
忧	ndnn
忾	nrnn
怀	ngiy
态	dynu
怂	wwnu
怃	nfqn
怄	naqy
怅	ntay
怆	nwbn
怜	nwyc
总	uknu
怼	cfnu
怿	ncfh
恋	yonu
恒	ngjg
恳	venu
恶	gogn
恸	nfcl
恹	nddy
恺	nmnn
恻	nmjh
恼	nybh
恽	nplh
悅	nwkq
悫	fpmn
悬	egcn
悭	njcf
悮	nkgd
悯	nuyy
惊	nyiy
惧	nhwy
惨	ncde
惩	tghn
惫	tlnu
惬	nagw
惭	nlrh
惮	nujf
惯	nxfm
愤	nfam
愦	nkhm
愿	drin
慍	nlwl
慑	nbcc
慭	godn
懑	iagn
懒	ngkm
懔	nyli
戆	ujtn
戋	gggt
戏	cat
戗	wbat
战	hkat
戬	goga
戯	haoa
戶	rnd
扑	rhy
托	rtan
执	rvyy
扩	ryt
扪	run
扫	rvg
扬	rnrt
扰	rdnn
抚	rfqn
抛	rvln
抟	rfny
抠	raqy
抡	rwxn
抢	rwbn
护	rynt
报	rbcy
担	rjgg
拟	rnyw
拢	rdxn
拣	ranw
拥	reh
拦	rufg
拧	rpsh
拨	rnty
择	rcfh
挂	rffg
挚	rvyr
挛	yorj
挜	rgog
挝	rfpy
挞	rdpy
挟	rguw
挠	ratq
挡	rivg
挢	rtdj
挣	rqvh
挤	ryjh
挥	rplh
挦	rvfy
挩	rwkq
捞	rapl
损	rkmy
捡	rwgi
换	rqmd
捣	rqym
据	rndg
掳	rhal
掴	rlgy
掷	rudb
掸	rujf
掺	rcde
掼	rxfm
揽	rjtq
揿	rqqw
搀	rqku
搁	rutk
搂	rovg
搄	rngg
搅	ripq
搵	rlwl
携	rwye
摄	rbcc
摅	rhan
摆	rlfc
摇	rerm
摈	rprw
摊	rcwy
撄	rmmv
撑	ripr
撵	rfwl
撷	rfkm
撸	rqgj
撺	rpwh
擜	rfmd
擞	rovt
擡	rfkf
攒	rtfm
敌	tdty
敓	wkqt
敘	wtty
敛	wgit
敩	ipbt
数	ovty
斋	ydmj
斓	yugi
斗	ufk
斩	lrh
断	onrh
无	fqv
旧	hjg
时	jfy
旷	jyt
旸	jnrt
昙	jfcu
昵	jnxn
昼	nyjg
昽	jdxn
显	jogf
晋	gogj
晒	jsg
晓	jatq
晔	jwxf
晕	jplj
晖	jplh
暂	lrjf
暅	jngg
暧	jepc
术	syi
朴	shy
机	smn
杀	qsu
杂	vsu
权	scy
杠	sag
条	tsu
来	goi
杨	snrt
杩	scg
杰	sou
松	swcy
极	seyy
构	sqcy
枞	swwy
枢	saqy
枣	gmiu
枥	sdln
枧	smqn
枨	stay
枪	swbn
枫	smqy
枭	qyns
柜	sang
柠	spsh
柺	skln
柽	scfg
栀	srgb
栅	smmg
标	sfiy
栈	sgt
栉	sabh
栊	sdxn
栋	saiy
栌	shnt
栎	sqiy
栏	sufg
树	scfy
栖	ssg
栗	ssu
样	sudh
栾	yosu
桠	sgog
桡	satq
桢	shmy
档	sivg
桤	smnn
桥	stdj
桦	swxf
桧	swfc
桨	uqsu
桩	syfg
桪	svfy
梁	ivws
梦	ssqu
梲	swkq
梼	sdtf
梾	sgoy
梿	slpy
检	swgi
棂	svoy
棱	sfwt
椁	sybg
椝	fwms
椟	sfnd
椠	lrsu
椢	slgy
椤	slqy
椫	sujf
椭	sbde
椮	scde
楼	sovg
榄	sjtq
榇	susy
榈	sukk
榉	siwh
榝	sqsc
榲	slwl
槚	ssmy
槛	sjtl
槟	sprw
槠	syfj
横	samw
樯	sfuk
樱	smmv
橥	qtfs
橱	sdgf
橹	sqgj
橼	sxxe
檩	syli
檯	sfkf
欢	cqwy
欤	gngw
欧	aqqw
歼	gqtf
殁	gqmc
殇	gqtr
残	gqgt
殒	gqkm
殓	gqwi
殚	gquf
殡	gqpw
殴	aqmc
毁	vamc
毂	fplc
毕	xxfj
毙	xxgx
毡	tfnk
毵	cden
毶	tfne
氇	tfnj
气	rnb
氢	rnca
氩	rngg
氳	rnll
汇	ian
汉	icy
汤	inrt
汹	iqbh
沟	iqcy
没	imcy
沣	idhh
沤	iaqy
沥	idln
沦	iwxn
沧	iwbn
沨	imqy
沩	iyly
沪	iynt
泞	ipsh
泪	ihg
泶	ipiu
泷	idxn
泸	ihnt
泺	iqiy
泻	ipgg
泼	inty
泽	icfh
泾	icag
洁	ifkg
洒	isg
洼	iffg
浃	iguw
浅	igt
浆	uqiu
浇	iatq
浈	ihmy
浉	ijgh
浊	ijy
测	imjh
浍	iwfc
济	iyjh
浏	iyjh
浐	iutt
浑	iplh
浒	iytf
浓	ipey
浔	ivfy
浕	inyu
涂	iwty
涌	iceh
涗	iwkq
涛	idtf
涝	iapl
涞	igoy
涟	ilpy
涠	ilfh
涡	ikmw
涢	ikmy
涣	iqmd
涤	itsy
润	iugg
涧	iujg
涨	ixty
涩	ivyh
淀	ipgh
渊	itoh
渌	iviy
渍	igmy
渎	ifnd
渐	ilrh
渑	ikjn
渔	iqgg
渖	ipjh
渗	icde
游	iytb
湾	iyox
湿	ijog
溁	iaps
溃	ikhm
溅	imgt
溆	iwtc
溇	iovg
溫	ilwl
溼	igxf
滗	ittn
滚	iuce
滞	igkh
滟	idhc
滠	ibcc
满	iagw
滢	iapy
滤	ihan
滥	ijtl
滦	iyos
滨	iprw
滩	icwy
滪	icbm
潆	iapi
潇	iavj
潋	iwgt
潍	ixwy
潙	ieto
潜	ifwj
潨	itli
潴	iqtj
澛	iqgj
澜	iugi
濑	igkm
濒	ihim
灏	ijym
灭	goi
灯	osh
灵	vou
灾	pou
灿	omh
炀	onrt
炉	oynt
炖	ogbn
炜	ofnh
炝	owbn
点	hkou
炼	oanw
炽	okwy
烁	oqiy
烂	oufg
烃	ocag
烛	ojy
烟	oldy
烦	odmy
烧	oatq
烨	owxf
烩	owfc
烫	inro
烬	onyu
热	rvyo
焕	oqmd
焖	ouny
焘	dtfo
熅	olwl
熏	tglo
爱	epdc
爲	etno
爷	wqbj
牍	thgd
牦	trtn
牵	dprh
牺	trsg
犊	trfd
状	udy
犷	qtyt
犸	qtcg
犹	qtdn
狈	qtmy
狝	qtqi
狞	qtps
独	qtjy
狭	qtgw
狮	qtjh
狯	qtwc
狰	qtqh
狱	qtyd
狲	qtbi
猃	qtwi
猎	qtaj
猕	qtxi
猡	qtlq
猪	qtfj
猫	qtal
猬	qtle
献	fmud
獭	qtgm
玑	gmn
玙	ggng
玚	gnrt
玛	gcg
玮	gfnh
环	ggiy
现	gmqn
玱	gwbn
玺	qigy
珐	gfcy
珑	gdxn
珰	givg
珲	gplh
琎	gfjp
琏	glpy
琐	gimy
琼	gyiy
瑶	germ
瑷	gepc
瑸	gprw
璎	gmmv
瓒	gtfm
瓮	wcgn
瓯	aqgn
电	jnv
画	glbj
畅	jhnr
畴	ldtf
疖	ubk
疗	ubk
疟	uagd
疠	udnv
疡	unre
疬	udlv
疭	uwwi
疮	uwbv
疯	umqi
疱	uqnv
疴	uskd
痈	uek
痉	ucad
痒	uudk
痖	ugog
痨	uapl
痪	uqmd
痫	uusi
痹	ulgj
瘅	uujf
瘆	ucde
瘗	uguf
瘘	uovd
瘪	uthx
瘫	ucwy
瘾	ubqn
瘿	ummv
癞	ugkm
癡	uxth
癣	uqgd
癫	ufhm
皁	rfj
皑	rmnn
皱	qvhc
皲	plhc
盏	glf
盐	fhlf
监	jtyl
盖	uglf
盗	uqwl
盘	telf
眍	haqy
眦	hhxn
眬	hdxn
睁	hqvh
睐	hgoy
睑	hwgi
瞆	hkhm
瞒	hagw
瞩	hnty
矫	tdtj
矶	dmn
矾	dmyy
矿	dyt
砀	dnrt
码	dcg
砖	dfny
砗	dlh
砚	dmqn
砜	dmqy
砺	dddn
砻	dxdf
砾	dqiy
础	dbmh
硁	dcag
硕	ddmy
硖	dguw
硗	datq
硙	dmnn
硚	dtdj
确	dqeh
硵	dhlq
硷	dwgi
碍	djgf
碛	dgmy
碜	dcde
碱	ddgt
礼	pynn
祃	pycg
祎	pyfh
祢	pyqi
祯	pyhm
祷	pydf
祸	pykw
禀	ylki
禄	pyvi
禅	pyuf
离	ybmc
秃	tmb
秆	tfh
种	tkhh
秘	tntt
积	tkwy
称	tqiy
秽	tmqy
秾	tpey
稅	twkq
稆	tkkg
稣	qgty
稳	tqvn
穑	tfuk
穞	tqgj
穷	pwlb
窃	pwav
窍	pwan
窎	pwqg
窑	pwrm
窜	pwkh
窝	pwkw
窥	pwfq
窦	pwfd
窭	pwov
竈	pwfx
竈	pwfv
竖	jcuf
竞	ukqb
笃	tcf
笋	tvtr
笔	ttfn
笕	tmqb
笺	tgr
笼	tdxb
笾	tlpu
筑	tamy
筚	txxf
筛	tjgh
筜	tivf
筝	tqvh
筹	tdtf
筼	tkmu
签	twgi
筿	ttsu
简	tujf
箓	tviu
箦	tgmu
箧	tagw
箨	trch
箩	tlqu
箪	tujf
箫	tvij
篑	tkhm
篓	tovf
篮	tjtl
篯	tqgr
篱	tybc
簖	tonr
籁	tgkm
籴	tyou
类	odu
籼	omh
粜	bmou
粝	oddn
粤	tlon
粪	oawu
粮	oyve
糁	ocde
糇	ownd
糉	oqbt
糍	ouxx
紧	jcxi
絷	rvyi
縆	xngg
縕	xlwl
繮	xglg
纔	xqky
纟	xxxx
纠	xnhh
纡	xgfh
红	xag
纣	xfy
纤	xtfh
纥	xtnn
约	xqyy
级	xeyy
纨	xvyy
纩	xyt
纪	xnn
纫	xvyy
纬	xfnh
纭	xfcy
纮	xdcy
纯	xgbn
纰	xxxn
纱	xitt
纲	xmqy
纳	xmwy
纴	xtfg
纵	xwwy
纶	xwxn
纷	xwvn
纸	xqan
纹	xyy
纺	xyn
纻	xpgg
纼	xxhh
纽	xnfg
纾	xcbh
线	xgt
绀	xafg
绁	xann
绂	xdcy
练	xanw
组	xegg
绅	xjhh
细	xlg
织	xkwy
终	xtuy
绉	xqvg
绊	xufh
绋	xxjh
绌	xbmh
绍	xvkg
绎	xcfh
经	xcag
绐	xckg
绑	xdtb
绒	xadt
结	xfkg
绔	xdfn
绕	xatq
绖	xgcf
绗	xtfh
绘	xwfc
给	xwgk
绚	xqjg
绛	xtah
络	xtkg
绝	xqcn
绞	xuqy
统	xycq
绠	xgjq
绡	xieg
绢	xkeg
绣	xten
绤	xwwk
绥	xevg
绦	xtsy
继	xonn
绨	xuxt
绩	xgmy
绪	xftj
绫	xfwt
绬	xamd
续	xfnd
绮	xdsk
绯	xdjd
绰	xhjh
绱	ximk
绲	xjxx
绳	xkjn
维	xwyg
绵	xrmh
绶	xepc
绷	xeeg
绸	xmfk
绹	xqrm
绺	xthk
绻	xudb
综	xpfi
绽	xpgh
绾	xpnn
绿	xviy
缀	xccc
缁	xvlg
缂	xafh
缃	xshg
缄	xdgt
缅	xdmd
缆	xjtq
缇	xjgh
缈	xhit
缉	xkbg
缊	xjlg
缋	xkhm
缌	xlny
缍	xtgf
缎	xwdc
缏	xwgq
缐	xriy
缑	xwnd
缒	xwnp
缓	xefc
缔	xuph
缕	xovg
编	xyna
缗	xnaj
缘	xxey
缙	xgoj
缚	xgef
缛	xdff
缜	xfhw
缝	xtdp
缞	xyke
缟	xymk
缠	xyjf
缡	xybc
缢	xuwl
缣	xuvo
缤	xprw
缥	xsfi
缦	xjlc
缧	xlxi
缨	xmmv
缩	xpwj
缪	xnwe
缫	xvjs
缬	xfkm
缭	xdui
缮	xudk
缯	xulj
缰	xglg
缱	xkhp
缲	xkks
缳	xlge
缴	xryt
缵	xtfm
罂	mmrm
网	mqqi
罗	lqu
罚	lyjj
罢	lfcu
罴	lfco
羁	lafc
羟	udca
羡	uguw
群	vtkd
翘	atgn
翙	mqng
翚	nplj
耢	dial
耧	diov
耸	wwbf
耻	bhg
聂	bccu
聋	dxbf
职	bkwy
聍	bpsh
联	budy
聩	bkhm
聪	bukn
肃	vijk
肠	enrt
肤	efwy
肮	eymn
肴	qdef
肾	jcef
肿	ekhh
胀	etay
胁	elwy
胆	ejgg
胜	etgg
胧	edxn
胨	eaiy
胪	ehnt
胫	ecag
胶	euqy
脉	eyni
脍	ewfc
脏	eyfg
脐	eyjh
脑	eybh
脓	epey
脔	yomw
脚	efcb
脫	ewkq
脶	ekmw
脸	ewgi
腊	eajg
腌	edjn
腘	elgy
腭	ekkn
腻	eafm
腼	edmd
腾	eudc
膃	elwl
膑	eprw
膻	eylg
臜	etfm
臥	ahnw
臺	fkpf
舆	wflw
舣	teyq
舰	temq
舱	tewb
舻	tehn
艰	cvey
艳	dhqc
艺	anb
节	abj
芈	gjgh
芗	axtr
芜	afqb
芦	aynr
苁	awwu
苇	afnh
苈	adlb
苋	amqb
苌	atay
苍	awbb
苎	apgf
苏	alwu
苘	amkf
苹	aguh
范	aibb
茎	acaf
茏	adxb
茑	aqyg
茔	apff
茕	apnf
茧	aju
荆	agaj
荐	adhb
荙	adpu
荚	aguw
荛	aatq
荜	axxf
荝	amjj
荞	atdj
荟	awfc
荠	ayjj
荡	ainr
荣	apsu
荤	aplj
荥	apiu
荦	aprh
荧	apou
荨	avfu
荩	anyu
荪	abiu
荫	abef
荬	anud
荭	axaf
荮	axfu
药	axqy
莅	awuf
莱	agou
莲	alpu
莳	ajfu
莴	akmw
莶	awgi
获	aqtd
莸	aqtn
莹	apgy
莺	apqg
莼	axgn
萚	arch
萝	alqu
萤	apju
营	apkk
萦	apxi
萧	avij
萨	abut
蒇	admt
蒉	akhm
蒋	auqf
蒌	aovf
蒏	apsg
蒕	alwl
蓝	ajtl
蓟	aqgj
蓠	aybc
蓣	acbm
蓥	apqf
蓦	ajdc
蔂	alxi
蔥	atln
蔷	afuk
蔹	awgt
蔺	auwy
蔼	ayjn
蔿	aeto
蕰	aijl
蕲	aujr
蕴	axjl
薮	aovt
藓	aqgd
蘊	axll
蘖	awns
虏	halv
虑	hani
虚	haog
虫	jhny
虬	jnn
虮	jmn
虱	ntji
虽	kju
虾	jghy
虿	dnju
蚀	qnjy
蚁	jyqy
蚂	jcg
蚃	xtju
蚕	gdju
蚝	jtfn
蚬	jmqn
蛊	jlf
蛎	jddn
蛏	jcfg
蛮	yoju
蛰	rvyj
蛱	jguw
蛲	jatq
蛳	jjgh
蛴	jyjh
蛻	jwkq
蜗	jkmw
蜡	jajg
蝇	jkjn
蝈	jlgy
蝉	jujf
蝎	jjqn
蝼	jovg
蝾	japs
螀	uqfj
螨	jagw
蟏	javj
衅	tluf
衆	tlti
衔	tqfh
衛	tnhh
补	puhy
衬	pufy
衮	uceu
袄	putd
袅	qyne
袆	pufh
袜	pugs
袭	dxye
袯	puny
装	ufye
裆	puiv
裈	pupl
裢	pulp
裣	puwi
裤	puyl
裥	puuj
褛	puov
褴	pujl
襕	puui
覈	sryt
见	mqb
观	cmqn
觃	mqbd
规	fwmq
觅	emqb
视	pymq
觇	hkmq
览	jtyq
觉	ipmq
觊	mnmq
觋	awwq
觌	fnuq
觍	mawq
觎	wgeq
觏	fjgq
觐	akgq
觑	haoq
觞	qetr
触	qejy
觯	qeuf
訚	uyd
詟	dxyf
誉	iwyf
誊	udyf
說	ywkq
讠	yyn
计	yfh
订	ysh
讣	yhy
认	ywy
讥	ymn
讦	yfh
讧	yag
讨	yfy
让	yhg
讪	ymh
讫	ytnn
讬	ytan
训	ykh
议	yyqy
讯	ynfh
记	ynn
讱	yvyy
讲	yfjh
讳	yfnh
讴	yaqy
讵	yang
讶	yaht
讷	ymwy
许	ytfh
讹	ywxn
论	ywxn
讻	yqbh
讼	ywcy
讽	ymqy
设	ymcy
访	yyn
诀	ynwy
证	yghg
诂	ydg
诃	yskg
评	yguh
诅	yegg
识	ykwy
诇	ymkg
诈	ythf
诉	yryy
诊	ywet
诋	yqay
诌	yqvg
词	yngk
诎	ybmh
诏	yvkg
诐	yhcy
译	ycfh
诒	yckg
诓	yagg
诔	ydiy
试	yaag
诖	yffg
诗	yffy
诘	yfkg
诙	ydoy
诚	ydnt
诛	yriy
诜	ytfq
话	ytdg
诞	ythp
诟	yrgk
诠	ywgg
诡	yqdb
询	yqjg
诣	yxjg
诤	yqvh
该	yynw
详	yudh
诧	ypta
诨	yplh
诩	yng
诪	ydtf
诫	yaah
诬	yaww
语	ygkg
诮	yieg
误	ykgd
诰	ytfk
诱	yten
诲	ytxu
诳	yqtg
说	yukq
诵	yceh
诶	yctd
请	ygeg
诸	yftj
诹	ybcy
诺	yadk
读	yfnd
诼	yeyy
诽	ydjd
课	yjsy
诿	ytvg
谀	yvwy
谁	ywyg
谂	ywyn
调	ymfk
谄	yqvg
谅	yyiy
谆	yybg
谇	yywf
谈	yooy
谉	ypjh
谊	ypeg
谋	yafs
谌	yadn
谍	yans
谎	yayq
谏	ygli
谐	yxxr
谑	yhag
谒	yjqn
谓	yleg
谔	ykkn
谕	ywgj
谖	yefc
谗	yqku
谘	yuqk
谙	yujg
谚	yute
谛	yuph
谜	yopy
谝	yyna
谞	ynhe
谟	yajd
谠	yipq
谡	ylwt
谢	ytmf
谣	yerm
谤	yupy
谥	yuwl
谦	yuvo
谧	yntl
谨	yakg
谩	yjlc
谪	yumd
谫	yuev
谬	ynwe
谭	ysjh
谮	yaqj
谯	ywyo
谰	yugi
谱	yuoj
谲	ycbk
谳	yfmd
谴	ykhp
谵	yqdy
谶	ywwg
豮	efam
贗	dwwm
贝	mhny
贞	hmu
负	qmu
贠	cmu
贡	amu
财	mftt
责	gmu
贤	jcmu
败	mty
账	mtay
货	wxmu
质	rfmi
贩	mrcy
贪	wynm
贫	wvmu
贬	mtpy
购	mqcy
贮	mpgg
贯	xfmu
贰	afmi
贱	mgt
贲	famu
贳	anmu
贴	mhkg
贵	khgm
贶	mkqn
贷	wamu
贸	qyvm
费	xjmu
贺	lkmu
贻	mckg
贼	madt
贽	rvym
贾	smu
贿	mdeg
赀	hxmu
赁	wtfm
赂	mtkg
赃	myfg
资	uqwm
赅	mynw
赆	mnyu
赇	mfiy
赈	mdfe
赉	gomu
赊	mwfi
赋	mgah
赌	mftj
赍	fwwm
赎	mfnd
赏	ipkm
赐	mjqr
赑	mmmu
赒	mmfk
赓	yvwm
赔	mukg
赕	mooy
赖	gkim
赗	mjhg
赘	gqtm
赙	mgef
赚	muvo
赛	pfjm
赜	ahkm
赝	dwwm
赞	tfqm
赟	ygam
赠	mulj
赡	mqdy
赢	ynky
赣	ujtm
赪	fohm
赵	fhqi
赶	fhfk
趋	fhqv
趱	fhtm
趸	dnkh
跃	khtd
跄	khwb
跞	khqi
践	khgt
跶	khdp
跷	khaq
跸	khxf
跹	khtp
跻	khyj
踊	khce
踌	khdf
踪	khpi
踬	khrm
踯	khub
蹑	khbc
蹒	khaw
蹰	khdf
蹿	khph
躏	khay
躜	khtm
躯	tmdq
轀	llwl
车	lgnh
轧	lnn
轨	lvn
轩	lfh
轪	ldy
轫	lvyy
转	lfny
轭	ldbn
轮	lwxn
软	lqwy
轰	lccu
轱	ldg
轲	lskg
轳	lhnt
轴	lmg
轵	lkwy
轶	lrwy
轷	ltuh
轸	lwet
轹	lqiy
轺	lvkg
轻	lcag
轼	laag
载	falk
轾	lgcf
轿	ltdj
辀	ltey
辁	lwgg
辂	ltkg
较	luqy
辄	lbnn
辅	lgey
辆	lgmw
辇	fwfl
辈	djdl
辉	iqpl
辊	ljxx
辋	lmun
辌	lyiy
辍	lccc
辎	lvlg
辏	ldwd
辐	lgkl
辑	lkbg
辒	ljlg
输	lwgj
辔	xlxk
辕	lfke
辖	lpdk
辗	lnae
辘	lynx
辙	lyct
辚	loqh
辞	tduh
辟	nkuh
辩	uyuh
辫	uxuh
边	lpv
辽	bpk
达	dpi
迁	tfpk
过	fpi
迈	dnpv
运	fcpi
还	gipi
这	ypi
进	fjpk
远	fqpv
违	fnhp
连	lpk
迟	nypi
迩	qipi
迳	capd
迹	yopi
适	tdpd
选	tfqp
逊	bipi
递	uxhp
逦	gmyp
逻	lqpi
遗	khgp
遥	ermp
邓	cbh
邝	ybh
邬	qngb
邮	mbh
邹	qvbh
邺	ogbh
邻	wycb
郁	debh
郏	guwb
郐	wfcb
郑	udbh
郓	plbh
郦	gmyb
郧	kmbh
郸	ujfb
酂	tfqb
酝	sgfc
酦	sgny
酱	uqsg
酽	sggd
酾	sggy
酿	sgye
醞	sgll
采	esu
释	toch
里	jfd
鉢	qsgg
鉤	qqkg
鉴	jtyq
銮	yoqf
銳	qwkq
錾	lrqf
钅	qtgn
钆	qnn
钇	qnn
针	qfh
钉	qsh
钊	qjh
钋	qhy
钌	qbh
钍	qfg
钎	qtfh
钏	qkh
钐	qet
钑	qeyy
钒	qmyy
钓	qqyy
钔	qun
钕	qvg
钖	qnrt
钗	qcyy
钘	qgah
钙	qghn
钚	qgiy
钛	qdyy
钜	qang
钝	qgbn
钞	qitt
钟	qkhh
钠	qmwy
钡	qmy
钢	qmqy
钣	qrcy
钤	qwyn
钥	qeg
钦	qqwy
钧	qqug
钨	qqng
钩	qqcy
钪	qymn
钫	qyn
钬	qoy
钭	qufh
钮	qnfg
钯	qcn
钰	qgyy
钱	qgt
钲	qghg
钳	qafg
钴	qdg
钵	qsgg
钶	qskg
钷	qakg
钸	qdmh
钹	qdcy
钺	qant
钻	qhkg
钼	qhg
钽	qjgg
钾	qlh
钿	qlg
铀	qmg
铁	qrwy
铂	qrg
铃	qwyc
铄	qqiy
铅	qmkg
铆	qqtb
铇	qqnn
铈	qymh
铉	qyxy
铊	qpxn
铋	qntt
铌	qnxn
铍	qhcy
铎	qcfh
铏	qgaj
铐	qftn
铑	qftx
铒	qbg
铓	qayn
铔	qgog
铕	qdeg
铖	qdnt
铗	qguw
铘	qahb
铙	qatq
铚	qgcf
铛	qivg
铜	qmgk
铝	qkkg
铞	qkmh
铟	qldy
铠	qmnn
铡	qmjh
铢	qriy
铣	qtfq
铤	qtfp
铥	qtfc
铦	qtdg
铧	qwxf
铨	qwgg
铩	qqsy
铪	qwgk
铫	qiqn
铬	qtkg
铭	qqkg
铮	qqvh
铯	qqcn
铰	quqy
铱	qyey
铲	qutt
铳	qycq
铴	qinr
铵	qpvg
银	qvey
铷	qvkg
铸	qdtf
铹	qapl
铺	qgey
铻	qgkg
铼	qgoy
铽	qany
链	qlpy
铿	qjcf
销	qieg
锁	qimy
锂	qjfg
锃	qkgg
锄	qegl
锅	qkmw
锆	qtfk
锇	qtrt
锈	qten
锉	qwwf
锊	qefy
锋	qtdh
锌	quh
锍	qycq
锎	quga
锏	qujg
锐	qukq
锑	quxt
锒	qyve
锓	qvpc
锔	qnnk
锕	qbsk
锖	qgeg
锗	qftj
锘	qadk
错	qajg
锚	qalg
锛	qdfa
锜	qdsk
锝	qjgf
锞	qjsy
锟	qjxx
锠	qjjg
锡	qjqr
锢	qldg
锣	qlqy
锤	qtgf
锥	qwyg
锦	qrmh
锧	qrfm
锨	qrqw
锩	qudb
锪	qqrn
锫	qukg
锬	qooy
锭	qpgh
键	qvfp
锯	qndg
锰	qblg
锱	qvlg
锲	qdhd
锳	qamd
锴	qxxr
锵	quqf
锶	qlny
锷	qkkn
锸	qtfv
锹	qtoy
锺	qtgf
锻	qwdc
锼	qvhc
锽	qrgg
锾	qefc
锿	qyey
镀	qyac
镁	qugd
镂	qovg
镃	quxx
镄	qxjm
镅	qnhg
镆	qajd
镇	qfhw
镈	qgef
镉	qgkh
镊	qbcc
镋	qipq
镌	qwye
镍	qths
镎	qwgr
镏	qqyl
镐	qymk
镑	qupy
镒	quwl
镓	qpey
镔	qprw
镕	qpwk
镖	qsfi
镗	qipf
镘	qjlc
镙	qlxi
镚	qmee
镛	qyvh
镜	qujq
镝	qumd
镞	qytd
镟	qyth
镠	qnwe
镡	qsjh
镢	qduw
镣	qdui
镤	qogy
镥	qqgj
镦	qybt
镧	qugi
镨	quoj
镩	qpwh
镪	qxkj
镫	qwgu
镬	qawc
镭	qflg
镮	qlge
镯	qlqj
镰	qyuo
镱	qujn
镲	qpwi
镳	qyno
镴	qvln
镵	qqky
镶	qyke
长	tayi
閱	uwkq
门	uyhn
闩	ugd
闪	uwi
闫	udd
闬	ufk
闭	ufte
问	ukd
闯	ucd
闰	ugd
闱	ufnh
闲	usi
闳	udci
间	ujd
闵	uyi
闶	uymv
闷	uni
闸	ulk
闹	uymh
闺	uffd
闻	ubd
闼	udpi
闽	uji
闾	ukkd
闿	umnv
阀	uwae
阁	utkd
阂	uynw
阃	ulsi
阄	uqjn
阅	uukq
阆	uyve
阇	uftj
阈	uakg
阉	udjn
阊	ujjd
阋	uvqv
阌	uepc
阍	uqaj
阎	uqvd
阏	uywu
阐	uujf
阑	ugli
阒	uhdi
阓	ukhm
阔	uitd
阕	uwgd
阖	ufcl
阗	ufhw
阘	ujnd
阙	uubw
阚	unbt
阛	ulge
队	bwy
阳	bjg
阴	beg
阵	blh
阶	bwjh
际	bfiy
陆	bfmh
陇	bdxn
陈	baiy
陉	bcag
陕	bguw
陦	bdtf
陧	bjfg
陨	bkmy
险	bwgi
随	bdep
隐	bqvn
隶	vii
隽	wyeb
难	cwyg
雇	ynwy
雏	qvwy
雠	wyyy
雳	fdlb
雾	ftlb
霁	fyjj
霉	ftxu
霡	feyi
霭	fyjn
靓	gemq
靔	gern
静	geqh
靥	dddl
鞑	afdp
鞒	aftj
鞯	afab
鞲	afff
韦	fnhk
韧	fnhy
韨	fnhc
韩	fjfh
韪	jghh
韫	fnhl
韬	fnhv
韵	ujqu
页	dmu
顶	sdmy
顷	xdmy
顸	fdmy
项	admy
顺	kdmy
须	edmy
顼	gdmy
顽	fqdm
顾	dbdm
顿	gbnm
颀	rdmy
颁	wvdm
颂	wcdm
颃	ymdm
预	cbdm
颅	hndm
领	wycm
颇	hcdm
颈	cadm
颉	fkdm
颊	guwm
颋	tfpm
颌	wgkm
颍	xidm
颎	xodm
颏	yntm
颐	ahkm
频	hidm
颒	iadm
颓	tmdm
颔	wynm
颕	xfim
颖	xtdm
颗	jsdm
题	jghm
颙	jmhm
颚	kkfm
颛	mdmm
颜	utem
额	ptkm
颞	bccm
颟	agmm
颠	fhwm
颡	cccm
颢	jyim
颣	oxim
颤	ylkm
颥	fdmm
颦	hidf
颧	akkm
风	mqi
飏	mqnr
飐	mqhk
飑	mqqn
飒	umqy
飓	mqhw
飔	mqln
飕	mqvc
飖	ermq
飗	mqql
飘	sfiq
飙	dddq
飚	mqoo
飞	nui
飨	xtwe
餍	ddwe
饣	qnb
饤	qnsh
饥	qnmn
饦	qnta
饧	qnnr
饨	qngn
饩	qnrn
饪	qntf
饫	qntd
饬	qntl
饭	qnrc
饮	qnqw
饯	qngt
饰	qnth
饱	qnqn
饲	qnnk
饳	qnbm
饴	qnck
饵	qnbg
饶	qnaq
饷	qntk
饸	qnwk
饹	qntk
饺	qnuq
饻	qnye
饼	qnua
饽	qnfb
饾	qngu
饿	qntt
馀	qnwt
馁	qnev
馂	qnct
馃	qnjs
馄	qnjx
馅	qnqv
馆	qnpn
馇	qnsg
馈	qnkm
馉	qnme
馊	qnvc
馋	qnqu
馌	qnfl
馍	qnad
馎	qngf
馏	qnql
馐	qnuf
馑	qnag
馒	qnjc
馓	qnat
馔	qnnw
馕	qnge
马	cnng
驭	ccy
驮	cdy
驯	ckh
驰	cbn
驱	caqy
驲	cjg
驳	cqqy
驴	cynt
驵	cegg
驶	ckqy
驷	clg
驸	cwfy
驹	cqkg
驺	cqvg
驻	cygg
驼	cpxn
驽	vccf
驾	lkcf
驿	ccfh
骀	cckg
骁	catq
骂	kkcf
骃	cldy
骄	ctdj
骅	cwxf
骆	ctkg
骇	cynw
骈	cuah
骉	cccf
骊	cgmy
骋	cmgn
验	cwgi
骍	cuh
骎	cvpc
骏	ccwt
骐	cadw
骑	cdsk
骒	cjsy
骓	cwyg
骔	cpfi
骕	cvij
骖	ccde
骗	cyna
骘	bhic
骙	cwgd
骚	ccyj
骛	cbtc
骜	gqtc
骝	cqyl
骞	pfjc
骟	cynn
骠	csfi
骡	clxi
骢	ctln
骣	cnbb
骤	cbci
骥	cuxw
骦	cfsh
骧	cyke
髅	meov
髋	mepq
髌	mepw
鬓	depw
鬶	fwmh
魇	ddrc
魉	rqcw
鰮	qoll
鱉	umio
鱼	qgf
鱽	qgvn
鱾	qgnn
鱿	qgdn
鲀	qggn
鲁	qgjf
鲂	qgyn
鲃	qgcn
鲄	qgsk
鲅	qgdc
鲆	qggh
鲇	qghk
鲈	qghn
鲉	qgmg
鲊	qgtf
鲋	qgwf
鲌	qgrg
鲍	qgqn
鲎	ipqg
鲏	qghc
鲐	qgck
鲑	qgff
鲒	qgfk
鲓	qgfn
鲔	qgde
鲕	qgdj
鲖	qgmk
鲗	qgmj
鲘	qgrk
鲙	qgwc
鲚	qgyj
鲛	qguq
鲜	qgud
鲝	udqg
鲞	udqg
鲟	qgvf
鲠	qggq
鲡	qggy
鲢	qglp
鲣	qgjf
鲤	qgjf
鲥	qgjf
鲦	qgts
鲧	qgti
鲨	iitg
鲩	qgpq
鲪	qgvk
鲫	qgvb
鲬	qgce
鲭	qgge
鲮	qgft
鲯	qgaw
鲰	qgbc
鲱	qgdd
鲲	qgjx
鲳	qgjj
鲴	qgld
鲵	qgvq
鲶	qgwn
鲷	qgmk
鲸	qgyi
鲹	qgce
鲺	qgnj
鲻	qgvl
鲼	qgfm
鲽	qgas
鲾	qggl
鲿	qgic
鳀	qgjh
鳁	qgjl
鳂	qgle
鳃	qgln
鳄	qgkn
鳅	qgto
鳆	qgtt
鳇	qgrg
鳈	qgri
鳉	qguf
鳊	qgya
鳋	qgcj
鳌	gqtg
鳍	qgfj
鳎	qgjn
鳏	qgli
鳐	qgem
鳑	qguy
鳒	qguo
鳓	qgal
鳔	qgsi
鳕	qgfv
鳖	umig
鳗	qgjc
鳘	txgg
鳙	qgyh
鳚	qgnf
鳛	qgnr
鳜	qgdw
鳝	qguk
鳞	qgoh
鳟	qguf
鳠	qgac
鳡	qgdn
鳢	qgmu
鳣	qgyg
鳤	qgtn
鸟	qyng
鸠	vqyg
鸡	cqyg
鸢	aqyg
鸣	kqyg
鸤	nqyg
鸥	aqqg
鸦	ahtg
鸧	wbqg
鸨	xfqg
鸩	pqqg
鸪	dqyg
鸫	aiqg
鸬	hnqg
鸭	lqyg
鸮	kgng
鸯	mdqg
鸰	wycg
鸱	qayg
鸲	qkqg
鸳	qbqg
鸴	ipqg
鸵	qynx
鸶	xxgg
鸷	rvyg
鸸	dmjg
鸹	tdqg
鸺	wsqg
鸻	tfhg
鸼	teqg
鸽	wgkg
鸾	yoqg
鸿	iaqg
鹀	awwg
鹁	fpbg
鹂	gmyg
鹃	keqg
鹄	tfkg
鹅	trng
鹆	wwkg
鹇	usqg
鹈	uxhg
鹉	gahg
鹊	ajqg
鹋	alqg
鹌	djng
鹍	jxxg
鹎	rtfg
鹏	eeqg
鹐	qvqg
鹑	ybqg
鹒	yvwg
鹓	pqbg
鹔	vijg
鹕	deqg
鹖	jqwg
鹗	kkfg
鹘	meqg
鹙	toqg
鹚	uxxg
鹛	nhqg
鹜	cbtg
鹝	gkmg
鹞	ermg
鹟	wcng
鹠	qyvg
鹡	iweg
鹢	uwlg
鹣	uvog
鹤	pwyg
鹥	atdg
鹦	mmvg
鹧	yaog
鹨	nweg
鹩	dujg
鹪	wyog
鹫	yidg
鹬	cbtg
鹭	khtg
鹮	lgkg
鹯	ylkg
鹰	ywwg
鹱	qync
鹲	apgg
鹲	apfg
鹳	akkg
鹴	fshg
鹾	hlqa
麦	gtu
麸	gtfw
麹	gtqo
麺	gtdd
麽	yssc
黄	amwu
黉	ipaw
黡	ddlo
黩	lfod
黪	lfoe
黾	kjnb
鼋	fqkn
鼌	jgkn
鼍	kkln
鼗	iqfc
鼹	vnuv
齄	thlg
齐	yjj
齑	ydjj
齿	hwbj
龀	hwbx
龁	hwbn
龂	hwbr
龃	hwbg
龄	hwbc
龅	hwbn
龆	hwbk
龇	hwbx
龈	hwbe
龉	hwbk
龊	hwbh
龋	hwby
龌	hwbf
龙	dxv
龚	dxaw
龛	wgkx
龟	qjnb
