拚	fs
後	ry
囗	uv
馀	ur
捱	fi
摺	fx
珮	wj
箝	vf
濛	dc
齄	za
垅	ty
挢	fp
疋	vv
頫	vy
硷	er
矇	mc
舨	vp
堀	tu
镙	jt
囝	wz
菸	cf
谘	yd
榘	ua
蹓	zp
慄	xx
跫	gz
揎	fg
臁	og
猓	qo
傢	rg
呯	kp
痖	bh
舡	vg
熳	ho
妺	nh
蹧	zh
睏	mw
廾	hp
蚵	ik
糸	yx
窆	xp
渖	dg
哜	kw
啯	kw
缍	si
蠛	ic
謦	uy
髟	ip
铓	jc
讬	yp
暸	od
搿	fr
丌	hp
厶	vd
揲	fn
惓	xb
迍	tz
朊	oe
氽	ru
匚	hv
嫋	ng
唻	kl
缏	sr
	dd
	jy
麴	lb
鳋	yy
鳆	yr
阢	eh
钸	ju
钶	jk
醣	yg
軎	ik
蟓	id
虍	bv
膪	ol
膣	ox
肜	op
缋	sv
礤	ec
砩	ef
猸	qm
沲	dr
榀	ak
楱	as
攵	ri
攴	by
擗	fu
揞	fl
憝	wx
彐	vh
弪	gs
庀	gb
巛	vv
坶	tm
佧	ru
乇	pq
鼟	ud
鼕	uw
鬠	ir
鬙	ib
骻	gd
鞥	gr
霂	yd
阨	ei
阓	mv
锠	jo
铦	jq
鈤	jo
酖	yg
邅	wz
這	yz
迆	yz
辸	nz
踰	zr
踡	zb
踄	zv
跼	zu
跩	zo
貍	po
谉	yg
诪	yf
觍	dj
蝨	vi
蜰	oi
蜅	if
葧	hu
萬	co
菎	co
莻	cn
苳	cw
苢	cu
臢	on
脣	io
脌	or
肐	or
聤	ew
聓	ge
耲	lw
羺	yy
羶	yw
籧	vh
簑	vw
筽	vk
筊	vl
祫	ur
碔	ew
硸	eu
硵	eb
硃	ep
砢	ek
眛	mh
皰	pb
瘧	bh
痳	ba
痀	bb
瓰	wf
瑩	hw
犺	qw
犛	hi
燐	hm
煖	ha
煆	hk
焾	hr
災	vh
瀽	dg
濬	db
沴	dr
汙	de
歞	od
歔	hd
欬	wd
檛	ak
槥	af
柮	ai
柤	aq
枱	as
枂	ao
曚	oc
旡	hv
旕	fk
敠	yb
敁	bb
攃	fc
揹	fb
扥	fp
懞	xc
慓	xx
愒	xo
悗	xd
怗	xb
彣	wp
彔	vu
彑	vv
彊	gh
屰	bc
尫	hw
尛	xx
孶	wz
嫳	bn
奼	np
奻	nn
墑	tl
囸	wh
囜	ws
喨	kw
啂	ka
唶	kg
唡	kh
唜	hk
唈	kk
咾	kt
吂	wk
卲	de
匽	ko
劻	kl
偟	rb
倆	rh
俬	rh
仒	rd
乻	fv
丟	ws
彿	rf
拏	nf
褔	yh
搲	fx
𠝹	td
啹	ku
㑩	rs
冚	gu
呪	kk
咑	kf
嗰	kr
嗱	kr
噉	kv
嬤	ng
燘	hm
牠	ny
琍	wh
罉	px
肶	ob
脷	oh
